Candidate Name,DOB,Registration Number,State,Maths,Physics,English,GK,Total Marks,PFT
Rohan Khan,16-04-2006,252951,Bihar,22,22,24,24,92,Pass
Peter D'Souza,23-12-2005,512318,Bihar,24,24,24,19,91,Pass
Aryan D'Souza,08-11-2004,568557,Bihar,19,24,23,21,87,Pass
Balbir Mehta,30-11-2005,347502,Bihar,22,24,24,16,86,Pass
Balbir Khan,02-01-2006,599971,Bihar,24,16,22,24,86,Pass
Krishna Pillai,05-01-2006,992320,Bihar,24,21,22,19,86,Pass
Krishna Fernandes,04-12-2004,959458,Bihar,24,15,23,23,85,Pass
Raj Chopra,01-02-2005,237835,Bihar,22,24,19,20,85,Pass
Rehan D'Souza,18-03-2005,337958,Bihar,23,20,22,20,85,Pass
Krishna Mehta,08-07-2005,974823,Bihar,23,17,21,24,85,Pass
Vivaan Verma,02-11-2005,397785,Bihar,20,22,22,21,85,Pass
Aarav Sharma,24-04-2006,923490,Bihar,20,21,20,24,85,Pass
Ishaan Mehta,26-04-2006,874262,Bihar,16,24,22,23,85,Pass
Krishna Pillai,23-01-2005,385879,Bihar,24,24,21,15,84,Pass
Aarav Singh,11-03-2005,215605,Bihar,14,24,22,24,84,Pass
Aditya Chopra,23-11-2005,386860,Bihar,24,17,22,21,84,Pass
Aditya Mehta,27-11-2005,738784,Bihar,20,16,24,24,84,Pass
Vivaan Singh,31-01-2005,988111,Bihar,22,23,18,20,83,Pass
Aditya Fernandes,31-03-2005,430190,Bihar,24,15,20,24,83,Pass
Aarav Fernandes,18-08-2005,177931,Bihar,20,19,24,20,83,Pass
Paul Reddy,05-01-2006,325532,Bihar,23,21,15,24,83,Pass
Manpreet Chopra,02-05-2006,195285,Bihar,16,24,21,22,83,Pass
Raj Sharma,03-02-2005,746154,Bihar,14,22,24,22,82,Pass
Rehan Khan,26-05-2005,674980,Bihar,21,22,15,24,82,Pass
Aditya Mehta,31-05-2005,754922,Bihar,17,19,24,22,82,Pass
Aarav Fernandes,24-07-2005,344408,Bihar,23,24,19,16,82,Pass
John D'Souza,27-08-2005,648348,Bihar,13,24,23,22,82,Pass
Rohan D'Souza,29-01-2006,843643,Bihar,23,21,20,18,82,Pass
Imran Fernandes,13-11-2004,648365,Bihar,21,16,22,22,81,Pass
Kunal Singh,31-03-2005,155903,Bihar,23,13,22,23,81,Pass
Kunal Chopra,02-04-2005,947895,Bihar,24,13,20,24,81,Pass
Sukhwinder Singh,23-07-2005,417643,Bihar,17,22,21,21,81,Pass
Mathew Khan,30-11-2005,374369,Bihar,20,21,23,17,81,Pass
Kunal Singh,29-12-2005,146858,Bihar,12,22,23,24,81,Pass
Vivaan Reddy,16-02-2006,179688,Bihar,20,16,22,23,81,Pass
Aryan Fernandes,15-04-2006,195765,Bihar,21,24,17,19,81,Pass
Ishaan Sharma,30-11-2004,380911,Bihar,23,21,17,19,80,Pass
Aarav Mehta,17-12-2004,269344,Bihar,18,20,20,22,80,Pass
Aryan Verma,16-01-2005,172383,Bihar,24,22,14,20,80,Pass
Mathew Mehta,30-01-2005,816829,Bihar,24,15,18,23,80,Pass
Aarav Reddy,04-02-2005,108311,Bihar,23,18,17,22,80,Pass
Sukhwinder Mehta,07-06-2005,232873,Bihar,24,10,22,24,80,Pass
Yash Pillai,07-07-2005,464585,Bihar,21,23,16,20,80,Pass
Krishna Khan,16-08-2005,118289,Bihar,18,17,24,21,80,Pass
Harjeet Mehta,06-04-2006,397731,Bihar,24,24,12,20,80,Pass
Manpreet Mehta,06-12-2004,880152,Bihar,21,24,23,11,79,Pass
Vivaan Khan,06-02-2005,965348,Bihar,21,23,13,22,79,Pass
Aryan D'Souza,26-02-2005,956029,Bihar,22,21,24,12,79,Pass
Vivaan Verma,17-04-2005,377099,Bihar,14,23,20,22,79,Pass
Aditya Verma,19-05-2005,465379,Bihar,17,21,23,18,79,Pass
Imran Fernandes,16-06-2005,833111,Bihar,17,16,23,23,79,Pass
Aditya D'Souza,22-09-2005,373620,Bihar,24,24,9,22,79,Pass
Aditya D'Souza,26-11-2005,858952,Bihar,19,19,22,19,79,Pass
Harjeet D'Souza,24-01-2006,871491,Bihar,23,18,18,20,79,Pass
Raj Singh,21-02-2006,905640,Bihar,23,15,17,24,79,Pass
Mathew Sharma,04-05-2006,180946,Bihar,24,20,17,18,79,Pass
Yash Pillai,11-12-2004,586778,Bihar,15,24,21,18,78,Pass
Manpreet Mehta,15-01-2005,669152,Bihar,24,17,21,16,78,Pass
Harjeet Fernandes,26-01-2005,675998,Bihar,13,24,18,23,78,Pass
Krishna Pillai,24-02-2005,241939,Bihar,17,21,23,17,78,Pass
Ishaan Fernandes,21-05-2005,214444,Bihar,22,22,15,19,78,Pass
Krishna Fernandes,25-08-2005,853088,Bihar,18,24,17,19,78,Pass
Krishna Singh,03-09-2005,976387,Bihar,23,22,11,22,78,Pass
Aarav Sharma,29-09-2005,852293,Bihar,20,18,22,18,78,Pass
Kunal Reddy,05-10-2005,667428,Bihar,22,20,17,19,78,Pass
Aditya Pillai,24-11-2005,251743,Bihar,18,17,21,22,78,Pass
Rohan Pillai,08-12-2005,473669,Bihar,24,17,24,13,78,Pass
Raj Khan,16-01-2006,586091,Bihar,17,17,23,21,78,Pass
Aryan D'Souza,27-03-2006,865691,Bihar,23,8,24,23,78,Pass
Rohan Verma,01-05-2006,246424,Bihar,24,18,20,16,78,Pass
John D'Souza,08-05-2006,407672,Bihar,19,22,19,18,78,Pass
Harjeet Khan,10-11-2004,927594,Bihar,21,24,10,22,77,Pass
Aarav Singh,24-11-2004,372681,Bihar,23,19,16,19,77,Pass
Aditya Mehta,25-03-2005,922728,Bihar,23,22,23,9,77,Pass
Raj Sharma,27-03-2005,330150,Bihar,24,23,17,13,77,Pass
Krishna Sharma,15-04-2005,957758,Bihar,22,12,24,19,77,Pass
Rohan Fernandes,11-05-2005,150168,Bihar,20,23,13,21,77,Pass
John Verma,26-05-2005,886412,Bihar,21,23,11,22,77,Pass
Paul Singh,07-07-2005,703378,Bihar,24,8,24,21,77,Pass
Raj D'Souza,29-07-2005,159222,Bihar,14,18,21,24,77,Pass
Yash Singh,14-10-2005,319768,Bihar,12,23,21,21,77,Pass
Rohan D'Souza,11-11-2005,790861,Bihar,24,20,9,24,77,Pass
Vivaan Sharma,15-11-2005,605740,Bihar,12,17,24,24,77,Pass
Kunal Pillai,03-03-2006,209487,Bihar,24,13,24,16,77,Pass
Yash Singh,12-11-2004,399156,Bihar,20,15,20,21,76,Pass
Yash Chopra,12-12-2004,236553,Bihar,24,18,16,18,76,Pass
Manpreet Fernandes,13-12-2004,649063,Bihar,20,14,19,23,76,Pass
Aditya Fernandes,30-12-2004,964254,Bihar,22,16,14,24,76,Pass
Gurpreet Singh,01-01-2005,228941,Bihar,14,24,14,24,76,Pass
Rohan Khan,15-03-2005,391510,Bihar,20,20,12,24,76,Pass
Aarav Singh,28-04-2005,703250,Bihar,22,22,22,10,76,Pass
Krishna Reddy,03-07-2005,747995,Bihar,13,21,20,22,76,Pass
David Reddy,25-08-2005,667746,Bihar,18,16,19,23,76,Pass
Yash Singh,07-09-2005,629367,Bihar,13,24,24,15,76,Pass
Raj Fernandes,03-11-2005,282870,Bihar,24,22,11,19,76,Pass
Aditya D'Souza,22-11-2005,993293,Bihar,8,23,22,23,76,Pass
Sukhwinder Verma,21-02-2006,296754,Bihar,15,23,21,17,76,Pass
Peter Khan,15-03-2006,131206,Bihar,20,16,24,16,76,Pass
Harjeet Singh,30-11-2004,414135,Bihar,17,19,19,20,75,Pass
Aditya Sharma,16-12-2004,621750,Bihar,21,17,21,16,75,Pass
Balbir Singh,01-03-2005,902986,Bihar,7,24,24,20,75,Pass
Aditya Reddy,24-04-2005,674803,Bihar,24,14,24,13,75,Pass
Rohan D'Souza,05-06-2005,859509,Bihar,14,14,24,23,75,Pass
Rohan Khan,17-07-2005,169519,Bihar,14,22,20,19,75,Pass
Krishna Fernandes,21-07-2005,343364,Bihar,22,16,24,13,75,Pass
Rohan Singh,02-08-2005,743623,Bihar,24,23,12,16,75,Pass
Kunal Singh,18-08-2005,454197,Bihar,21,17,14,23,75,Pass
Ishaan Khan,16-09-2005,664752,Bihar,20,24,18,13,75,Pass
Mathew D'Souza,04-11-2005,514766,Bihar,19,21,17,18,75,Pass
Aryan Chopra,17-11-2005,493703,Bihar,24,12,16,23,75,Pass
Yash Sharma,23-11-2005,423084,Bihar,13,23,21,18,75,Pass
Rohan Pillai,14-12-2005,894486,Bihar,24,24,4,23,75,Pass
Mathew Reddy,14-02-2006,860736,Bihar,21,6,24,24,75,Pass
Gurpreet D'Souza,19-02-2006,459710,Bihar,19,15,21,20,75,Pass
Yash Khan,23-02-2006,826411,Bihar,14,23,24,14,75,Pass
Yash Reddy,07-03-2006,561407,Bihar,19,10,22,24,75,Pass
Vivaan Khan,09-03-2006,930696,Bihar,15,23,22,15,75,Pass
Yash Khan,10-03-2006,865954,Bihar,11,24,18,22,75,Pass
Krishna Fernandes,07-05-2006,690808,Bihar,19,12,23,21,75,Pass
Aarav Singh,03-12-2004,214759,Bihar,20,22,10,22,74,Pass
Vivaan Sharma,14-12-2004,714743,Bihar,21,23,18,12,74,Pass
Peter Khan,22-04-2005,840627,Bihar,15,14,21,24,74,Pass
Vivaan Verma,06-05-2005,426791,Bihar,23,20,11,20,74,Pass
Kunal D'Souza,30-05-2005,757353,Bihar,16,23,17,18,74,Pass
Vivaan Verma,17-10-2005,878095,Bihar,15,20,22,17,74,Pass
Aarav D'Souza,20-10-2005,351340,Bihar,20,12,24,18,74,Pass
Ishaan D'Souza,21-10-2005,370524,Bihar,9,22,22,21,74,Pass
Aryan Verma,14-02-2006,901328,Bihar,8,23,22,21,74,Pass
Aditya Fernandes,06-04-2006,873133,Bihar,13,22,15,24,74,Pass
Aditya Sharma,22-04-2006,336837,Bihar,16,19,23,16,74,Pass
Aditya Sharma,11-11-2004,212636,Bihar,23,24,9,17,73,Pass
Sukhwinder D'Souza,14-11-2004,949793,Bihar,24,9,21,19,73,Pass
Krishna Fernandes,16-11-2004,341172,Bihar,8,22,19,24,73,Pass
Krishna Fernandes,12-12-2004,299680,Bihar,23,17,11,22,73,Pass
David D'Souza,17-03-2005,404767,Bihar,17,17,20,19,73,Pass
Yash Reddy,08-04-2005,651778,Bihar,22,14,19,18,73,Pass
Ishaan Mehta,17-04-2005,758462,Bihar,7,22,20,24,73,Pass
Vivaan Mehta,31-05-2005,892401,Bihar,21,21,19,12,73,Pass
Yash Pillai,11-06-2005,221170,Bihar,22,24,11,16,73,Pass
John Verma,16-06-2005,216733,Bihar,24,11,16,22,73,Pass
Vivaan Chopra,27-08-2005,391012,Bihar,18,24,20,11,73,Pass
John Fernandes,30-08-2005,470074,Bihar,23,16,16,18,73,Pass
Gurpreet Singh,01-09-2005,511562,Bihar,15,20,19,19,73,Pass
Vivaan Chopra,26-09-2005,867795,Bihar,22,21,16,14,73,Pass
Gurpreet D'Souza,27-09-2005,794069,Bihar,14,15,22,22,73,Pass
Paul Pillai,05-10-2005,885785,Bihar,20,12,24,17,73,Pass
Krishna Reddy,28-12-2005,125584,Bihar,21,18,13,21,73,Pass
Raj Mehta,05-01-2006,957590,Bihar,13,22,21,17,73,Pass
Krishna Singh,28-01-2006,577806,Bihar,18,12,20,23,73,Pass
Vivaan Pillai,10-02-2006,955203,Bihar,19,12,24,18,73,Pass
Rohan Mehta,12-02-2006,469036,Bihar,21,21,9,22,73,Pass
Aditya Verma,17-02-2006,703982,Bihar,23,17,18,15,73,Pass
Raj Sharma,22-02-2006,986674,Bihar,22,14,22,15,73,Pass
Aryan Sharma,08-03-2006,790379,Bihar,18,16,20,19,73,Pass
Rohan Singh,23-04-2006,486770,Bihar,24,17,19,13,73,Pass
Aditya Reddy,25-04-2006,548349,Bihar,22,13,21,17,73,Pass
Raj Reddy,12-11-2004,227602,Bihar,19,9,23,21,72,Pass
Zaid Fernandes,14-11-2004,641272,Bihar,24,16,9,23,72,Pass
Ishaan Pillai,06-12-2004,152144,Bihar,23,23,14,12,72,Pass
Rohan Sharma,07-12-2004,650782,Bihar,7,23,18,24,72,Pass
Krishna Mehta,29-12-2004,151348,Bihar,13,20,22,17,72,Pass
Rohan Pillai,18-01-2005,852147,Bihar,8,21,23,20,72,Pass
Peter D'Souza,08-02-2005,316531,Bihar,14,23,22,13,72,Pass
Paul D'Souza,12-02-2005,675201,Bihar,24,12,21,15,72,Pass
Raj Pillai,18-02-2005,404209,Bihar,22,20,9,21,72,Pass
Aryan Verma,18-02-2005,128784,Bihar,21,18,16,17,72,Pass
Aditya Verma,19-02-2005,477384,Bihar,20,23,12,17,72,Pass
Raj Verma,05-03-2005,487360,Bihar,15,13,21,23,72,Pass
Rohan D'Souza,18-03-2005,444618,Bihar,14,21,17,20,72,Pass
Vivaan Sharma,30-03-2005,672008,Bihar,20,22,21,9,72,Pass
Vivaan Fernandes,01-05-2005,491594,Bihar,24,22,6,20,72,Pass
Raj Reddy,04-06-2005,858428,Bihar,21,19,11,21,72,Pass
Yash Chopra,02-08-2005,149929,Bihar,15,15,19,23,72,Pass
Rohan Pillai,09-08-2005,130985,Bihar,12,20,18,22,72,Pass
Vivaan Chopra,27-08-2005,114836,Bihar,21,19,9,23,72,Pass
Rohan Sharma,30-08-2005,159405,Bihar,19,16,19,18,72,Pass
Aarav Fernandes,27-12-2005,658621,Bihar,23,19,21,9,72,Pass
Aarav Fernandes,27-12-2005,975842,Bihar,21,22,7,22,72,Pass
Kunal Reddy,13-03-2006,827736,Bihar,18,21,20,13,72,Pass
Rohan D'Souza,30-03-2006,815626,Bihar,21,19,8,24,72,Pass
Rohan D'Souza,05-04-2006,498588,Bihar,18,21,15,18,72,Pass
Manpreet Singh,08-04-2006,899298,Bihar,6,21,22,23,72,Pass
David Fernandes,15-04-2006,780537,Bihar,6,22,20,24,72,Pass
Rohan Fernandes,17-04-2006,200092,Bihar,15,19,20,18,72,Pass
Raj Khan,15-11-2004,694183,Bihar,19,20,24,8,71,Pass
Aditya Mehta,29-12-2004,345671,Bihar,23,24,11,13,71,Pass
Rehan Verma,04-01-2005,151365,Bihar,24,17,17,13,71,Pass
Rohan Fernandes,08-01-2005,247348,Bihar,22,16,15,18,71,Pass
Vivaan Chopra,16-02-2005,254803,Bihar,15,13,23,20,71,Pass
Gurpreet Chopra,06-03-2005,915221,Bihar,15,21,22,13,71,Pass
Ishaan D'Souza,02-06-2005,848972,Bihar,20,14,23,14,71,Pass
Krishna Verma,27-06-2005,783798,Bihar,5,24,24,18,71,Pass
Rohan D'Souza,07-08-2005,677994,Bihar,10,16,21,24,71,Pass
Vivaan Verma,11-08-2005,931417,Bihar,9,21,22,19,71,Pass
Yash Khan,09-10-2005,331817,Bihar,24,22,17,8,71,Pass
Aryan Sharma,27-10-2005,875368,Bihar,16,15,20,20,71,Pass
Yash Reddy,07-12-2005,616221,Bihar,9,24,21,17,71,Pass
Manpreet Fernandes,12-12-2005,555949,Bihar,19,21,15,16,71,Pass
Aarav Pillai,14-12-2005,257902,Bihar,23,22,7,19,71,Pass
Mathew Chopra,16-12-2005,660154,Bihar,12,19,19,21,71,Pass
Balbir Sharma,19-12-2005,454480,Bihar,19,7,22,23,71,Pass
John Mehta,11-01-2006,886139,Bihar,18,20,16,17,71,Pass
Aarav D'Souza,04-03-2006,538582,Bihar,14,21,14,22,71,Pass
Yash Pillai,19-04-2006,287190,Bihar,21,12,16,22,71,Pass
Yash D'Souza,04-12-2004,791460,Bihar,14,23,21,12,70,Pass
Manpreet D'Souza,26-12-2004,239893,Bihar,10,22,14,24,70,Pass
Rehan Sharma,01-01-2005,789296,Bihar,10,24,18,18,70,Pass
Yash D'Souza,17-01-2005,961832,Bihar,17,20,20,13,70,Pass
Yash Verma,02-04-2005,322759,Bihar,18,24,10,18,70,Pass
Harjeet Verma,03-04-2005,885775,Bihar,12,21,14,23,70,Pass
Mathew Reddy,12-04-2005,941345,Bihar,17,16,18,19,70,Pass
Rohan D'Souza,08-05-2005,210056,Bihar,12,17,19,22,70,Pass
Mathew Reddy,14-06-2005,589121,Bihar,13,21,13,23,70,Pass
Ishaan Pillai,18-06-2005,274343,Bihar,23,8,23,16,70,Pass
Aryan Khan,24-06-2005,364648,Bihar,16,20,23,11,70,Pass
Mathew Pillai,30-06-2005,430749,Bihar,15,13,21,21,70,Pass
Kunal Fernandes,02-07-2005,256351,Bihar,20,15,22,13,70,Pass
Krishna Verma,13-08-2005,378231,Bihar,22,18,14,16,70,Pass
Ishaan Khan,21-08-2005,337915,Bihar,13,24,24,9,70,Pass
Aditya Reddy,02-09-2005,389145,Bihar,5,22,20,23,70,Pass
Ishaan Verma,18-09-2005,150401,Bihar,14,12,23,21,70,Pass
Yash Pillai,22-11-2005,981497,Bihar,15,21,23,11,70,Pass
Zaid Sharma,30-11-2005,888372,Bihar,17,23,13,17,70,Pass
Yash Fernandes,19-12-2005,370699,Bihar,11,20,21,18,70,Pass
Gurpreet Chopra,01-01-2006,577314,Bihar,22,20,16,12,70,Pass
Aryan Verma,09-01-2006,169062,Bihar,12,23,21,14,70,Pass
Aryan Chopra,11-01-2006,732962,Bihar,11,21,17,21,70,Pass
Yash Verma,14-01-2006,158194,Bihar,22,16,13,19,70,Pass
Aarav Verma,19-03-2006,171798,Bihar,15,20,11,24,70,Pass
Raj Mehta,21-03-2006,782526,Bihar,15,18,15,22,70,Pass
Harjeet D'Souza,26-03-2006,807574,Bihar,13,23,16,18,70,Pass
Aditya Fernandes,31-03-2006,583333,Bihar,18,17,17,18,70,Pass
Balbir Pillai,03-04-2006,410255,Bihar,17,15,21,17,70,Pass
Yash Reddy,23-04-2006,459803,Bihar,22,13,11,24,70,Pass
Kunal D'Souza,23-11-2004,480720,Bihar,16,20,24,9,69,Pass
Manpreet Singh,14-12-2004,595690,Bihar,9,21,24,15,69,Pass
Raj Pillai,19-12-2004,797436,Bihar,20,8,21,20,69,Pass
Sukhwinder Fernandes,23-12-2004,319559,Bihar,19,11,16,23,69,Pass
Ishaan Mehta,26-12-2004,284469,Bihar,18,12,19,20,69,Pass
Rohan Verma,29-12-2004,774831,Bihar,23,19,8,19,69,Pass
Krishna Pillai,31-12-2004,461886,Bihar,16,14,19,20,69,Pass
Aryan Chopra,19-01-2005,218201,Bihar,14,13,23,19,69,Pass
Yash Mehta,30-01-2005,122375,Bihar,4,20,23,22,69,Pass
John Singh,09-02-2005,596229,Bihar,19,13,18,19,69,Pass
Kunal Khan,10-02-2005,374546,Bihar,4,19,22,24,69,Pass
Rohan Verma,23-03-2005,589817,Bihar,23,18,24,4,69,Pass
Ishaan Mehta,02-05-2005,174418,Bihar,6,21,23,19,69,Pass
Aarav Sharma,06-05-2005,429506,Bihar,20,18,12,19,69,Pass
Ishaan D'Souza,09-05-2005,425564,Bihar,14,21,21,13,69,Pass
Ishaan Verma,18-05-2005,747444,Bihar,24,21,6,18,69,Pass
Yash Fernandes,26-05-2005,657455,Bihar,17,17,11,24,69,Pass
Kunal Reddy,12-06-2005,168385,Bihar,6,15,24,24,69,Pass
Aryan Khan,17-06-2005,977252,Bihar,23,17,10,19,69,Pass
Sukhwinder Verma,19-06-2005,749387,Bihar,19,22,15,13,69,Pass
Vivaan Verma,20-06-2005,336581,Bihar,24,14,18,13,69,Pass
Aryan Singh,24-06-2005,478898,Bihar,23,9,14,23,69,Pass
Aryan Mehta,01-07-2005,373172,Bihar,18,13,24,14,69,Pass
Rohan Pillai,15-07-2005,385572,Bihar,21,5,20,23,69,Pass
Aryan Mehta,22-07-2005,538529,Bihar,8,21,17,23,69,Pass
Harjeet Mehta,19-09-2005,880434,Bihar,19,15,17,18,69,Pass
Yash Sharma,04-10-2005,914468,Bihar,24,21,19,5,69,Pass
Ishaan D'Souza,21-10-2005,992180,Bihar,19,15,15,20,69,Pass
Krishna Singh,24-10-2005,256230,Bihar,19,13,18,19,69,Pass
Krishna Singh,28-11-2005,503498,Bihar,19,11,17,22,69,Pass
Raj Chopra,06-12-2005,199685,Bihar,15,18,16,20,69,Pass
Ishaan Verma,25-12-2005,628781,Bihar,21,21,21,6,69,Pass
Yash Sharma,31-12-2005,181815,Bihar,20,8,23,18,69,Pass
Krishna Chopra,31-01-2006,876826,Bihar,13,11,22,23,69,Pass
Imran Reddy,07-02-2006,286749,Bihar,22,18,7,22,69,Pass
Krishna Verma,14-02-2006,219192,Bihar,6,21,18,24,69,Pass
Ishaan Khan,18-02-2006,258221,Bihar,23,16,17,13,69,Pass
Manpreet Singh,17-03-2006,234449,Bihar,7,21,22,19,69,Pass
Krishna Singh,07-04-2006,975557,Bihar,8,17,20,24,69,Pass
Krishna D'Souza,13-04-2006,110366,Bihar,24,9,18,18,69,Pass
Vivaan Verma,24-04-2006,504136,Bihar,19,24,8,18,69,Pass
Vivaan Chopra,21-11-2004,404921,Bihar,6,18,22,22,68,Pass
Balbir Pillai,24-12-2004,543884,Bihar,12,15,20,21,68,Pass
Vivaan Chopra,06-01-2005,881402,Bihar,18,20,17,13,68,Pass
Yash Sharma,14-01-2005,554854,Bihar,11,20,14,23,68,Pass
Manpreet Chopra,21-01-2005,972533,Bihar,21,21,20,6,68,Pass
Paul Reddy,03-02-2005,602108,Bihar,16,6,22,24,68,Pass
Aryan D'Souza,05-02-2005,988667,Bihar,22,19,4,23,68,Pass
Mathew Sharma,30-03-2005,685604,Bihar,24,22,9,13,68,Pass
Peter D'Souza,16-05-2005,961138,Bihar,9,21,18,20,68,Pass
Aditya D'Souza,23-05-2005,460775,Bihar,12,22,15,19,68,Pass
Aditya Singh,01-06-2005,813247,Bihar,15,8,23,22,68,Pass
Gurpreet Verma,27-06-2005,667659,Bihar,14,24,9,21,68,Pass
Harjeet Pillai,07-07-2005,538155,Bihar,23,12,22,11,68,Pass
Krishna Chopra,19-07-2005,498533,Bihar,7,23,18,20,68,Pass
Peter Mehta,20-07-2005,222392,Bihar,23,23,12,10,68,Pass
Kunal Verma,03-08-2005,881572,Bihar,17,20,15,16,68,Pass
Aarav D'Souza,04-08-2005,949279,Bihar,23,11,13,21,68,Pass
Ayaan D'Souza,08-08-2005,271612,Bihar,22,18,19,9,68,Pass
Farhan Khan,17-08-2005,449865,Bihar,7,24,20,17,68,Pass
Rohan Pillai,22-08-2005,114434,Bihar,17,21,10,20,68,Pass
Raj Chopra,09-09-2005,494274,Bihar,11,24,21,12,68,Pass
Raj Reddy,20-09-2005,151638,Bihar,15,17,16,20,68,Pass
Harjeet Singh,06-10-2005,921593,Bihar,21,22,16,9,68,Pass
Ishaan Fernandes,12-10-2005,196995,Bihar,13,22,14,19,68,Pass
Yash Khan,19-10-2005,731366,Bihar,5,20,19,24,68,Pass
David Reddy,10-11-2005,171614,Bihar,23,11,24,10,68,Pass
Harjeet Singh,02-12-2005,965322,Bihar,15,23,22,8,68,Pass
Rohan Pillai,04-12-2005,873593,Bihar,24,23,12,9,68,Pass
Vivaan Reddy,20-12-2005,787745,Bihar,22,9,24,13,68,Pass
Harjeet Sharma,29-01-2006,571192,Bihar,19,24,6,19,68,Pass
Rohan Khan,18-02-2006,491096,Bihar,12,14,23,19,68,Pass
Raj Mehta,23-02-2006,835375,Bihar,14,19,16,19,68,Pass
Harjeet Reddy,25-02-2006,901196,Bihar,22,10,16,20,68,Pass
Yash Khan,04-03-2006,384581,Bihar,7,24,18,19,68,Pass
Krishna Fernandes,08-03-2006,897146,Bihar,24,21,5,18,68,Pass
Sukhwinder Fernandes,24-03-2006,624458,Bihar,23,11,24,10,68,Pass
Balbir Verma,04-04-2006,706114,Bihar,16,12,22,18,68,Pass
Aryan Chopra,11-04-2006,526220,Bihar,13,14,19,22,68,Pass
Krishna Pillai,17-11-2004,576628,Bihar,9,19,19,20,67,Pass
Raj Pillai,21-11-2004,818558,Bihar,23,13,22,9,67,Pass
Rohan Khan,22-11-2004,344583,Bihar,13,19,15,20,67,Pass
Raj Verma,29-11-2004,270198,Bihar,18,15,12,22,67,Pass
Gurpreet Pillai,11-12-2004,952240,Bihar,5,17,21,24,67,Pass
Yash Reddy,14-12-2004,467802,Bihar,15,23,7,22,67,Pass
Manpreet Mehta,27-01-2005,134255,Bihar,23,8,14,22,67,Pass
Raj Verma,30-01-2005,423452,Bihar,15,24,9,19,67,Pass
John Sharma,31-01-2005,569344,Bihar,13,16,20,18,67,Pass
David D'Souza,13-02-2005,113488,Bihar,21,15,14,17,67,Pass
Kunal Verma,20-02-2005,923714,Bihar,16,23,10,18,67,Pass
Imran Chopra,08-03-2005,515586,Bihar,23,21,15,8,67,Pass
John Fernandes,04-04-2005,291375,Bihar,19,15,13,20,67,Pass
Harjeet Mehta,16-04-2005,851809,Bihar,17,24,10,16,67,Pass
Ishaan Reddy,28-04-2005,314501,Bihar,20,18,6,23,67,Pass
Vivaan Verma,02-05-2005,826592,Bihar,23,5,16,23,67,Pass
Ishaan Singh,05-05-2005,635741,Bihar,11,24,14,18,67,Pass
John Pillai,20-05-2005,431060,Bihar,23,11,15,18,67,Pass
Aarav Chopra,06-06-2005,392423,Bihar,18,19,24,6,67,Pass
Rohan Verma,24-06-2005,721747,Bihar,12,23,14,18,67,Pass
Krishna Verma,08-07-2005,324178,Bihar,14,11,18,24,67,Pass
Aarav Khan,11-07-2005,788583,Bihar,16,19,21,11,67,Pass
Peter Verma,11-08-2005,694792,Bihar,19,7,17,24,67,Pass
Krishna Verma,29-08-2005,736948,Bihar,12,23,8,24,67,Pass
Manpreet Khan,01-09-2005,926850,Bihar,11,14,21,21,67,Pass
Krishna Sharma,07-09-2005,759189,Bihar,13,10,22,22,67,Pass
Ayaan Sharma,27-09-2005,941627,Bihar,23,15,15,14,67,Pass
Kunal Verma,02-10-2005,908188,Bihar,24,21,6,16,67,Pass
Krishna Khan,08-10-2005,868643,Bihar,11,22,18,16,67,Pass
Rohan Khan,17-10-2005,916110,Bihar,21,19,11,16,67,Pass
John Mehta,14-11-2005,722962,Bihar,22,15,6,24,67,Pass
Rohan Reddy,26-11-2005,200835,Bihar,20,22,5,20,67,Pass
Mathew Fernandes,28-11-2005,182378,Bihar,15,24,6,22,67,Pass
Paul Verma,09-12-2005,121271,Bihar,24,9,23,11,67,Pass
Rohan Singh,10-12-2005,868915,Bihar,7,18,22,20,67,Pass
Yash Mehta,22-12-2005,357322,Bihar,23,8,21,15,67,Pass
Aryan Singh,28-12-2005,896125,Bihar,19,8,20,20,67,Pass
Aditya Reddy,05-01-2006,650893,Bihar,21,15,19,12,67,Pass
Harjeet D'Souza,06-01-2006,118646,Bihar,23,5,21,18,67,Pass
Raj Reddy,25-01-2006,698649,Bihar,23,21,4,19,67,Pass
Balbir Pillai,05-02-2006,770575,Bihar,7,14,23,23,67,Pass
Vivaan Khan,09-02-2006,374098,Bihar,14,23,13,17,67,Pass
Balbir Reddy,22-02-2006,236696,Bihar,8,18,23,18,67,Pass
Aarav D'Souza,26-02-2006,885509,Bihar,24,15,18,10,67,Pass
Sukhwinder Chopra,27-02-2006,684240,Bihar,15,23,22,7,67,Pass
Vivaan Fernandes,16-03-2006,395586,Bihar,24,16,13,14,67,Pass
Kunal Khan,02-05-2006,967258,Bihar,6,21,23,17,67,Pass
Manpreet D'Souza,15-02-2006,267938,Uttar Pradesh,22,5,24,23,74,Pass
Krishna D'Souza,20-11-2004,913323,Uttar Pradesh,15,19,24,14,72,Pass
Raj Chopra,27-11-2004,564809,Uttar Pradesh,24,11,18,19,72,Pass
Rohan Sharma,11-12-2004,208347,Uttar Pradesh,22,22,5,23,72,Pass
Yash Sharma,04-01-2005,885983,Uttar Pradesh,24,23,16,9,72,Pass
Aryan Mehta,10-03-2005,521172,Uttar Pradesh,16,14,18,24,72,Pass
David Khan,11-03-2005,686614,Uttar Pradesh,16,22,22,12,72,Pass
Balbir Sharma,26-03-2005,401739,Uttar Pradesh,17,20,17,18,72,Pass
Raj Sharma,08-05-2005,619358,Uttar Pradesh,21,21,24,6,72,Pass
Krishna Singh,31-05-2005,676788,Uttar Pradesh,12,22,14,24,72,Pass
Farhan Singh,29-06-2005,100168,Uttar Pradesh,15,21,19,17,72,Pass
Aryan Fernandes,23-08-2005,568114,Uttar Pradesh,16,19,17,20,72,Pass
Ishaan Sharma,18-03-2006,997141,Uttar Pradesh,11,19,19,23,72,Pass
Yash Fernandes,23-03-2006,886875,Uttar Pradesh,21,21,10,20,72,Pass
Balbir Pillai,25-03-2005,192108,Uttar Pradesh,13,21,15,22,71,Pass
Rohan D'Souza,12-04-2005,503279,Uttar Pradesh,20,13,21,17,71,Pass
Kunal D'Souza,15-05-2005,290777,Uttar Pradesh,9,23,21,18,71,Pass
Paul Mehta,30-05-2005,103821,Uttar Pradesh,18,6,23,24,71,Pass
Vivaan Chopra,14-06-2005,153810,Uttar Pradesh,9,19,23,20,71,Pass
Raj Singh,24-09-2005,162795,Uttar Pradesh,11,20,18,22,71,Pass
Manpreet D'Souza,04-10-2005,110541,Uttar Pradesh,18,22,15,16,71,Pass
Kunal Fernandes,03-11-2005,902891,Uttar Pradesh,5,23,22,21,71,Pass
Aditya Reddy,15-11-2005,136939,Uttar Pradesh,23,14,20,14,71,Pass
Kunal Chopra,17-11-2005,501317,Uttar Pradesh,20,7,24,20,71,Pass
Yash Sharma,23-03-2006,149437,Uttar Pradesh,21,15,23,12,71,Pass
Aarav Fernandes,29-11-2004,514000,Uttar Pradesh,17,16,18,19,70,Pass
Krishna Verma,17-12-2004,697452,Uttar Pradesh,17,5,24,24,70,Pass
Aditya Fernandes,12-03-2005,409491,Uttar Pradesh,16,13,24,17,70,Pass
Rohan Pillai,15-04-2005,322259,Uttar Pradesh,23,6,23,18,70,Pass
Manpreet Pillai,08-06-2005,272396,Uttar Pradesh,22,13,15,20,70,Pass
Vivaan Khan,19-08-2005,750720,Uttar Pradesh,22,23,4,21,70,Pass
Mathew Pillai,14-09-2005,763921,Uttar Pradesh,23,20,7,20,70,Pass
Aryan Pillai,12-10-2005,385252,Uttar Pradesh,8,19,24,19,70,Pass
Kunal Reddy,12-11-2005,393879,Uttar Pradesh,23,9,24,14,70,Pass
Rohan Khan,27-11-2005,464936,Uttar Pradesh,19,23,10,18,70,Pass
Ishaan Singh,30-12-2005,944585,Uttar Pradesh,8,18,23,21,70,Pass
Kunal Chopra,16-02-2006,295347,Uttar Pradesh,17,15,22,16,70,Pass
Aditya Fernandes,09-03-2006,148527,Uttar Pradesh,22,5,20,23,70,Pass
Aarav Pillai,16-11-2004,388708,Uttar Pradesh,17,5,23,24,69,Pass
Ishaan D'Souza,16-11-2004,592761,Uttar Pradesh,15,13,20,21,69,Pass
Aryan Khan,17-11-2004,629387,Uttar Pradesh,19,16,22,12,69,Pass
Gurpreet Pillai,22-11-2004,879477,Uttar Pradesh,22,22,12,13,69,Pass
Vivaan Sharma,22-11-2004,577121,Uttar Pradesh,22,19,22,6,69,Pass
Aryan Fernandes,06-12-2004,654285,Uttar Pradesh,12,23,14,20,69,Pass
Ishaan Singh,06-01-2005,350937,Uttar Pradesh,19,17,10,23,69,Pass
Kunal D'Souza,01-02-2005,169207,Uttar Pradesh,19,18,20,12,69,Pass
Rohan Singh,15-03-2005,946166,Uttar Pradesh,20,6,23,20,69,Pass
Kunal Khan,11-04-2005,332099,Uttar Pradesh,11,19,23,16,69,Pass
Yash Reddy,29-05-2005,585647,Uttar Pradesh,19,20,13,17,69,Pass
Ishaan Chopra,06-06-2005,736411,Uttar Pradesh,19,16,14,20,69,Pass
Raj D'Souza,17-06-2005,296152,Uttar Pradesh,18,22,13,16,69,Pass
Aditya Sharma,18-08-2005,392930,Uttar Pradesh,14,20,12,23,69,Pass
David Pillai,04-09-2005,100808,Uttar Pradesh,24,19,4,22,69,Pass
Sukhwinder Sharma,21-09-2005,465448,Uttar Pradesh,13,17,21,18,69,Pass
Rohan Singh,05-10-2005,760407,Uttar Pradesh,4,18,24,23,69,Pass
Aarav Reddy,10-10-2005,474433,Uttar Pradesh,16,11,18,24,69,Pass
Paul Mehta,29-10-2005,891904,Uttar Pradesh,17,5,23,24,69,Pass
Ishaan Fernandes,10-11-2005,789265,Uttar Pradesh,16,19,20,14,69,Pass
Rohan Fernandes,14-11-2005,525633,Uttar Pradesh,20,20,20,9,69,Pass
Aditya D'Souza,19-11-2005,606214,Uttar Pradesh,11,18,18,22,69,Pass
Aarav Reddy,20-11-2005,832769,Uttar Pradesh,11,14,21,23,69,Pass
Rohan D'Souza,08-02-2006,897203,Uttar Pradesh,19,21,19,10,69,Pass
Aditya Pillai,15-04-2006,141171,Uttar Pradesh,22,23,19,5,69,Pass
Kunal Khan,15-04-2006,402930,Uttar Pradesh,18,8,21,22,69,Pass
Sukhwinder D'Souza,05-05-2006,650973,Uttar Pradesh,10,22,22,15,69,Pass
Gurpreet Singh,10-11-2004,734966,Uttar Pradesh,19,6,24,19,68,Pass
Yash Reddy,16-11-2004,827958,Uttar Pradesh,13,15,19,21,68,Pass
Vivaan Pillai,22-11-2004,557312,Uttar Pradesh,17,24,22,5,68,Pass
Rohan Sharma,23-12-2004,152912,Uttar Pradesh,21,14,23,10,68,Pass
Sukhwinder Singh,04-01-2005,647805,Uttar Pradesh,20,17,23,8,68,Pass
Gurpreet Fernandes,20-01-2005,498762,Uttar Pradesh,24,10,14,20,68,Pass
Rohan Verma,28-03-2005,113619,Uttar Pradesh,18,18,10,22,68,Pass
Mathew Khan,06-04-2005,798293,Uttar Pradesh,14,18,16,20,68,Pass
Kunal Fernandes,28-04-2005,433194,Uttar Pradesh,19,24,19,6,68,Pass
Yash Khan,25-06-2005,565385,Uttar Pradesh,24,15,19,10,68,Pass
Raj Khan,06-10-2005,678995,Uttar Pradesh,17,10,24,17,68,Pass
Aditya D'Souza,12-10-2005,966456,Uttar Pradesh,20,22,6,20,68,Pass
Vivaan D'Souza,15-11-2005,626680,Uttar Pradesh,21,15,11,21,68,Pass
Yash Reddy,10-12-2005,616807,Uttar Pradesh,22,6,22,18,68,Pass
Balbir Singh,15-12-2005,427927,Uttar Pradesh,15,18,11,24,68,Pass
Ishaan Khan,17-12-2005,904365,Uttar Pradesh,16,17,22,13,68,Pass
Harjeet Singh,28-12-2005,757541,Uttar Pradesh,14,16,19,19,68,Pass
Aarav Mehta,07-03-2006,735293,Uttar Pradesh,14,18,15,21,68,Pass
Kunal Singh,11-03-2006,173220,Uttar Pradesh,20,5,19,24,68,Pass
Kunal Sharma,12-03-2006,493935,Uttar Pradesh,21,5,23,19,68,Pass
Balbir Singh,02-04-2006,768464,Uttar Pradesh,20,22,7,19,68,Pass
Kunal Pillai,10-04-2006,873617,Uttar Pradesh,9,17,24,18,68,Pass
Harjeet Mehta,15-04-2006,962294,Uttar Pradesh,20,16,15,17,68,Pass
Paul Pillai,02-12-2004,812623,Uttar Pradesh,19,17,7,24,67,Pass
Raj Sharma,06-04-2005,477948,Uttar Pradesh,13,21,13,20,67,Pass
Yash Verma,11-04-2005,704468,Uttar Pradesh,14,11,20,22,67,Pass
Ishaan Singh,13-04-2005,537100,Uttar Pradesh,15,18,10,24,67,Pass
Yash Sharma,16-05-2005,240892,Uttar Pradesh,13,18,23,13,67,Pass
Kunal D'Souza,03-06-2005,676159,Uttar Pradesh,20,15,10,22,67,Pass
Peter Fernandes,08-06-2005,903607,Uttar Pradesh,13,18,19,17,67,Pass
Manpreet Sharma,01-07-2005,562468,Uttar Pradesh,16,20,7,24,67,Pass
Balbir Singh,13-08-2005,891930,Uttar Pradesh,4,24,16,23,67,Pass
Gurpreet Mehta,29-09-2005,779714,Uttar Pradesh,24,14,23,6,67,Pass
Yash Mehta,30-09-2005,753310,Uttar Pradesh,16,21,23,7,67,Pass
Rohan D'Souza,11-10-2005,242251,Uttar Pradesh,24,14,22,7,67,Pass
Sukhwinder Chopra,18-10-2005,928105,Uttar Pradesh,16,23,22,6,67,Pass
Paul Verma,20-10-2005,308763,Uttar Pradesh,19,19,7,22,67,Pass
Kunal Sharma,21-10-2005,948890,Uttar Pradesh,22,23,14,8,67,Pass
Aarav Chopra,15-11-2005,348719,Uttar Pradesh,21,13,22,11,67,Pass
Vivaan Pillai,22-11-2005,873463,Uttar Pradesh,13,20,10,24,67,Pass
Aarav Singh,04-12-2005,480696,Uttar Pradesh,23,16,11,17,67,Pass
Paul Mehta,09-12-2005,468161,Uttar Pradesh,20,22,18,7,67,Pass
Ishaan Fernandes,16-02-2006,655387,Uttar Pradesh,23,15,11,18,67,Pass
Aryan Sharma,05-03-2006,370322,Uttar Pradesh,24,15,4,24,67,Pass
Ishaan Fernandes,08-03-2006,630538,Uttar Pradesh,15,10,20,22,67,Pass
Gurpreet Khan,07-04-2006,190017,Uttar Pradesh,12,16,17,22,67,Pass
Ishaan Singh,22-04-2006,375016,Uttar Pradesh,16,18,9,24,67,Pass
Vivaan Reddy,01-05-2006,400950,Uttar Pradesh,15,14,18,20,67,Pass
Vivaan Chopra,03-05-2006,305567,Uttar Pradesh,16,19,11,21,67,Pass
Aditya Pillai,15-11-2004,292012,Uttar Pradesh,16,6,24,20,66,Pass
Aarav Mehta,28-11-2004,210248,Uttar Pradesh,17,10,17,22,66,Pass
Harjeet Fernandes,20-12-2004,376675,Uttar Pradesh,23,13,16,14,66,Pass
Rohan Fernandes,02-01-2005,118030,Uttar Pradesh,23,15,22,6,66,Pass
Ishaan Verma,29-01-2005,409071,Uttar Pradesh,24,7,23,12,66,Pass
Yash Sharma,04-02-2005,546614,Uttar Pradesh,19,21,12,14,66,Pass
Sukhwinder Mehta,27-02-2005,254811,Uttar Pradesh,21,24,4,17,66,Pass
Yash Pillai,08-03-2005,188059,Uttar Pradesh,20,5,21,20,66,Pass
Raj Chopra,12-03-2005,131378,Uttar Pradesh,24,23,10,9,66,Pass
Vivaan Reddy,14-03-2005,944627,Uttar Pradesh,10,18,19,19,66,Pass
Sukhwinder Sharma,30-03-2005,995833,Uttar Pradesh,15,12,23,16,66,Pass
Rohan Sharma,13-04-2005,327327,Uttar Pradesh,19,23,13,11,66,Pass
Ishaan D'Souza,26-04-2005,454487,Uttar Pradesh,24,5,19,18,66,Pass
Aryan Khan,27-06-2005,622478,Uttar Pradesh,11,23,17,15,66,Pass
Kunal Mehta,29-06-2005,615387,Uttar Pradesh,18,19,17,12,66,Pass
Raj Fernandes,07-07-2005,843539,Uttar Pradesh,17,22,5,22,66,Pass
Yash Fernandes,01-09-2005,533755,Uttar Pradesh,5,20,24,17,66,Pass
Vivaan Pillai,11-09-2005,948189,Uttar Pradesh,15,19,17,15,66,Pass
Aarav Sharma,23-09-2005,742261,Uttar Pradesh,23,6,16,21,66,Pass
Aarav Pillai,19-11-2005,414277,Uttar Pradesh,24,4,17,21,66,Pass
Rohan Chopra,25-11-2005,887628,Uttar Pradesh,21,13,22,10,66,Pass
Ayaan Fernandes,31-01-2006,193273,Uttar Pradesh,15,15,15,21,66,Pass
Farhan Sharma,12-03-2006,588111,Uttar Pradesh,11,15,17,23,66,Pass
Balbir Verma,13-03-2006,198870,Uttar Pradesh,8,15,22,21,66,Pass
Kunal Khan,28-12-2004,855022,Uttar Pradesh,9,12,20,24,65,Pass
Aarav Fernandes,02-02-2005,666543,Uttar Pradesh,21,13,22,9,65,Pass
Rohan Chopra,03-03-2005,901575,Uttar Pradesh,21,10,24,10,65,Pass
Kunal Mehta,25-03-2005,954976,Uttar Pradesh,18,13,15,19,65,Pass
Aarav Reddy,02-04-2005,217507,Uttar Pradesh,9,24,11,21,65,Pass
Ishaan Chopra,04-04-2005,348424,Uttar Pradesh,12,19,17,17,65,Pass
Balbir Sharma,23-04-2005,135014,Uttar Pradesh,10,18,21,16,65,Pass
Kunal Reddy,25-04-2005,572508,Uttar Pradesh,22,8,15,20,65,Pass
Aryan Chopra,04-05-2005,128888,Uttar Pradesh,22,5,23,15,65,Pass
Kunal Sharma,24-05-2005,690668,Uttar Pradesh,15,15,11,24,65,Pass
Raj Fernandes,21-06-2005,312592,Uttar Pradesh,22,13,9,21,65,Pass
Vivaan Fernandes,23-06-2005,603714,Uttar Pradesh,14,13,20,18,65,Pass
Peter Singh,25-06-2005,218439,Uttar Pradesh,23,6,15,21,65,Pass
Manpreet Reddy,28-06-2005,535683,Uttar Pradesh,23,12,13,17,65,Pass
John Verma,25-07-2005,343209,Uttar Pradesh,24,10,18,13,65,Pass
Aarav Reddy,29-07-2005,354510,Uttar Pradesh,17,24,6,18,65,Pass
Zaid Singh,07-08-2005,461739,Uttar Pradesh,10,19,15,21,65,Pass
Gurpreet Fernandes,14-08-2005,471948,Uttar Pradesh,23,17,14,11,65,Pass
Harjeet Chopra,14-08-2005,595335,Uttar Pradesh,15,7,21,22,65,Pass
Vivaan Singh,21-09-2005,862975,Uttar Pradesh,21,24,11,9,65,Pass
Aarav Pillai,23-09-2005,535974,Uttar Pradesh,8,16,22,19,65,Pass
Aarav Reddy,12-10-2005,383756,Uttar Pradesh,23,19,6,17,65,Pass
Vivaan D'Souza,25-10-2005,222011,Uttar Pradesh,21,13,8,23,65,Pass
Rohan Sharma,28-10-2005,395422,Uttar Pradesh,23,21,17,4,65,Pass
Raj Verma,31-10-2005,771002,Uttar Pradesh,24,23,7,11,65,Pass
Sukhwinder D'Souza,07-11-2005,526618,Uttar Pradesh,12,18,21,14,65,Pass
Vivaan Fernandes,21-12-2005,740365,Uttar Pradesh,14,20,16,15,65,Pass
Aarav Fernandes,31-12-2005,960377,Uttar Pradesh,23,11,16,15,65,Pass
Raj Reddy,13-01-2006,299757,Uttar Pradesh,16,21,7,21,65,Pass
Ishaan Sharma,13-01-2006,721577,Uttar Pradesh,11,15,23,16,65,Pass
Aditya Singh,19-01-2006,290257,Uttar Pradesh,15,22,14,14,65,Pass
Rohan Sharma,13-03-2006,235548,Uttar Pradesh,7,19,23,16,65,Pass
Yash Singh,15-04-2006,321017,Uttar Pradesh,14,22,16,13,65,Pass
Aryan Verma,05-05-2006,967911,Uttar Pradesh,18,5,23,19,65,Pass
Harjeet Chopra,15-11-2004,668903,Uttar Pradesh,19,13,24,8,64,Pass
Aryan Khan,31-12-2004,746167,Uttar Pradesh,19,7,22,16,64,Pass
Kunal D'Souza,31-12-2004,549587,Uttar Pradesh,18,19,9,18,64,Pass
Balbir Chopra,07-01-2005,506160,Uttar Pradesh,9,13,19,23,64,Pass
Mathew Mehta,23-01-2005,390826,Uttar Pradesh,6,20,16,22,64,Pass
Ishaan Khan,24-01-2005,120756,Uttar Pradesh,19,15,17,13,64,Pass
Rohan Fernandes,24-02-2005,564351,Uttar Pradesh,17,15,19,13,64,Pass
Rohan Verma,17-03-2005,719204,Uttar Pradesh,13,13,14,24,64,Pass
Aryan D'Souza,07-04-2005,663132,Uttar Pradesh,24,9,8,23,64,Pass
Aditya Verma,09-04-2005,901326,Uttar Pradesh,10,15,18,21,64,Pass
Vivaan Singh,10-04-2005,337142,Uttar Pradesh,23,18,5,18,64,Pass
Yash Verma,04-05-2005,230430,Uttar Pradesh,23,9,9,23,64,Pass
Raj Sharma,12-05-2005,519264,Uttar Pradesh,24,7,16,17,64,Pass
Harjeet Reddy,08-07-2005,597744,Uttar Pradesh,23,5,12,24,64,Pass
Yash Mehta,08-07-2005,502803,Uttar Pradesh,22,10,18,14,64,Pass
Balbir Reddy,15-07-2005,650168,Uttar Pradesh,22,21,12,9,64,Pass
Rohan Reddy,16-07-2005,241545,Uttar Pradesh,16,20,4,24,64,Pass
Manpreet Verma,01-11-2005,311068,Uttar Pradesh,16,21,20,7,64,Pass
Aryan D'Souza,05-11-2005,976109,Uttar Pradesh,11,24,20,9,64,Pass
Balbir Khan,10-12-2005,721570,Uttar Pradesh,7,22,20,15,64,Pass
Ayaan Khan,20-12-2005,730520,Uttar Pradesh,13,5,23,23,64,Pass
Ishaan Reddy,22-12-2005,755994,Uttar Pradesh,14,23,10,17,64,Pass
Zaid Verma,13-01-2006,835045,Uttar Pradesh,11,12,22,19,64,Pass
Ishaan D'Souza,08-02-2006,948589,Uttar Pradesh,16,12,21,15,64,Pass
Krishna Fernandes,25-02-2006,870051,Uttar Pradesh,10,13,21,20,64,Pass
Raj Singh,13-03-2006,290867,Uttar Pradesh,19,15,8,22,64,Pass
Aditya Mehta,16-03-2006,892808,Uttar Pradesh,20,19,8,17,64,Pass
Balbir Fernandes,29-03-2006,117563,Uttar Pradesh,24,5,12,23,64,Pass
Krishna Fernandes,13-04-2006,329155,Uttar Pradesh,18,6,18,22,64,Pass
Krishna Fernandes,19-04-2006,643314,Uttar Pradesh,5,13,24,22,64,Pass
Paul Fernandes,05-05-2006,513889,Uttar Pradesh,17,5,21,21,64,Pass
Vivaan Fernandes,26-11-2004,602837,Uttar Pradesh,20,12,9,22,63,Pass
Kunal Reddy,02-01-2005,613064,Uttar Pradesh,16,24,19,4,63,Pass
Vivaan Sharma,30-01-2005,382363,Uttar Pradesh,7,19,14,23,63,Pass
Krishna Khan,24-02-2005,491912,Uttar Pradesh,8,17,23,15,63,Pass
Aryan Singh,09-03-2005,656916,Uttar Pradesh,8,23,23,9,63,Pass
Krishna Singh,13-03-2005,211831,Uttar Pradesh,7,23,20,13,63,Pass
David Khan,15-03-2005,999042,Uttar Pradesh,24,8,15,16,63,Pass
Kunal Fernandes,12-04-2005,743852,Uttar Pradesh,23,5,12,23,63,Pass
Sukhwinder Pillai,26-04-2005,667463,Uttar Pradesh,16,12,18,17,63,Pass
Raj Chopra,29-04-2005,774991,Uttar Pradesh,19,14,19,11,63,Pass
Raj D'Souza,15-05-2005,234761,Uttar Pradesh,17,8,16,22,63,Pass
Kunal Reddy,18-06-2005,218310,Uttar Pradesh,22,12,10,19,63,Pass
Kunal Chopra,09-07-2005,763072,Uttar Pradesh,6,12,24,21,63,Pass
Raj Fernandes,29-07-2005,780370,Uttar Pradesh,18,12,21,12,63,Pass
Yash Khan,07-08-2005,307738,Uttar Pradesh,9,17,19,18,63,Pass
Yash Reddy,12-09-2005,293309,Uttar Pradesh,14,14,23,12,63,Pass
Rohan Verma,29-09-2005,152717,Uttar Pradesh,18,8,24,13,63,Pass
Raj Verma,08-10-2005,820490,Uttar Pradesh,19,17,9,18,63,Pass
Raj Verma,19-10-2005,149862,Uttar Pradesh,19,22,12,10,63,Pass
Krishna Verma,19-10-2005,186996,Uttar Pradesh,8,17,19,19,63,Pass
Gurpreet D'Souza,23-10-2005,984481,Uttar Pradesh,15,18,6,24,63,Pass
Aryan Mehta,14-01-2006,587336,Uttar Pradesh,13,20,22,8,63,Pass
Raj Reddy,21-01-2006,528653,Uttar Pradesh,19,15,18,11,63,Pass
Aryan Verma,02-02-2006,440982,Uttar Pradesh,19,10,23,11,63,Pass
Krishna Singh,21-02-2006,851919,Uttar Pradesh,11,15,24,13,63,Pass
Krishna Singh,09-04-2006,629895,Uttar Pradesh,8,20,16,19,63,Pass
Krishna Reddy,02-05-2006,562137,Uttar Pradesh,13,17,11,22,63,Pass
Krishna Verma,04-05-2006,692691,Uttar Pradesh,20,19,4,20,63,Pass
Yash Reddy,08-05-2006,998106,Uttar Pradesh,14,18,13,18,63,Pass
Mathew D'Souza,20-11-2004,677743,Uttar Pradesh,4,14,23,21,62,Pass
Vivaan Mehta,05-12-2004,221774,Uttar Pradesh,16,19,19,8,62,Pass
Raj Chopra,05-01-2005,746673,Uttar Pradesh,16,22,17,7,62,Pass
Raj Mehta,11-01-2005,520044,Uttar Pradesh,6,17,15,24,62,Pass
Aarav Mehta,14-01-2005,307855,Uttar Pradesh,5,22,20,15,62,Pass
Krishna Fernandes,10-02-2005,158901,Uttar Pradesh,20,11,16,15,62,Pass
Kunal D'Souza,19-02-2005,368350,Uttar Pradesh,20,24,11,7,62,Pass
Vivaan Sharma,22-02-2005,320163,Uttar Pradesh,16,20,17,9,62,Pass
Aditya Sharma,16-04-2005,940600,Uttar Pradesh,4,21,13,24,62,Pass
Krishna Reddy,17-04-2005,552652,Uttar Pradesh,14,15,24,9,62,Pass
Gurpreet Pillai,19-05-2005,610805,Uttar Pradesh,9,16,20,17,62,Pass
Aditya Pillai,21-05-2005,202031,Uttar Pradesh,5,19,21,17,62,Pass
Aarav Chopra,20-06-2005,929886,Uttar Pradesh,10,9,20,23,62,Pass
Ishaan Reddy,04-07-2005,825554,Uttar Pradesh,13,23,7,19,62,Pass
Raj Verma,10-09-2005,991946,Uttar Pradesh,17,18,11,16,62,Pass
Rohan D'Souza,10-09-2005,538790,Uttar Pradesh,11,17,17,17,62,Pass
Kunal Reddy,09-10-2005,283733,Uttar Pradesh,21,10,17,14,62,Pass
Krishna Khan,14-10-2005,889692,Uttar Pradesh,11,24,12,15,62,Pass
Aditya Verma,23-10-2005,181640,Uttar Pradesh,14,8,23,17,62,Pass
John Pillai,13-11-2005,703998,Uttar Pradesh,13,14,21,14,62,Pass
Aryan D'Souza,06-12-2005,500591,Uttar Pradesh,12,5,21,24,62,Pass
Yash Fernandes,18-12-2005,296166,Uttar Pradesh,18,8,19,17,62,Pass
Ayaan Sharma,30-12-2005,895333,Uttar Pradesh,23,22,5,12,62,Pass
Yash Sharma,15-01-2006,519037,Uttar Pradesh,13,23,10,16,62,Pass
Aryan Chopra,16-02-2006,161145,Uttar Pradesh,14,12,12,24,62,Pass
Kunal Khan,07-03-2006,224897,Uttar Pradesh,17,5,17,23,62,Pass
Raj Khan,11-03-2006,946871,Uttar Pradesh,17,7,15,23,62,Pass
Aarav Mehta,12-03-2006,699774,Uttar Pradesh,15,19,8,20,62,Pass
Sukhwinder Singh,17-03-2006,696508,Uttar Pradesh,15,15,24,8,62,Pass
Rohan Sharma,02-05-2006,452150,Uttar Pradesh,14,10,18,20,62,Pass
Ishaan Khan,03-05-2006,582401,Uttar Pradesh,21,11,14,16,62,Pass
Aryan Chopra,04-05-2006,849165,Uttar Pradesh,16,18,12,16,62,Pass
Rohan Mehta,26-12-2004,701710,Uttar Pradesh,19,5,21,16,61,Pass
Yash Reddy,06-01-2005,879804,Uttar Pradesh,24,9,14,14,61,Pass
Raj Verma,22-01-2005,856126,Uttar Pradesh,13,5,23,20,61,Pass
Aryan Pillai,16-03-2005,126919,Uttar Pradesh,23,5,24,9,61,Pass
Ishaan D'Souza,16-03-2005,318614,Uttar Pradesh,18,7,14,22,61,Pass
Paul Chopra,14-04-2005,498801,Uttar Pradesh,20,5,23,13,61,Pass
Ishaan Singh,08-05-2005,255414,Uttar Pradesh,15,18,9,19,61,Pass
Balbir Khan,11-05-2005,226325,Uttar Pradesh,4,22,23,12,61,Pass
Aditya Sharma,07-06-2005,678857,Uttar Pradesh,11,16,19,15,61,Pass
Krishna Singh,23-06-2005,212222,Uttar Pradesh,21,9,13,18,61,Pass
Aryan Verma,28-07-2005,407332,Uttar Pradesh,17,14,8,22,61,Pass
Raj Chopra,03-08-2005,659501,Uttar Pradesh,14,5,19,23,61,Pass
Raj Verma,19-08-2005,386477,Uttar Pradesh,7,10,20,24,61,Pass
Yash Chopra,23-08-2005,467885,Uttar Pradesh,24,10,9,18,61,Pass
Mathew Pillai,31-08-2005,987678,Uttar Pradesh,19,10,13,19,61,Pass
Raj Sharma,05-09-2005,378545,Uttar Pradesh,23,10,23,5,61,Pass
Aarav Pillai,13-09-2005,996637,Uttar Pradesh,17,16,23,5,61,Pass
Gurpreet Fernandes,23-09-2005,786196,Uttar Pradesh,23,7,16,15,61,Pass
Gurpreet Reddy,15-10-2005,855763,Uttar Pradesh,20,9,24,8,61,Pass
Raj Pillai,21-10-2005,879483,Uttar Pradesh,6,14,23,18,61,Pass
Yash Sharma,31-10-2005,489099,Uttar Pradesh,19,18,17,7,61,Pass
Aarav Pillai,06-11-2005,147426,Uttar Pradesh,11,20,10,20,61,Pass
David Khan,24-11-2005,153624,Uttar Pradesh,13,22,7,19,61,Pass
Rohan Sharma,30-11-2005,327569,Uttar Pradesh,11,8,22,20,61,Pass
Rehan Pillai,13-12-2005,734373,Uttar Pradesh,22,10,9,20,61,Pass
Balbir Sharma,15-12-2005,674932,Uttar Pradesh,18,17,19,7,61,Pass
Aarav Pillai,27-12-2005,805268,Uttar Pradesh,5,13,19,24,61,Pass
Sukhwinder Reddy,05-01-2006,669271,Uttar Pradesh,9,5,23,24,61,Pass
Rohan Khan,19-01-2006,641821,Uttar Pradesh,5,21,14,21,61,Pass
Aarav Pillai,12-02-2006,682558,Uttar Pradesh,11,23,11,16,61,Pass
Peter Singh,15-02-2006,780091,Uttar Pradesh,5,24,21,11,61,Pass
Raj Pillai,24-02-2006,693809,Uttar Pradesh,21,6,24,10,61,Pass
Balbir Khan,26-02-2006,952065,Uttar Pradesh,21,17,17,6,61,Pass
Aryan Sharma,06-03-2006,630113,Uttar Pradesh,17,9,21,14,61,Pass
Balbir Verma,22-03-2006,710393,Uttar Pradesh,17,5,23,16,61,Pass
Krishna Mehta,22-03-2006,208786,Uttar Pradesh,11,22,7,21,61,Pass
Aditya Pillai,23-03-2006,931460,Uttar Pradesh,19,5,19,18,61,Pass
Krishna Mehta,05-04-2006,787972,Uttar Pradesh,18,8,11,24,61,Pass
John Pillai,21-04-2006,561056,Uttar Pradesh,21,16,13,11,61,Pass
Rohan Chopra,24-04-2006,168583,Uttar Pradesh,22,19,10,10,61,Pass
Rohan Fernandes,27-04-2006,111270,Uttar Pradesh,9,21,12,19,61,Pass
Ishaan Reddy,03-05-2006,725376,Uttar Pradesh,21,22,5,13,61,Pass
John Mehta,17-11-2004,736559,Uttar Pradesh,13,21,19,7,60,Pass
Kunal Fernandes,18-11-2004,866740,Uttar Pradesh,14,6,20,20,60,Pass
Aryan Sharma,06-12-2004,372052,Uttar Pradesh,12,14,14,20,60,Pass
Rohan D'Souza,30-12-2004,244484,Uttar Pradesh,13,16,11,20,60,Pass
Raj Singh,02-01-2005,784581,Uttar Pradesh,20,4,23,13,60,Pass
Krishna D'Souza,22-02-2005,955180,Uttar Pradesh,4,17,20,19,60,Pass
Raj Khan,31-03-2005,494702,Uttar Pradesh,13,5,22,20,60,Pass
Aarav Pillai,05-04-2005,362607,Uttar Pradesh,18,21,15,6,60,Pass
Sukhwinder Chopra,06-04-2005,137788,Uttar Pradesh,21,11,14,14,60,Pass
Imran D'Souza,07-04-2005,483298,Uttar Pradesh,16,5,19,20,60,Pass
Yash Verma,09-04-2005,622267,Uttar Pradesh,12,6,24,18,60,Pass
Vivaan Singh,19-04-2005,584260,Uttar Pradesh,24,7,11,18,60,Pass
Aarav Verma,25-04-2005,202791,Uttar Pradesh,16,16,14,14,60,Pass
Krishna Verma,31-05-2005,516477,Uttar Pradesh,11,22,12,15,60,Pass
Krishna Singh,09-07-2005,940857,Uttar Pradesh,15,13,14,18,60,Pass
Aryan Verma,20-07-2005,620867,Uttar Pradesh,14,23,19,4,60,Pass
Rohan Mehta,27-07-2005,885090,Uttar Pradesh,14,19,21,6,60,Pass
Sukhwinder Fernandes,31-07-2005,391850,Uttar Pradesh,7,19,18,16,60,Pass
Sukhwinder Fernandes,31-07-2005,585966,Uttar Pradesh,5,23,9,23,60,Pass
Aditya Chopra,07-08-2005,176809,Uttar Pradesh,8,19,21,12,60,Pass
Mathew Chopra,10-09-2005,268147,Uttar Pradesh,14,9,22,15,60,Pass
Krishna Verma,11-09-2005,292538,Uttar Pradesh,11,23,18,8,60,Pass
Kunal Pillai,28-10-2005,449327,Uttar Pradesh,15,7,24,14,60,Pass
Manpreet Reddy,06-12-2005,841686,Uttar Pradesh,23,19,12,6,60,Pass
Ishaan Reddy,31-12-2005,780598,Uttar Pradesh,11,5,22,22,60,Pass
Aarav Fernandes,02-01-2006,895599,Uttar Pradesh,20,15,5,20,60,Pass
Peter Singh,06-01-2006,349839,Uttar Pradesh,17,10,14,19,60,Pass
Vivaan Khan,09-01-2006,120816,Uttar Pradesh,13,16,23,8,60,Pass
Raj Sharma,11-01-2006,517983,Uttar Pradesh,11,4,22,23,60,Pass
Ishaan D'Souza,20-01-2006,969954,Uttar Pradesh,23,23,7,7,60,Pass
Mathew Sharma,04-02-2006,691680,Uttar Pradesh,23,8,24,5,60,Pass
Vivaan Reddy,06-02-2006,478314,Uttar Pradesh,21,13,8,18,60,Pass
Farhan Verma,24-03-2006,758279,Uttar Pradesh,9,21,13,17,60,Pass
Balbir Khan,27-03-2006,835442,Uttar Pradesh,16,13,8,23,60,Pass
Manpreet Sharma,04-05-2006,981690,Uttar Pradesh,17,7,21,15,60,Pass
Aditya Pillai,29-08-2005,990804,Rajasthan,24,23,20,21,88,Pass
Mathew Fernandes,26-10-2005,749913,Rajasthan,21,21,23,23,88,Pass
Paul Pillai,18-11-2004,266504,Rajasthan,24,22,22,19,87,Pass
Krishna Mehta,06-10-2005,410155,Rajasthan,21,19,22,24,86,Pass
Aarav Khan,10-12-2005,830828,Rajasthan,20,24,20,22,86,Pass
Zaid D'Souza,28-02-2005,696434,Rajasthan,24,19,24,18,85,Pass
Aditya Singh,28-04-2005,805743,Rajasthan,20,23,18,24,85,Pass
Yash Reddy,18-12-2005,161591,Rajasthan,24,22,23,16,85,Pass
Gurpreet Verma,05-02-2005,718228,Rajasthan,23,21,17,23,84,Pass
Aryan Pillai,24-07-2005,219290,Rajasthan,24,24,19,17,84,Pass
Ishaan Reddy,20-01-2006,517524,Rajasthan,22,20,24,18,84,Pass
Imran Verma,10-03-2006,539655,Rajasthan,22,16,24,22,84,Pass
Rehan Singh,02-01-2005,138245,Rajasthan,23,15,21,24,83,Pass
Aditya D'Souza,09-03-2005,880068,Rajasthan,23,19,18,23,83,Pass
Imran Verma,18-05-2005,448127,Rajasthan,22,22,17,22,83,Pass
Aryan Mehta,07-06-2005,175489,Rajasthan,24,11,24,24,83,Pass
Aarav Chopra,16-10-2005,701179,Rajasthan,16,21,23,23,83,Pass
Aditya Chopra,31-12-2004,828775,Rajasthan,20,20,19,23,82,Pass
Vivaan Sharma,28-07-2005,815532,Rajasthan,17,24,22,19,82,Pass
Peter Verma,16-01-2006,955683,Rajasthan,22,14,24,22,82,Pass
Raj Mehta,21-01-2006,219340,Rajasthan,23,22,14,23,82,Pass
Aarav Reddy,08-04-2006,958826,Rajasthan,24,22,20,16,82,Pass
Raj Singh,24-04-2006,619885,Rajasthan,18,20,22,22,82,Pass
Krishna D'Souza,08-11-2004,486550,Rajasthan,23,22,15,21,81,Pass
Rohan Khan,30-01-2005,714316,Rajasthan,13,24,22,22,81,Pass
Krishna Fernandes,12-02-2005,965441,Rajasthan,24,20,13,24,81,Pass
Yash Fernandes,29-07-2005,792795,Rajasthan,21,19,20,21,81,Pass
Yash Verma,09-08-2005,785550,Rajasthan,24,24,19,14,81,Pass
Ayaan Pillai,02-09-2005,292638,Rajasthan,19,21,23,18,81,Pass
Peter Chopra,05-09-2005,577661,Rajasthan,22,16,23,20,81,Pass
Yash Fernandes,09-11-2005,838921,Rajasthan,24,21,18,18,81,Pass
Harjeet Chopra,12-03-2006,478309,Rajasthan,20,19,22,20,81,Pass
Balbir Reddy,02-04-2006,172756,Rajasthan,15,21,21,24,81,Pass
Farhan Chopra,13-04-2006,291134,Rajasthan,24,18,16,23,81,Pass
Balbir Mehta,23-01-2005,435045,Rajasthan,10,23,24,23,80,Pass
Rohan Verma,02-05-2005,448276,Rajasthan,21,23,13,23,80,Pass
John Sharma,05-06-2005,246613,Rajasthan,19,20,18,23,80,Pass
Ayaan D'Souza,09-08-2005,582271,Rajasthan,19,24,14,23,80,Pass
Kunal Mehta,27-01-2006,248880,Rajasthan,18,17,22,23,80,Pass
Ishaan Chopra,10-01-2005,898790,Rajasthan,22,14,24,19,79,Pass
Aditya Sharma,23-01-2005,662372,Rajasthan,18,22,15,24,79,Pass
Rohan Verma,22-03-2005,267634,Rajasthan,20,15,20,24,79,Pass
Farhan Verma,24-04-2005,976934,Rajasthan,20,19,20,20,79,Pass
Aditya Sharma,12-05-2005,782822,Rajasthan,21,19,21,18,79,Pass
Gurpreet Singh,22-06-2005,984495,Rajasthan,20,11,24,24,79,Pass
David Sharma,14-07-2005,782852,Rajasthan,20,21,22,16,79,Pass
Ishaan Reddy,23-08-2005,256421,Rajasthan,13,24,19,23,79,Pass
Harjeet Reddy,09-09-2005,104563,Rajasthan,21,23,24,11,79,Pass
Aryan Reddy,15-10-2005,756654,Rajasthan,21,12,22,24,79,Pass
Aryan Verma,21-01-2006,233193,Rajasthan,23,15,23,18,79,Pass
Imran Reddy,02-04-2006,469105,Rajasthan,23,24,21,11,79,Pass
Aarav Pillai,08-12-2004,486563,Rajasthan,13,23,18,24,78,Pass
Manpreet Fernandes,26-04-2005,803501,Rajasthan,19,23,23,13,78,Pass
Yash Pillai,26-06-2005,906533,Rajasthan,19,19,23,17,78,Pass
Imran Fernandes,30-09-2005,616666,Rajasthan,23,22,16,17,78,Pass
Kunal Khan,09-10-2005,627652,Rajasthan,18,22,14,24,78,Pass
Kunal Khan,23-01-2006,250728,Rajasthan,23,24,8,23,78,Pass
Balbir Verma,08-12-2004,774774,Rajasthan,22,24,23,8,77,Pass
Vivaan Reddy,18-12-2004,201113,Rajasthan,18,21,23,15,77,Pass
Raj Fernandes,30-01-2005,962324,Rajasthan,7,24,23,23,77,Pass
Rohan Pillai,06-03-2005,166265,Rajasthan,13,17,23,24,77,Pass
Imran Verma,12-07-2005,942669,Rajasthan,23,23,19,12,77,Pass
David Reddy,29-08-2005,761892,Rajasthan,10,24,22,21,77,Pass
Sukhwinder Sharma,07-09-2005,912765,Rajasthan,18,19,16,24,77,Pass
Vivaan Reddy,05-10-2005,538789,Rajasthan,15,18,23,21,77,Pass
Peter Khan,30-10-2005,176108,Rajasthan,23,22,11,21,77,Pass
Kunal D'Souza,20-11-2005,811696,Rajasthan,18,18,23,18,77,Pass
David Chopra,10-01-2006,200449,Rajasthan,18,24,15,20,77,Pass
Peter D'Souza,04-03-2006,975928,Rajasthan,23,15,17,22,77,Pass
Raj Khan,17-11-2004,841345,Rajasthan,19,23,24,10,76,Pass
Aarav Mehta,21-12-2004,328071,Rajasthan,19,24,16,17,76,Pass
Balbir Sharma,29-01-2005,363097,Rajasthan,20,19,14,23,76,Pass
Aarav Verma,17-02-2005,845878,Rajasthan,19,11,23,23,76,Pass
Harjeet Chopra,18-02-2005,426879,Rajasthan,24,19,16,17,76,Pass
Yash Reddy,20-03-2005,809462,Rajasthan,10,23,19,24,76,Pass
Peter Mehta,06-05-2005,393355,Rajasthan,16,23,22,15,76,Pass
Paul Reddy,10-05-2005,574900,Rajasthan,13,23,21,19,76,Pass
Kunal Chopra,13-05-2005,817720,Rajasthan,17,13,22,24,76,Pass
Yash Chopra,24-06-2005,908009,Rajasthan,23,7,23,23,76,Pass
Zaid Reddy,07-10-2005,220721,Rajasthan,24,23,17,12,76,Pass
Mathew Pillai,20-10-2005,661913,Rajasthan,19,19,17,21,76,Pass
Krishna Singh,16-01-2006,951548,Rajasthan,13,22,24,17,76,Pass
Manpreet Reddy,18-01-2006,247047,Rajasthan,8,24,24,20,76,Pass
Kunal Chopra,11-03-2006,892246,Rajasthan,19,15,18,24,76,Pass
Balbir Singh,16-01-2005,327414,Rajasthan,19,11,22,23,75,Pass
Raj Mehta,29-05-2005,419864,Rajasthan,15,20,23,17,75,Pass
Ishaan Mehta,25-07-2005,894632,Rajasthan,12,20,19,24,75,Pass
Ishaan Mehta,11-08-2005,893703,Rajasthan,19,19,24,13,75,Pass
Krishna Pillai,01-10-2005,177872,Rajasthan,18,24,9,24,75,Pass
Raj D'Souza,12-10-2005,653900,Rajasthan,24,18,21,12,75,Pass
Yash Chopra,29-10-2005,679263,Rajasthan,12,17,23,23,75,Pass
Vivaan Singh,22-01-2006,142790,Rajasthan,12,23,20,20,75,Pass
Paul Reddy,25-01-2006,582865,Rajasthan,21,23,7,24,75,Pass
David Chopra,11-03-2006,647191,Rajasthan,16,21,22,16,75,Pass
Ayaan Reddy,19-03-2006,769943,Rajasthan,16,16,22,21,75,Pass
Aarav Verma,15-04-2006,846396,Rajasthan,5,23,24,23,75,Pass
Mathew Khan,27-12-2004,634671,Rajasthan,23,22,20,9,74,Pass
Aarav Singh,15-01-2005,433644,Rajasthan,16,18,23,17,74,Pass
Manpreet Khan,25-01-2005,914949,Rajasthan,22,20,11,21,74,Pass
Aditya Fernandes,17-02-2005,149893,Rajasthan,24,18,9,23,74,Pass
Aditya Mehta,04-03-2005,700772,Rajasthan,21,21,14,18,74,Pass
Kunal D'Souza,17-03-2005,380363,Rajasthan,18,24,23,9,74,Pass
Aditya Sharma,25-03-2005,673068,Rajasthan,21,23,10,20,74,Pass
Ishaan Chopra,10-06-2005,672931,Rajasthan,11,17,24,22,74,Pass
Peter Reddy,20-06-2005,584802,Rajasthan,12,21,18,23,74,Pass
Kunal Chopra,25-07-2005,512465,Rajasthan,22,13,20,19,74,Pass
Ishaan Sharma,03-08-2005,391434,Rajasthan,7,24,24,19,74,Pass
Gurpreet Pillai,19-08-2005,246354,Rajasthan,23,15,12,24,74,Pass
Vivaan D'Souza,23-10-2005,263594,Rajasthan,18,14,24,18,74,Pass
Aryan D'Souza,24-01-2006,430157,Rajasthan,23,23,9,19,74,Pass
Vivaan Reddy,25-01-2006,496119,Rajasthan,13,19,20,22,74,Pass
Aditya Fernandes,19-02-2006,265086,Rajasthan,16,22,14,22,74,Pass
Ishaan Fernandes,12-03-2006,852869,Rajasthan,14,15,22,23,74,Pass
Yash Verma,24-04-2006,158229,Rajasthan,11,20,21,22,74,Pass
Rohan Pillai,25-04-2006,492549,Rajasthan,18,12,21,23,74,Pass
Aarav D'Souza,19-01-2005,161224,Rajasthan,4,21,24,24,73,Pass
Kunal Singh,01-05-2005,819624,Rajasthan,19,24,18,12,73,Pass
Krishna Khan,24-05-2005,741209,Rajasthan,23,16,15,19,73,Pass
Yash Khan,02-06-2005,240550,Rajasthan,17,13,22,21,73,Pass
Aryan Reddy,18-07-2005,694232,Rajasthan,20,8,21,24,73,Pass
Aditya Khan,04-08-2005,904420,Rajasthan,23,11,20,19,73,Pass
Yash Khan,19-09-2005,866126,Rajasthan,21,24,8,20,73,Pass
Krishna Khan,27-10-2005,442126,Rajasthan,19,14,16,24,73,Pass
Harjeet Fernandes,11-12-2005,712595,Rajasthan,24,20,17,12,73,Pass
Sukhwinder D'Souza,12-01-2006,768196,Rajasthan,21,22,7,23,73,Pass
Yash Verma,04-02-2006,478594,Rajasthan,15,10,24,24,73,Pass
Peter D'Souza,08-02-2006,629657,Rajasthan,17,22,20,14,73,Pass
Aarav Sharma,09-02-2006,313236,Rajasthan,12,18,22,21,73,Pass
Raj Pillai,21-02-2006,989060,Rajasthan,7,22,23,21,73,Pass
Rohan Reddy,08-11-2004,478636,Rajasthan,10,22,18,22,72,Pass
Ayaan Singh,12-11-2004,222740,Rajasthan,7,24,18,23,72,Pass
Kunal Sharma,01-03-2005,812274,Rajasthan,11,17,24,20,72,Pass
Imran Reddy,04-03-2005,937878,Rajasthan,11,18,22,21,72,Pass
Mathew Sharma,10-04-2005,148556,Rajasthan,22,23,15,12,72,Pass
Gurpreet Khan,14-04-2005,824823,Rajasthan,24,18,13,17,72,Pass
Vivaan Sharma,20-04-2005,388412,Rajasthan,18,23,8,23,72,Pass
Aditya Sharma,17-06-2005,192290,Rajasthan,24,24,11,13,72,Pass
Krishna Pillai,17-06-2005,263415,Rajasthan,19,22,10,21,72,Pass
Krishna Pillai,09-08-2005,836383,Rajasthan,22,13,15,22,72,Pass
Rohan Sharma,10-08-2005,818404,Rajasthan,21,18,23,10,72,Pass
Krishna Singh,15-08-2005,527299,Rajasthan,12,23,15,22,72,Pass
Aryan Chopra,18-08-2005,401395,Rajasthan,15,23,22,12,72,Pass
Yash Verma,26-08-2005,301522,Rajasthan,13,24,19,16,72,Pass
Raj Reddy,10-09-2005,606054,Rajasthan,23,21,16,12,72,Pass
Yash Singh,25-10-2005,349968,Rajasthan,22,21,9,20,72,Pass
Rohan Verma,03-12-2005,921597,Rajasthan,13,21,23,15,72,Pass
Kunal Pillai,15-02-2006,333201,Rajasthan,6,24,21,21,72,Pass
Kunal Pillai,18-04-2006,841758,Rajasthan,21,17,24,10,72,Pass
Harjeet Khan,18-12-2004,377583,Rajasthan,16,18,15,22,71,Pass
Rohan Verma,07-01-2005,979497,Rajasthan,11,20,23,17,71,Pass
Aditya Khan,21-04-2005,736252,Rajasthan,23,14,14,20,71,Pass
Yash Khan,20-05-2005,633898,Rajasthan,20,18,9,24,71,Pass
Balbir Singh,23-05-2005,318854,Rajasthan,15,17,24,15,71,Pass
Kunal Sharma,27-05-2005,650418,Rajasthan,17,14,20,20,71,Pass
Paul Khan,06-07-2005,920211,Rajasthan,12,24,11,24,71,Pass
Ishaan Singh,19-08-2005,840267,Rajasthan,18,9,21,23,71,Pass
Ishaan Pillai,10-11-2005,621531,Rajasthan,20,21,6,24,71,Pass
Balbir Fernandes,11-11-2005,256865,Rajasthan,13,22,20,16,71,Pass
Harjeet D'Souza,18-11-2005,266884,Rajasthan,22,18,8,23,71,Pass
Aryan Verma,20-12-2005,100634,Rajasthan,19,7,21,24,71,Pass
Farhan Chopra,20-01-2006,733035,Rajasthan,22,12,15,22,71,Pass
Aarav Singh,09-02-2006,575231,Rajasthan,18,11,20,22,71,Pass
Yash Pillai,28-02-2006,938128,Rajasthan,15,17,15,24,71,Pass
Kunal Khan,04-03-2006,757640,Rajasthan,15,22,19,15,71,Pass
Mathew Sharma,07-03-2006,679763,Rajasthan,20,13,19,19,71,Pass
Aditya Sharma,15-03-2006,750829,Rajasthan,20,21,16,14,71,Pass
Aditya Fernandes,10-04-2006,851774,Rajasthan,20,18,11,22,71,Pass
Balbir Mehta,27-04-2006,672930,Rajasthan,7,22,22,20,71,Pass
Aditya Pillai,21-01-2005,420476,Rajasthan,21,17,10,22,70,Pass
Raj Sharma,15-02-2005,210190,Rajasthan,17,12,17,24,70,Pass
Aryan Singh,25-02-2005,563868,Rajasthan,24,22,13,11,70,Pass
Rohan Chopra,25-02-2005,338568,Rajasthan,21,4,21,24,70,Pass
Manpreet Khan,12-03-2005,409759,Rajasthan,20,17,23,10,70,Pass
Raj Verma,19-03-2005,469627,Rajasthan,14,23,17,16,70,Pass
Manpreet Sharma,27-03-2005,901565,Rajasthan,9,18,20,23,70,Pass
Kunal Mehta,03-05-2005,210615,Rajasthan,21,14,18,17,70,Pass
Ishaan Mehta,05-07-2005,119876,Rajasthan,10,18,22,20,70,Pass
Aarav Chopra,08-07-2005,441980,Rajasthan,15,11,22,22,70,Pass
Vivaan Reddy,15-08-2005,103215,Rajasthan,18,9,23,20,70,Pass
Yash Fernandes,08-09-2005,265175,Rajasthan,21,5,21,23,70,Pass
Rohan Sharma,18-09-2005,323850,Rajasthan,23,16,15,16,70,Pass
Kunal Pillai,25-09-2005,748413,Rajasthan,13,20,16,21,70,Pass
Raj Chopra,27-09-2005,554058,Rajasthan,18,20,17,15,70,Pass
Kunal Mehta,24-11-2005,961378,Rajasthan,13,20,14,23,70,Pass
Aditya Khan,26-11-2005,684139,Rajasthan,21,21,21,7,70,Pass
Imran Chopra,25-12-2005,899132,Rajasthan,21,21,17,11,70,Pass
John Pillai,08-01-2006,578536,Rajasthan,13,21,13,23,70,Pass
Manpreet Mehta,11-02-2006,661386,Rajasthan,20,15,21,14,70,Pass
Krishna Sharma,17-02-2006,684060,Rajasthan,23,21,6,20,70,Pass
Rohan Pillai,30-03-2006,130321,Rajasthan,23,20,21,6,70,Pass
Ishaan Khan,03-04-2006,210641,Rajasthan,19,20,12,19,70,Pass
Raj Mehta,18-11-2004,643972,Rajasthan,16,20,18,15,69,Pass
Aryan Mehta,08-12-2004,953184,Rajasthan,20,23,6,20,69,Pass
Ishaan Verma,04-02-2005,941972,Rajasthan,24,8,24,13,69,Pass
Sukhwinder Fernandes,16-02-2005,110929,Rajasthan,19,17,20,13,69,Pass
Krishna Pillai,20-02-2005,201139,Rajasthan,13,15,18,23,69,Pass
Krishna Sharma,02-03-2005,618799,Rajasthan,23,6,24,16,69,Pass
Peter Singh,12-05-2005,756618,Rajasthan,21,15,22,11,69,Pass
Yash Mehta,25-06-2005,446370,Rajasthan,24,15,12,18,69,Pass
Raj Sharma,29-06-2005,894353,Rajasthan,19,21,13,16,69,Pass
Raj Chopra,16-07-2005,608400,Rajasthan,14,15,17,23,69,Pass
Ishaan Singh,06-08-2005,164492,Rajasthan,14,12,22,21,69,Pass
Krishna D'Souza,07-08-2005,935798,Rajasthan,14,9,23,23,69,Pass
Peter Khan,21-08-2005,245960,Rajasthan,18,15,21,15,69,Pass
Balbir Khan,22-08-2005,291487,Rajasthan,10,24,19,16,69,Pass
Rohan Reddy,27-08-2005,613844,Rajasthan,14,21,23,11,69,Pass
Raj Khan,02-10-2005,397251,Rajasthan,11,15,21,22,69,Pass
Krishna Verma,17-10-2005,254570,Rajasthan,22,15,19,13,69,Pass
Aryan Khan,06-11-2005,137944,Rajasthan,16,20,11,22,69,Pass
Balbir Mehta,08-11-2005,160697,Rajasthan,17,17,18,17,69,Pass
Manpreet Khan,17-11-2005,757315,Rajasthan,21,18,10,20,69,Pass
Rohan D'Souza,09-12-2005,259365,Rajasthan,16,24,5,24,69,Pass
Manpreet Mehta,14-01-2006,747380,Rajasthan,21,22,7,19,69,Pass
Aryan Verma,26-01-2006,615050,Rajasthan,11,24,10,24,69,Pass
Ishaan D'Souza,29-01-2006,253921,Rajasthan,13,21,15,20,69,Pass
Krishna D'Souza,08-02-2006,522630,Rajasthan,20,15,10,24,69,Pass
Zaid Khan,21-02-2006,353246,Rajasthan,15,14,20,20,69,Pass
Aryan Pillai,24-02-2006,762701,Rajasthan,23,19,6,21,69,Pass
Vivaan Mehta,15-03-2006,981306,Rajasthan,15,10,20,24,69,Pass
Aditya Pillai,19-03-2006,171446,Rajasthan,21,22,18,8,69,Pass
Rohan Khan,24-03-2006,199251,Rajasthan,21,19,17,12,69,Pass
Yash Sharma,07-04-2006,898603,Rajasthan,14,22,18,15,69,Pass
Aarav Singh,29-04-2006,709487,Rajasthan,20,19,23,7,69,Pass
Kunal Singh,07-11-2004,463149,Rajasthan,20,17,13,18,68,Pass
Ishaan Chopra,26-11-2004,785207,Rajasthan,17,21,22,8,68,Pass
Peter Khan,06-12-2004,261244,Rajasthan,15,24,14,15,68,Pass
Yash Verma,18-12-2004,222960,Rajasthan,21,23,7,17,68,Pass
Krishna D'Souza,27-12-2004,498763,Rajasthan,21,23,17,7,68,Pass
Aryan Singh,14-01-2005,788719,Rajasthan,23,5,21,19,68,Pass
Peter Verma,22-01-2005,676866,Rajasthan,20,10,17,21,68,Pass
Kunal Sharma,27-01-2005,588637,Rajasthan,21,14,14,19,68,Pass
Aditya Sharma,11-02-2005,503233,Rajasthan,20,21,10,17,68,Pass
Kunal Reddy,18-03-2005,591829,Rajasthan,20,21,12,15,68,Pass
Aryan Verma,30-04-2005,152090,Rajasthan,23,17,10,18,68,Pass
Rohan Pillai,15-06-2005,572798,Rajasthan,16,17,11,24,68,Pass
Raj Khan,06-07-2005,566223,Rajasthan,23,21,7,17,68,Pass
Vivaan Chopra,07-07-2005,671788,Rajasthan,21,20,10,17,68,Pass
John Singh,08-07-2005,969262,Rajasthan,7,16,22,23,68,Pass
Balbir D'Souza,13-07-2005,529163,Rajasthan,16,22,9,21,68,Pass
Aarav Pillai,18-07-2005,666727,Rajasthan,12,24,21,11,68,Pass
Rohan Sharma,02-08-2005,151893,Rajasthan,17,17,18,16,68,Pass
Krishna Singh,20-09-2005,386521,Rajasthan,15,23,7,23,68,Pass
Manpreet Singh,22-10-2005,636221,Rajasthan,23,11,23,11,68,Pass
Mathew Reddy,05-11-2005,242488,Rajasthan,16,16,12,24,68,Pass
Kunal Khan,09-11-2005,890095,Rajasthan,10,24,12,22,68,Pass
Raj Pillai,21-11-2005,263154,Rajasthan,16,14,21,17,68,Pass
Aarav D'Souza,06-12-2005,262191,Rajasthan,18,22,18,10,68,Pass
Rohan Reddy,07-01-2006,818353,Rajasthan,15,17,12,24,68,Pass
Kunal Reddy,08-01-2006,851776,Rajasthan,19,4,23,22,68,Pass
Kunal Reddy,10-01-2006,224253,Rajasthan,24,14,11,19,68,Pass
Aarav D'Souza,19-01-2006,495297,Rajasthan,18,18,13,19,68,Pass
Aarav Khan,25-01-2006,806074,Rajasthan,23,21,7,17,68,Pass
Krishna Chopra,05-02-2006,380564,Rajasthan,18,24,13,13,68,Pass
Aryan D'Souza,09-02-2006,762399,Rajasthan,23,8,14,23,68,Pass
Aarav Chopra,11-02-2006,153982,Rajasthan,20,13,16,19,68,Pass
Harjeet Mehta,12-11-2004,991090,Rajasthan,24,4,19,20,67,Pass
Gurpreet Singh,07-03-2005,891943,Rajasthan,17,16,15,19,67,Pass
Aryan D'Souza,18-03-2005,910842,Rajasthan,23,21,15,8,67,Pass
Raj Sharma,04-05-2005,923626,Rajasthan,17,8,19,23,67,Pass
Kunal D'Souza,12-05-2005,236176,Rajasthan,24,9,13,21,67,Pass
Paul Mehta,03-06-2005,631523,Rajasthan,13,21,19,14,67,Pass
Aarav Pillai,11-06-2005,427709,Rajasthan,23,23,6,15,67,Pass
Aryan Pillai,28-06-2005,488618,Rajasthan,24,24,6,13,67,Pass
Zaid Khan,23-07-2005,181464,Rajasthan,16,22,23,6,67,Pass
Krishna Reddy,25-07-2005,363011,Rajasthan,22,17,12,16,67,Pass
Raj Singh,30-07-2005,514859,Rajasthan,24,17,19,7,67,Pass
John Singh,02-08-2005,584304,Rajasthan,20,10,16,21,67,Pass
Vivaan Sharma,12-08-2005,259659,Rajasthan,22,11,11,23,67,Pass
Raj Sharma,14-08-2005,231631,Rajasthan,5,22,20,20,67,Pass
David Fernandes,24-08-2005,387632,Rajasthan,21,20,5,21,67,Pass
Aditya Pillai,05-09-2005,368466,Rajasthan,17,14,24,12,67,Pass
Balbir Singh,22-09-2005,756969,Rajasthan,22,17,6,22,67,Pass
Sukhwinder Sharma,16-11-2005,526451,Rajasthan,6,23,20,18,67,Pass
Yash Chopra,23-11-2005,799077,Rajasthan,20,23,8,16,67,Pass
Zaid Sharma,08-12-2005,328705,Rajasthan,23,6,24,14,67,Pass
Raj Verma,15-12-2005,547353,Rajasthan,22,11,16,18,67,Pass
Raj Verma,31-12-2005,576640,Rajasthan,14,13,18,22,67,Pass
Sukhwinder Sharma,01-03-2006,180366,Rajasthan,21,13,22,11,67,Pass
Yash Pillai,11-03-2006,296055,Rajasthan,15,18,23,11,67,Pass
Ishaan Reddy,26-03-2006,777370,Rajasthan,16,14,16,21,67,Pass
Zaid Singh,29-03-2006,960897,Rajasthan,15,9,20,23,67,Pass
Aditya Fernandes,31-03-2006,919005,Rajasthan,21,13,16,17,67,Pass
Krishna Khan,07-04-2006,335036,Rajasthan,6,19,21,21,67,Pass
Aryan Khan,20-04-2006,183553,Rajasthan,21,16,6,24,67,Pass
Harjeet Verma,21-04-2006,968803,Rajasthan,18,16,11,22,67,Pass
Krishna Reddy,03-05-2006,746851,Rajasthan,18,8,19,22,67,Pass
Paul Reddy,18-11-2004,599184,Rajasthan,22,14,24,6,66,Pass
Harjeet Pillai,29-11-2004,461463,Rajasthan,18,20,6,22,66,Pass
Aarav Reddy,06-01-2005,654057,Rajasthan,14,20,23,9,66,Pass
Ishaan Khan,11-01-2005,686162,Rajasthan,17,9,18,22,66,Pass
Manpreet Verma,26-01-2005,525952,Rajasthan,9,19,24,14,66,Pass
Harjeet D'Souza,27-01-2005,364308,Rajasthan,22,23,8,13,66,Pass
Imran Reddy,14-02-2005,856994,Rajasthan,8,20,20,18,66,Pass
Aarav Khan,17-02-2005,965281,Rajasthan,20,16,21,9,66,Pass
Aryan Sharma,04-04-2005,222206,Rajasthan,23,24,7,12,66,Pass
David Singh,06-05-2005,645153,Rajasthan,14,12,24,16,66,Pass
Mathew Khan,01-06-2005,670928,Rajasthan,19,21,22,4,66,Pass
Zaid Pillai,02-06-2005,730231,Rajasthan,9,23,12,22,66,Pass
Rohan Fernandes,15-06-2005,275139,Rajasthan,21,11,22,12,66,Pass
Ishaan Pillai,16-06-2005,782139,Rajasthan,14,23,24,5,66,Pass
Harjeet Verma,24-06-2005,920023,Rajasthan,24,4,18,20,66,Pass
Yash Pillai,04-08-2005,175115,Rajasthan,15,16,14,21,66,Pass
Yash Sharma,08-08-2005,806280,Rajasthan,16,21,7,22,66,Pass
Vivaan Verma,09-08-2005,760443,Rajasthan,21,12,14,19,66,Pass
Krishna D'Souza,10-08-2005,809388,Rajasthan,21,23,10,12,66,Pass
Rohan Chopra,21-08-2005,991471,Rajasthan,24,11,22,9,66,Pass
Balbir Mehta,10-09-2005,455171,Rajasthan,17,14,16,19,66,Pass
Peter Mehta,05-10-2005,710012,Rajasthan,13,18,22,13,66,Pass
Vivaan Reddy,15-12-2005,180908,Rajasthan,22,17,17,10,66,Pass
Aarav Sharma,20-12-2005,444290,Rajasthan,20,14,19,13,66,Pass
Raj Reddy,14-01-2006,632410,Rajasthan,16,20,19,11,66,Pass
Rohan Mehta,30-01-2006,287550,Rajasthan,21,18,13,14,66,Pass
Vivaan Sharma,18-02-2006,833275,Rajasthan,11,24,10,21,66,Pass
Aditya Fernandes,27-02-2006,205963,Rajasthan,23,6,21,16,66,Pass
Aryan Reddy,06-03-2006,599436,Rajasthan,23,7,15,21,66,Pass
Yash Singh,22-04-2006,543021,Rajasthan,17,19,11,19,66,Pass
Rohan Reddy,30-04-2006,725051,Rajasthan,16,4,24,22,66,Pass
Gurpreet Sharma,19-12-2004,923662,Tamil Nadu,24,23,24,21,92,Pass
Sukhwinder Chopra,23-10-2005,830620,Tamil Nadu,23,24,24,20,91,Pass
Kunal Mehta,09-03-2006,209225,Tamil Nadu,20,22,23,23,88,Pass
Sukhwinder Chopra,27-05-2005,229339,Tamil Nadu,21,19,23,24,87,Pass
Aryan Khan,27-03-2005,842216,Tamil Nadu,21,20,24,21,86,Pass
Ishaan Reddy,15-01-2006,356499,Tamil Nadu,17,23,23,23,86,Pass
Sukhwinder Mehta,08-12-2005,135507,Tamil Nadu,19,23,18,24,84,Pass
Kunal Verma,09-12-2005,253013,Tamil Nadu,17,24,20,22,83,Pass
Aryan Singh,25-01-2006,572647,Tamil Nadu,18,22,23,20,83,Pass
Peter Sharma,17-05-2005,655151,Tamil Nadu,19,24,22,17,82,Pass
Aditya Fernandes,02-01-2006,704618,Tamil Nadu,22,16,21,23,82,Pass
Gurpreet Reddy,25-03-2006,188885,Tamil Nadu,23,15,24,20,82,Pass
Rohan Singh,07-12-2004,724073,Tamil Nadu,19,24,24,14,81,Pass
Manpreet Khan,23-12-2004,593923,Tamil Nadu,24,19,19,19,81,Pass
Mathew Singh,27-12-2004,593074,Tamil Nadu,24,20,18,19,81,Pass
Aditya Fernandes,15-04-2005,749773,Tamil Nadu,17,24,18,22,81,Pass
Aryan Pillai,25-09-2005,895521,Tamil Nadu,24,23,22,12,81,Pass
Krishna Fernandes,28-10-2005,215538,Tamil Nadu,23,23,22,13,81,Pass
Yash Fernandes,07-11-2005,500018,Tamil Nadu,13,24,21,23,81,Pass
Yash Pillai,15-11-2004,301113,Tamil Nadu,22,20,18,20,80,Pass
Farhan Fernandes,25-11-2004,451556,Tamil Nadu,17,24,22,17,80,Pass
Balbir Fernandes,03-12-2004,355668,Tamil Nadu,23,18,17,22,80,Pass
Ishaan Verma,10-01-2005,181351,Tamil Nadu,22,11,24,23,80,Pass
John Reddy,20-01-2005,801876,Tamil Nadu,21,23,23,13,80,Pass
Kunal Singh,22-05-2005,933901,Tamil Nadu,22,19,17,22,80,Pass
Raj Sharma,10-08-2005,709735,Tamil Nadu,24,24,15,17,80,Pass
Rohan Fernandes,13-11-2005,565379,Tamil Nadu,24,11,22,23,80,Pass
Ishaan Khan,08-01-2006,998041,Tamil Nadu,19,22,18,21,80,Pass
Ishaan Singh,20-01-2006,826852,Tamil Nadu,23,23,16,18,80,Pass
Ishaan Khan,18-04-2006,482287,Tamil Nadu,24,16,22,18,80,Pass
Ishaan Mehta,07-05-2006,168526,Tamil Nadu,23,24,14,19,80,Pass
Peter D'Souza,21-01-2005,141361,Tamil Nadu,20,13,23,23,79,Pass
Paul Verma,21-04-2005,693584,Tamil Nadu,22,19,18,20,79,Pass
Rohan Singh,03-07-2005,518077,Tamil Nadu,20,22,23,14,79,Pass
David Pillai,14-07-2005,236339,Tamil Nadu,18,17,22,22,79,Pass
Aditya Fernandes,07-08-2005,248536,Tamil Nadu,17,22,19,21,79,Pass
Ayaan Singh,01-10-2005,449733,Tamil Nadu,23,16,22,18,79,Pass
Aarav Fernandes,16-12-2004,231850,Tamil Nadu,14,17,24,23,78,Pass
Farhan Verma,23-12-2004,417944,Tamil Nadu,18,20,23,17,78,Pass
Ishaan Singh,20-02-2005,242548,Tamil Nadu,22,23,17,16,78,Pass
Rohan Mehta,24-08-2005,835189,Tamil Nadu,24,23,16,15,78,Pass
Aditya D'Souza,20-01-2006,812038,Tamil Nadu,21,18,23,16,78,Pass
Paul Pillai,01-02-2006,473662,Tamil Nadu,22,11,24,21,78,Pass
Gurpreet Fernandes,10-03-2006,195599,Tamil Nadu,20,20,21,17,78,Pass
Rohan Reddy,27-03-2006,381823,Tamil Nadu,13,20,22,23,78,Pass
Aryan Sharma,07-12-2004,121736,Tamil Nadu,17,19,22,19,77,Pass
Aditya Pillai,18-12-2004,224288,Tamil Nadu,19,22,15,21,77,Pass
Aryan Verma,14-01-2005,555713,Tamil Nadu,16,20,20,21,77,Pass
Aditya Singh,31-01-2005,963365,Tamil Nadu,23,20,22,12,77,Pass
Aditya Chopra,10-06-2005,678569,Tamil Nadu,24,20,15,18,77,Pass
Raj D'Souza,30-07-2005,451079,Tamil Nadu,22,14,22,19,77,Pass
Peter Sharma,01-08-2005,243157,Tamil Nadu,21,10,23,23,77,Pass
Manpreet Khan,20-09-2005,508347,Tamil Nadu,22,18,23,14,77,Pass
Harjeet D'Souza,06-10-2005,181724,Tamil Nadu,22,9,23,23,77,Pass
Vivaan Reddy,10-10-2005,898000,Tamil Nadu,15,22,16,24,77,Pass
Ishaan Fernandes,16-01-2006,537283,Tamil Nadu,13,22,22,20,77,Pass
Rohan Reddy,01-04-2006,140007,Tamil Nadu,23,15,24,15,77,Pass
Peter Reddy,15-04-2006,127873,Tamil Nadu,20,23,14,20,77,Pass
Ayaan Mehta,23-02-2005,688326,Tamil Nadu,20,22,15,19,76,Pass
Raj Pillai,29-03-2005,333780,Tamil Nadu,22,21,9,24,76,Pass
Aditya Chopra,13-04-2005,939877,Tamil Nadu,12,23,24,17,76,Pass
Yash Fernandes,07-08-2005,161287,Tamil Nadu,23,16,16,21,76,Pass
Aditya D'Souza,24-09-2005,517498,Tamil Nadu,15,24,24,13,76,Pass
Vivaan Reddy,27-12-2005,287500,Tamil Nadu,23,8,21,24,76,Pass
Yash D'Souza,02-01-2006,798545,Tamil Nadu,12,16,24,24,76,Pass
Kunal Pillai,12-02-2006,236143,Tamil Nadu,10,20,24,22,76,Pass
Rehan Reddy,19-04-2006,425320,Tamil Nadu,17,15,23,21,76,Pass
Kunal Mehta,10-12-2004,354000,Tamil Nadu,21,24,22,8,75,Pass
Balbir Sharma,13-01-2005,277708,Tamil Nadu,15,22,16,22,75,Pass
Balbir Pillai,18-01-2005,108098,Tamil Nadu,24,21,7,23,75,Pass
Raj Mehta,09-03-2005,727690,Tamil Nadu,23,13,21,18,75,Pass
Vivaan Khan,01-06-2005,623146,Tamil Nadu,16,24,24,11,75,Pass
Kunal Singh,14-06-2005,116552,Tamil Nadu,17,23,13,22,75,Pass
Aditya Pillai,28-06-2005,463002,Tamil Nadu,22,5,24,24,75,Pass
Aarav Sharma,30-06-2005,177979,Tamil Nadu,23,21,12,19,75,Pass
Gurpreet Singh,05-07-2005,224939,Tamil Nadu,17,23,19,16,75,Pass
Aditya Mehta,03-01-2006,111271,Tamil Nadu,14,24,13,24,75,Pass
Aditya Fernandes,14-11-2004,616490,Tamil Nadu,16,17,22,19,74,Pass
Aryan Sharma,20-11-2004,672318,Tamil Nadu,17,23,15,19,74,Pass
Krishna D'Souza,08-12-2004,644859,Tamil Nadu,23,18,18,15,74,Pass
Raj Singh,11-12-2004,863717,Tamil Nadu,12,22,21,19,74,Pass
Ishaan Fernandes,11-01-2005,754674,Tamil Nadu,24,20,23,7,74,Pass
Aarav Mehta,14-01-2005,518723,Tamil Nadu,21,22,8,23,74,Pass
Balbir Sharma,27-01-2005,466366,Tamil Nadu,13,20,17,24,74,Pass
Imran Sharma,13-02-2005,907646,Tamil Nadu,23,17,18,16,74,Pass
John Mehta,16-02-2005,496663,Tamil Nadu,19,24,9,22,74,Pass
Aryan Sharma,11-05-2005,132682,Tamil Nadu,22,23,14,15,74,Pass
Aryan Sharma,08-06-2005,348336,Tamil Nadu,22,20,9,23,74,Pass
Rohan Singh,26-08-2005,698275,Tamil Nadu,19,22,11,22,74,Pass
Farhan Mehta,08-09-2005,890963,Tamil Nadu,22,22,14,16,74,Pass
Manpreet Reddy,19-09-2005,344878,Tamil Nadu,18,19,13,24,74,Pass
Rohan Singh,01-10-2005,947952,Tamil Nadu,14,15,21,24,74,Pass
Manpreet Reddy,01-01-2006,127230,Tamil Nadu,16,22,12,24,74,Pass
Aarav Reddy,08-01-2006,253479,Tamil Nadu,14,15,23,22,74,Pass
Aarav Pillai,07-03-2006,611140,Tamil Nadu,12,22,21,19,74,Pass
Ishaan Mehta,14-03-2006,310632,Tamil Nadu,22,21,10,21,74,Pass
Krishna Singh,24-12-2004,314129,Tamil Nadu,23,21,19,10,73,Pass
Zaid Sharma,24-12-2004,704674,Tamil Nadu,13,20,16,24,73,Pass
Harjeet Fernandes,07-01-2005,729203,Tamil Nadu,21,22,7,23,73,Pass
Aryan Mehta,09-02-2005,207672,Tamil Nadu,12,22,16,23,73,Pass
Raj Reddy,22-03-2005,681454,Tamil Nadu,21,23,7,22,73,Pass
Vivaan Pillai,31-03-2005,416183,Tamil Nadu,10,20,21,22,73,Pass
Imran Pillai,21-05-2005,121708,Tamil Nadu,18,19,15,21,73,Pass
Gurpreet Reddy,24-06-2005,157948,Tamil Nadu,23,24,11,15,73,Pass
Krishna Verma,26-06-2005,179544,Tamil Nadu,24,24,12,13,73,Pass
Aditya Khan,25-07-2005,916023,Tamil Nadu,21,13,20,19,73,Pass
Ishaan Mehta,27-07-2005,566014,Tamil Nadu,22,18,23,10,73,Pass
Farhan Singh,29-08-2005,475902,Tamil Nadu,12,22,15,24,73,Pass
Aarav Pillai,15-09-2005,943050,Tamil Nadu,11,24,18,20,73,Pass
Imran Khan,28-10-2005,592808,Tamil Nadu,8,23,18,24,73,Pass
Manpreet D'Souza,03-02-2006,277460,Tamil Nadu,16,19,17,21,73,Pass
Farhan Khan,17-02-2006,390515,Tamil Nadu,24,15,12,22,73,Pass
Gurpreet Pillai,21-02-2006,758934,Tamil Nadu,18,22,19,14,73,Pass
Aryan Singh,20-04-2006,141463,Tamil Nadu,19,18,13,23,73,Pass
Rohan Mehta,10-01-2005,800938,Tamil Nadu,21,11,24,16,72,Pass
David Verma,12-01-2005,523048,Tamil Nadu,14,21,17,20,72,Pass
Aryan Singh,10-04-2005,280016,Tamil Nadu,13,23,18,18,72,Pass
Vivaan D'Souza,20-06-2005,434184,Tamil Nadu,18,13,17,24,72,Pass
Manpreet Chopra,29-06-2005,435063,Tamil Nadu,13,24,21,14,72,Pass
Kunal Reddy,30-06-2005,980848,Tamil Nadu,22,20,19,11,72,Pass
Kunal Verma,09-11-2005,634412,Tamil Nadu,22,10,19,21,72,Pass
Zaid Singh,03-01-2006,327680,Tamil Nadu,9,18,21,24,72,Pass
Aditya Reddy,22-04-2006,250007,Tamil Nadu,21,14,22,15,72,Pass
Krishna Singh,06-05-2006,166964,Tamil Nadu,22,16,22,12,72,Pass
Manpreet Sharma,03-12-2004,790202,Tamil Nadu,21,20,19,11,71,Pass
Manpreet Reddy,26-12-2004,579470,Tamil Nadu,18,20,13,20,71,Pass
Vivaan Reddy,25-01-2005,168283,Tamil Nadu,24,12,14,21,71,Pass
Kunal Sharma,28-05-2005,365540,Tamil Nadu,23,7,17,24,71,Pass
Aarav Fernandes,13-07-2005,808862,Tamil Nadu,11,16,21,23,71,Pass
Zaid Singh,12-08-2005,305221,Tamil Nadu,23,16,11,21,71,Pass
Aarav Mehta,30-08-2005,229645,Tamil Nadu,16,22,10,23,71,Pass
Aarav Mehta,17-02-2006,729547,Tamil Nadu,12,18,23,18,71,Pass
Raj Singh,25-02-2006,274315,Tamil Nadu,8,16,23,24,71,Pass
Aditya Pillai,22-03-2006,349012,Tamil Nadu,19,19,12,21,71,Pass
Ishaan Sharma,03-05-2006,469605,Tamil Nadu,20,17,16,18,71,Pass
Ishaan Verma,03-05-2006,180572,Tamil Nadu,14,18,23,16,71,Pass
Krishna Reddy,09-01-2005,963828,Tamil Nadu,24,24,6,16,70,Pass
Aditya Mehta,17-02-2005,377345,Tamil Nadu,21,19,7,23,70,Pass
Aryan Verma,20-03-2005,151465,Tamil Nadu,19,8,19,24,70,Pass
Gurpreet Mehta,29-06-2005,322767,Tamil Nadu,18,5,24,23,70,Pass
Paul Fernandes,10-07-2005,231895,Tamil Nadu,13,23,18,16,70,Pass
Vivaan Singh,28-07-2005,794733,Tamil Nadu,21,20,12,17,70,Pass
Kunal D'Souza,11-12-2005,345956,Tamil Nadu,22,11,16,21,70,Pass
Aditya Chopra,18-02-2006,668540,Tamil Nadu,20,15,16,19,70,Pass
Rohan Reddy,20-04-2006,697624,Tamil Nadu,20,16,14,20,70,Pass
Aarav Singh,07-01-2005,670447,Tamil Nadu,22,23,19,5,69,Pass
Aarav Singh,22-01-2005,809649,Tamil Nadu,16,16,17,20,69,Pass
Vivaan Reddy,31-01-2005,335655,Tamil Nadu,18,19,12,20,69,Pass
Ishaan Khan,09-02-2005,225050,Tamil Nadu,14,22,12,21,69,Pass
Ishaan Verma,17-02-2005,473272,Tamil Nadu,23,6,17,23,69,Pass
Kunal Pillai,22-04-2005,714936,Tamil Nadu,18,19,17,15,69,Pass
Rohan Singh,24-04-2005,374510,Tamil Nadu,11,19,22,17,69,Pass
Rohan Singh,23-05-2005,666855,Tamil Nadu,12,21,15,21,69,Pass
Yash Chopra,06-06-2005,620774,Tamil Nadu,23,12,17,17,69,Pass
Yash Singh,11-08-2005,490465,Tamil Nadu,23,14,20,12,69,Pass
Raj Sharma,25-09-2005,225535,Tamil Nadu,12,19,14,24,69,Pass
Gurpreet Reddy,26-10-2005,292932,Tamil Nadu,21,20,19,9,69,Pass
Mathew Singh,09-11-2005,448464,Tamil Nadu,23,24,6,16,69,Pass
Sukhwinder Singh,09-11-2005,701687,Tamil Nadu,19,24,22,4,69,Pass
Aryan Reddy,10-11-2005,427146,Tamil Nadu,13,15,18,23,69,Pass
Yash Pillai,12-11-2005,229950,Tamil Nadu,19,11,21,18,69,Pass
Aryan Mehta,22-11-2005,945335,Tamil Nadu,24,23,14,8,69,Pass
Yash Fernandes,22-11-2005,202247,Tamil Nadu,20,7,22,20,69,Pass
Rohan Singh,27-12-2005,390231,Tamil Nadu,24,9,15,21,69,Pass
Mathew D'Souza,14-02-2006,852252,Tamil Nadu,20,22,22,5,69,Pass
Rohan Fernandes,04-04-2006,172986,Tamil Nadu,11,15,19,24,69,Pass
Imran Khan,05-04-2006,922124,Tamil Nadu,20,7,20,22,69,Pass
Ayaan Singh,15-04-2006,636408,Tamil Nadu,15,24,11,19,69,Pass
Manpreet Pillai,24-11-2004,527071,Tamil Nadu,7,17,24,20,68,Pass
Harjeet D'Souza,20-05-2005,128157,Tamil Nadu,12,22,23,11,68,Pass
Aarav Mehta,31-07-2005,726646,Tamil Nadu,18,8,20,22,68,Pass
Aarav Reddy,28-08-2005,133877,Tamil Nadu,15,23,20,10,68,Pass
Gurpreet Pillai,01-12-2005,227299,Tamil Nadu,14,21,9,24,68,Pass
Rohan Chopra,17-12-2005,471676,Tamil Nadu,23,17,7,21,68,Pass
Ishaan Fernandes,04-02-2006,728989,Tamil Nadu,18,24,21,5,68,Pass
Vivaan Singh,13-12-2004,902323,Tamil Nadu,18,14,24,11,67,Pass
Aryan Singh,18-12-2004,635600,Tamil Nadu,24,11,16,16,67,Pass
John Fernandes,31-12-2004,701626,Tamil Nadu,23,16,4,24,67,Pass
Gurpreet Mehta,05-04-2005,536846,Tamil Nadu,20,21,18,8,67,Pass
Aarav Fernandes,19-05-2005,965654,Tamil Nadu,14,10,23,20,67,Pass
Rohan Chopra,26-06-2005,962446,Tamil Nadu,16,18,13,20,67,Pass
Balbir Chopra,08-09-2005,830602,Tamil Nadu,21,6,24,16,67,Pass
Ishaan Singh,09-09-2005,426106,Tamil Nadu,6,22,20,19,67,Pass
Raj Chopra,18-09-2005,484197,Tamil Nadu,24,7,15,21,67,Pass
Ayaan Verma,20-09-2005,677910,Tamil Nadu,17,18,24,8,67,Pass
Aarav Chopra,06-01-2006,241736,Tamil Nadu,21,9,17,20,67,Pass
Krishna Verma,27-03-2006,471740,Tamil Nadu,18,17,20,12,67,Pass
Vivaan Fernandes,19-06-2005,163532,Andhra Pradesh,24,19,24,23,90,Pass
Yash Chopra,12-11-2005,484856,Andhra Pradesh,23,22,24,17,86,Pass
Sukhwinder Singh,09-06-2005,806541,Andhra Pradesh,23,20,21,21,85,Pass
Aarav Khan,18-04-2005,284081,Andhra Pradesh,18,23,24,19,84,Pass
Harjeet Mehta,28-07-2005,248157,Andhra Pradesh,23,18,20,20,81,Pass
Krishna Reddy,06-11-2005,972628,Andhra Pradesh,14,20,23,24,81,Pass
Aditya Fernandes,12-02-2006,535250,Andhra Pradesh,20,22,16,22,80,Pass
Gurpreet Sharma,07-12-2004,337220,Andhra Pradesh,18,19,23,19,79,Pass
Rehan Mehta,11-09-2005,274571,Andhra Pradesh,13,19,24,23,79,Pass
Yash Chopra,12-01-2005,287996,Andhra Pradesh,24,19,17,18,78,Pass
Sukhwinder Singh,18-01-2005,423038,Andhra Pradesh,18,21,21,18,78,Pass
Kunal Reddy,09-06-2005,915395,Andhra Pradesh,24,8,23,23,78,Pass
Raj Verma,23-08-2005,388948,Andhra Pradesh,20,21,16,21,78,Pass
Paul Mehta,18-04-2006,615499,Andhra Pradesh,16,24,23,15,78,Pass
Harjeet Reddy,07-04-2005,679362,Andhra Pradesh,21,17,22,17,77,Pass
Aditya Reddy,05-06-2005,113781,Andhra Pradesh,20,23,14,20,77,Pass
Raj Chopra,05-12-2005,192721,Andhra Pradesh,21,21,15,20,77,Pass
Zaid D'Souza,20-03-2006,522247,Andhra Pradesh,21,22,14,20,77,Pass
Vivaan Fernandes,27-01-2005,307264,Andhra Pradesh,23,23,17,13,76,Pass
Rehan Reddy,29-11-2004,343485,Andhra Pradesh,22,12,19,22,75,Pass
Gurpreet Pillai,08-03-2005,732267,Andhra Pradesh,14,23,19,18,74,Pass
Kunal Mehta,24-03-2005,921112,Andhra Pradesh,23,7,23,21,74,Pass
Peter Singh,31-05-2005,388882,Andhra Pradesh,17,13,23,21,74,Pass
John D'Souza,17-07-2005,168302,Andhra Pradesh,18,24,17,15,74,Pass
Rohan Verma,25-07-2005,429261,Andhra Pradesh,15,21,15,23,74,Pass
Krishna Reddy,19-09-2005,379379,Andhra Pradesh,21,20,16,17,74,Pass
Vivaan Singh,29-11-2005,244435,Andhra Pradesh,14,21,20,19,74,Pass
Ishaan Sharma,14-03-2006,479117,Andhra Pradesh,21,19,22,12,74,Pass
Krishna Singh,23-03-2006,908465,Andhra Pradesh,24,20,15,15,74,Pass
Zaid Mehta,07-06-2005,821160,Andhra Pradesh,9,20,23,21,73,Pass
Raj Reddy,10-06-2005,856471,Andhra Pradesh,15,22,13,23,73,Pass
Manpreet Reddy,13-06-2005,564574,Andhra Pradesh,16,13,20,24,73,Pass
Aarav Fernandes,30-10-2005,769927,Andhra Pradesh,24,20,23,6,73,Pass
Yash Sharma,26-01-2006,753071,Andhra Pradesh,10,18,24,21,73,Pass
Ishaan Verma,30-03-2006,333397,Andhra Pradesh,14,24,14,21,73,Pass
Farhan Chopra,09-11-2004,888828,Andhra Pradesh,24,18,20,10,72,Pass
Mathew Chopra,10-03-2005,446644,Andhra Pradesh,24,21,11,16,72,Pass
Peter D'Souza,03-08-2005,172802,Andhra Pradesh,11,21,19,21,72,Pass
David D'Souza,02-11-2005,359208,Andhra Pradesh,12,15,24,21,72,Pass
Vivaan Pillai,17-11-2005,879208,Andhra Pradesh,21,23,16,12,72,Pass
Ayaan Singh,29-04-2006,363887,Andhra Pradesh,12,22,21,17,72,Pass
Aditya Verma,25-01-2005,604465,Andhra Pradesh,17,17,15,22,71,Pass
Manpreet D'Souza,25-05-2005,509012,Andhra Pradesh,14,12,24,21,71,Pass
Aditya Reddy,17-08-2005,107093,Andhra Pradesh,18,6,24,23,71,Pass
Rohan Fernandes,26-10-2005,432686,Andhra Pradesh,17,17,16,21,71,Pass
Rohan D'Souza,14-11-2005,220145,Andhra Pradesh,13,19,22,17,71,Pass
Harjeet D'Souza,13-01-2006,383519,Andhra Pradesh,16,24,15,16,71,Pass
Manpreet Verma,01-05-2005,261248,Andhra Pradesh,18,11,20,21,70,Pass
Krishna Sharma,14-05-2005,806715,Andhra Pradesh,8,21,23,18,70,Pass
Peter Verma,26-06-2005,581281,Andhra Pradesh,7,23,18,22,70,Pass
Sukhwinder Khan,29-07-2005,409282,Andhra Pradesh,22,22,15,11,70,Pass
Ishaan Singh,01-09-2005,922281,Andhra Pradesh,8,18,20,24,70,Pass
Balbir Singh,18-11-2004,435361,Andhra Pradesh,19,24,17,9,69,Pass
Raj D'Souza,10-12-2004,159858,Andhra Pradesh,19,20,18,12,69,Pass
Aditya Chopra,07-01-2005,888684,Andhra Pradesh,23,23,16,7,69,Pass
Vivaan D'Souza,20-01-2005,845281,Andhra Pradesh,24,4,19,22,69,Pass
Zaid Verma,25-04-2005,916995,Andhra Pradesh,17,18,13,21,69,Pass
Kunal Mehta,15-09-2005,472774,Andhra Pradesh,16,18,22,13,69,Pass
Yash Fernandes,25-09-2005,871051,Andhra Pradesh,18,5,24,22,69,Pass
Aditya Sharma,01-01-2006,294276,Andhra Pradesh,24,10,18,17,69,Pass
Ishaan Mehta,09-04-2006,565406,Andhra Pradesh,16,24,18,11,69,Pass
Krishna Pillai,22-01-2005,428061,Andhra Pradesh,17,8,21,22,68,Pass
Gurpreet Pillai,11-02-2005,211712,Andhra Pradesh,18,16,12,22,68,Pass
Zaid Mehta,18-02-2005,968970,Andhra Pradesh,24,20,12,12,68,Pass
Rohan Pillai,02-03-2005,151379,Andhra Pradesh,7,21,22,18,68,Pass
David D'Souza,24-04-2005,653790,Andhra Pradesh,8,24,24,12,68,Pass
Raj Khan,28-09-2005,526046,Andhra Pradesh,7,21,18,22,68,Pass
Aarav Khan,12-12-2005,632547,Andhra Pradesh,20,18,18,12,68,Pass
Rohan D'Souza,01-01-2006,591061,Andhra Pradesh,18,16,13,21,68,Pass
Kunal Pillai,10-01-2006,463223,Andhra Pradesh,15,11,24,18,68,Pass
Ishaan Reddy,06-02-2006,850802,Andhra Pradesh,24,15,23,6,68,Pass
Krishna Reddy,12-03-2006,616528,Andhra Pradesh,23,20,11,14,68,Pass
Gurpreet Singh,27-11-2004,871871,Andhra Pradesh,15,20,8,24,67,Pass
Vivaan Fernandes,30-05-2005,345201,Andhra Pradesh,18,7,24,18,67,Pass
Sukhwinder Pillai,24-07-2005,270167,Andhra Pradesh,15,13,20,19,67,Pass
Aryan Chopra,26-08-2005,376126,Andhra Pradesh,22,21,8,16,67,Pass
Ishaan Khan,31-08-2005,863654,Andhra Pradesh,21,20,22,4,67,Pass
Gurpreet Reddy,04-10-2005,816320,Andhra Pradesh,13,24,18,12,67,Pass
Aditya D'Souza,24-11-2005,777187,Andhra Pradesh,9,16,20,22,67,Pass
Aryan Mehta,02-03-2006,336829,Andhra Pradesh,21,14,17,15,67,Pass
Mathew Pillai,10-03-2006,733332,Andhra Pradesh,16,19,11,21,67,Pass
Raj Mehta,26-04-2006,751146,Andhra Pradesh,19,24,12,12,67,Pass
Aarav Fernandes,05-05-2006,774676,Andhra Pradesh,10,22,14,21,67,Pass
Manpreet Khan,25-11-2004,204890,Andhra Pradesh,5,24,16,21,66,Pass
Vivaan Mehta,07-12-2004,324809,Andhra Pradesh,21,17,18,10,66,Pass
Raj Chopra,14-12-2004,725729,Andhra Pradesh,13,20,16,17,66,Pass
Harjeet Pillai,30-12-2004,659176,Andhra Pradesh,16,11,16,23,66,Pass
Aarav D'Souza,22-03-2005,583270,Andhra Pradesh,12,23,16,15,66,Pass
Gurpreet Singh,23-03-2005,394727,Andhra Pradesh,23,23,13,7,66,Pass
Rohan Pillai,04-05-2005,127184,Andhra Pradesh,17,22,5,22,66,Pass
Ishaan Pillai,30-05-2005,530563,Andhra Pradesh,7,20,19,20,66,Pass
Vivaan Sharma,06-06-2005,341949,Andhra Pradesh,14,12,16,24,66,Pass
Manpreet Reddy,08-06-2005,671765,Andhra Pradesh,15,20,18,13,66,Pass
Krishna D'Souza,18-09-2005,543252,Andhra Pradesh,12,19,12,23,66,Pass
Raj Fernandes,25-09-2005,946073,Andhra Pradesh,17,21,15,13,66,Pass
Aarav Mehta,04-10-2005,763179,Andhra Pradesh,17,15,10,24,66,Pass
Manpreet Mehta,08-10-2005,821377,Andhra Pradesh,21,11,22,12,66,Pass
Manpreet Singh,11-01-2006,895847,Andhra Pradesh,18,9,23,16,66,Pass
Harjeet Reddy,03-03-2006,977201,Andhra Pradesh,17,22,23,4,66,Pass
Manpreet Pillai,16-03-2006,175094,Andhra Pradesh,14,13,24,15,66,Pass
Krishna Khan,08-12-2004,887999,Andhra Pradesh,16,20,5,24,65,Pass
Aarav Pillai,18-12-2004,978080,Andhra Pradesh,11,18,16,20,65,Pass
Aditya Khan,12-02-2005,999665,Andhra Pradesh,19,13,18,15,65,Pass
Aryan D'Souza,22-06-2005,332487,Andhra Pradesh,24,17,14,10,65,Pass
Kunal Khan,11-07-2005,644695,Andhra Pradesh,20,12,15,18,65,Pass
Aditya Reddy,12-07-2005,685262,Andhra Pradesh,24,11,10,20,65,Pass
Vivaan Reddy,12-07-2005,428394,Andhra Pradesh,12,10,22,21,65,Pass
Peter Chopra,06-08-2005,426035,Andhra Pradesh,20,15,18,12,65,Pass
Vivaan Khan,20-08-2005,173490,Andhra Pradesh,13,19,12,21,65,Pass
John Khan,04-09-2005,767467,Andhra Pradesh,17,20,21,7,65,Pass
Aditya Reddy,09-09-2005,139374,Andhra Pradesh,11,19,24,11,65,Pass
Aditya D'Souza,24-10-2005,374617,Andhra Pradesh,10,20,23,12,65,Pass
Rohan Fernandes,14-12-2005,253065,Andhra Pradesh,20,21,19,5,65,Pass
Gurpreet D'Souza,27-12-2005,704739,Andhra Pradesh,22,19,15,9,65,Pass
Rohan Pillai,16-01-2006,192081,Andhra Pradesh,7,21,23,14,65,Pass
Harjeet D'Souza,30-01-2006,301163,Andhra Pradesh,9,18,20,18,65,Pass
Aryan Fernandes,21-03-2006,830353,Andhra Pradesh,23,11,20,11,65,Pass
Aryan D'Souza,09-04-2006,976702,Andhra Pradesh,19,14,8,24,65,Pass
Aryan Verma,13-11-2004,437188,Andhra Pradesh,18,17,8,21,64,Pass
Aditya Verma,13-11-2004,142615,Andhra Pradesh,17,23,8,16,64,Pass
Ishaan D'Souza,01-01-2005,111802,Andhra Pradesh,21,19,5,19,64,Pass
Vivaan Singh,19-01-2005,705994,Andhra Pradesh,21,10,11,22,64,Pass
Raj Reddy,24-01-2005,385224,Andhra Pradesh,15,20,11,18,64,Pass
Aditya Reddy,02-02-2005,712123,Andhra Pradesh,12,24,23,5,64,Pass
Aarav Verma,07-02-2005,216976,Andhra Pradesh,18,14,24,8,64,Pass
Yash Khan,02-03-2005,655558,Andhra Pradesh,17,13,13,21,64,Pass
Ishaan Mehta,11-04-2005,677617,Andhra Pradesh,20,22,10,12,64,Pass
Rohan Sharma,03-06-2005,605344,Andhra Pradesh,8,20,13,23,64,Pass
Vivaan Sharma,19-08-2005,221747,Andhra Pradesh,24,13,17,10,64,Pass
Vivaan Verma,16-09-2005,666653,Andhra Pradesh,19,20,17,8,64,Pass
Rohan Pillai,26-01-2006,640640,Andhra Pradesh,19,13,20,12,64,Pass
Kunal Sharma,04-03-2006,472923,Andhra Pradesh,19,9,18,18,64,Pass
Harjeet Chopra,13-03-2006,629287,Andhra Pradesh,19,12,15,18,64,Pass
Gurpreet D'Souza,07-04-2006,967726,Andhra Pradesh,15,19,9,21,64,Pass
Aarav Chopra,05-05-2006,624600,Andhra Pradesh,13,23,14,14,64,Pass
Raj Pillai,25-01-2005,707436,Andhra Pradesh,13,11,15,24,63,Pass
John Mehta,28-01-2005,268590,Andhra Pradesh,24,5,15,19,63,Pass
Manpreet Singh,13-05-2005,969818,Andhra Pradesh,5,19,24,15,63,Pass
Krishna Singh,15-05-2005,555682,Andhra Pradesh,17,18,22,6,63,Pass
Kunal Reddy,17-05-2005,390690,Andhra Pradesh,7,20,12,24,63,Pass
Raj Sharma,05-08-2005,309732,Andhra Pradesh,11,22,10,20,63,Pass
Mathew Singh,12-08-2005,806028,Andhra Pradesh,13,20,6,24,63,Pass
Aryan Fernandes,01-09-2005,705635,Andhra Pradesh,18,9,18,18,63,Pass
Krishna Khan,02-09-2005,747983,Andhra Pradesh,23,9,8,23,63,Pass
Aryan Pillai,03-09-2005,181581,Andhra Pradesh,19,24,16,4,63,Pass
Aarav Singh,10-09-2005,894202,Andhra Pradesh,24,13,22,4,63,Pass
Ishaan Sharma,16-09-2005,220146,Andhra Pradesh,7,16,21,19,63,Pass
Harjeet Chopra,13-10-2005,549735,Andhra Pradesh,12,19,12,20,63,Pass
Rehan Fernandes,07-11-2005,594995,Andhra Pradesh,20,9,21,13,63,Pass
Kunal Mehta,08-11-2005,388080,Andhra Pradesh,23,18,18,4,63,Pass
Aryan Verma,01-01-2006,123862,Andhra Pradesh,8,17,23,15,63,Pass
Krishna Fernandes,08-01-2006,817861,Andhra Pradesh,9,17,20,17,63,Pass
Kunal Singh,18-01-2006,852754,Andhra Pradesh,15,19,21,8,63,Pass
Krishna Sharma,22-02-2006,381681,Andhra Pradesh,13,21,5,24,63,Pass
Yash Fernandes,29-04-2006,896103,Andhra Pradesh,23,10,17,13,63,Pass
Gurpreet Sharma,29-01-2005,903010,Punjab,23,20,22,24,89,Pass
Ishaan D'Souza,26-11-2005,378532,Punjab,22,24,17,23,86,Pass
Ishaan Verma,04-01-2006,960436,Punjab,20,24,23,19,86,Pass
Aditya Chopra,11-05-2005,218879,Punjab,19,24,24,18,85,Pass
Raj Fernandes,08-05-2006,831619,Punjab,21,24,20,20,85,Pass
Vivaan Fernandes,04-11-2005,214380,Punjab,24,19,18,23,84,Pass
Vivaan Khan,06-12-2005,204550,Punjab,22,24,21,17,84,Pass
Aarav Verma,04-01-2006,383592,Punjab,23,22,20,19,84,Pass
Balbir Verma,30-04-2005,241357,Punjab,19,19,23,21,82,Pass
Kunal Singh,17-07-2005,688339,Punjab,21,15,23,23,82,Pass
Vivaan D'Souza,24-02-2006,155646,Punjab,22,24,21,15,82,Pass
Ishaan Fernandes,21-01-2005,567096,Punjab,19,24,16,22,81,Pass
John Mehta,13-02-2005,259496,Punjab,11,23,24,23,81,Pass
Manpreet Reddy,16-09-2005,790745,Punjab,20,23,16,22,81,Pass
Rohan Singh,24-03-2006,875682,Punjab,23,23,21,14,81,Pass
Raj Reddy,24-03-2005,968514,Punjab,16,20,24,20,80,Pass
Aditya D'Souza,14-06-2005,849475,Punjab,19,16,24,21,80,Pass
Yash Sharma,05-03-2006,970448,Punjab,21,17,23,19,80,Pass
Aditya Verma,09-04-2006,734770,Punjab,16,21,22,21,80,Pass
Aarav Singh,16-04-2006,344562,Punjab,23,17,18,22,80,Pass
Manpreet Mehta,06-05-2006,775362,Punjab,23,17,21,19,80,Pass
Rohan Singh,16-12-2004,841430,Punjab,23,17,16,23,79,Pass
Vivaan Sharma,24-12-2004,402494,Punjab,23,20,15,21,79,Pass
Kunal Mehta,19-09-2005,797434,Punjab,20,24,24,11,79,Pass
Rohan Khan,10-12-2005,599704,Punjab,16,22,24,17,79,Pass
Yash Reddy,11-12-2005,245929,Punjab,17,21,18,23,79,Pass
Manpreet Khan,09-04-2006,708611,Punjab,15,21,20,23,79,Pass
Kunal Fernandes,24-03-2005,321417,Punjab,18,23,24,13,78,Pass
Paul Fernandes,29-03-2005,800031,Punjab,17,18,20,23,78,Pass
Gurpreet Fernandes,08-04-2005,333883,Punjab,23,21,14,20,78,Pass
Aryan Khan,17-04-2005,349815,Punjab,15,23,22,18,78,Pass
Rohan Reddy,16-12-2005,410132,Punjab,14,22,22,20,78,Pass
Aryan Verma,26-11-2004,820029,Punjab,21,24,12,20,77,Pass
Aditya Pillai,13-03-2005,790871,Punjab,20,18,21,18,77,Pass
Sukhwinder Khan,03-04-2005,898282,Punjab,10,24,20,23,77,Pass
Aryan Singh,03-05-2005,481616,Punjab,23,20,15,19,77,Pass
Manpreet D'Souza,22-06-2005,883274,Punjab,23,17,24,13,77,Pass
Harjeet Reddy,13-12-2004,368572,Punjab,24,17,22,13,76,Pass
John Pillai,08-02-2005,131644,Punjab,15,17,23,21,76,Pass
Aarav Khan,03-11-2005,937845,Punjab,8,22,22,24,76,Pass
David Fernandes,09-11-2005,141621,Punjab,17,17,18,24,76,Pass
Ishaan Mehta,31-12-2005,884769,Punjab,15,24,19,18,76,Pass
Harjeet Fernandes,31-01-2006,239421,Punjab,20,19,14,23,76,Pass
Aarav Fernandes,06-03-2006,162645,Punjab,22,15,17,22,76,Pass
Raj Verma,23-03-2006,821691,Punjab,6,24,24,22,76,Pass
Aryan Chopra,22-02-2005,244080,Punjab,23,20,16,16,75,Pass
Krishna Khan,11-03-2005,488446,Punjab,22,21,20,12,75,Pass
Balbir D'Souza,06-01-2006,921438,Punjab,19,18,20,18,75,Pass
Gurpreet Chopra,28-01-2005,920109,Punjab,23,15,22,14,74,Pass
Aditya Singh,15-04-2005,291339,Punjab,19,24,13,18,74,Pass
Rehan Verma,09-06-2005,398279,Punjab,19,18,16,21,74,Pass
Aarav Singh,27-08-2005,224041,Punjab,17,18,21,18,74,Pass
Rohan Pillai,22-09-2005,979181,Punjab,17,20,19,18,74,Pass
Kunal Chopra,06-10-2005,370988,Punjab,24,22,17,11,74,Pass
Aryan Singh,20-10-2005,329954,Punjab,20,18,13,23,74,Pass
Aarav Mehta,06-12-2005,658598,Punjab,10,23,23,18,74,Pass
Manpreet Reddy,17-01-2006,220309,Punjab,23,11,16,24,74,Pass
Manpreet D'Souza,17-11-2004,930389,Punjab,18,11,21,23,73,Pass
Krishna Reddy,19-12-2004,875469,Punjab,16,12,24,21,73,Pass
Aarav Singh,24-03-2005,435769,Punjab,22,22,11,18,73,Pass
Gurpreet Chopra,14-05-2005,721489,Punjab,18,21,21,13,73,Pass
Aarav Chopra,01-11-2005,801353,Punjab,24,24,7,18,73,Pass
Raj Chopra,02-12-2005,877029,Punjab,24,23,8,18,73,Pass
Ishaan Verma,16-01-2006,898514,Punjab,14,24,18,17,73,Pass
Paul Reddy,23-01-2006,698873,Punjab,14,14,23,22,73,Pass
Peter Mehta,21-01-2005,720079,Punjab,24,23,11,14,72,Pass
Sukhwinder Verma,14-02-2005,611196,Punjab,17,23,18,14,72,Pass
Gurpreet Fernandes,19-06-2005,200870,Punjab,18,13,19,22,72,Pass
Harjeet Pillai,06-07-2005,960958,Punjab,18,19,11,24,72,Pass
Krishna Pillai,27-08-2005,204412,Punjab,11,24,21,16,72,Pass
Aarav Chopra,17-10-2005,465915,Punjab,19,19,12,22,72,Pass
Rohan Khan,24-12-2005,627296,Punjab,21,24,8,19,72,Pass
Yash Verma,25-12-2005,329859,Punjab,13,23,12,24,72,Pass
Ishaan Khan,14-01-2005,826390,Punjab,18,23,17,13,71,Pass
Aryan Fernandes,23-01-2005,921823,Punjab,24,7,17,23,71,Pass
David Singh,01-04-2005,540918,Punjab,12,23,14,22,71,Pass
Paul Reddy,03-04-2005,229790,Punjab,24,4,21,22,71,Pass
David Pillai,10-05-2005,593113,Punjab,15,24,21,11,71,Pass
Ayaan Chopra,20-09-2005,791175,Punjab,14,22,11,24,71,Pass
Manpreet Verma,07-01-2005,200247,Punjab,9,23,17,21,70,Pass
Aditya Sharma,09-02-2005,378430,Punjab,22,14,16,18,70,Pass
Ishaan Reddy,24-02-2005,845322,Punjab,17,5,24,24,70,Pass
Balbir Singh,16-03-2005,847446,Punjab,14,23,13,20,70,Pass
Aditya Reddy,09-06-2005,682757,Punjab,23,10,15,22,70,Pass
Aditya Chopra,22-07-2005,835280,Punjab,20,15,18,17,70,Pass
Raj Singh,03-08-2005,588240,Punjab,16,20,17,17,70,Pass
Imran Reddy,26-08-2005,223068,Punjab,24,6,20,20,70,Pass
Kunal Pillai,27-09-2005,121471,Punjab,11,22,23,14,70,Pass
Kunal Reddy,17-11-2005,875746,Punjab,21,10,24,15,70,Pass
Ayaan Pillai,21-12-2004,392292,Punjab,17,7,24,21,69,Pass
Imran Reddy,03-01-2005,999907,Punjab,23,12,22,12,69,Pass
Kunal Reddy,21-03-2005,267272,Punjab,16,7,22,24,69,Pass
Aditya Singh,20-06-2005,968342,Punjab,24,17,21,7,69,Pass
Mathew Mehta,30-06-2005,465468,Punjab,14,24,16,15,69,Pass
Harjeet Mehta,09-09-2005,750718,Punjab,22,20,13,14,69,Pass
Raj Pillai,26-02-2006,990186,Punjab,16,19,11,23,69,Pass
Gurpreet Khan,25-03-2006,764905,Punjab,22,18,14,15,69,Pass
Gurpreet Verma,10-02-2005,437921,Punjab,22,8,19,19,68,Pass
Sukhwinder Mehta,08-03-2005,655348,Punjab,15,13,16,24,68,Pass
Ishaan Reddy,20-09-2005,254368,Punjab,24,18,21,5,68,Pass
Yash Pillai,30-09-2005,226291,Punjab,21,12,11,24,68,Pass
Imran Verma,02-10-2005,719949,Punjab,5,20,20,23,68,Pass
Zaid Chopra,16-10-2005,580420,Punjab,21,23,18,6,68,Pass
Raj Sharma,03-11-2005,449808,Punjab,14,22,24,8,68,Pass
Krishna Pillai,12-11-2005,279257,Punjab,11,21,12,24,68,Pass
Rohan Singh,03-12-2005,739640,Punjab,21,19,7,21,68,Pass
Rohan Verma,11-02-2006,413656,Punjab,21,10,17,20,68,Pass
Ayaan Mehta,09-01-2005,404117,Punjab,18,7,20,22,67,Pass
Aarav D'Souza,24-01-2005,350184,Punjab,7,16,24,20,67,Pass
Mathew Pillai,04-02-2005,191361,Punjab,13,11,20,23,67,Pass
Rohan Reddy,05-02-2005,686111,Punjab,12,11,23,21,67,Pass
Harjeet Chopra,11-03-2005,331647,Punjab,23,22,7,15,67,Pass
Vivaan Mehta,13-04-2005,612916,Punjab,11,21,12,23,67,Pass
Gurpreet Pillai,22-05-2005,983841,Punjab,17,18,13,19,67,Pass
Rohan Mehta,06-06-2005,472244,Punjab,20,21,13,13,67,Pass
Aryan Sharma,15-06-2005,862226,Punjab,17,18,8,24,67,Pass
Manpreet Chopra,22-07-2005,209491,Punjab,10,21,23,13,67,Pass
Aarav Chopra,28-07-2005,820965,Punjab,6,22,16,23,67,Pass
Kunal Mehta,24-11-2005,580416,Punjab,20,19,5,23,67,Pass
Vivaan Khan,26-11-2005,783166,Punjab,16,17,22,12,67,Pass
Rohan Verma,17-01-2006,548963,Punjab,19,13,17,18,67,Pass
Harjeet Singh,13-04-2006,657374,Punjab,9,22,17,19,67,Pass
Rohan Reddy,21-04-2006,553050,Punjab,8,22,22,15,67,Pass
Gurpreet Mehta,12-04-2005,676189,Punjab,14,21,8,23,66,Pass
Gurpreet Pillai,02-05-2005,855618,Punjab,17,23,14,12,66,Pass
Aarav Khan,18-07-2005,409851,Punjab,16,7,22,21,66,Pass
Balbir Sharma,18-09-2005,360181,Punjab,14,23,17,12,66,Pass
Kunal Fernandes,01-01-2006,966758,Punjab,14,19,21,12,66,Pass
Krishna Verma,02-02-2006,455623,Punjab,20,21,20,5,66,Pass
Aryan Singh,15-04-2006,229012,Punjab,19,14,9,24,66,Pass
Gurpreet D'Souza,18-11-2004,989335,Punjab,16,18,12,19,65,Pass
David Pillai,11-12-2004,172340,Punjab,8,23,14,20,65,Pass
Vivaan Khan,19-01-2005,815900,Punjab,17,4,23,21,65,Pass
Kunal Singh,29-01-2005,592217,Punjab,22,16,7,20,65,Pass
Raj Chopra,09-04-2005,821845,Punjab,13,15,15,22,65,Pass
Yash Sharma,24-04-2005,308835,Punjab,23,10,16,16,65,Pass
Mathew Fernandes,16-05-2005,655875,Punjab,11,19,17,18,65,Pass
Ishaan Verma,28-05-2005,520942,Punjab,18,24,5,18,65,Pass
Raj Pillai,11-06-2005,413082,Punjab,14,13,14,24,65,Pass
Rehan Verma,16-06-2005,818311,Punjab,22,20,12,11,65,Pass
Ayaan Pillai,03-09-2005,460336,Punjab,24,15,15,11,65,Pass
Krishna Fernandes,10-10-2005,991351,Punjab,22,24,12,7,65,Pass
Vivaan Chopra,01-11-2005,349619,Punjab,11,20,24,10,65,Pass
Aryan Singh,30-11-2005,353485,Punjab,11,12,24,18,65,Pass
Krishna Pillai,10-12-2005,415628,Punjab,17,7,20,21,65,Pass
Rohan D'Souza,18-02-2006,114300,Punjab,7,19,19,20,65,Pass
Yash Sharma,11-03-2006,811630,Punjab,20,16,8,21,65,Pass
Yash Khan,06-12-2004,730287,Madhya Pradesh,24,4,23,24,75,Pass
Raj D'Souza,12-11-2004,935666,Madhya Pradesh,23,4,24,22,73,Pass
Raj Fernandes,30-10-2005,783583,Madhya Pradesh,23,24,22,4,73,Pass
Kunal Singh,06-04-2005,132895,Madhya Pradesh,22,21,23,4,70,Pass
Vivaan Chopra,20-10-2005,385381,Madhya Pradesh,24,19,23,4,70,Pass
Manpreet Chopra,18-02-2005,182803,Madhya Pradesh,22,4,23,20,69,Pass
Aryan Fernandes,14-10-2005,561781,Madhya Pradesh,18,23,24,4,69,Pass
Krishna Reddy,27-10-2005,257123,Madhya Pradesh,23,23,19,4,69,Pass
Kunal Singh,15-01-2006,355687,Madhya Pradesh,22,19,24,4,69,Pass
Yash Reddy,01-02-2006,871886,Madhya Pradesh,19,23,23,4,69,Pass
Mathew Verma,30-12-2004,134310,Madhya Pradesh,20,23,21,4,68,Pass
Sukhwinder Verma,29-03-2006,695244,Madhya Pradesh,22,23,19,4,68,Pass
Aryan Khan,01-02-2005,965942,Madhya Pradesh,21,24,18,4,67,Pass
Rohan Mehta,13-11-2004,883465,Madhya Pradesh,23,4,22,17,66,Pass
Sukhwinder Singh,28-02-2005,889801,Madhya Pradesh,20,24,18,4,66,Pass
Yash Chopra,19-07-2005,504482,Madhya Pradesh,23,21,18,4,66,Pass
Balbir Pillai,18-11-2004,392256,Madhya Pradesh,21,4,23,17,65,Pass
John Verma,16-04-2005,172939,Madhya Pradesh,22,16,23,4,65,Pass
Kunal Singh,11-06-2005,473452,Madhya Pradesh,16,22,23,4,65,Pass
Aditya Reddy,18-07-2005,946505,Madhya Pradesh,21,4,19,21,65,Pass
Ishaan Mehta,19-09-2005,406914,Madhya Pradesh,15,4,24,22,65,Pass
Krishna Khan,31-12-2004,751351,Madhya Pradesh,23,23,14,4,64,Pass
Aarav Chopra,31-12-2004,220556,Madhya Pradesh,20,20,20,4,64,Pass
Gurpreet Mehta,02-01-2005,420096,Madhya Pradesh,19,22,19,4,64,Pass
Aditya Sharma,17-02-2005,160329,Madhya Pradesh,23,18,19,4,64,Pass
Aarav Fernandes,12-04-2005,600344,Madhya Pradesh,14,24,22,4,64,Pass
Paul Mehta,15-04-2005,319355,Madhya Pradesh,23,13,24,4,64,Pass
Aryan Sharma,31-08-2005,659155,Madhya Pradesh,17,20,23,4,64,Pass
Aryan Khan,14-09-2005,601461,Madhya Pradesh,21,20,19,4,64,Pass
Manpreet Reddy,15-10-2005,933152,Madhya Pradesh,13,4,24,23,64,Pass
Raj Fernandes,28-01-2006,670857,Madhya Pradesh,22,14,24,4,64,Pass
Manpreet D'Souza,24-04-2006,174628,Madhya Pradesh,19,21,20,4,64,Pass
Harjeet Pillai,11-01-2005,499284,Madhya Pradesh,15,24,20,4,63,Pass
Harjeet Mehta,17-01-2005,207675,Madhya Pradesh,23,4,16,20,63,Pass
Vivaan Fernandes,11-04-2005,924678,Madhya Pradesh,18,24,17,4,63,Pass
John Mehta,21-04-2005,383423,Madhya Pradesh,15,24,20,4,63,Pass
Aarav Fernandes,12-06-2005,382312,Madhya Pradesh,21,20,18,4,63,Pass
Aryan Mehta,28-10-2005,850838,Madhya Pradesh,21,4,19,19,63,Pass
Aryan Singh,29-01-2006,759979,Madhya Pradesh,23,22,14,4,63,Pass
Imran Singh,09-02-2006,162577,Madhya Pradesh,24,11,24,4,63,Pass
Aditya Verma,13-04-2006,209955,Madhya Pradesh,13,23,23,4,63,Pass
Balbir Khan,22-11-2004,781697,Madhya Pradesh,13,23,22,4,62,Pass
Aryan Sharma,29-11-2004,500673,Madhya Pradesh,18,24,16,4,62,Pass
Yash Sharma,07-12-2004,947852,Madhya Pradesh,22,4,18,18,62,Pass
Paul Sharma,22-01-2005,290152,Madhya Pradesh,22,13,23,4,62,Pass
Imran Fernandes,11-02-2005,731838,Madhya Pradesh,14,4,24,20,62,Pass
Rohan Singh,22-04-2005,275982,Madhya Pradesh,21,4,17,20,62,Pass
Aditya Verma,26-06-2005,358728,Madhya Pradesh,15,19,24,4,62,Pass
Raj Fernandes,16-12-2005,680268,Madhya Pradesh,15,22,21,4,62,Pass
Aryan D'Souza,13-03-2006,335643,Madhya Pradesh,13,4,21,24,62,Pass
Rohan Sharma,24-11-2004,240872,Madhya Pradesh,24,4,16,17,61,Pass
Mathew Fernandes,23-05-2005,216931,Madhya Pradesh,23,16,18,4,61,Pass
Zaid Reddy,22-07-2005,368409,Madhya Pradesh,23,4,10,24,61,Pass
Rehan Chopra,07-09-2005,325519,Madhya Pradesh,16,18,23,4,61,Pass
Yash Reddy,21-09-2005,967796,Madhya Pradesh,17,4,18,22,61,Pass
Gurpreet Pillai,20-01-2005,924576,Madhya Pradesh,23,23,10,4,60,Pass
Manpreet Sharma,24-02-2005,673012,Madhya Pradesh,16,17,23,4,60,Pass
Sukhwinder D'Souza,18-04-2005,721033,Madhya Pradesh,16,16,24,4,60,Pass
Aryan Reddy,15-09-2005,336254,Madhya Pradesh,24,4,23,9,60,Pass
Ishaan Fernandes,12-10-2005,408176,Madhya Pradesh,10,4,23,23,60,Pass
Paul Pillai,07-11-2005,821580,Madhya Pradesh,15,4,23,18,60,Pass
Krishna Chopra,10-12-2005,492167,Madhya Pradesh,12,24,20,4,60,Pass
Kunal Chopra,19-11-2004,316109,Madhya Pradesh,21,4,15,19,59,Pass
Rehan Fernandes,13-12-2004,357219,Madhya Pradesh,19,22,14,4,59,Pass
Rohan Singh,26-12-2004,255228,Madhya Pradesh,23,24,8,4,59,Pass
Aarav Mehta,26-03-2005,936153,Madhya Pradesh,18,17,20,4,59,Pass
Krishna Mehta,30-03-2005,823504,Madhya Pradesh,21,18,16,4,59,Pass
Vivaan Khan,23-04-2005,136300,Madhya Pradesh,11,21,23,4,59,Pass
Paul Chopra,09-08-2005,745329,Madhya Pradesh,21,16,18,4,59,Pass
Aditya Mehta,14-09-2005,819664,Madhya Pradesh,18,13,24,4,59,Pass
Kunal D'Souza,07-12-2005,801807,Madhya Pradesh,16,23,16,4,59,Pass
Aditya Mehta,14-12-2005,331222,Madhya Pradesh,19,13,23,4,59,Pass
Aryan Reddy,01-02-2006,400535,Madhya Pradesh,17,16,22,4,59,Pass
Aryan Verma,11-03-2006,351392,Madhya Pradesh,15,21,19,4,59,Pass
Farhan Fernandes,25-04-2006,158422,Madhya Pradesh,12,23,20,4,59,Pass
Mathew D'Souza,08-11-2004,952330,Madhya Pradesh,24,4,23,7,58,Pass
Raj Verma,22-09-2005,794362,Madhya Pradesh,18,14,22,4,58,Pass
Yash Chopra,04-10-2005,965789,Madhya Pradesh,13,4,20,21,58,Pass
Mathew Reddy,25-01-2006,587631,Madhya Pradesh,22,20,12,4,58,Pass
Raj Singh,18-03-2006,681257,Madhya Pradesh,24,4,18,12,58,Pass
Zaid Mehta,21-01-2005,642097,Madhya Pradesh,9,4,23,21,57,Pass
Sukhwinder Pillai,18-04-2005,605305,Madhya Pradesh,17,4,21,15,57,Pass
Raj Chopra,03-05-2005,252659,Madhya Pradesh,15,14,24,4,57,Pass
Vivaan Mehta,15-05-2005,523925,Madhya Pradesh,9,4,21,23,57,Pass
Aryan Chopra,25-05-2005,810037,Madhya Pradesh,10,4,22,21,57,Pass
Krishna Reddy,20-06-2005,419318,Madhya Pradesh,18,4,19,16,57,Pass
Rohan Singh,11-08-2005,693233,Madhya Pradesh,23,4,22,8,57,Pass
Rohan D'Souza,18-08-2005,940077,Madhya Pradesh,24,20,9,4,57,Pass
Vivaan Verma,06-09-2005,580934,Madhya Pradesh,19,14,20,4,57,Pass
Aditya Mehta,17-09-2005,658849,Madhya Pradesh,18,4,16,19,57,Pass
Aditya Mehta,20-09-2005,114525,Madhya Pradesh,21,4,15,17,57,Pass
Krishna Verma,30-10-2005,810060,Madhya Pradesh,18,18,17,4,57,Pass
Krishna Pillai,21-11-2005,756986,Madhya Pradesh,18,4,24,11,57,Pass
Harjeet Chopra,10-01-2006,594522,Madhya Pradesh,24,4,5,24,57,Pass
Aryan Verma,13-01-2006,204196,Madhya Pradesh,23,6,24,4,57,Pass
Vivaan Verma,05-12-2004,209615,Madhya Pradesh,8,14,18,16,56,Pass
Yash Pillai,26-12-2004,342313,Madhya Pradesh,12,23,14,7,56,Pass
Raj Fernandes,31-12-2004,285075,Madhya Pradesh,13,14,14,15,56,Pass
John Reddy,08-01-2005,203025,Madhya Pradesh,17,20,13,6,56,Pass
Rohan Fernandes,25-01-2005,765942,Madhya Pradesh,17,21,14,4,56,Pass
Krishna D'Souza,21-02-2005,460020,Madhya Pradesh,18,16,14,8,56,Pass
Sukhwinder Fernandes,23-02-2005,907804,Madhya Pradesh,10,17,23,6,56,Pass
David Chopra,28-02-2005,422685,Madhya Pradesh,6,10,20,20,56,Pass
Aryan Pillai,07-03-2005,702591,Madhya Pradesh,15,13,7,21,56,Pass
Ishaan Fernandes,13-03-2005,854218,Madhya Pradesh,13,21,9,13,56,Pass
Yash Singh,04-04-2005,476711,Madhya Pradesh,14,15,19,8,56,Pass
Yash Pillai,26-04-2005,803158,Madhya Pradesh,18,18,5,15,56,Pass
Raj Chopra,03-05-2005,792727,Madhya Pradesh,5,13,19,19,56,Pass
Harjeet Mehta,30-05-2005,929677,Madhya Pradesh,13,5,18,20,56,Pass
Rohan Khan,08-06-2005,775992,Madhya Pradesh,16,4,13,23,56,Pass
Sukhwinder Verma,23-06-2005,495515,Madhya Pradesh,19,18,5,14,56,Pass
Krishna Fernandes,03-07-2005,469506,Madhya Pradesh,15,4,21,16,56,Pass
Zaid D'Souza,06-08-2005,960302,Madhya Pradesh,6,6,21,23,56,Pass
Ayaan Mehta,07-08-2005,432969,Madhya Pradesh,7,22,10,17,56,Pass
Yash Reddy,04-09-2005,563911,Madhya Pradesh,24,14,4,14,56,Pass
Yash Chopra,14-09-2005,338252,Madhya Pradesh,21,8,23,4,56,Pass
Rohan D'Souza,16-09-2005,784810,Madhya Pradesh,4,19,14,19,56,Pass
Yash Singh,28-09-2005,574384,Madhya Pradesh,14,4,14,24,56,Pass
Aarav Reddy,23-10-2005,365125,Madhya Pradesh,18,16,18,4,56,Pass
Rohan Singh,26-10-2005,647540,Madhya Pradesh,4,21,15,16,56,Pass
Peter Sharma,28-10-2005,591148,Madhya Pradesh,12,14,18,12,56,Pass
Raj Verma,14-12-2005,784116,Madhya Pradesh,18,12,18,8,56,Pass
Ishaan Fernandes,24-01-2006,371488,Madhya Pradesh,19,14,19,4,56,Pass
Farhan Fernandes,26-01-2006,551351,Madhya Pradesh,17,7,16,16,56,Pass
Balbir Pillai,06-02-2006,953931,Madhya Pradesh,16,18,14,8,56,Pass
Ishaan Khan,08-02-2006,110771,Madhya Pradesh,18,10,24,4,56,Pass
Raj Mehta,18-03-2006,891491,Madhya Pradesh,23,18,6,9,56,Pass
Kunal Verma,23-03-2006,610745,Madhya Pradesh,22,18,12,4,56,Pass
Krishna Khan,28-04-2006,340926,Madhya Pradesh,18,21,13,4,56,Pass
Sukhwinder Reddy,15-12-2005,181362,Haryana,15,23,24,21,83,Pass
Aryan Verma,18-03-2006,302118,Haryana,19,18,24,22,83,Pass
Rohan Khan,19-04-2005,840021,Haryana,21,18,18,24,81,Pass
Sukhwinder Verma,11-08-2005,968829,Haryana,21,18,21,20,80,Pass
Rohan Pillai,22-01-2006,230587,Haryana,23,23,13,21,80,Pass
Rohan Reddy,29-03-2006,306954,Haryana,24,21,18,17,80,Pass
Rohan Mehta,01-12-2004,299090,Haryana,20,20,17,22,79,Pass
Krishna Khan,10-01-2005,977116,Haryana,19,23,16,21,79,Pass
Manpreet Sharma,20-01-2005,845014,Haryana,17,22,19,21,79,Pass
Paul Khan,20-04-2005,540516,Haryana,22,14,22,21,79,Pass
Yash Verma,10-05-2005,281074,Haryana,22,12,22,23,79,Pass
Imran Fernandes,01-07-2005,296792,Haryana,20,21,22,16,79,Pass
Vivaan Singh,14-08-2005,744845,Haryana,18,23,23,15,79,Pass
Ishaan Pillai,20-10-2005,957165,Haryana,19,14,24,22,79,Pass
Rohan Chopra,14-01-2005,645577,Haryana,24,8,24,22,78,Pass
Rohan Khan,02-02-2006,251779,Haryana,24,21,21,12,78,Pass
Vivaan Singh,20-02-2006,443996,Haryana,15,24,16,23,78,Pass
Kunal Mehta,11-11-2004,200622,Haryana,23,10,24,20,77,Pass
Gurpreet Reddy,09-01-2005,847931,Haryana,19,19,21,18,77,Pass
Aryan Pillai,05-02-2005,836599,Haryana,22,11,20,24,77,Pass
Raj Sharma,16-10-2005,468483,Haryana,18,24,24,11,77,Pass
Aryan Verma,28-03-2006,447312,Haryana,19,24,20,14,77,Pass
John D'Souza,11-05-2005,462882,Haryana,9,20,23,24,76,Pass
Kunal Sharma,10-02-2005,717420,Haryana,23,20,21,11,75,Pass
Kunal Fernandes,19-06-2005,963948,Haryana,17,20,21,17,75,Pass
Ishaan Sharma,17-09-2005,837503,Haryana,21,17,23,14,75,Pass
Gurpreet Sharma,17-02-2006,454347,Haryana,24,7,23,21,75,Pass
Kunal Pillai,06-04-2006,250789,Haryana,24,24,8,19,75,Pass
Mathew D'Souza,14-11-2004,608247,Haryana,21,17,24,12,74,Pass
Peter Khan,15-02-2005,888167,Haryana,21,21,11,21,74,Pass
Ishaan Mehta,14-06-2005,366034,Haryana,23,23,17,11,74,Pass
Zaid Fernandes,20-07-2005,530685,Haryana,19,17,16,22,74,Pass
Krishna D'Souza,03-11-2005,556857,Haryana,23,22,14,15,74,Pass
Ishaan Khan,31-03-2005,861142,Haryana,10,22,17,24,73,Pass
Yash Singh,02-05-2005,592683,Haryana,19,12,21,21,73,Pass
Raj Khan,05-05-2005,590581,Haryana,14,13,22,24,73,Pass
Ishaan Sharma,20-05-2005,757150,Haryana,12,23,14,24,73,Pass
Mathew Fernandes,10-10-2005,249811,Haryana,17,22,17,17,73,Pass
Kunal Singh,22-02-2006,389641,Haryana,23,11,20,19,73,Pass
Vivaan Chopra,13-04-2006,854282,Haryana,18,21,10,24,73,Pass
Rohan Reddy,07-11-2004,364170,Haryana,6,22,21,23,72,Pass
Ishaan Reddy,16-11-2004,558717,Haryana,17,19,17,19,72,Pass
Raj D'Souza,15-01-2005,302910,Haryana,17,23,12,20,72,Pass
Krishna Verma,19-04-2005,700530,Haryana,17,19,16,20,72,Pass
Sukhwinder Sharma,11-06-2005,611999,Haryana,17,17,22,16,72,Pass
Yash Pillai,30-08-2005,190060,Haryana,21,22,21,8,72,Pass
Aryan Singh,27-09-2005,778950,Haryana,13,22,18,19,72,Pass
Aryan Reddy,21-04-2006,445462,Haryana,22,19,15,16,72,Pass
Aarav Singh,28-04-2006,501176,Haryana,24,23,10,15,72,Pass
Aarav Reddy,01-05-2006,352573,Haryana,13,22,19,18,72,Pass
Krishna Singh,12-12-2004,645143,Haryana,20,22,18,11,71,Pass
Raj Pillai,06-01-2005,120990,Haryana,15,20,23,13,71,Pass
Aryan Pillai,25-02-2005,430597,Haryana,18,20,17,16,71,Pass
Rohan Khan,12-04-2005,158099,Haryana,12,22,24,13,71,Pass
Ishaan Sharma,04-06-2005,493904,Haryana,18,14,18,21,71,Pass
Raj Reddy,12-07-2005,561292,Haryana,10,21,17,23,71,Pass
Zaid D'Souza,11-08-2005,786111,Haryana,20,11,20,20,71,Pass
Aarav Mehta,02-09-2005,941893,Haryana,24,18,21,8,71,Pass
Aditya Khan,26-09-2005,412063,Haryana,24,6,20,21,71,Pass
Ishaan Sharma,02-11-2005,582889,Haryana,17,17,16,21,71,Pass
Aditya Mehta,04-05-2006,675627,Haryana,21,5,21,24,71,Pass
Aditya D'Souza,11-11-2004,155772,Haryana,6,18,22,24,70,Pass
Peter Verma,30-04-2005,669911,Haryana,11,16,19,24,70,Pass
Harjeet Verma,21-06-2005,711498,Haryana,23,22,10,15,70,Pass
Kunal Mehta,23-06-2005,764967,Haryana,7,20,24,19,70,Pass
Kunal Reddy,30-07-2005,923554,Haryana,13,20,18,19,70,Pass
Aditya Verma,04-12-2005,459503,Haryana,24,4,23,19,70,Pass
Kunal Reddy,05-01-2006,848035,Haryana,17,16,13,24,70,Pass
Aditya Fernandes,04-03-2006,678196,Haryana,23,11,16,20,70,Pass
Peter Reddy,14-03-2006,148756,Haryana,21,15,23,11,70,Pass
Kunal Verma,27-01-2005,893034,Haryana,20,15,17,17,69,Pass
Ishaan Chopra,21-02-2005,678414,Haryana,24,15,10,20,69,Pass
Imran Mehta,27-04-2005,895588,Haryana,21,17,8,23,69,Pass
Peter Chopra,07-06-2005,142110,Haryana,13,17,22,17,69,Pass
Kunal Verma,08-06-2005,373356,Haryana,15,14,18,22,69,Pass
Aryan D'Souza,16-06-2005,367877,Haryana,17,20,17,15,69,Pass
Ishaan Fernandes,30-06-2005,670181,Haryana,13,18,17,21,69,Pass
Raj D'Souza,05-08-2005,389185,Haryana,24,15,13,17,69,Pass
Rohan Singh,12-08-2005,556990,Haryana,16,22,14,17,69,Pass
Aarav Chopra,18-08-2005,590953,Haryana,22,23,9,15,69,Pass
Ishaan Fernandes,26-08-2005,513819,Haryana,19,21,17,12,69,Pass
Harjeet Verma,18-11-2005,870194,Haryana,17,10,23,19,69,Pass
Krishna Fernandes,23-11-2005,109636,Haryana,15,20,11,23,69,Pass
Raj Chopra,11-12-2005,428997,Haryana,21,10,15,23,69,Pass
Kunal D'Souza,23-12-2005,204290,Haryana,7,20,19,23,69,Pass
Krishna D'Souza,04-03-2006,842954,Haryana,21,24,6,18,69,Pass
Aryan Verma,01-04-2006,794390,Haryana,24,19,12,14,69,Pass
Ishaan Fernandes,10-04-2006,247958,Haryana,19,16,12,22,69,Pass
Ishaan Verma,08-11-2004,125844,Haryana,23,14,7,24,68,Pass
Kunal Reddy,09-01-2005,660021,Haryana,21,11,20,16,68,Pass
Aryan Reddy,21-03-2005,695075,Haryana,20,11,22,15,68,Pass
Imran Singh,29-04-2005,766995,Haryana,20,7,23,18,68,Pass
Mathew Fernandes,30-04-2005,110855,Haryana,20,17,10,21,68,Pass
Aditya Khan,29-05-2005,123363,Haryana,13,14,22,19,68,Pass
David Chopra,01-06-2005,844898,Haryana,5,23,17,23,68,Pass
Gurpreet Verma,04-07-2005,244220,Haryana,23,4,21,20,68,Pass
Aditya Khan,06-08-2005,943716,Haryana,12,22,14,20,68,Pass
Raj Chopra,02-09-2005,274671,Haryana,19,16,9,24,68,Pass
Raj Mehta,07-09-2005,597437,Haryana,11,14,24,19,68,Pass
Yash Fernandes,11-11-2005,956212,Haryana,22,15,7,24,68,Pass
Balbir Khan,22-03-2006,106968,Haryana,23,20,16,9,68,Pass
Raj Singh,10-11-2004,248270,Haryana,11,17,20,19,67,Pass
Aditya Reddy,21-11-2004,455777,Haryana,21,17,10,19,67,Pass
Krishna Sharma,26-01-2005,311907,Haryana,10,24,23,10,67,Pass
Gurpreet Sharma,03-08-2005,775683,Haryana,22,10,11,24,67,Pass
Aryan Verma,07-08-2005,942042,Haryana,14,17,18,18,67,Pass
Aarav Chopra,12-08-2005,259015,Haryana,23,6,15,23,67,Pass
Raj Singh,12-08-2005,162491,Haryana,11,14,24,18,67,Pass
Rohan Pillai,16-11-2005,150898,Haryana,10,16,23,18,67,Pass
Vivaan Verma,02-12-2005,821861,Haryana,24,8,12,23,67,Pass
Krishna Singh,04-03-2006,885733,Haryana,20,15,19,13,67,Pass
Sukhwinder D'Souza,28-03-2006,301537,Haryana,16,9,18,24,67,Pass
Krishna Chopra,01-12-2004,662481,Haryana,21,16,8,21,66,Pass
Vivaan Pillai,04-01-2005,250332,Haryana,23,18,16,9,66,Pass
Sukhwinder D'Souza,15-02-2005,254961,Haryana,12,12,20,22,66,Pass
Manpreet Fernandes,23-03-2005,219864,Haryana,21,20,18,7,66,Pass
Aryan Fernandes,24-04-2005,780881,Haryana,23,20,5,18,66,Pass
Ayaan Mehta,29-04-2005,504311,Haryana,18,13,23,12,66,Pass
Mathew Verma,11-07-2005,446288,Haryana,23,8,21,14,66,Pass
Kunal Khan,15-07-2005,318647,Haryana,22,21,13,10,66,Pass
Aryan Chopra,22-07-2005,241398,Haryana,12,17,23,14,66,Pass
Ishaan Singh,18-08-2005,931313,Haryana,7,23,18,18,66,Pass
Gurpreet Singh,12-09-2005,177515,Haryana,20,4,19,23,66,Pass
Ishaan Sharma,10-10-2005,621997,Haryana,17,7,18,24,66,Pass
Rohan Pillai,19-11-2005,881755,Haryana,6,17,24,19,66,Pass
Aditya Sharma,30-01-2006,916557,Haryana,18,19,18,11,66,Pass
Mathew Reddy,06-02-2006,314793,Haryana,23,5,21,17,66,Pass
Yash Sharma,20-12-2005,926944,Karnataka,21,24,23,21,89,Pass
Aarav Verma,28-04-2005,914521,Karnataka,19,23,21,21,84,Pass
Raj Reddy,04-08-2005,624372,Karnataka,22,22,19,5,68,Pass
Paul Verma,23-11-2004,821030,Karnataka,24,17,16,10,67,Pass
Krishna Verma,21-02-2005,653029,Karnataka,17,11,23,16,67,Pass
Kunal Khan,13-03-2005,771095,Karnataka,18,23,18,8,67,Pass
Kunal Fernandes,19-04-2005,176748,Karnataka,19,23,20,5,67,Pass
David Mehta,08-06-2005,553758,Karnataka,21,22,8,16,67,Pass
Manpreet D'Souza,02-10-2005,325948,Karnataka,23,21,8,15,67,Pass
Gurpreet Verma,26-11-2005,992967,Karnataka,9,16,18,24,67,Pass
Krishna Khan,10-12-2005,213828,Karnataka,13,17,20,17,67,Pass
Rohan Pillai,14-12-2005,769395,Karnataka,10,23,18,16,67,Pass
Raj Verma,16-03-2006,470589,Karnataka,15,18,14,20,67,Pass
John Khan,24-12-2004,842809,Karnataka,14,21,7,24,66,Pass
Rohan Mehta,31-12-2004,905949,Karnataka,14,9,19,24,66,Pass
Sukhwinder Singh,18-03-2005,503072,Karnataka,8,18,19,21,66,Pass
Ishaan Verma,29-05-2005,384651,Karnataka,15,23,20,8,66,Pass
Rohan Chopra,19-07-2005,772141,Karnataka,11,17,15,23,66,Pass
Aditya Sharma,12-08-2005,873975,Karnataka,16,17,23,10,66,Pass
Krishna Mehta,26-08-2005,714844,Karnataka,18,5,19,24,66,Pass
Raj Reddy,30-08-2005,157683,Karnataka,12,23,18,13,66,Pass
Yash Khan,20-10-2005,471136,Karnataka,7,19,21,19,66,Pass
Balbir Pillai,04-11-2005,662968,Karnataka,21,16,6,23,66,Pass
Aarav Mehta,16-01-2006,501840,Karnataka,19,23,20,4,66,Pass
Ishaan Sharma,07-03-2006,220267,Karnataka,18,20,23,5,66,Pass
Aditya Khan,23-03-2006,633237,Karnataka,18,16,24,8,66,Pass
Aryan Mehta,24-03-2006,761552,Karnataka,20,21,10,15,66,Pass
Aarav Chopra,13-04-2006,230822,Karnataka,24,17,14,11,66,Pass
Yash D'Souza,22-12-2004,183702,Karnataka,16,19,16,14,65,Pass
Aryan Verma,16-03-2005,808656,Karnataka,6,22,21,16,65,Pass
Rohan Reddy,05-05-2005,840494,Karnataka,22,15,24,4,65,Pass
Manpreet Chopra,10-05-2005,496535,Karnataka,16,23,19,7,65,Pass
Rohan Pillai,30-05-2005,455005,Karnataka,21,19,20,5,65,Pass
Krishna Chopra,08-06-2005,188936,Karnataka,9,19,14,23,65,Pass
Farhan Singh,12-07-2005,205284,Karnataka,15,19,9,22,65,Pass
Kunal D'Souza,22-07-2005,527100,Karnataka,4,22,22,17,65,Pass
Aditya Reddy,16-08-2005,982992,Karnataka,18,22,13,12,65,Pass
Raj Khan,14-10-2005,606990,Karnataka,20,19,8,18,65,Pass
Raj Reddy,21-10-2005,628587,Karnataka,21,19,6,19,65,Pass
Vivaan Khan,25-12-2005,627821,Karnataka,7,15,20,23,65,Pass
Aditya Singh,04-01-2006,219175,Karnataka,13,11,20,21,65,Pass
Harjeet Mehta,20-01-2006,885548,Karnataka,13,20,18,14,65,Pass
Ishaan Pillai,14-04-2006,182667,Karnataka,23,22,11,9,65,Pass
Balbir D'Souza,10-12-2004,290081,Karnataka,4,19,24,17,64,Pass
Aryan Mehta,20-12-2004,945127,Karnataka,16,18,6,24,64,Pass
Rohan Singh,21-12-2004,501654,Karnataka,15,19,16,14,64,Pass
Aditya Fernandes,29-01-2005,542421,Karnataka,19,11,17,17,64,Pass
Imran Reddy,01-02-2005,360861,Karnataka,20,7,16,21,64,Pass
Sukhwinder D'Souza,19-03-2005,720884,Karnataka,18,18,17,11,64,Pass
David Singh,06-04-2005,525674,Karnataka,19,19,7,19,64,Pass
Harjeet Fernandes,02-05-2005,321285,Karnataka,21,20,14,9,64,Pass
Paul Singh,14-05-2005,737483,Karnataka,13,9,18,24,64,Pass
Gurpreet Verma,29-07-2005,882356,Karnataka,17,16,13,18,64,Pass
Aryan Fernandes,01-09-2005,328862,Karnataka,23,19,10,12,64,Pass
Rohan Fernandes,02-10-2005,247968,Karnataka,18,15,22,9,64,Pass
Rohan Fernandes,12-11-2005,440849,Karnataka,22,12,18,12,64,Pass
Aarav Mehta,06-12-2005,909492,Karnataka,7,17,22,18,64,Pass
Gurpreet Singh,13-12-2005,685642,Karnataka,13,18,18,15,64,Pass
Aryan Chopra,13-01-2006,125271,Karnataka,20,13,17,14,64,Pass
Harjeet Pillai,22-01-2006,185657,Karnataka,12,19,21,12,64,Pass
Vivaan Verma,20-02-2006,177152,Karnataka,20,18,18,8,64,Pass
Vivaan Sharma,24-02-2006,416761,Karnataka,4,22,14,24,64,Pass
Peter Singh,10-03-2006,709345,Karnataka,9,21,24,10,64,Pass
Yash Sharma,15-03-2006,420890,Karnataka,23,9,18,14,64,Pass
Krishna Sharma,26-04-2006,717853,Karnataka,23,14,20,7,64,Pass
Gurpreet Chopra,17-11-2004,549022,Karnataka,24,13,16,10,63,Pass
Ishaan D'Souza,17-12-2004,198530,Karnataka,23,9,23,8,63,Pass
Aditya Sharma,04-05-2005,361318,Karnataka,7,22,21,13,63,Pass
Krishna Pillai,06-05-2005,811487,Karnataka,24,11,9,19,63,Pass
Zaid Fernandes,07-07-2005,938495,Karnataka,22,12,17,12,63,Pass
Raj Fernandes,13-11-2005,591080,Karnataka,23,5,24,11,63,Pass
Harjeet Khan,29-01-2006,983568,Karnataka,12,11,24,16,63,Pass
Harjeet Fernandes,17-02-2006,902303,Karnataka,13,23,19,8,63,Pass
Kunal Singh,19-02-2006,641181,Karnataka,18,15,9,21,63,Pass
Harjeet Pillai,03-04-2006,998148,Karnataka,23,21,5,14,63,Pass
Krishna Sharma,30-12-2004,493641,Karnataka,13,19,18,12,62,Pass
Manpreet Sharma,10-01-2005,407066,Karnataka,20,19,18,5,62,Pass
Aarav Singh,13-01-2005,816581,Karnataka,21,9,15,17,62,Pass
Paul Reddy,22-02-2005,434294,Karnataka,19,22,9,12,62,Pass
Aditya Mehta,11-05-2005,937522,Karnataka,14,19,19,10,62,Pass
Vivaan Verma,08-07-2005,566681,Karnataka,14,8,24,16,62,Pass
Aarav Fernandes,09-07-2005,237867,Karnataka,13,18,13,18,62,Pass
Krishna Reddy,14-07-2005,996488,Karnataka,11,7,20,24,62,Pass
Vivaan Khan,03-09-2005,387196,Karnataka,13,17,8,24,62,Pass
Kunal Reddy,02-11-2005,148751,Karnataka,13,17,19,13,62,Pass
Krishna Pillai,07-11-2005,985750,Karnataka,20,18,20,4,62,Pass
Rohan Fernandes,05-01-2006,340896,Karnataka,10,23,15,14,62,Pass
David Sharma,06-01-2006,986595,Karnataka,4,23,17,18,62,Pass
Yash Reddy,26-02-2006,461676,Karnataka,22,4,23,13,62,Pass
Ishaan Reddy,12-03-2006,714594,Karnataka,15,14,24,9,62,Pass
Paul Fernandes,12-11-2004,505004,Karnataka,8,23,10,20,61,Pass
Aditya Sharma,23-12-2004,255376,Karnataka,24,19,7,11,61,Pass
Aditya Singh,25-12-2004,414855,Karnataka,18,18,20,5,61,Pass
David Verma,25-05-2005,557931,Karnataka,11,18,23,9,61,Pass
Raj Singh,29-05-2005,165579,Karnataka,21,12,20,8,61,Pass
Rohan Singh,08-06-2005,327355,Karnataka,20,7,13,21,61,Pass
Aryan Singh,01-07-2005,955331,Karnataka,20,24,12,5,61,Pass
John Verma,28-08-2005,508243,Karnataka,8,9,20,24,61,Pass
Yash Reddy,31-10-2005,707974,Karnataka,16,10,21,14,61,Pass
Balbir D'Souza,15-11-2005,277958,Karnataka,17,16,15,13,61,Pass
John Reddy,06-12-2005,710992,Karnataka,21,23,11,6,61,Pass
Harjeet Singh,25-12-2005,584342,Karnataka,12,18,17,14,61,Pass
Rohan Fernandes,08-01-2006,903296,Karnataka,15,9,18,19,61,Pass
Vivaan Fernandes,21-01-2006,147615,Karnataka,22,12,9,18,61,Pass
Raj Fernandes,03-03-2006,386813,Karnataka,5,16,20,20,61,Pass
Yash Khan,25-03-2006,691027,Karnataka,14,6,23,18,61,Pass
Raj Chopra,17-04-2006,504229,Karnataka,24,4,21,12,61,Pass
Aryan Singh,05-05-2006,582683,Maharashtra,23,4,22,24,73,Pass
Aarav Chopra,16-12-2004,866541,Maharashtra,22,4,20,24,70,Pass
Rehan Fernandes,17-06-2005,890099,Maharashtra,6,21,22,21,70,Pass
Aryan Chopra,24-09-2005,947172,Maharashtra,22,4,22,22,70,Pass
Gurpreet Chopra,18-11-2005,478727,Maharashtra,24,4,21,21,70,Pass
Paul Chopra,02-08-2005,222049,Maharashtra,19,4,22,23,68,Pass
Krishna Chopra,15-10-2005,909572,Maharashtra,24,4,21,19,68,Pass
Ishaan D'Souza,11-01-2006,633720,Maharashtra,21,4,18,24,67,Pass
Kunal Mehta,27-04-2006,322708,Maharashtra,17,4,23,23,67,Pass
Balbir Khan,07-08-2005,689205,Maharashtra,22,4,22,18,66,Pass
John Reddy,03-02-2006,149356,Maharashtra,8,22,22,14,66,Pass
Aryan Fernandes,24-02-2006,832691,Maharashtra,23,4,23,16,66,Pass
Yash Fernandes,26-03-2006,593380,Maharashtra,20,4,20,22,66,Pass
Balbir Reddy,17-04-2006,866131,Maharashtra,18,4,24,20,66,Pass
Sukhwinder Reddy,18-12-2004,603373,Maharashtra,23,4,18,20,65,Pass
Rohan Reddy,30-04-2005,820759,Maharashtra,20,4,22,19,65,Pass
Aryan Singh,23-07-2005,905277,Maharashtra,24,4,16,21,65,Pass
Zaid Reddy,18-08-2005,262447,Maharashtra,24,4,20,17,65,Pass
Yash Verma,05-02-2005,446997,Maharashtra,24,4,19,17,64,Pass
Aryan Fernandes,05-02-2005,861950,Maharashtra,16,4,22,22,64,Pass
Kunal Khan,11-02-2005,707595,Maharashtra,23,4,16,21,64,Pass
Vivaan Singh,03-11-2005,718361,Maharashtra,24,4,15,21,64,Pass
Balbir Verma,18-06-2005,310223,Maharashtra,22,4,18,19,63,Pass
Balbir Pillai,10-09-2005,416910,Maharashtra,6,10,23,24,63,Pass
Aditya Mehta,17-10-2005,598636,Maharashtra,16,4,22,21,63,Pass
Aarav Pillai,02-06-2005,146157,Maharashtra,12,4,22,24,62,Pass
Rohan Reddy,23-10-2005,621578,Maharashtra,15,4,19,24,62,Pass
Ishaan Khan,06-03-2005,635938,Maharashtra,24,4,10,23,61,Pass
Gurpreet Mehta,06-07-2005,593024,Maharashtra,13,4,22,22,61,Pass
Manpreet D'Souza,10-10-2005,839366,Maharashtra,21,4,21,15,61,Pass
Imran Mehta,28-10-2005,582076,Maharashtra,16,4,24,17,61,Pass
Aarav Verma,30-10-2005,595949,Maharashtra,13,4,24,20,61,Pass
Aryan Verma,26-03-2006,162784,Maharashtra,17,4,19,21,61,Pass
Balbir Sharma,28-03-2006,945015,Maharashtra,20,4,15,22,61,Pass
Kunal Fernandes,21-04-2006,157073,Maharashtra,11,4,22,24,61,Pass
Yash Mehta,22-08-2005,264901,Maharashtra,14,4,18,24,60,Pass
Balbir Singh,25-10-2005,547678,Maharashtra,14,4,18,24,60,Pass
Sukhwinder Reddy,05-11-2005,639611,Maharashtra,20,4,18,18,60,Pass
Yash Verma,05-01-2006,428671,Maharashtra,20,4,20,16,60,Pass
Aryan Mehta,18-01-2006,434689,Maharashtra,19,4,21,16,60,Pass
David D'Souza,03-04-2006,817460,Maharashtra,20,4,18,18,60,Pass
Raj Mehta,24-04-2006,352327,Maharashtra,24,4,21,11,60,Pass
Aarav Pillai,05-05-2006,306889,Maharashtra,22,4,19,15,60,Pass
Raj Pillai,15-05-2005,509916,Maharashtra,17,4,14,24,59,Pass
Kunal Reddy,18-06-2005,447597,Maharashtra,22,4,11,22,59,Pass
Krishna Fernandes,13-07-2005,546083,Maharashtra,20,4,11,24,59,Pass
Ishaan Sharma,13-08-2005,716548,Maharashtra,23,4,19,13,59,Pass
David Verma,18-12-2005,190713,Maharashtra,18,4,24,13,59,Pass
Aryan Khan,01-03-2005,394389,Maharashtra,17,4,14,23,58,Pass
Farhan Chopra,15-06-2005,865495,Maharashtra,21,4,24,9,58,Pass
Farhan Mehta,09-07-2005,863547,Maharashtra,19,4,23,12,58,Pass
Krishna Chopra,27-10-2005,956382,Maharashtra,18,4,16,20,58,Pass
Yash Chopra,13-11-2005,155901,Maharashtra,23,4,7,24,58,Pass
Kunal Reddy,22-01-2006,767377,Maharashtra,20,4,17,17,58,Pass
Yash Singh,05-05-2006,500440,Maharashtra,22,4,24,8,58,Pass
Ishaan Sharma,22-11-2004,380484,Maharashtra,14,4,16,23,57,Pass
Kunal Chopra,05-07-2005,783967,Maharashtra,13,4,22,18,57,Pass
Aarav Reddy,17-08-2005,146014,Maharashtra,21,4,18,14,57,Pass
Raj Verma,23-09-2005,631066,Maharashtra,11,4,20,22,57,Pass
Rohan Khan,06-01-2006,514244,Maharashtra,23,4,18,12,57,Pass
Aryan Pillai,08-01-2006,529938,Maharashtra,13,4,23,17,57,Pass
Yash Reddy,04-03-2005,276707,Maharashtra,12,4,20,20,56,Pass
Farhan Sharma,06-04-2005,328546,Maharashtra,15,4,19,18,56,Pass
Farhan Mehta,17-10-2005,476089,Maharashtra,22,4,9,21,56,Pass
Manpreet Reddy,06-11-2005,642285,Maharashtra,7,4,22,23,56,Pass
Aarav Singh,17-11-2005,406907,Maharashtra,13,4,19,20,56,Pass
Rohan Sharma,13-02-2006,838472,Maharashtra,12,4,22,18,56,Pass
Ishaan Chopra,23-02-2006,694380,Maharashtra,9,4,20,23,56,Pass
Raj D'Souza,05-05-2006,979581,Maharashtra,6,20,20,10,56,Pass
Balbir Khan,17-01-2005,343216,Maharashtra,20,4,9,22,55,Pass
Ishaan D'Souza,13-02-2005,565583,Maharashtra,21,4,19,11,55,Pass
Aryan Fernandes,18-04-2005,548265,Maharashtra,21,4,9,21,55,Pass
Raj Chopra,09-07-2005,906049,Maharashtra,4,4,23,24,55,Pass
Kunal Sharma,14-08-2005,322511,Maharashtra,17,4,17,17,55,Pass
Rohan Fernandes,15-09-2005,962482,Maharashtra,18,4,21,12,55,Pass
Aditya D'Souza,17-01-2006,873931,Maharashtra,13,13,16,13,55,Pass
Sukhwinder Pillai,07-12-2004,236615,Maharashtra,16,4,24,10,54,Pass
Kunal Fernandes,05-01-2005,787331,Maharashtra,23,4,8,19,54,Pass
Rohan Verma,11-01-2005,314476,Maharashtra,10,4,20,20,54,Pass
Paul Pillai,01-03-2005,660339,Maharashtra,21,4,22,7,54,Pass
Aarav Chopra,24-03-2005,703591,Maharashtra,13,4,17,20,54,Pass
Balbir Sharma,20-06-2005,537250,Maharashtra,7,4,22,21,54,Pass
Kunal Reddy,05-09-2005,779374,Maharashtra,17,4,18,15,54,Pass
Kunal Fernandes,08-10-2005,448346,Maharashtra,17,4,22,11,54,Pass
Krishna Chopra,28-10-2005,326696,Maharashtra,6,12,17,19,54,Pass
Gurpreet Mehta,05-11-2005,285939,Maharashtra,24,4,16,10,54,Pass
Yash Fernandes,22-11-2005,333885,Maharashtra,6,14,18,16,54,Pass
Rohan Fernandes,28-11-2005,523739,Maharashtra,23,4,10,17,54,Pass
Rohan Reddy,29-03-2006,592634,Maharashtra,21,4,17,12,54,Pass
Raj Mehta,11-11-2004,239768,Maharashtra,23,4,17,9,53,Pass
Aditya Sharma,23-11-2004,909139,Maharashtra,6,17,24,6,53,Pass
Raj Sharma,03-01-2005,235924,Maharashtra,20,4,20,9,53,Pass
Aarav Singh,08-04-2005,319315,Maharashtra,13,4,19,17,53,Pass
Vivaan Pillai,15-05-2005,279071,Maharashtra,6,21,4,22,53,Pass
Aarav Pillai,14-07-2005,950580,Maharashtra,5,4,21,23,53,Pass
Yash Chopra,02-08-2005,720265,Maharashtra,23,4,7,19,53,Pass
Kunal Verma,16-08-2005,539729,Maharashtra,20,4,12,17,53,Pass
Aditya Khan,23-08-2005,936254,Maharashtra,11,4,20,18,53,Pass
Aryan Fernandes,16-10-2005,889941,Maharashtra,19,4,16,14,53,Pass
Krishna Mehta,01-11-2005,877407,Maharashtra,22,4,16,11,53,Pass
Gurpreet Khan,22-03-2006,400966,Maharashtra,14,4,17,18,53,Pass
Krishna Khan,16-01-2005,374561,Jharkhand,24,23,20,21,88,Pass
Rohan Khan,28-02-2005,655423,Jharkhand,24,17,23,23,87,Pass
Krishna Chopra,11-11-2004,567346,Jharkhand,23,13,23,8,67,Pass
Sukhwinder Singh,15-12-2004,940199,Jharkhand,21,15,10,21,67,Pass
Ishaan Khan,06-01-2005,821632,Jharkhand,4,15,24,24,67,Pass
Raj Khan,13-01-2005,960907,Jharkhand,17,15,16,19,67,Pass
Vivaan Singh,14-01-2005,492708,Jharkhand,24,7,23,13,67,Pass
Manpreet Singh,06-02-2005,119194,Jharkhand,13,19,21,14,67,Pass
Aryan Mehta,24-04-2005,132691,Jharkhand,18,17,20,12,67,Pass
Krishna Sharma,04-06-2005,315749,Jharkhand,18,19,6,24,67,Pass
Aditya Khan,10-09-2005,541917,Jharkhand,10,22,19,16,67,Pass
Ishaan Pillai,09-12-2005,360133,Jharkhand,8,19,16,24,67,Pass
Aditya D'Souza,20-12-2005,312399,Jharkhand,22,13,17,15,67,Pass
Kunal Khan,24-11-2004,828810,Jharkhand,23,15,9,19,66,Pass
Kunal Fernandes,18-12-2004,771335,Jharkhand,16,17,16,17,66,Pass
Mathew Verma,09-01-2005,805929,Jharkhand,20,18,24,4,66,Pass
Aryan Chopra,28-01-2005,183095,Jharkhand,24,9,13,20,66,Pass
Imran Chopra,04-03-2005,394234,Jharkhand,11,21,13,21,66,Pass
Vivaan Singh,12-03-2005,640196,Jharkhand,6,21,16,23,66,Pass
Raj Pillai,28-03-2005,806963,Jharkhand,24,23,14,5,66,Pass
Mathew Mehta,09-04-2005,476013,Jharkhand,17,12,22,15,66,Pass
Vivaan Pillai,23-04-2005,157223,Jharkhand,11,18,16,21,66,Pass
Kunal D'Souza,14-05-2005,594182,Jharkhand,18,11,21,16,66,Pass
Yash D'Souza,08-07-2005,270879,Jharkhand,17,17,22,10,66,Pass
Aditya Chopra,22-07-2005,251978,Jharkhand,18,9,16,23,66,Pass
Raj Verma,03-08-2005,195618,Jharkhand,17,22,16,11,66,Pass
Krishna D'Souza,09-08-2005,367422,Jharkhand,23,5,24,14,66,Pass
Kunal Sharma,23-09-2005,451378,Jharkhand,12,9,22,23,66,Pass
Aarav Reddy,03-10-2005,894572,Jharkhand,23,16,14,13,66,Pass
Ishaan Mehta,04-10-2005,574699,Jharkhand,22,24,4,16,66,Pass
Balbir Singh,27-12-2005,220260,Jharkhand,12,20,19,15,66,Pass
Aditya Chopra,26-02-2006,965429,Jharkhand,4,23,21,18,66,Pass
Manpreet Pillai,13-03-2006,629436,Jharkhand,24,24,9,9,66,Pass
Vivaan D'Souza,11-04-2006,202844,Jharkhand,18,22,21,5,66,Pass
Farhan Sharma,01-05-2005,119203,Jharkhand,22,14,21,8,65,Pass
Aditya Khan,08-05-2005,320271,Jharkhand,8,20,24,13,65,Pass
Rohan Fernandes,22-05-2005,645350,Jharkhand,24,15,21,5,65,Pass
Raj Khan,30-06-2005,520030,Jharkhand,13,6,24,22,65,Pass
Aryan Chopra,20-07-2005,629312,Jharkhand,20,6,22,17,65,Pass
Harjeet Reddy,07-09-2005,430688,Jharkhand,22,8,17,18,65,Pass
Aditya Reddy,21-10-2005,425500,Jharkhand,16,10,15,24,65,Pass
Kunal Khan,02-12-2005,294185,Jharkhand,13,16,14,22,65,Pass
Manpreet Pillai,21-01-2006,559643,Jharkhand,13,22,10,20,65,Pass
Raj Chopra,23-02-2006,125599,Jharkhand,21,17,5,22,65,Pass
Paul Reddy,13-03-2006,734883,Jharkhand,17,4,22,22,65,Pass
Krishna Verma,03-04-2006,422153,Jharkhand,9,17,19,20,65,Pass
Aryan Chopra,04-04-2006,586576,Jharkhand,9,20,14,22,65,Pass
Aarav D'Souza,05-03-2005,831436,Jharkhand,24,12,24,4,64,Pass
Aryan Reddy,01-04-2005,314520,Jharkhand,17,19,10,18,64,Pass
Aryan Sharma,06-05-2005,745742,Jharkhand,16,16,17,15,64,Pass
Ishaan D'Souza,13-05-2005,324255,Jharkhand,7,16,22,19,64,Pass
Ishaan Fernandes,23-07-2005,352467,Jharkhand,13,19,12,20,64,Pass
Paul Sharma,09-08-2005,269824,Jharkhand,20,8,13,23,64,Pass
Kunal Mehta,13-08-2005,266785,Jharkhand,22,18,19,5,64,Pass
Vivaan Singh,06-09-2005,463681,Jharkhand,22,16,11,15,64,Pass
Krishna Reddy,08-09-2005,609851,Jharkhand,24,8,20,12,64,Pass
Rehan Reddy,27-10-2005,843217,Jharkhand,8,15,19,22,64,Pass
Kunal Chopra,08-11-2005,885620,Jharkhand,19,12,20,13,64,Pass
Aryan Pillai,12-12-2005,953440,Jharkhand,17,6,22,19,64,Pass
Aditya Chopra,08-01-2006,890018,Jharkhand,19,23,4,18,64,Pass
Vivaan Sharma,08-03-2006,261232,Jharkhand,24,14,15,11,64,Pass
Yash Khan,08-03-2006,229540,Jharkhand,20,22,18,4,64,Pass
Vivaan Pillai,09-03-2006,605351,Jharkhand,13,19,18,14,64,Pass
Aditya Fernandes,11-01-2005,380700,Jharkhand,21,14,7,21,63,Pass
Aryan D'Souza,05-02-2005,373312,Jharkhand,18,18,6,21,63,Pass
Kunal Khan,03-04-2005,823170,Jharkhand,21,19,17,6,63,Pass
Rohan Verma,14-06-2005,855028,Jharkhand,7,22,23,11,63,Pass
Aryan Pillai,02-07-2005,743179,Jharkhand,23,10,17,13,63,Pass
Aryan Verma,25-07-2005,735904,Jharkhand,22,12,23,6,63,Pass
Kunal Pillai,01-10-2005,583476,Jharkhand,21,24,13,5,63,Pass
Aryan Sharma,03-10-2005,490641,Jharkhand,16,18,7,22,63,Pass
Peter Khan,24-10-2005,493238,Jharkhand,9,16,17,21,63,Pass
Raj Verma,03-11-2005,581282,Jharkhand,12,22,7,22,63,Pass
Aarav Verma,29-01-2006,248882,Jharkhand,18,18,18,9,63,Pass
Raj Verma,04-03-2006,383430,Jharkhand,18,12,9,24,63,Pass
David D'Souza,10-03-2006,455178,Jharkhand,22,5,13,23,63,Pass
Gurpreet D'Souza,30-11-2004,803803,Jharkhand,23,22,7,10,62,Pass
Gurpreet Sharma,07-03-2005,186329,Jharkhand,11,17,14,20,62,Pass
Sukhwinder Reddy,23-03-2005,451344,Jharkhand,10,23,8,21,62,Pass
Vivaan Verma,20-04-2005,516535,Jharkhand,23,5,16,18,62,Pass
Raj Fernandes,04-06-2005,386917,Jharkhand,17,12,10,23,62,Pass
Mathew Verma,25-09-2005,591112,Jharkhand,14,15,22,11,62,Pass
Aryan Mehta,03-10-2005,915273,Jharkhand,10,23,6,23,62,Pass
Harjeet Khan,17-10-2005,289080,Jharkhand,16,23,4,19,62,Pass
Harjeet Fernandes,27-12-2005,407975,Jharkhand,8,23,7,24,62,Pass
Aditya D'Souza,22-02-2006,471461,Jharkhand,17,24,5,16,62,Pass
Yash Fernandes,22-02-2006,543805,Jharkhand,11,16,23,12,62,Pass
Aarav Pillai,14-03-2006,253777,Jharkhand,24,21,4,13,62,Pass
Raj Khan,08-11-2004,694445,West Bengal,19,8,12,15,54,Pass
Aryan Singh,22-01-2005,877771,West Bengal,9,5,21,19,54,Pass
Rehan Reddy,23-01-2005,462743,West Bengal,24,6,13,11,54,Pass
Aarav Sharma,24-01-2005,799843,West Bengal,4,22,7,21,54,Pass
Yash Singh,12-02-2005,343036,West Bengal,11,6,17,20,54,Pass
Manpreet Verma,13-03-2005,359307,West Bengal,22,5,20,7,54,Pass
Aarav Fernandes,19-03-2005,164281,West Bengal,6,18,16,14,54,Pass
Raj Khan,20-03-2005,783241,West Bengal,11,11,24,8,54,Pass
Aarav D'Souza,27-03-2005,802819,West Bengal,7,13,21,13,54,Pass
Aryan Chopra,28-03-2005,946639,West Bengal,14,9,24,7,54,Pass
Krishna D'Souza,03-04-2005,813605,West Bengal,11,17,5,21,54,Pass
Kunal Verma,05-04-2005,827086,West Bengal,7,18,24,5,54,Pass
Raj Sharma,30-08-2005,237086,West Bengal,6,18,16,14,54,Pass
Peter D'Souza,16-09-2005,592899,West Bengal,14,12,4,24,54,Pass
Aryan Khan,19-09-2005,407426,West Bengal,24,19,4,7,54,Pass
Aarav Verma,28-10-2005,849134,West Bengal,9,14,10,21,54,Pass
Gurpreet Pillai,01-11-2005,252456,West Bengal,13,18,18,5,54,Pass
Aryan D'Souza,07-12-2005,843490,West Bengal,5,22,10,17,54,Pass
David D'Souza,27-12-2005,626811,West Bengal,12,7,20,15,54,Pass
Aditya Mehta,28-01-2006,234793,West Bengal,6,17,7,24,54,Pass
Ishaan Chopra,07-02-2006,955685,West Bengal,10,15,8,21,54,Pass
Sukhwinder Fernandes,12-02-2006,829620,West Bengal,6,19,20,9,54,Pass
Aditya Chopra,01-03-2006,196379,West Bengal,16,7,15,16,54,Pass
Yash Chopra,20-03-2006,174441,West Bengal,9,16,15,14,54,Pass
Aditya Singh,21-03-2006,723868,West Bengal,22,11,9,12,54,Pass
Yash Singh,19-11-2004,541444,West Bengal,15,15,8,15,53,Pass
Raj Pillai,24-11-2004,615866,West Bengal,18,17,4,14,53,Pass
Raj D'Souza,30-11-2004,473068,West Bengal,19,14,6,14,53,Pass
Yash Fernandes,29-12-2004,162395,West Bengal,11,16,19,7,53,Pass
Vivaan Pillai,01-01-2005,839961,West Bengal,7,22,6,18,53,Pass
Vivaan Pillai,02-01-2005,200538,West Bengal,9,23,9,12,53,Pass
Rohan Chopra,02-02-2005,602355,West Bengal,11,15,4,23,53,Pass
Farhan Fernandes,29-03-2005,966671,West Bengal,5,18,9,21,53,Pass
Yash Verma,04-04-2005,620342,West Bengal,15,16,17,5,53,Pass
Krishna Chopra,05-04-2005,164126,West Bengal,10,10,9,24,53,Pass
Raj Chopra,07-04-2005,261659,West Bengal,6,11,24,12,53,Pass
Manpreet Khan,12-04-2005,920505,West Bengal,8,16,17,12,53,Pass
Aarav Mehta,23-04-2005,523091,West Bengal,15,8,6,24,53,Pass
Aarav Reddy,03-07-2005,838705,West Bengal,8,8,24,13,53,Pass
Rohan Fernandes,05-07-2005,414229,West Bengal,24,5,15,9,53,Pass
Sukhwinder Chopra,27-08-2005,644072,West Bengal,24,6,19,4,53,Pass
Aarav Sharma,06-09-2005,599393,West Bengal,5,13,22,13,53,Pass
Aditya D'Souza,08-09-2005,464950,West Bengal,9,8,14,22,53,Pass
Krishna Sharma,09-10-2005,350448,West Bengal,10,15,23,5,53,Pass
Ishaan Reddy,03-11-2005,963765,West Bengal,22,18,5,8,53,Pass
Sukhwinder Chopra,16-11-2005,943482,West Bengal,14,23,10,6,53,Pass
Aditya D'Souza,02-01-2006,644044,West Bengal,16,23,5,9,53,Pass
Vivaan Singh,08-01-2006,937558,West Bengal,19,18,9,7,53,Pass
Rehan Mehta,05-02-2006,561057,West Bengal,11,15,19,8,53,Pass
Aryan Reddy,03-03-2006,575109,West Bengal,14,10,8,21,53,Pass
Ishaan Verma,08-04-2006,672392,West Bengal,6,23,13,11,53,Pass
Imran Verma,23-04-2006,281935,West Bengal,18,19,6,10,53,Pass
Kunal Verma,27-04-2006,277546,West Bengal,21,8,12,12,53,Pass
Raj Pillai,14-11-2004,684192,West Bengal,9,13,14,16,52,Pass
Manpreet Sharma,19-11-2004,349990,West Bengal,8,5,17,22,52,Pass
Krishna D'Souza,21-12-2004,353012,West Bengal,18,12,7,15,52,Pass
David Fernandes,05-01-2005,483628,West Bengal,19,15,7,11,52,Pass
Rohan Chopra,20-01-2005,842793,West Bengal,4,18,12,18,52,Pass
Vivaan Fernandes,28-02-2005,208721,West Bengal,8,4,21,19,52,Pass
Aarav Singh,01-03-2005,667747,West Bengal,18,11,15,8,52,Pass
Aarav Verma,26-03-2005,503840,West Bengal,8,13,23,8,52,Pass
Aarav Fernandes,08-04-2005,359305,West Bengal,22,7,4,19,52,Pass
Manpreet Pillai,17-04-2005,553591,West Bengal,10,12,8,22,52,Pass
Yash Chopra,18-05-2005,153785,West Bengal,20,5,17,10,52,Pass
Ishaan Fernandes,31-05-2005,245241,West Bengal,17,7,15,13,52,Pass
Aarav Singh,05-06-2005,850678,West Bengal,18,5,21,8,52,Pass
Balbir Mehta,26-07-2005,666680,West Bengal,5,20,18,9,52,Pass
Yash Pillai,31-07-2005,869455,West Bengal,15,13,5,19,52,Pass
Rohan Pillai,31-07-2005,165374,West Bengal,9,10,16,17,52,Pass
Rohan Khan,03-08-2005,988604,West Bengal,15,13,6,18,52,Pass
Raj Khan,26-08-2005,384891,West Bengal,18,7,5,22,52,Pass
Zaid Pillai,09-09-2005,379185,West Bengal,10,8,16,18,52,Pass
Krishna Reddy,16-10-2005,435477,West Bengal,4,8,21,19,52,Pass
Yash Khan,03-11-2005,591852,West Bengal,14,20,4,14,52,Pass
Rohan Singh,07-11-2005,683931,West Bengal,18,18,6,10,52,Pass
Aditya Fernandes,15-11-2005,560392,West Bengal,13,11,14,14,52,Pass
Kunal Sharma,18-11-2005,545023,West Bengal,7,19,11,15,52,Pass
Ishaan Reddy,18-12-2005,720283,West Bengal,21,6,13,12,52,Pass
John Verma,04-01-2006,306671,West Bengal,16,6,10,20,52,Pass
Aryan Mehta,06-04-2006,206274,West Bengal,11,21,14,6,52,Pass
Balbir Sharma,23-04-2006,176225,West Bengal,11,6,16,19,52,Pass
Aditya Sharma,26-04-2006,506755,West Bengal,13,5,22,12,52,Pass
Rohan D'Souza,11-05-2005,696807,Odisha,23,23,22,21,89,Pass
Aditya Pillai,01-12-2004,818103,Odisha,23,19,24,21,87,Pass
Ishaan Fernandes,28-07-2005,885215,Odisha,18,23,23,22,86,Pass
Balbir Pillai,26-11-2004,546331,Odisha,16,24,24,21,85,Pass
Yash Fernandes,24-02-2005,423552,Odisha,17,22,24,21,84,Pass
Krishna D'Souza,23-02-2005,892384,Odisha,21,17,21,24,83,Pass
Kunal Reddy,13-10-2005,575673,Odisha,19,20,23,21,83,Pass
Rohan Khan,14-12-2005,593951,Odisha,19,23,18,23,83,Pass
Rohan Pillai,26-12-2005,791041,Odisha,22,22,16,23,83,Pass
Balbir Fernandes,17-12-2004,894468,Odisha,24,22,17,18,81,Pass
Aarav D'Souza,26-11-2004,774512,Odisha,23,14,22,21,80,Pass
Paul Sharma,22-07-2005,733166,Odisha,18,24,24,14,80,Pass
Ishaan Pillai,01-08-2005,404692,Odisha,16,19,22,23,80,Pass
Aditya Singh,21-12-2004,716876,Odisha,24,20,18,17,79,Pass
Peter D'Souza,21-03-2005,980740,Odisha,22,13,21,23,79,Pass
Kunal Sharma,25-07-2005,255983,Odisha,15,20,22,22,79,Pass
Aarav Singh,24-02-2006,601247,Odisha,23,14,21,21,79,Pass
Raj Sharma,18-04-2006,853087,Odisha,19,16,24,20,79,Pass
Sukhwinder Fernandes,20-04-2006,211461,Odisha,20,16,19,24,79,Pass
Yash Fernandes,14-02-2005,306025,Odisha,22,17,24,15,78,Pass
Raj Khan,11-10-2005,509291,Odisha,18,19,24,17,78,Pass
Ishaan Mehta,22-12-2005,133640,Odisha,22,14,23,19,78,Pass
Yash Fernandes,10-04-2006,742482,Odisha,18,21,20,19,78,Pass
Paul Fernandes,01-09-2005,713850,Odisha,20,23,14,20,77,Pass
Peter Sharma,04-12-2004,424556,Odisha,19,20,24,13,76,Pass
Raj Sharma,26-02-2005,554326,Odisha,23,24,11,18,76,Pass
John Khan,12-03-2005,927524,Odisha,21,12,23,20,76,Pass
Balbir Fernandes,13-12-2005,309912,Odisha,23,21,8,24,76,Pass
Raj Singh,07-05-2006,551394,Odisha,16,19,18,23,76,Pass
Rohan Chopra,23-11-2004,427967,Odisha,22,16,24,13,75,Pass
Ishaan Mehta,20-11-2005,455052,Odisha,16,19,16,24,75,Pass
Ishaan Fernandes,21-11-2004,327230,Odisha,20,19,22,13,74,Pass
Paul D'Souza,11-03-2005,665081,Odisha,23,23,12,16,74,Pass
Rohan Mehta,28-03-2006,957246,Odisha,20,11,21,22,74,Pass
Kunal Reddy,21-01-2005,308765,Odisha,18,17,14,24,73,Pass
Sukhwinder Sharma,07-05-2005,623595,Odisha,24,10,24,15,73,Pass
Farhan Sharma,03-07-2005,400948,Odisha,20,16,21,16,73,Pass
Vivaan Sharma,07-07-2005,257745,Odisha,24,22,18,9,73,Pass
Yash Chopra,06-08-2005,592587,Odisha,21,15,16,21,73,Pass
Harjeet D'Souza,27-10-2005,874894,Odisha,22,7,24,20,73,Pass
Ishaan Chopra,06-04-2005,516872,Odisha,19,23,7,23,72,Pass
Raj Reddy,28-05-2005,776680,Odisha,20,23,23,6,72,Pass
Zaid Fernandes,19-12-2005,560620,Odisha,18,22,23,9,72,Pass
Aarav Khan,12-01-2005,146410,Odisha,15,24,8,24,71,Pass
Raj D'Souza,07-05-2005,575034,Odisha,8,23,18,22,71,Pass
Ishaan Chopra,01-08-2005,575924,Odisha,16,23,17,15,71,Pass
Vivaan Chopra,04-12-2005,877714,Odisha,13,22,18,18,71,Pass
Farhan Fernandes,18-02-2006,372653,Odisha,15,23,17,16,71,Pass
Rohan Reddy,27-02-2005,861548,Odisha,6,16,24,24,70,Pass
John D'Souza,28-03-2005,639242,Odisha,12,22,14,22,70,Pass
Gurpreet Pillai,27-08-2005,585830,Odisha,18,16,21,15,70,Pass
Aditya D'Souza,11-12-2005,109920,Odisha,19,21,16,14,70,Pass
Manpreet Chopra,01-05-2006,158321,Odisha,18,21,12,19,70,Pass
Gurpreet Chopra,16-03-2005,642513,Odisha,21,15,12,21,69,Pass
Krishna Singh,06-04-2005,519897,Odisha,17,14,21,17,69,Pass
Manpreet Khan,07-08-2005,869537,Odisha,21,20,10,18,69,Pass
Aryan D'Souza,04-10-2005,753872,Odisha,24,16,20,9,69,Pass
John D'Souza,28-03-2006,641333,Odisha,15,11,19,24,69,Pass
Harjeet Singh,28-01-2005,189491,Odisha,16,18,12,22,68,Pass
Kunal Sharma,02-06-2005,209809,Odisha,20,15,22,11,68,Pass
Krishna Sharma,04-01-2006,197712,Odisha,9,24,19,16,68,Pass
Harjeet Pillai,21-01-2006,620995,Odisha,15,18,20,15,68,Pass
Yash Mehta,24-03-2006,518198,Odisha,7,18,21,22,68,Pass
Aryan Chopra,28-03-2006,262315,Odisha,11,24,15,18,68,Pass
Mathew D'Souza,19-11-2004,230085,Odisha,23,19,9,16,67,Pass
Aarav Reddy,11-01-2005,421491,Odisha,12,23,12,20,67,Pass
David Verma,07-06-2005,887705,Odisha,16,14,17,20,67,Pass
Aditya Verma,28-06-2005,317360,Odisha,18,13,22,14,67,Pass
Rohan Chopra,24-07-2005,810211,Odisha,18,10,20,19,67,Pass
John Fernandes,24-08-2005,353521,Odisha,5,22,22,18,67,Pass
David Chopra,08-10-2005,391719,Odisha,23,16,19,9,67,Pass
Krishna D'Souza,05-12-2004,339032,Odisha,16,22,4,24,66,Pass
Kunal Mehta,19-04-2005,547046,Odisha,19,20,16,11,66,Pass
Ishaan Singh,22-04-2005,114126,Odisha,24,19,12,11,66,Pass
Zaid Fernandes,15-06-2005,257561,Odisha,22,24,12,8,66,Pass
Aditya Reddy,15-11-2005,714730,Odisha,17,7,23,19,66,Pass
Ishaan D'Souza,11-12-2005,292456,Odisha,15,24,23,4,66,Pass
Sukhwinder Pillai,23-02-2006,936976,Assam,21,24,18,19,82,Pass
Kunal Pillai,30-01-2006,575165,Assam,19,18,21,23,81,Pass
Aarav Mehta,26-04-2006,657730,Assam,20,22,20,19,81,Pass
David Fernandes,21-01-2006,953272,Assam,23,19,24,14,80,Pass
Krishna Reddy,12-12-2004,817559,Assam,13,22,21,22,78,Pass
Aryan Singh,17-02-2005,705165,Assam,17,20,21,20,78,Pass
Kunal Pillai,06-07-2005,491125,Assam,14,19,22,23,78,Pass
Manpreet Sharma,19-04-2005,946569,Assam,7,23,24,23,77,Pass
Krishna Verma,19-11-2005,337308,Assam,20,16,22,18,76,Pass
Krishna Fernandes,09-02-2006,256072,Assam,23,24,17,12,76,Pass
Krishna Mehta,30-06-2005,922086,Assam,12,17,22,24,75,Pass
Vivaan Fernandes,28-10-2005,847850,Assam,24,7,21,23,75,Pass
Manpreet D'Souza,13-05-2005,777668,Assam,18,18,21,17,74,Pass
Krishna Singh,30-06-2005,787214,Assam,24,24,9,16,73,Pass
Sukhwinder Verma,07-03-2006,470394,Assam,24,16,23,10,73,Pass
Ishaan Pillai,12-12-2004,811269,Assam,23,14,15,20,72,Pass
Manpreet Khan,28-04-2005,270219,Assam,19,12,23,18,72,Pass
Aryan Verma,14-07-2005,231127,Assam,15,17,23,16,71,Pass
John Chopra,01-11-2005,940034,Assam,19,22,8,22,71,Pass
Mathew Chopra,03-02-2006,349059,Assam,21,20,17,13,71,Pass
Aarav D'Souza,11-08-2005,420045,Assam,20,24,15,11,70,Pass
Krishna Sharma,20-10-2005,613255,Assam,18,23,13,16,70,Pass
Krishna Verma,22-02-2005,611795,Assam,9,16,23,21,69,Pass
Peter Verma,07-03-2005,548520,Assam,17,19,16,17,69,Pass
Aditya Mehta,21-04-2005,339332,Assam,21,10,23,15,69,Pass
Farhan Khan,04-06-2005,162184,Assam,19,14,19,17,69,Pass
Manpreet Chopra,28-12-2004,849715,Assam,14,12,18,24,68,Pass
Manpreet Pillai,20-05-2005,328372,Assam,16,21,12,19,68,Pass
Paul Verma,10-06-2005,124417,Assam,13,12,20,23,68,Pass
Kunal Chopra,26-06-2005,417129,Assam,14,20,22,12,68,Pass
Vivaan Khan,04-07-2005,834991,Assam,12,19,13,24,68,Pass
Yash Pillai,09-01-2005,726103,Assam,14,12,17,24,67,Pass
Krishna Pillai,26-01-2005,407800,Assam,17,14,13,23,67,Pass
Yash D'Souza,13-02-2005,611633,Assam,13,22,18,14,67,Pass
Aditya Sharma,16-04-2005,826469,Assam,16,15,14,22,67,Pass
Kunal Singh,06-09-2005,432404,Assam,18,16,13,20,67,Pass
Mathew Verma,31-01-2006,748483,Assam,10,23,12,22,67,Pass
Ishaan Reddy,18-12-2004,585041,Assam,15,21,18,12,66,Pass
Manpreet Mehta,01-05-2005,818250,Assam,21,22,10,13,66,Pass
Vivaan D'Souza,16-12-2005,194790,Assam,10,9,23,24,66,Pass
Ishaan Mehta,24-04-2005,472790,Assam,22,23,13,7,65,Pass
Rehan Verma,05-01-2006,781918,Assam,22,22,17,4,65,Pass
Vivaan Khan,26-01-2006,803963,Assam,20,22,7,16,65,Pass
Krishna D'Souza,26-01-2006,195164,Assam,15,22,22,6,65,Pass
Ishaan Pillai,06-12-2004,850864,Assam,24,17,13,10,64,Pass
Gurpreet D'Souza,16-01-2005,833256,Assam,18,19,7,20,64,Pass
Aryan D'Souza,21-03-2005,492936,Assam,17,18,13,16,64,Pass
Aarav D'Souza,04-08-2005,638420,Assam,15,24,10,15,64,Pass
Manpreet Chopra,14-11-2005,957524,Assam,19,16,19,10,64,Pass
Kunal Fernandes,18-11-2005,782648,Assam,21,18,4,21,64,Pass
Aarav Pillai,14-03-2006,860644,Assam,22,18,14,10,64,Pass
David Mehta,23-04-2006,921141,Assam,12,13,23,16,64,Pass
Ishaan Sharma,02-05-2006,645369,Assam,17,22,20,5,64,Pass
Aditya Fernandes,02-05-2006,990282,Assam,16,22,4,22,64,Pass
Vivaan Fernandes,21-11-2004,200322,Assam,21,12,6,24,63,Pass
Vivaan Singh,04-02-2005,513525,Assam,23,17,8,15,63,Pass
Aditya D'Souza,18-08-2005,447276,Assam,8,20,20,15,63,Pass
Aarav Chopra,11-10-2005,878390,Assam,10,10,20,23,63,Pass
Aditya Verma,03-02-2006,102679,Assam,13,10,17,23,63,Pass
Kunal Verma,20-01-2005,685401,Assam,9,24,6,23,62,Pass
Kunal Mehta,13-03-2005,550448,Assam,16,10,20,16,62,Pass
Aarav Singh,22-07-2005,777114,Assam,9,19,22,12,62,Pass
Vivaan D'Souza,01-08-2005,517407,Assam,16,18,15,13,62,Pass
Kunal Verma,11-08-2005,980490,Assam,9,13,20,20,62,Pass
Zaid Mehta,17-12-2005,274949,Assam,13,24,12,13,62,Pass
Aarav Verma,25-01-2006,698159,Assam,18,8,15,21,62,Pass
Yash D'Souza,08-04-2006,809376,Assam,13,16,15,18,62,Pass
Yash Verma,04-12-2004,398916,Assam,10,22,14,15,61,Pass
Aarav Pillai,28-12-2004,963677,Assam,15,19,20,7,61,Pass
Manpreet Khan,12-07-2005,257696,Assam,10,24,18,9,61,Pass
Ishaan Mehta,07-10-2005,636835,Assam,4,17,21,19,61,Pass
Paul Chopra,23-11-2005,497968,Assam,24,4,9,24,61,Pass
Raj Pillai,22-02-2006,564057,Assam,23,7,24,7,61,Pass
Rohan Reddy,14-04-2005,785350,Telangana,22,23,23,10,78,Pass
Raj Fernandes,04-10-2005,318037,Telangana,19,24,17,18,78,Pass
Raj Pillai,26-05-2005,568288,Telangana,14,18,20,17,69,Pass
Krishna Fernandes,31-08-2005,304667,Telangana,23,20,22,4,69,Pass
Ishaan Verma,09-10-2005,100086,Telangana,11,20,17,21,69,Pass
Aditya D'Souza,22-10-2005,147753,Telangana,13,18,24,14,69,Pass
Rohan Mehta,30-12-2005,622416,Telangana,20,22,18,9,69,Pass
Ishaan D'Souza,08-04-2006,995835,Telangana,23,15,18,13,69,Pass
Vivaan Mehta,04-12-2005,857752,Telangana,17,22,7,22,68,Pass
David Khan,25-03-2006,387624,Telangana,21,8,19,20,68,Pass
Aditya Khan,12-01-2005,560498,Telangana,18,7,24,18,67,Pass
Krishna Chopra,18-03-2005,777137,Telangana,16,24,21,6,67,Pass
Rohan D'Souza,05-10-2005,133580,Telangana,15,20,16,16,67,Pass
Aditya Sharma,22-11-2005,900565,Telangana,13,14,20,20,67,Pass
Peter D'Souza,04-03-2006,461724,Telangana,14,19,23,11,67,Pass
Kunal Verma,06-12-2004,858534,Telangana,18,23,7,18,66,Pass
Yash Fernandes,21-12-2004,518151,Telangana,18,21,20,7,66,Pass
Imran Fernandes,26-12-2004,187840,Telangana,20,4,22,20,66,Pass
Manpreet Pillai,29-12-2004,248426,Telangana,5,15,23,23,66,Pass
Manpreet Reddy,08-01-2005,367949,Telangana,22,4,22,18,66,Pass
Balbir Chopra,15-01-2005,641856,Telangana,16,10,21,19,66,Pass
Raj Mehta,26-04-2005,814662,Telangana,11,18,21,16,66,Pass
Manpreet Mehta,23-05-2005,446139,Telangana,7,16,23,20,66,Pass
John Pillai,10-10-2005,803452,Telangana,13,24,24,5,66,Pass
Aarav Singh,23-12-2005,569846,Telangana,21,18,20,7,66,Pass
David Mehta,20-01-2006,575205,Telangana,21,20,10,15,66,Pass
Aarav Chopra,05-03-2005,229190,Telangana,24,14,4,23,65,Pass
Aryan Sharma,16-06-2005,814250,Telangana,17,5,21,22,65,Pass
Balbir Chopra,17-06-2005,137368,Telangana,13,14,20,18,65,Pass
John Chopra,12-07-2005,414480,Telangana,24,11,15,15,65,Pass
Manpreet Singh,13-07-2005,495295,Telangana,15,23,6,21,65,Pass
Aditya Singh,16-08-2005,167145,Telangana,11,9,21,24,65,Pass
Aditya Verma,11-12-2005,947311,Telangana,14,18,18,15,65,Pass
Kunal Sharma,15-12-2005,213833,Telangana,24,16,11,14,65,Pass
John Pillai,28-02-2006,378020,Telangana,17,24,10,14,65,Pass
John Singh,27-03-2006,873336,Telangana,19,12,22,12,65,Pass
Aryan Singh,07-04-2006,956226,Telangana,23,18,10,14,65,Pass
Raj Reddy,26-03-2005,385442,Telangana,22,6,19,17,64,Pass
Aarav Fernandes,12-06-2005,831683,Telangana,16,15,14,19,64,Pass
Harjeet Chopra,13-06-2005,371174,Telangana,6,12,24,22,64,Pass
John Chopra,03-07-2005,818203,Telangana,15,18,16,15,64,Pass
Vivaan Khan,06-11-2005,468619,Telangana,16,18,6,24,64,Pass
Ishaan Sharma,28-11-2005,505364,Telangana,4,20,19,21,64,Pass
Rohan Chopra,22-12-2004,147759,Telangana,22,13,12,16,63,Pass
John Pillai,23-10-2005,726027,Telangana,10,23,24,6,63,Pass
Aarav Fernandes,19-01-2006,343188,Telangana,20,14,20,9,63,Pass
Aryan Khan,27-01-2006,676066,Telangana,7,9,24,23,63,Pass
Rohan Singh,03-02-2006,765838,Telangana,6,18,20,19,63,Pass
Raj Verma,11-03-2006,367604,Telangana,11,20,15,17,63,Pass
Manpreet Pillai,21-03-2006,923659,Telangana,23,23,5,12,63,Pass
Harjeet Sharma,01-05-2006,696620,Telangana,7,24,13,19,63,Pass
Paul Sharma,10-11-2004,877685,Telangana,10,20,19,13,62,Pass
David Khan,01-12-2004,714270,Telangana,20,10,14,18,62,Pass
Aarav Pillai,24-12-2004,330802,Telangana,11,23,14,14,62,Pass
Peter Sharma,20-01-2005,134232,Telangana,17,22,16,7,62,Pass
Balbir D'Souza,09-03-2005,135556,Telangana,13,15,14,20,62,Pass
Mathew Chopra,03-04-2005,924523,Telangana,20,9,22,11,62,Pass
Vivaan Fernandes,06-09-2005,762243,Telangana,9,15,20,18,62,Pass
Yash Khan,12-01-2006,770182,Telangana,8,11,20,23,62,Pass
Rehan Verma,07-02-2006,581381,Telangana,16,13,13,20,62,Pass
Harjeet D'Souza,05-04-2006,297657,Telangana,7,11,22,22,62,Pass
Krishna Verma,27-04-2006,612562,Telangana,17,20,14,11,62,Pass
Aryan Fernandes,10-11-2004,801799,Telangana,22,24,11,4,61,Pass
Krishna Sharma,12-02-2005,611317,Telangana,8,21,12,20,61,Pass
Ishaan Mehta,09-04-2005,938085,Telangana,15,18,14,14,61,Pass
Manpreet Khan,02-05-2005,846866,Telangana,6,14,18,23,61,Pass
Yash Pillai,03-05-2005,200745,Telangana,14,23,4,20,61,Pass
Vivaan D'Souza,01-07-2005,715281,Telangana,13,16,23,9,61,Pass
Aryan D'Souza,22-07-2005,157442,Telangana,8,11,23,19,61,Pass
Manpreet Reddy,03-12-2005,486176,Telangana,21,11,16,13,61,Pass
Kunal Fernandes,12-12-2005,926824,Telangana,15,10,21,15,61,Pass
Aditya Sharma,06-01-2006,550001,Telangana,9,8,23,21,61,Pass
Yash Pillai,09-02-2006,937135,Telangana,11,11,16,23,61,Pass
Aarav Pillai,26-02-2006,683733,Telangana,15,20,18,8,61,Pass
Raj Pillai,05-03-2006,444823,Telangana,16,24,10,11,61,Pass
Ishaan Singh,03-11-2005,638107,Chhattisgarh,23,24,24,18,89,Pass
Manpreet Mehta,31-01-2005,995898,Chhattisgarh,24,18,24,21,87,Pass
Gurpreet Khan,06-04-2005,396707,Chhattisgarh,20,22,19,24,85,Pass
Kunal Reddy,21-11-2005,712846,Chhattisgarh,20,20,23,21,84,Pass
Rohan Reddy,16-12-2004,474444,Chhattisgarh,18,20,23,18,79,Pass
Gurpreet Verma,19-02-2005,930450,Chhattisgarh,19,23,16,21,79,Pass
Aryan Mehta,02-05-2005,824825,Chhattisgarh,15,17,24,22,78,Pass
Paul Fernandes,06-09-2005,372122,Chhattisgarh,21,15,19,23,78,Pass
Vivaan Verma,16-03-2006,545972,Chhattisgarh,15,18,22,23,78,Pass
Rehan Reddy,28-12-2004,645533,Chhattisgarh,21,15,24,17,77,Pass
Aarav Singh,09-12-2005,328156,Chhattisgarh,17,18,18,24,77,Pass
Vivaan Khan,27-01-2005,213850,Chhattisgarh,24,6,23,23,76,Pass
Aryan Khan,03-02-2005,796470,Chhattisgarh,22,11,21,22,76,Pass
Harjeet Singh,14-04-2005,706092,Chhattisgarh,13,16,23,24,76,Pass
Yash Reddy,20-03-2006,879872,Chhattisgarh,16,22,23,15,76,Pass
Peter Chopra,05-04-2006,749493,Chhattisgarh,17,16,24,19,76,Pass
John D'Souza,19-04-2005,162615,Chhattisgarh,20,17,19,19,75,Pass
Sukhwinder Mehta,03-05-2005,798813,Chhattisgarh,22,11,21,20,74,Pass
Aryan Khan,27-10-2005,304688,Chhattisgarh,21,14,24,15,74,Pass
Balbir Mehta,21-11-2005,251964,Chhattisgarh,22,21,12,19,74,Pass
Raj Sharma,20-04-2005,782679,Chhattisgarh,17,23,24,9,73,Pass
Sukhwinder Singh,10-10-2005,720439,Chhattisgarh,14,17,21,21,73,Pass
Aryan Singh,03-12-2005,580350,Chhattisgarh,24,13,14,22,73,Pass
Rohan Verma,13-03-2006,639290,Chhattisgarh,22,24,8,19,73,Pass
Rohan Mehta,03-01-2005,352037,Chhattisgarh,21,17,20,14,72,Pass
Raj Sharma,06-04-2005,477647,Chhattisgarh,16,10,23,23,72,Pass
Aryan Sharma,28-04-2005,734181,Chhattisgarh,13,21,20,18,72,Pass
Sukhwinder Verma,20-06-2005,303885,Chhattisgarh,21,8,20,23,72,Pass
Rohan D'Souza,05-02-2006,940799,Chhattisgarh,17,17,16,22,72,Pass
Aditya Sharma,25-12-2004,235655,Chhattisgarh,20,5,23,23,71,Pass
Rehan Singh,02-01-2005,285215,Chhattisgarh,19,23,15,14,71,Pass
Raj Singh,27-03-2005,510611,Chhattisgarh,13,15,24,18,70,Pass
Peter Singh,19-11-2005,948535,Chhattisgarh,22,15,11,22,70,Pass
Manpreet Fernandes,26-03-2006,553308,Chhattisgarh,11,18,23,18,70,Pass
Aditya Mehta,30-11-2004,119324,Chhattisgarh,21,15,24,9,69,Pass
Yash Chopra,30-03-2005,487062,Chhattisgarh,21,18,20,10,69,Pass
Ishaan Chopra,13-05-2005,242328,Chhattisgarh,9,24,13,23,69,Pass
Raj D'Souza,09-07-2005,206928,Chhattisgarh,11,17,17,24,69,Pass
Gurpreet Khan,31-10-2005,930058,Chhattisgarh,11,21,16,21,69,Pass
Vivaan Khan,09-03-2005,393485,Chhattisgarh,18,19,11,20,68,Pass
Yash D'Souza,17-03-2005,117842,Chhattisgarh,11,24,17,16,68,Pass
Kunal Reddy,26-06-2005,675568,Chhattisgarh,15,15,16,22,68,Pass
Imran Fernandes,26-10-2005,368826,Chhattisgarh,18,16,23,11,68,Pass
Peter D'Souza,11-04-2006,184693,Chhattisgarh,21,18,16,13,68,Pass
David Reddy,10-04-2005,965170,Chhattisgarh,21,13,24,9,67,Pass
David D'Souza,17-05-2005,515465,Chhattisgarh,15,13,20,19,67,Pass
Farhan D'Souza,20-07-2005,429257,Chhattisgarh,24,12,10,21,67,Pass
Rohan Khan,10-08-2005,151175,Chhattisgarh,16,11,20,20,67,Pass
Balbir Mehta,08-10-2005,743499,Chhattisgarh,15,24,7,21,67,Pass
Ishaan Reddy,29-11-2004,537674,Chhattisgarh,23,17,17,9,66,Pass
Ishaan Sharma,03-01-2005,300359,Chhattisgarh,15,18,22,11,66,Pass
Ishaan Chopra,23-04-2005,863470,Chhattisgarh,15,22,5,24,66,Pass
Harjeet D'Souza,27-04-2005,249750,Chhattisgarh,8,22,17,19,66,Pass
Rohan Mehta,14-05-2005,826699,Chhattisgarh,23,17,4,22,66,Pass
Mathew Singh,19-07-2005,570505,Chhattisgarh,10,19,15,22,66,Pass
Sukhwinder Mehta,30-07-2005,385322,Chhattisgarh,19,16,9,22,66,Pass
Aarav Sharma,17-08-2005,395453,Chhattisgarh,24,19,14,9,66,Pass
Aditya Sharma,10-10-2005,856885,Chhattisgarh,20,17,21,8,66,Pass
Gurpreet Singh,11-11-2005,822365,Chhattisgarh,9,17,16,24,66,Pass
Balbir Pillai,17-01-2006,999244,Kerala,19,20,24,24,87,Pass
Manpreet Fernandes,02-04-2005,544655,Kerala,19,22,19,24,84,Pass
Kunal D'Souza,16-03-2005,164733,Kerala,13,20,24,14,71,Pass
Rohan Chopra,16-11-2004,154975,Kerala,21,22,15,9,67,Pass
Raj Khan,01-02-2005,469830,Kerala,20,9,21,17,67,Pass
Aditya Verma,13-12-2005,422264,Kerala,19,24,10,14,67,Pass
Imran Fernandes,06-02-2006,132486,Kerala,14,14,16,23,67,Pass
Aryan Chopra,11-03-2006,382646,Kerala,12,9,22,24,67,Pass
Kunal Fernandes,18-08-2005,323413,Kerala,20,16,18,12,66,Pass
Aditya Sharma,28-09-2005,483291,Kerala,11,23,12,20,66,Pass
Kunal Reddy,29-10-2005,466027,Kerala,19,20,5,22,66,Pass
Ishaan Verma,02-02-2006,112132,Kerala,20,17,9,20,66,Pass
Krishna Pillai,19-02-2006,831562,Kerala,12,11,22,21,66,Pass
Vivaan Singh,17-03-2005,228350,Kerala,7,19,21,18,65,Pass
Imran Singh,09-04-2005,137960,Kerala,15,19,16,15,65,Pass
Ishaan Fernandes,02-07-2005,577568,Kerala,17,21,16,11,65,Pass
Aryan Mehta,01-10-2005,342484,Kerala,9,18,18,20,65,Pass
Ishaan Fernandes,07-12-2005,260574,Kerala,18,22,5,20,65,Pass
Kunal Chopra,14-11-2004,383407,Kerala,20,10,24,10,64,Pass
Manpreet Verma,19-12-2004,942927,Kerala,7,17,24,16,64,Pass
Krishna Verma,02-01-2005,650153,Kerala,15,19,19,11,64,Pass
Yash Khan,23-04-2005,895749,Kerala,19,9,17,19,64,Pass
Ishaan Pillai,17-05-2005,501032,Kerala,23,16,4,21,64,Pass
Aryan Pillai,28-08-2005,216330,Kerala,17,14,21,12,64,Pass
Harjeet Pillai,03-09-2005,118172,Kerala,15,23,21,5,64,Pass
Peter Khan,08-09-2005,232579,Kerala,13,21,11,19,64,Pass
Rohan Sharma,02-11-2005,934229,Kerala,13,14,15,22,64,Pass
Balbir Verma,13-03-2006,110170,Kerala,14,13,15,22,64,Pass
John Chopra,20-03-2006,383723,Kerala,16,19,24,5,64,Pass
Manpreet Reddy,03-04-2006,261989,Kerala,20,24,6,14,64,Pass
Ishaan Reddy,03-07-2005,107263,Kerala,19,15,5,24,63,Pass
Aditya Mehta,08-07-2005,139296,Kerala,20,6,17,20,63,Pass
Krishna Pillai,30-07-2005,468062,Kerala,18,17,13,15,63,Pass
Gurpreet Reddy,11-09-2005,171401,Kerala,20,12,21,10,63,Pass
Sukhwinder Verma,07-11-2005,951001,Kerala,21,19,16,7,63,Pass
Harjeet Reddy,10-12-2005,672308,Kerala,16,12,19,16,63,Pass
Ishaan Singh,11-02-2006,643544,Kerala,4,22,17,20,63,Pass
Aarav Mehta,16-03-2006,373252,Kerala,19,18,9,17,63,Pass
Raj Mehta,08-12-2004,769115,Kerala,7,21,23,11,62,Pass
Sukhwinder Mehta,06-03-2005,167856,Kerala,24,15,11,12,62,Pass
Vivaan Reddy,13-04-2005,652909,Kerala,20,6,12,24,62,Pass
Paul Sharma,18-06-2005,711002,Kerala,16,19,19,8,62,Pass
Krishna Pillai,14-11-2005,320551,Kerala,23,19,12,8,62,Pass
Gurpreet Sharma,15-11-2005,844072,Kerala,4,15,19,24,62,Pass
Kunal Reddy,19-12-2004,795404,Kerala,20,23,7,11,61,Pass
Yash Verma,22-12-2004,578689,Kerala,4,22,23,12,61,Pass
Yash Khan,19-03-2005,925519,Kerala,9,14,23,15,61,Pass
Kunal Sharma,06-05-2005,307501,Kerala,24,11,14,12,61,Pass
Aarav Mehta,18-05-2005,547390,Kerala,6,19,13,23,61,Pass
Vivaan Pillai,20-07-2005,743978,Kerala,24,13,11,13,61,Pass
Aryan Sharma,20-07-2005,790708,Kerala,5,19,16,21,61,Pass
Sukhwinder Sharma,23-08-2005,975386,Kerala,7,11,19,24,61,Pass
Aryan Verma,29-08-2005,981722,Kerala,15,11,21,14,61,Pass
Raj Singh,21-09-2005,814108,Kerala,9,14,16,22,61,Pass
Zaid Fernandes,20-12-2005,987297,Kerala,13,20,24,4,61,Pass
Aryan Reddy,15-01-2006,277621,Kerala,16,16,17,12,61,Pass
Peter Fernandes,28-01-2006,236084,Kerala,21,6,21,13,61,Pass
Vivaan Pillai,26-03-2006,621585,Kerala,20,17,9,15,61,Pass
Ishaan Khan,28-04-2006,648681,Kerala,14,11,13,23,61,Pass
Aditya Mehta,18-10-2005,594310,Jammu & Kashmir + Ladakh,19,24,19,21,83,Pass
Krishna Chopra,19-05-2005,787267,Jammu & Kashmir + Ladakh,22,21,23,13,79,Pass
Gurpreet Sharma,23-11-2005,269675,Jammu & Kashmir + Ladakh,16,16,22,17,71,Pass
Krishna Fernandes,07-07-2005,671527,Jammu & Kashmir + Ladakh,20,22,13,15,70,Pass
Aryan Reddy,10-01-2006,206393,Jammu & Kashmir + Ladakh,23,11,19,17,70,Pass
Paul Pillai,09-04-2006,848375,Jammu & Kashmir + Ladakh,17,9,19,23,68,Pass
Krishna Pillai,14-03-2005,909990,Jammu & Kashmir + Ladakh,5,19,24,19,67,Pass
Aditya Khan,27-03-2005,804909,Jammu & Kashmir + Ladakh,8,12,23,24,67,Pass
Vivaan Fernandes,27-04-2005,755439,Jammu & Kashmir + Ladakh,15,15,15,22,67,Pass
Vivaan Khan,05-11-2005,361366,Jammu & Kashmir + Ladakh,23,22,10,12,67,Pass
Ayaan Chopra,15-11-2005,530501,Jammu & Kashmir + Ladakh,23,16,12,16,67,Pass
Rohan Pillai,21-11-2004,756384,Jammu & Kashmir + Ladakh,19,16,15,16,66,Pass
Krishna D'Souza,11-02-2005,717610,Jammu & Kashmir + Ladakh,12,13,17,24,66,Pass
Krishna Fernandes,03-03-2005,172864,Jammu & Kashmir + Ladakh,5,24,16,21,66,Pass
Rohan Sharma,09-03-2005,321644,Jammu & Kashmir + Ladakh,16,4,23,23,66,Pass
Ishaan D'Souza,29-04-2005,740840,Jammu & Kashmir + Ladakh,17,12,20,17,66,Pass
Yash Verma,26-06-2005,814317,Jammu & Kashmir + Ladakh,6,21,22,17,66,Pass
Zaid Pillai,01-07-2005,708954,Jammu & Kashmir + Ladakh,12,23,14,17,66,Pass
Ishaan Pillai,22-09-2005,642582,Jammu & Kashmir + Ladakh,14,10,20,22,66,Pass
Yash Pillai,19-11-2005,820439,Jammu & Kashmir + Ladakh,15,19,22,10,66,Pass
Aditya Sharma,06-12-2005,736532,Jammu & Kashmir + Ladakh,6,18,19,23,66,Pass
Vivaan Khan,08-02-2006,804498,Jammu & Kashmir + Ladakh,20,10,24,12,66,Pass
Rohan Mehta,18-02-2006,840801,Jammu & Kashmir + Ladakh,23,11,15,17,66,Pass
John Mehta,02-05-2006,200108,Jammu & Kashmir + Ladakh,21,24,17,4,66,Pass
Raj Mehta,22-07-2005,691441,Jammu & Kashmir + Ladakh,17,7,21,20,65,Pass
Raj Khan,04-10-2005,265676,Jammu & Kashmir + Ladakh,23,9,21,12,65,Pass
Ishaan D'Souza,08-10-2005,410201,Jammu & Kashmir + Ladakh,22,5,24,14,65,Pass
Ishaan Chopra,09-10-2005,803059,Jammu & Kashmir + Ladakh,22,10,9,24,65,Pass
Paul Mehta,30-11-2004,266564,Jammu & Kashmir + Ladakh,24,11,19,10,64,Pass
Rohan Verma,10-03-2005,772455,Jammu & Kashmir + Ladakh,14,21,15,14,64,Pass
Ishaan Fernandes,25-03-2005,324481,Jammu & Kashmir + Ladakh,14,7,22,21,64,Pass
Aditya Chopra,15-04-2005,440061,Jammu & Kashmir + Ladakh,20,13,7,24,64,Pass
Kunal Chopra,20-08-2005,835342,Jammu & Kashmir + Ladakh,9,14,19,22,64,Pass
Yash Sharma,25-11-2005,788332,Jammu & Kashmir + Ladakh,10,22,11,21,64,Pass
Yash Sharma,23-01-2006,600392,Jammu & Kashmir + Ladakh,12,18,20,14,64,Pass
Vivaan Chopra,20-04-2006,855153,Jammu & Kashmir + Ladakh,12,14,20,18,64,Pass
Aryan Reddy,12-12-2004,703458,Jammu & Kashmir + Ladakh,13,23,4,23,63,Pass
Rohan Khan,01-06-2005,699076,Jammu & Kashmir + Ladakh,24,19,13,7,63,Pass
Rohan Fernandes,21-03-2005,603965,Jammu & Kashmir + Ladakh,10,21,24,7,62,Pass
Vivaan Khan,02-05-2005,355786,Jammu & Kashmir + Ladakh,8,10,21,23,62,Pass
Rohan Singh,13-05-2005,218613,Jammu & Kashmir + Ladakh,24,9,18,11,62,Pass
Rohan Mehta,19-05-2005,461462,Jammu & Kashmir + Ladakh,18,12,14,18,62,Pass
Krishna Verma,04-06-2005,829965,Jammu & Kashmir + Ladakh,7,24,8,23,62,Pass
Vivaan Mehta,06-06-2005,473840,Jammu & Kashmir + Ladakh,17,19,21,5,62,Pass
Yash Fernandes,24-07-2005,411574,Jammu & Kashmir + Ladakh,20,19,16,7,62,Pass
Sukhwinder Fernandes,09-12-2005,429561,Jammu & Kashmir + Ladakh,8,23,9,22,62,Pass
Aditya Sharma,25-12-2005,700246,Jammu & Kashmir + Ladakh,15,21,22,4,62,Pass
Imran Mehta,31-03-2006,843428,Jammu & Kashmir + Ladakh,21,4,15,22,62,Pass
Raj Reddy,20-11-2004,183246,Jammu & Kashmir + Ladakh,12,9,21,19,61,Pass
Farhan Verma,19-12-2004,487934,Jammu & Kashmir + Ladakh,14,9,22,16,61,Pass
Vivaan Verma,21-01-2005,773824,Jammu & Kashmir + Ladakh,24,4,18,15,61,Pass
Peter Verma,31-01-2005,428481,Jammu & Kashmir + Ladakh,18,21,9,13,61,Pass
Raj Mehta,04-08-2005,707218,Jammu & Kashmir + Ladakh,13,23,12,13,61,Pass
Aditya Pillai,28-10-2005,296886,Jammu & Kashmir + Ladakh,13,23,4,21,61,Pass
Sukhwinder Chopra,13-11-2005,290985,Jammu & Kashmir + Ladakh,4,22,22,13,61,Pass
Kunal Sharma,14-11-2005,390711,Jammu & Kashmir + Ladakh,23,4,12,22,61,Pass
Aditya Verma,09-02-2006,836123,Jammu & Kashmir + Ladakh,4,22,21,14,61,Pass
Aditya Singh,04-03-2006,345451,Jammu & Kashmir + Ladakh,23,10,8,20,61,Pass
Balbir Sharma,22-02-2005,373382,Himachal Pradesh,21,21,20,22,84,Pass
Ishaan Sharma,04-01-2006,507155,Himachal Pradesh,21,18,21,24,84,Pass
Sukhwinder Chopra,09-01-2005,468387,Himachal Pradesh,13,22,17,24,76,Pass
Peter Chopra,18-06-2005,740137,Himachal Pradesh,10,24,22,15,71,Pass
Peter Fernandes,17-06-2005,527634,Himachal Pradesh,19,12,20,19,70,Pass
David Sharma,12-07-2005,503862,Himachal Pradesh,9,24,23,14,70,Pass
Manpreet Verma,05-03-2005,909332,Himachal Pradesh,18,20,7,22,67,Pass
Rohan Pillai,28-03-2005,456039,Himachal Pradesh,9,18,19,21,67,Pass
David D'Souza,07-09-2005,774942,Himachal Pradesh,22,5,16,24,67,Pass
Gurpreet Sharma,26-04-2006,850694,Himachal Pradesh,11,22,20,14,67,Pass
Aryan Khan,02-12-2004,860069,Himachal Pradesh,19,23,20,4,66,Pass
David D'Souza,08-08-2005,400712,Himachal Pradesh,16,11,21,18,66,Pass
Aarav Singh,04-12-2005,564431,Himachal Pradesh,11,21,20,14,66,Pass
Rehan Reddy,12-03-2006,681191,Himachal Pradesh,15,24,19,8,66,Pass
Aryan D'Souza,23-03-2005,573537,Himachal Pradesh,21,17,22,5,65,Pass
Aryan Singh,21-12-2005,257189,Himachal Pradesh,19,11,20,15,65,Pass
Ishaan Pillai,02-02-2006,946929,Himachal Pradesh,24,13,12,16,65,Pass
Paul Khan,05-04-2006,193800,Himachal Pradesh,17,17,17,14,65,Pass
Raj Reddy,21-01-2005,990593,Himachal Pradesh,20,8,13,23,64,Pass
Yash Mehta,17-03-2005,595278,Himachal Pradesh,6,17,20,21,64,Pass
Rohan Sharma,27-06-2005,768368,Himachal Pradesh,9,19,23,13,64,Pass
Krishna Reddy,05-11-2005,265588,Himachal Pradesh,15,12,24,13,64,Pass
Paul Sharma,02-01-2006,735646,Himachal Pradesh,16,15,16,17,64,Pass
Vivaan Reddy,06-03-2006,771431,Himachal Pradesh,8,12,22,22,64,Pass
Aarav Pillai,26-04-2006,190296,Himachal Pradesh,13,8,20,23,64,Pass
Yash D'Souza,12-12-2004,105194,Himachal Pradesh,17,4,21,21,63,Pass
Sukhwinder Singh,06-02-2005,723229,Himachal Pradesh,21,10,17,15,63,Pass
Krishna Khan,14-02-2005,182544,Himachal Pradesh,6,23,19,15,63,Pass
Aarav Reddy,25-04-2005,852462,Himachal Pradesh,24,5,13,21,63,Pass
Zaid Chopra,09-07-2005,231481,Himachal Pradesh,13,8,19,23,63,Pass
Krishna Mehta,16-02-2006,373021,Himachal Pradesh,12,22,20,9,63,Pass
Balbir Sharma,08-03-2006,423394,Himachal Pradesh,19,13,11,20,63,Pass
Raj Singh,21-12-2004,596344,Himachal Pradesh,22,13,16,11,62,Pass
Yash Mehta,25-01-2005,690680,Himachal Pradesh,13,10,24,15,62,Pass
Yash Pillai,24-03-2005,378560,Himachal Pradesh,13,16,11,22,62,Pass
Manpreet Chopra,11-05-2005,244894,Himachal Pradesh,10,18,10,24,62,Pass
Kunal Verma,27-05-2005,964353,Himachal Pradesh,10,15,23,14,62,Pass
Aryan Sharma,01-03-2006,280964,Himachal Pradesh,11,17,11,23,62,Pass
Gurpreet Singh,05-03-2006,326733,Himachal Pradesh,23,5,14,20,62,Pass
Vivaan Chopra,08-04-2006,898176,Himachal Pradesh,18,17,12,15,62,Pass
Gurpreet Mehta,18-11-2004,290341,Himachal Pradesh,13,14,15,19,61,Pass
Balbir Singh,09-07-2005,772773,Himachal Pradesh,16,18,11,16,61,Pass
David Reddy,01-09-2005,707052,Himachal Pradesh,10,18,18,15,61,Pass
Aryan Singh,28-09-2005,898751,Himachal Pradesh,11,14,22,14,61,Pass
Aarav Fernandes,06-11-2005,818533,Himachal Pradesh,10,21,14,16,61,Pass
Vivaan Sharma,19-12-2005,719405,Himachal Pradesh,5,16,23,17,61,Pass
Mathew Pillai,16-03-2006,827716,Himachal Pradesh,20,21,7,13,61,Pass
Aarav Chopra,06-05-2006,854491,Himachal Pradesh,4,12,24,21,61,Pass
Aryan Sharma,19-01-2005,885380,Himachal Pradesh,20,7,21,12,60,Pass
Rohan Mehta,13-05-2005,292397,Himachal Pradesh,10,10,23,17,60,Pass
Manpreet Reddy,04-09-2005,177457,Himachal Pradesh,24,7,16,13,60,Pass
Rohan Chopra,26-11-2005,151290,Himachal Pradesh,18,13,6,23,60,Pass
Sukhwinder Chopra,02-03-2005,982484,Himachal Pradesh,17,13,11,18,59,Pass
Aarav Singh,13-03-2005,331362,Himachal Pradesh,17,9,23,10,59,Pass
Yash Mehta,08-02-2006,950297,Himachal Pradesh,17,19,18,5,59,Pass
David Chopra,13-03-2006,615681,Himachal Pradesh,19,10,20,10,59,Pass
Rohan Mehta,23-12-2004,185029,Gujarat,21,24,24,22,91,Pass
Balbir Verma,21-02-2006,483218,Gujarat,22,20,22,22,86,Pass
Balbir D'Souza,03-10-2005,316139,Gujarat,23,17,22,23,85,Pass
Aditya Sharma,08-04-2006,104611,Gujarat,24,16,22,23,85,Pass
Yash Verma,12-04-2006,734198,Gujarat,22,19,21,23,85,Pass
Vivaan Chopra,01-04-2005,496476,Gujarat,23,21,21,19,84,Pass
Farhan Singh,12-12-2005,930423,Gujarat,17,21,23,23,84,Pass
Sukhwinder Khan,17-02-2006,978161,Gujarat,22,22,17,22,83,Pass
Ishaan Pillai,07-03-2005,338741,Gujarat,22,19,21,20,82,Pass
Aarav Reddy,21-02-2006,864459,Gujarat,16,20,22,21,79,Pass
Aditya D'Souza,29-12-2004,553333,Gujarat,14,20,22,22,78,Pass
Ishaan Khan,16-01-2006,803785,Gujarat,18,14,22,24,78,Pass
Harjeet Chopra,14-03-2006,232459,Gujarat,14,22,21,21,78,Pass
Ishaan Reddy,06-02-2005,302883,Gujarat,23,17,17,20,77,Pass
Aryan Chopra,31-10-2005,388495,Gujarat,10,21,24,22,77,Pass
Rohan Sharma,14-11-2005,732028,Gujarat,22,20,23,12,77,Pass
Yash Chopra,20-06-2005,454275,Gujarat,22,24,14,16,76,Pass
Rohan Mehta,07-02-2005,403996,Gujarat,24,20,12,19,75,Pass
Mathew Pillai,09-12-2005,433726,Gujarat,19,24,14,18,75,Pass
Paul Chopra,14-12-2005,225322,Gujarat,12,21,19,23,75,Pass
Mathew Pillai,04-04-2006,903451,Gujarat,19,23,15,18,75,Pass
Peter Singh,04-05-2006,862829,Gujarat,16,18,18,22,74,Pass
Aditya Mehta,05-08-2005,258906,Gujarat,24,17,17,15,73,Pass
Yash Chopra,28-12-2005,520575,Gujarat,14,22,15,22,73,Pass
Aditya Verma,26-03-2006,788600,Gujarat,23,14,21,15,73,Pass
Raj Reddy,01-12-2004,694573,Gujarat,13,22,23,14,72,Pass
Vivaan Reddy,07-12-2004,446828,Gujarat,24,20,23,5,72,Pass
Paul Pillai,31-01-2005,888443,Gujarat,24,15,18,15,72,Pass
Rohan Singh,31-03-2006,262461,Gujarat,21,16,21,14,72,Pass
Aarav Fernandes,31-12-2004,887698,Gujarat,18,16,21,16,71,Pass
Rohan Singh,15-01-2005,713230,Gujarat,22,20,17,12,71,Pass
Aryan Singh,18-07-2005,922656,Gujarat,12,24,21,14,71,Pass
Yash Verma,08-08-2005,244526,Gujarat,20,14,15,22,71,Pass
Farhan Fernandes,21-11-2004,593231,Gujarat,11,19,19,21,70,Pass
Yash Chopra,09-04-2005,596707,Gujarat,23,20,10,17,70,Pass
Krishna Khan,05-04-2006,283214,Gujarat,7,23,17,23,70,Pass
Harjeet Fernandes,21-07-2005,901305,Gujarat,18,21,6,24,69,Pass
Yash Fernandes,24-02-2005,353788,Gujarat,18,20,20,10,68,Pass
Ishaan Fernandes,15-03-2005,501206,Gujarat,18,18,9,23,68,Pass
Gurpreet Fernandes,23-12-2005,826547,Gujarat,11,23,12,22,68,Pass
Manpreet Khan,10-01-2006,384984,Gujarat,19,20,20,9,68,Pass
Raj Chopra,17-01-2006,581815,Gujarat,20,13,14,21,68,Pass
Raj Chopra,04-04-2005,729266,Gujarat,11,18,22,16,67,Pass
Harjeet Singh,19-04-2005,217249,Gujarat,12,20,18,17,67,Pass
Rohan Reddy,23-05-2005,474716,Gujarat,20,10,22,15,67,Pass
Aryan Verma,24-06-2005,761069,Gujarat,20,21,5,21,67,Pass
Ishaan Verma,31-07-2005,421366,Gujarat,21,16,20,10,67,Pass
Aditya D'Souza,09-09-2005,922295,Gujarat,21,7,21,18,67,Pass
Peter Mehta,09-10-2005,925651,Gujarat,22,20,9,16,67,Pass
Aryan Khan,10-11-2004,704186,Gujarat,21,8,15,22,66,Pass
Rehan Sharma,10-02-2005,176558,Gujarat,12,24,6,24,66,Pass
Ishaan Verma,03-07-2005,154022,Gujarat,6,23,21,16,66,Pass
Harjeet Singh,02-09-2005,795049,Gujarat,18,24,8,16,66,Pass
Manpreet Verma,05-04-2006,619793,Gujarat,15,15,24,12,66,Pass
Manpreet Mehta,03-03-2005,189111,Delhi,21,21,20,21,83,Pass
Rohan Mehta,01-04-2005,207489,Delhi,24,16,19,24,83,Pass
Yash Khan,16-02-2006,282925,Delhi,14,23,20,22,79,Pass
Vivaan Mehta,29-12-2004,708596,Delhi,24,23,7,24,78,Pass
Zaid Chopra,23-08-2005,768680,Delhi,9,24,21,24,78,Pass
Rehan Pillai,29-12-2005,511591,Delhi,13,17,24,24,78,Pass
Peter Verma,24-12-2004,653592,Delhi,16,19,22,20,77,Pass
David Reddy,03-03-2006,422910,Delhi,22,24,23,8,77,Pass
Ishaan Sharma,20-04-2006,404542,Delhi,21,23,19,14,77,Pass
Kunal Chopra,16-02-2006,972226,Delhi,21,24,20,11,76,Pass
Raj D'Souza,07-11-2004,291933,Delhi,19,12,19,24,74,Pass
Ayaan D'Souza,30-01-2005,134444,Delhi,15,18,22,19,74,Pass
Kunal D'Souza,16-11-2005,937675,Delhi,23,24,12,15,74,Pass
Aryan Verma,30-09-2005,392953,Delhi,14,16,20,23,73,Pass
Aryan Sharma,02-12-2005,322885,Delhi,19,24,19,11,73,Pass
Kunal D'Souza,19-02-2006,631089,Delhi,18,19,14,22,73,Pass
Krishna Chopra,16-04-2005,824228,Delhi,16,16,19,21,72,Pass
Vivaan Khan,07-11-2005,775489,Delhi,17,17,23,15,72,Pass
Aditya Reddy,13-02-2005,224781,Delhi,5,22,21,23,71,Pass
Vivaan Fernandes,19-02-2005,983076,Delhi,20,17,11,22,70,Pass
Harjeet Reddy,02-09-2005,986334,Delhi,13,16,19,21,69,Pass
Vivaan D'Souza,08-03-2006,923561,Delhi,16,20,14,19,69,Pass
Ishaan Sharma,30-03-2005,929577,Delhi,16,17,13,22,68,Pass
Ishaan Reddy,09-10-2005,416403,Delhi,21,10,18,19,68,Pass
Aryan Sharma,15-01-2006,246714,Delhi,12,20,15,21,68,Pass
Aditya Reddy,14-04-2006,276265,Delhi,15,12,19,22,68,Pass
Aarav Reddy,03-08-2005,604230,Delhi,16,15,19,17,67,Pass
Yash Pillai,23-08-2005,538481,Delhi,14,24,10,19,67,Pass
Krishna Fernandes,08-12-2005,699989,Delhi,12,18,17,20,67,Pass
Raj Chopra,15-08-2005,574466,Uttarakhand,5,16,22,24,67,Pass
Aryan Pillai,27-08-2005,554532,Uttarakhand,5,15,24,18,62,Pass
Aryan Khan,14-11-2004,829047,Uttarakhand,11,14,13,12,50,Pass
Vivaan Khan,14-06-2005,693400,Uttarakhand,19,8,15,8,50,Pass
Krishna Chopra,03-09-2005,214717,Uttarakhand,9,12,8,21,50,Pass
Gurpreet Singh,13-12-2005,354433,Uttarakhand,13,14,14,9,50,Pass
Aditya Pillai,24-01-2006,741756,Uttarakhand,9,5,19,17,50,Pass
David Mehta,02-03-2006,483452,Uttarakhand,10,9,14,17,50,Pass
Sukhwinder Reddy,13-04-2006,453007,Uttarakhand,17,15,8,10,50,Pass
Yash Sharma,16-04-2005,373912,Uttarakhand,16,9,16,8,49,Pass
Harjeet Mehta,21-09-2005,451487,Uttarakhand,4,19,13,13,49,Pass
Manpreet Verma,19-02-2006,801983,Uttarakhand,16,8,13,12,49,Pass
Paul Verma,15-03-2006,939970,Uttarakhand,6,11,11,21,49,Pass
Harjeet Reddy,08-11-2004,700760,Uttarakhand,16,14,10,8,48,Pass
Krishna Chopra,08-07-2005,221284,Uttarakhand,20,11,10,7,48,Pass
Kunal Mehta,06-03-2006,297387,Uttarakhand,6,15,16,11,48,Pass
Rohan Khan,14-02-2005,238098,Uttarakhand,16,9,5,17,47,Pass
Yash Verma,20-06-2005,210675,Uttarakhand,5,13,11,18,47,Pass
Ishaan Verma,14-07-2005,434164,Uttarakhand,10,4,11,22,47,Pass
Vivaan Fernandes,12-09-2005,189432,Uttarakhand,6,18,8,15,47,Pass
Krishna Pillai,17-09-2005,474123,Uttarakhand,10,9,18,10,47,Pass
Vivaan Verma,07-04-2006,926258,Uttarakhand,7,20,8,12,47,Pass
Ishaan Singh,18-04-2005,468152,Meghalaya,19,23,18,20,80,Pass
Peter Mehta,07-11-2005,452231,Meghalaya,14,22,19,24,79,Pass
Aryan D'Souza,25-10-2005,162434,Meghalaya,23,24,20,11,78,Pass
Sukhwinder Mehta,07-02-2006,671676,Meghalaya,21,19,21,17,78,Pass
Krishna Verma,08-08-2005,375363,Meghalaya,24,22,20,11,77,Pass
Paul Fernandes,11-01-2006,907494,Meghalaya,16,24,24,10,74,Pass
Krishna D'Souza,22-10-2005,108449,Meghalaya,22,21,16,7,66,Pass
Rohan Singh,25-03-2006,238978,Meghalaya,24,7,15,15,61,Pass
Raj Verma,23-12-2004,335984,Meghalaya,18,14,6,22,60,Pass
Krishna Singh,22-01-2006,750049,Meghalaya,5,23,20,12,60,Pass
Kunal Chopra,27-04-2005,840526,Meghalaya,6,14,21,18,59,Pass
Aarav Verma,05-12-2004,964335,Meghalaya,7,19,9,23,58,Pass
Vivaan D'Souza,26-08-2005,612745,Meghalaya,23,22,6,7,58,Pass
Manpreet D'Souza,10-12-2004,355653,Meghalaya,16,10,21,10,57,Pass
Krishna Khan,05-01-2006,586956,Meghalaya,24,12,12,9,57,Pass
Krishna Reddy,27-11-2005,258849,Meghalaya,12,18,18,8,56,Pass
Aryan Khan,20-02-2006,775601,Meghalaya,24,21,5,5,55,Pass
David Pillai,10-08-2005,362766,Andaman & Nicobar,20,10,24,19,73,Pass
Aditya Singh,15-10-2005,253702,Andaman & Nicobar,23,19,6,15,63,Pass
Raj D'Souza,10-10-2005,511500,Andaman & Nicobar,18,18,4,17,57,Pass
Raj Pillai,25-11-2004,320846,Andaman & Nicobar,13,16,20,7,56,Pass
Manpreet Pillai,27-12-2004,213033,Andaman & Nicobar,16,9,23,4,52,Pass
Yash Reddy,04-02-2005,923630,Andaman & Nicobar,5,20,16,10,51,Pass
Rohan Pillai,02-08-2005,287773,Andaman & Nicobar,11,4,12,24,51,Pass
Aryan Chopra,07-03-2005,262045,Andaman & Nicobar,16,4,20,10,50,Pass
Krishna Reddy,29-06-2005,854774,Andaman & Nicobar,7,20,17,6,50,Pass
Sukhwinder Mehta,19-09-2005,549753,Andaman & Nicobar,17,4,5,22,48,Pass
Raj Chopra,29-06-2005,448795,Andaman & Nicobar,4,14,23,6,47,Pass
John Chopra,21-09-2005,880268,Andaman & Nicobar,4,22,7,14,47,Pass
Aditya Chopra,12-11-2004,843737,Andaman & Nicobar,19,6,6,15,46,Pass
Aarav Pillai,13-12-2005,743001,Andaman & Nicobar,9,14,7,16,46,Pass
Paul Fernandes,25-10-2005,219236,Manipur,4,20,23,24,71,Pass
Krishna Pillai,22-04-2006,384211,Manipur,4,15,24,21,64,Pass
Raj Chopra,05-05-2005,490927,Manipur,4,20,19,19,62,Pass
Paul D'Souza,06-10-2005,296314,Manipur,4,21,22,15,62,Pass
David Mehta,10-04-2005,391901,Manipur,4,24,13,18,59,Pass
Vivaan Mehta,25-12-2004,238284,Manipur,4,22,24,8,58,Pass
Raj Khan,03-04-2005,300249,Manipur,4,21,22,11,58,Pass
Aryan D'Souza,11-08-2005,902268,Manipur,4,23,14,17,58,Pass
Krishna Pillai,11-12-2005,983538,Manipur,4,17,24,13,58,Pass
Krishna Fernandes,05-02-2006,917704,Manipur,4,21,24,9,58,Pass
Sukhwinder Verma,27-04-2005,270015,Manipur,4,9,21,22,56,Pass
Krishna Chopra,13-03-2006,558493,Manipur,4,18,23,11,56,Pass
Rohan Sharma,26-03-2005,310563,Nagaland,19,24,21,23,87,Pass
Ishaan Sharma,09-03-2006,908895,Nagaland,24,14,21,18,77,Pass
Aarav Pillai,25-03-2006,906500,Nagaland,24,24,4,24,76,Pass
Vivaan Chopra,15-04-2006,887041,Nagaland,19,17,22,18,76,Pass
Paul Reddy,05-01-2006,582359,Nagaland,7,14,16,8,45,Pass
Krishna Sharma,04-06-2005,299287,Nagaland,16,6,8,12,42,Pass
Aditya Khan,23-03-2006,627455,Nagaland,14,8,14,6,42,Pass
Krishna Singh,16-09-2005,416488,Nagaland,5,6,11,19,41,Pass
Ishaan Singh,19-12-2005,277627,Nagaland,9,15,9,8,41,Pass
Ishaan Pillai,19-03-2005,378324,Sikkim,22,15,9,13,59,Pass
Yash D'Souza,14-04-2005,874267,Sikkim,12,14,23,10,59,Pass
Yash Pillai,03-09-2005,279681,Sikkim,22,20,6,10,58,Pass
Zaid Fernandes,29-03-2006,996983,Sikkim,22,19,5,12,58,Pass
Rohan Chopra,04-03-2005,816753,Sikkim,20,5,22,8,55,Pass
David Mehta,02-10-2005,935273,Sikkim,4,19,11,12,46,Pass
Raj Singh,23-03-2006,249078,Sikkim,17,5,14,8,44,Pass
Gurpreet Singh,03-04-2006,473060,Sikkim,10,5,4,24,43,Pass
Mathew Verma,02-05-2005,566582,Mizoram,18,23,24,15,80,Pass
Manpreet Pillai,19-05-2005,754886,Mizoram,9,8,13,14,44,Pass
Kunal Sharma,22-04-2006,117156,Mizoram,4,6,10,24,44,Pass
John Fernandes,19-07-2005,600186,Mizoram,8,11,17,7,43,Pass
Raj Sharma,13-07-2005,694734,Mizoram,6,5,11,19,41,Pass
Aditya Mehta,20-09-2005,285122,Mizoram,19,4,8,10,41,Pass
Mathew Chopra,19-11-2004,597112,Mizoram,5,24,5,5,39,Pass
Rohan D'Souza,25-06-2005,220553,Mizoram,23,4,6,6,39,Pass
Harjeet Verma,23-09-2005,266322,Arunachal Pradesh,11,6,23,21,61,Pass
Balbir D'Souza,07-01-2005,395925,Arunachal Pradesh,7,5,22,24,58,Pass
Aarav Mehta,11-11-2005,394011,Arunachal Pradesh,12,6,16,23,57,Pass
Kunal Mehta,22-04-2005,582195,Arunachal Pradesh,12,9,14,17,52,Pass
Harjeet D'Souza,22-03-2006,122870,Arunachal Pradesh,13,7,16,16,52,Pass
Harjeet Chopra,23-04-2005,509829,Arunachal Pradesh,11,8,16,16,51,Pass
Yash Mehta,18-02-2006,601799,Arunachal Pradesh,9,9,9,24,51,Pass
Sukhwinder Chopra,25-05-2005,814057,Puducherry,13,23,20,24,80,Pass
Aryan Reddy,25-08-2005,349082,Puducherry,24,22,6,22,74,Pass
Sukhwinder Reddy,13-11-2004,826767,Puducherry,16,24,7,11,58,Pass
Krishna Khan,13-04-2005,785819,Puducherry,24,5,11,13,53,Pass
Kunal Fernandes,26-10-2005,660533,Puducherry,16,12,18,7,53,Pass
Aditya Reddy,21-04-2005,647201,Puducherry,24,17,5,6,52,Pass
Kunal Singh,21-09-2005,880151,Puducherry,6,5,20,12,43,Pass
Yash Khan,16-11-2004,419362,Tripura,20,12,23,23,78,Pass
Mathew D'Souza,12-08-2005,356422,Tripura,22,20,16,17,75,Pass
Aarav Pillai,22-11-2005,622986,Tripura,21,24,11,16,72,Pass
Rehan Sharma,02-09-2005,604161,Tripura,24,8,24,10,66,Pass
Gurpreet Mehta,09-04-2005,385973,Tripura,18,13,10,24,65,Pass
Sukhwinder Verma,05-05-2005,879440,Tripura,19,20,7,19,65,Pass
Aryan Mehta,18-11-2005,490520,Daman & Diu / D&N Haveli,9,9,8,16,42,Pass
Krishna D'Souza,30-04-2005,113262,Daman & Diu / D&N Haveli,5,9,18,6,38,Pass
David Sharma,03-04-2005,918004,Daman & Diu / D&N Haveli,7,6,5,18,36,Pass
Sukhwinder Mehta,25-04-2005,194569,Daman & Diu / D&N Haveli,9,9,11,7,36,Pass
Yash Mehta,31-12-2004,743087,Daman & Diu / D&N Haveli,7,9,6,12,34,Pass
John D'Souza,30-11-2004,935847,Daman & Diu / D&N Haveli,8,9,9,7,33,Pass
Rohan Pillai,01-11-2005,124686,Goa,5,18,13,4,40,Pass
Gurpreet Singh,11-01-2005,545073,Goa,6,15,5,12,38,Pass
Harjeet Mehta,23-04-2005,152613,Goa,9,7,5,17,38,Pass
