Candidate Name,DOB,Registration Number,State,Maths,Physics,English,GK,Total Marks,PFT
Yash Khan,25-09-2005,671944,Jharkhand,3,5,13,5,26,Pass
Ishaan Khan,04-01-2005,836114,Himachal Pradesh,0,5,22,17,44,Pass
Paul Mehta,24-11-2005,296684,Uttar Pradesh,7,5,15,17,44,Pass
Yash Sharma,29-06-2005,159591,Kerala,21,8,10,2,41,Pass
Rohan D'Souza,15-03-2006,840095,Tamil Nadu,19,13,10,1,43,Pass
Ishaan Verma,04-04-2005,180555,Odisha,5,17,5,8,35,Pass
Peter Sharma,03-05-2005,782979,Uttar Pradesh,22,9,6,7,44,Pass
Aarav Verma,02-02-2006,585042,Karnataka,17,21,13,2,53,Pass
Balbir Sharma,27-04-2005,803980,Gujarat,5,6,0,0,11,Pass
Aditya Pillai,19-12-2005,108834,Uttar Pradesh,19,9,18,12,58,Pass
Yash Mehta,22-10-2005,924427,Haryana,10,8,6,0,24,Pass
Ishaan Fernandes,10-10-2005,222497,Bihar,16,20,9,0,45,Pass
Aryan D'Souza,25-03-2005,499433,Madhya Pradesh,14,7,24,0,45,Pass
Krishna Chopra,05-02-2005,788045,Odisha,7,16,7,8,38,Pass
Krishna Chopra,31-10-2005,905035,Maharashtra,3,18,13,19,53,Pass
Rohan Singh,21-02-2005,134509,Maharashtra,0,9,11,14,34,Pass
Sukhwinder Singh,17-02-2006,580551,Punjab,23,6,20,2,51,Pass
Gurpreet Chopra,26-10-2005,384755,Andhra Pradesh,2,4,24,19,49,Pass
Manpreet Khan,23-03-2005,335533,Bihar,14,20,7,18,59,Pass
Aarav Pillai,05-04-2005,619020,Andhra Pradesh,12,14,9,10,45,Pass
Vivaan Khan,09-01-2005,548595,Jharkhand,3,7,6,10,26,Pass
Yash Khan,01-07-2005,101660,Telangana,23,2,19,7,51,Pass
Aditya Fernandes,27-03-2006,408783,Tamil Nadu,6,9,4,9,28,Pass
Vivaan Mehta,14-03-2006,446126,Bihar,14,22,6,23,65,Pass
Aditya Reddy,06-11-2005,142449,Uttar Pradesh,3,9,17,22,51,Pass
Aditya Fernandes,30-01-2006,105236,Andhra Pradesh,15,11,11,9,46,Pass
Zaid Khan,20-11-2004,789100,Rajasthan,3,12,9,12,36,Pass
Raj Sharma,12-04-2005,803924,Uttar Pradesh,7,9,1,12,29,Pass
Balbir Reddy,18-09-2005,548757,Jharkhand,10,24,6,19,59,Pass
Gurpreet Fernandes,03-03-2006,241997,Bihar,7,1,24,3,35,Pass
Vivaan D'Souza,29-10-2005,614599,Gujarat,7,7,6,5,25,Pass
Aditya Fernandes,07-05-2006,903251,Telangana,13,6,20,15,54,Pass
John Reddy,07-04-2005,811907,Bihar,6,0,10,13,29,Pass
Aryan Singh,17-03-2005,690865,Chhattisgarh,13,4,4,23,44,Pass
Farhan Chopra,20-01-2006,733035,Rajasthan,22,12,15,22,71,Pass
Aarav Reddy,05-01-2005,330505,Telangana,3,22,16,5,46,Pass
Zaid Singh,06-01-2005,361031,Kerala,16,17,0,23,56,Pass
Kunal Verma,02-12-2005,773836,Rajasthan,12,6,0,21,39,Pass
Sukhwinder D'Souza,21-02-2005,616246,Rajasthan,19,23,1,12,55,Pass
Kunal Mehta,09-03-2006,209225,Tamil Nadu,20,22,23,23,88,Pass
Kunal D'Souza,30-08-2005,452486,Uttarakhand,3,23,13,14,53,Pass
Raj Fernandes,05-10-2005,452684,Uttar Pradesh,7,9,1,19,36,Pass
Zaid Verma,24-10-2005,239102,Bihar,11,0,24,9,44,Pass
Krishna Khan,02-12-2004,862301,Madhya Pradesh,1,22,23,24,70,Pass
Krishna Verma,19-03-2006,808554,Punjab,3,8,14,20,45,Pass
Ishaan Khan,23-01-2005,395974,Bihar,14,15,8,5,42,Pass
Kunal Reddy,20-01-2005,987148,Punjab,11,16,9,8,44,Pass
David Sharma,20-04-2006,547671,Bihar,5,18,5,10,38,Pass
Rohan Verma,23-12-2004,696398,Chhattisgarh,23,5,3,12,43,Pass
John Reddy,27-10-2005,800289,Jammu & Kashmir + Ladakh,23,4,3,3,33,Pass
Raj D'Souza,14-11-2005,804021,Rajasthan,18,15,23,3,59,Pass
Aarav Verma,30-04-2005,401637,Uttar Pradesh,14,9,9,13,45,Pass
Ayaan Mehta,08-07-2005,481658,Uttar Pradesh,7,9,10,2,28,Pass
Aryan Pillai,22-05-2005,432791,Jammu & Kashmir + Ladakh,17,10,13,1,41,Pass
Ishaan Reddy,14-04-2005,394498,Maharashtra,12,9,11,9,41,Pass
Kunal Mehta,09-02-2006,388054,Rajasthan,0,24,2,3,29,Pass
Gurpreet Mehta,25-07-2005,931511,West Bengal,21,7,13,8,49,Pass
Yash Reddy,20-06-2005,331281,Karnataka,14,5,15,10,44,Pass
Peter Sharma,10-01-2005,952103,Maharashtra,6,1,13,6,26,Pass
David Verma,26-01-2006,636587,Tamil Nadu,13,19,0,2,34,Pass
Krishna Khan,16-11-2004,270001,Rajasthan,12,19,5,16,52,Pass
Vivaan Fernandes,14-09-2005,603521,West Bengal,3,23,16,20,62,Pass
Aarav Pillai,31-12-2004,474249,Andhra Pradesh,21,7,0,19,47,Pass
John Khan,03-03-2006,958145,West Bengal,5,16,7,11,39,Pass
Mathew Chopra,28-08-2005,369367,West Bengal,16,11,3,15,45,Pass
Kunal Singh,01-03-2006,398248,Himachal Pradesh,21,16,3,21,61,Pass
Balbir Verma,05-03-2005,788874,Karnataka,24,21,2,10,57,Pass
Raj D'Souza,22-05-2005,262653,Tamil Nadu,4,4,23,2,33,Pass
Ishaan Mehta,03-07-2005,708523,Tamil Nadu,5,23,10,4,42,Pass
Yash Verma,07-04-2005,870964,Punjab,15,9,10,15,49,Pass
Ishaan Singh,07-03-2005,172586,West Bengal,3,16,18,19,56,Pass
Kunal D'Souza,14-08-2005,417624,Rajasthan,19,9,8,7,43,Pass
Rohan Khan,26-04-2005,522161,Tamil Nadu,13,18,5,9,45,Pass
Yash Mehta,16-04-2006,283688,Uttar Pradesh,17,9,3,4,33,Pass
Kunal Pillai,07-12-2004,964263,Uttarakhand,3,0,16,21,40,Pass
Balbir Verma,12-02-2006,348868,Uttar Pradesh,9,9,22,14,54,Pass
Aditya Sharma,01-01-2006,192749,Madhya Pradesh,4,19,12,18,53,Pass
Gurpreet Sharma,15-09-2005,157540,Madhya Pradesh,3,6,5,3,17,Pass
Raj Verma,15-08-2005,496019,Bihar,0,2,22,21,45,Pass
Mathew Mehta,30-03-2006,297370,Maharashtra,13,1,16,3,33,Pass
Raj Mehta,29-09-2005,249384,Uttar Pradesh,9,9,7,14,39,Pass
Krishna Reddy,08-11-2005,741170,Karnataka,5,11,11,14,41,Pass
Manpreet Verma,17-01-2005,116718,Punjab,7,18,10,22,57,Pass
Aarav D'Souza,25-04-2005,997896,Haryana,9,19,3,15,46,Pass
Ishaan Mehta,09-11-2005,214493,Maharashtra,6,1,18,24,49,Pass
Peter Verma,02-02-2005,508458,Haryana,2,21,22,23,68,Pass
Manpreet Pillai,05-03-2006,902191,Uttar Pradesh,15,9,3,14,41,Pass
Paul Mehta,25-12-2005,681690,Maharashtra,9,14,1,12,36,Pass
Harjeet Reddy,03-11-2005,619804,Maharashtra,6,22,21,2,51,Pass
Manpreet Reddy,26-01-2005,548270,Uttarakhand,3,7,8,17,35,Pass
Krishna Chopra,03-09-2005,214717,Uttarakhand,9,12,8,21,50,Pass
Kunal Verma,05-04-2005,827086,West Bengal,7,18,24,5,54,Pass
Aryan Sharma,02-03-2005,769110,Madhya Pradesh,12,7,7,9,35,Pass
Imran D'Souza,05-11-2005,447866,Mizoram,13,21,7,2,43,Pass
Vivaan Pillai,26-02-2006,501637,Uttar Pradesh,11,9,17,14,51,Pass
Sukhwinder Chopra,25-01-2006,531341,Bihar,9,22,5,15,51,Pass
Aarav Chopra,24-09-2005,538235,Bihar,3,13,3,23,42,Pass
Balbir Khan,02-01-2006,599971,Bihar,24,16,22,24,86,Pass
Raj Fernandes,23-11-2005,731124,Gujarat,9,6,8,9,32,Pass
Aryan D'Souza,30-04-2006,898438,Telangana,14,3,8,16,41,Pass
Aarav Sharma,19-08-2005,279818,Rajasthan,14,19,8,1,42,Pass
Balbir Verma,04-03-2005,536962,Madhya Pradesh,0,8,0,8,16,Pass
Vivaan Khan,27-11-2004,144983,Bihar,12,5,15,8,40,Pass
Vivaan Pillai,29-03-2006,137037,Telangana,9,5,7,22,43,Pass
David Verma,20-12-2004,521945,Himachal Pradesh,24,0,16,11,51,Pass
Paul Khan,08-02-2005,193884,Bihar,11,0,4,23,38,Pass
Rohan Khan,06-07-2005,941658,Bihar,16,5,1,23,45,Pass
Aditya D'Souza,25-10-2005,286114,Bihar,2,17,17,2,38,Pass
Yash Reddy,06-01-2005,879804,Uttar Pradesh,24,9,14,14,61,Pass
Yash Fernandes,12-03-2005,478547,Bihar,6,11,6,24,47,Pass
Harjeet Khan,21-04-2006,749942,Bihar,6,24,2,22,54,Pass
Krishna Pillai,21-11-2005,523129,Odisha,15,0,12,14,41,Pass
Yash D'Souza,21-09-2005,171039,Uttar Pradesh,6,9,4,14,33,Pass
Balbir Reddy,24-11-2005,104979,Haryana,4,7,15,16,42,Pass
Yash Singh,25-02-2005,176017,Tamil Nadu,11,5,20,4,40,Pass
Sukhwinder Verma,13-02-2005,890830,Bihar,10,5,19,10,44,Pass
Vivaan Chopra,18-02-2006,562162,Haryana,16,5,16,1,38,Pass
Gurpreet Pillai,06-08-2005,411290,West Bengal,3,22,10,21,56,Pass
Vivaan Sharma,18-05-2005,922892,Telangana,9,11,7,7,34,Pass
Gurpreet Sharma,14-10-2005,190923,Uttar Pradesh,16,9,4,14,43,Pass
Yash Reddy,11-12-2005,245929,Punjab,17,21,18,23,79,Pass
Krishna Chopra,24-02-2006,869404,West Bengal,8,24,2,18,52,Pass
Manpreet Pillai,29-07-2005,415423,West Bengal,6,12,21,11,50,Pass
Paul Sharma,26-07-2005,112292,West Bengal,3,10,23,16,52,Pass
Yash Singh,26-04-2006,625962,Rajasthan,18,20,8,16,62,Pass
Sukhwinder Singh,12-05-2005,556207,Goa,3,2,19,23,47,Pass
Mathew Khan,13-04-2006,504502,Uttar Pradesh,4,9,4,14,31,Pass
Vivaan Khan,16-01-2006,849170,Tamil Nadu,0,21,23,21,65,Pass
Aryan Mehta,21-06-2005,984044,Haryana,0,2,18,13,33,Pass
Aditya Verma,23-07-2005,194151,Tamil Nadu,18,9,5,1,33,Pass
Aryan Fernandes,24-04-2006,387074,Andhra Pradesh,19,10,13,8,50,Pass
Harjeet Pillai,04-08-2005,153660,Uttar Pradesh,8,9,4,14,35,Pass
Aryan Singh,09-05-2005,926901,Bihar,22,8,7,22,59,Pass
Aryan Sharma,14-01-2005,852286,Odisha,12,5,18,12,47,Pass
Krishna Fernandes,14-02-2005,690040,Assam,6,23,5,1,35,Pass
Yash Singh,04-04-2005,476711,Madhya Pradesh,14,15,19,8,56,Pass
Balbir Khan,17-11-2005,556116,Tamil Nadu,12,21,11,13,57,Pass
Aarav Reddy,12-11-2005,958972,Kerala,0,18,12,12,42,Pass
Aarav Pillai,13-04-2005,128144,Madhya Pradesh,1,14,18,15,48,Pass
Ishaan Verma,25-02-2005,681973,Maharashtra,11,1,9,17,38,Pass
Kunal Sharma,13-04-2006,470939,Madhya Pradesh,20,1,6,5,32,Pass
Vivaan Chopra,12-11-2004,795790,Uttarakhand,4,1,8,14,27,Pass
Aryan Reddy,20-11-2004,884516,Gujarat,19,19,1,21,60,Pass
Rohan Reddy,05-08-2005,272060,Tamil Nadu,21,14,7,5,47,Pass
Aditya Pillai,29-11-2005,746277,Uttar Pradesh,3,9,4,14,30,Pass
Aditya Khan,02-05-2005,520467,Haryana,4,3,12,20,39,Pass
Aditya Fernandes,29-03-2005,314381,Uttar Pradesh,11,9,4,14,38,Pass
Aarav Chopra,14-06-2005,769537,Uttar Pradesh,0,9,4,14,27,Pass
Balbir Pillai,10-09-2005,416910,Maharashtra,6,10,23,24,63,Pass
Raj Reddy,22-01-2006,978468,Madhya Pradesh,0,5,8,16,29,Pass
Rohan Verma,31-07-2005,376449,Punjab,23,3,17,5,48,Pass
Aryan Chopra,11-04-2005,742580,Andhra Pradesh,19,8,11,8,46,Pass
Yash D'Souza,22-02-2006,925478,Bihar,11,3,24,3,41,Pass
Aarav Khan,28-12-2005,283329,Telangana,1,12,3,8,24,Pass
Vivaan Khan,02-05-2005,355786,Jammu & Kashmir + Ladakh,8,10,21,23,62,Pass
Ishaan Reddy,09-09-2005,458641,Rajasthan,2,24,7,7,40,Pass
Aditya Verma,17-05-2005,190161,Uttar Pradesh,23,9,4,14,50,Pass
Raj Sharma,18-10-2005,823424,Telangana,7,12,3,21,43,Pass
Yash Fernandes,22-11-2005,333885,Maharashtra,6,14,18,16,54,Pass
Rohan Sharma,06-01-2006,823068,Uttar Pradesh,22,9,4,14,49,Pass
Aditya Fernandes,25-02-2006,254359,Odisha,15,20,3,0,38,Pass
Kunal D'Souza,29-10-2005,337349,Assam,7,12,17,22,58,Pass
Aarav Verma,17-02-2005,845878,Rajasthan,19,11,23,23,76,Pass
Kunal Pillai,22-02-2006,146823,West Bengal,24,2,1,6,33,Pass
Gurpreet Reddy,08-07-2005,228189,Rajasthan,15,0,23,10,48,Pass
Manpreet Chopra,27-01-2006,497387,Telangana,13,17,15,3,48,Pass
Vivaan Fernandes,13-03-2006,753371,Delhi,19,17,12,18,66,Pass
Raj Singh,12-12-2005,414066,Andhra Pradesh,13,15,6,1,35,Pass
Yash Fernandes,07-11-2005,500018,Tamil Nadu,13,24,21,23,81,Pass
Manpreet Pillai,28-08-2005,787426,Telangana,16,4,3,16,39,Pass
Yash Reddy,16-03-2006,474415,Madhya Pradesh,24,16,1,8,49,Pass
Rohan Chopra,02-01-2005,719093,Madhya Pradesh,16,23,3,10,52,Pass
Yash Mehta,23-09-2005,165902,Rajasthan,12,14,7,0,33,Pass
Yash Sharma,04-02-2005,877618,Odisha,15,6,13,4,38,Pass
Aryan Reddy,23-08-2005,838458,Delhi,23,20,0,22,65,Pass
Krishna D'Souza,20-02-2006,891275,Tamil Nadu,9,10,8,17,44,Pass
David Singh,09-02-2005,490634,Punjab,2,4,18,19,43,Pass
Krishna Pillai,12-12-2004,184917,Punjab,4,16,21,17,58,Pass
Kunal Chopra,23-05-2005,753151,Madhya Pradesh,13,0,6,8,27,Pass
Yash Singh,31-01-2006,840831,Maharashtra,6,21,2,24,53,Pass
Zaid D'Souza,15-04-2005,981715,Tamil Nadu,3,20,5,16,44,Pass
Ishaan Chopra,26-02-2005,542163,Madhya Pradesh,2,0,18,17,37,Pass
Yash Pillai,24-01-2005,909397,Gujarat,4,10,16,15,45,Pass
Harjeet Verma,15-12-2005,961654,Chhattisgarh,20,8,22,14,64,Pass
Krishna Fernandes,04-03-2005,371269,Jharkhand,18,15,2,23,58,Pass
Krishna Mehta,11-01-2006,717173,Tripura,4,5,12,8,29,Pass
Peter Pillai,30-03-2005,589640,Maharashtra,14,13,1,9,37,Pass
Peter Chopra,20-07-2005,534464,Gujarat,22,3,14,1,40,Pass
Peter Singh,12-02-2006,567940,Andhra Pradesh,2,10,13,22,47,Pass
Aryan Pillai,09-09-2005,320397,Madhya Pradesh,1,10,11,22,44,Pass
Ishaan Reddy,22-04-2005,204416,Haryana,1,20,3,13,37,Pass
Yash Khan,09-05-2006,912548,Punjab,22,19,3,9,53,Pass
Rohan Fernandes,26-06-2005,798059,Uttar Pradesh,13,9,4,14,40,Pass
Aditya Fernandes,24-10-2005,922496,Haryana,10,23,0,23,56,Pass
Sukhwinder Verma,17-05-2005,846778,Kerala,6,16,6,2,30,Pass
Ishaan D'Souza,14-06-2005,787000,Madhya Pradesh,24,19,6,6,55,Pass
Paul Verma,18-06-2005,190011,Bihar,16,24,1,19,60,Pass
Imran Verma,26-07-2005,302699,Rajasthan,7,2,8,4,21,Pass
Aryan Mehta,14-11-2005,400192,Bihar,8,12,8,14,42,Pass
John Singh,16-08-2005,186719,Rajasthan,8,6,17,11,42,Pass
Raj Fernandes,21-11-2005,436051,Andhra Pradesh,2,0,11,17,30,Pass
David Mehta,19-11-2005,184357,Maharashtra,12,7,12,12,43,Pass
Raj Reddy,11-03-2006,682749,Uttar Pradesh,16,9,4,14,43,Pass
Raj Mehta,26-02-2006,582578,Bihar,15,0,23,4,42,Pass
Peter D'Souza,04-10-2005,173748,Maharashtra,3,0,23,23,49,Pass
Mathew Verma,16-12-2005,797285,Maharashtra,11,10,6,8,35,Pass
Balbir Chopra,12-02-2006,359176,Punjab,17,8,15,16,56,Pass
Aditya Mehta,26-11-2005,665123,Tamil Nadu,13,1,10,13,37,Pass
Yash Pillai,03-01-2006,916750,Tripura,12,24,11,3,50,Pass
Krishna Verma,10-04-2006,394601,Rajasthan,7,17,14,7,45,Pass
Imran Mehta,15-04-2005,556111,Tamil Nadu,18,5,17,16,56,Pass
Rohan Verma,18-06-2005,736040,West Bengal,14,4,18,3,39,Pass
Balbir Khan,24-10-2005,336786,Maharashtra,17,15,4,0,36,Pass
Raj Singh,28-05-2005,471763,Madhya Pradesh,6,1,0,18,25,Pass
Mathew Fernandes,02-02-2005,486623,Haryana,22,11,11,4,48,Pass
Yash Mehta,07-05-2006,522306,Odisha,9,7,11,6,33,Pass
Balbir Pillai,29-10-2005,977608,Rajasthan,13,20,14,14,61,Pass
John Sharma,16-05-2005,920838,Uttar Pradesh,17,9,4,14,44,Pass
Aryan D'Souza,22-09-2005,948462,Bihar,19,22,6,2,49,Pass
Aditya Khan,09-02-2006,389701,Madhya Pradesh,1,22,15,17,55,Pass
Yash Khan,13-11-2005,516700,Madhya Pradesh,2,0,13,23,38,Pass
Krishna Verma,25-05-2005,785651,Telangana,6,3,4,16,29,Pass
Vivaan Mehta,27-05-2005,556560,Rajasthan,17,2,18,22,59,Pass
Ishaan Fernandes,06-04-2005,782523,West Bengal,16,6,8,7,37,Pass
Yash Khan,23-12-2004,280127,Maharashtra,9,22,3,3,37,Pass
Aarav Verma,21-08-2005,616393,Uttar Pradesh,13,9,4,14,40,Pass
Vivaan Mehta,19-12-2004,129752,Uttar Pradesh,20,9,4,14,47,Pass
Zaid Singh,03-01-2006,768994,Uttar Pradesh,1,9,4,14,28,Pass
Kunal Reddy,06-01-2005,330320,Himachal Pradesh,1,9,9,9,28,Pass
Paul Reddy,13-03-2006,734883,Jharkhand,17,4,22,22,65,Pass
Sukhwinder D'Souza,04-06-2005,383808,Bihar,15,9,19,1,44,Pass
Kunal Khan,24-04-2005,532208,Tamil Nadu,13,10,20,18,61,Pass
Aarav Khan,24-03-2006,916008,Maharashtra,21,5,7,10,43,Pass
Vivaan Sharma,01-09-2005,285928,Jharkhand,3,23,14,5,45,Pass
Yash Chopra,29-11-2005,970627,Karnataka,9,2,7,0,18,Pass
Krishna Fernandes,28-08-2005,568104,West Bengal,21,5,7,10,43,Pass
Manpreet Pillai,13-04-2005,604514,Uttar Pradesh,5,9,4,14,32,Pass
Aryan Fernandes,15-01-2006,265758,Kerala,17,19,6,3,45,Pass
Aryan Reddy,04-05-2006,926664,Himachal Pradesh,12,9,8,10,39,Pass
Gurpreet Reddy,21-03-2006,171203,Tamil Nadu,20,4,20,3,47,Pass
David Mehta,19-10-2005,940354,Telangana,3,12,11,19,45,Pass
Ishaan Verma,18-11-2005,957366,Chhattisgarh,7,7,23,6,43,Pass
Farhan Reddy,19-02-2006,630640,Jharkhand,3,1,17,5,26,Pass
Yash Reddy,03-05-2006,822684,West Bengal,4,9,20,8,41,Pass
Manpreet Pillai,29-08-2005,652352,Punjab,16,12,24,3,55,Pass
Manpreet Verma,16-04-2006,262002,Haryana,7,0,14,24,45,Pass
Aryan Chopra,20-07-2005,629312,Jharkhand,20,6,22,17,65,Pass
Vivaan Reddy,03-06-2005,168454,Uttar Pradesh,11,9,4,14,38,Pass
Balbir Pillai,25-02-2005,141119,Telangana,4,3,18,22,47,Pass
Kunal D'Souza,15-12-2005,715432,Tamil Nadu,9,16,7,3,35,Pass
Aarav Reddy,09-05-2005,618902,Uttar Pradesh,0,9,4,14,27,Pass
Aarav Pillai,29-12-2004,934722,Haryana,23,3,13,11,50,Pass
Kunal Verma,16-06-2005,844910,Uttar Pradesh,9,9,4,14,36,Pass
Aditya Sharma,23-11-2004,909139,Maharashtra,6,17,24,6,53,Pass
Peter Reddy,30-07-2005,106632,Punjab,22,22,3,4,51,Pass
Imran Pillai,31-05-2005,271961,Telangana,4,2,17,8,31,Pass
Krishna Reddy,24-01-2006,706046,Haryana,2,24,15,24,65,Pass
Mathew Reddy,18-02-2005,534657,Punjab,23,8,0,17,48,Pass
Harjeet D'Souza,24-04-2005,115850,Haryana,10,24,12,19,65,Pass
Aryan Verma,19-05-2005,118059,Tamil Nadu,0,4,10,10,24,Pass
Aryan Pillai,26-01-2005,753940,Madhya Pradesh,1,3,22,21,47,Pass
Gurpreet Chopra,14-11-2005,519707,Haryana,14,5,9,5,33,Pass
Aarav Fernandes,26-09-2005,700241,Bihar,3,10,7,11,31,Pass
Kunal Khan,12-08-2005,413063,Uttarakhand,3,23,8,22,56,Pass
Imran Reddy,28-07-2005,604962,West Bengal,4,12,22,6,44,Pass
John Chopra,16-06-2005,570853,Himachal Pradesh,8,9,9,5,31,Pass
Vivaan Reddy,20-11-2004,443893,Bihar,9,0,10,10,29,Pass
Raj Reddy,10-09-2005,606054,Rajasthan,23,21,16,12,72,Pass
Aryan Reddy,03-05-2005,149870,Rajasthan,15,12,17,12,56,Pass
Ishaan Verma,17-12-2004,567029,Meghalaya,13,4,24,0,41,Pass
Aarav Fernandes,15-11-2004,427318,Bihar,23,1,10,8,42,Pass
Raj D'Souza,05-05-2006,979581,Maharashtra,6,20,20,10,56,Pass
Rehan Sharma,21-02-2005,535078,Punjab,16,21,2,14,53,Pass
Harjeet Verma,11-01-2006,185720,Tamil Nadu,5,17,11,14,47,Pass
Yash Sharma,26-04-2006,611610,Uttar Pradesh,3,9,4,14,30,Pass
Rohan Reddy,21-11-2004,400312,Assam,5,3,14,23,45,Pass
John D'Souza,12-01-2005,386027,Andhra Pradesh,18,6,18,8,50,Pass
Harjeet Singh,17-12-2005,725087,Andhra Pradesh,13,19,11,7,50,Pass
Aryan Singh,11-03-2005,608630,Gujarat,18,24,1,19,62,Pass
Vivaan Pillai,09-05-2006,542439,Rajasthan,21,23,0,3,47,Pass
Sukhwinder Mehta,12-11-2004,913336,Uttar Pradesh,11,9,4,14,38,Pass
Yash Verma,02-12-2004,127478,Jharkhand,4,24,16,3,47,Pass
Imran Fernandes,16-10-2005,217953,Maharashtra,3,9,24,17,53,Pass
Aryan Khan,14-04-2006,990329,Chhattisgarh,16,5,5,0,26,Pass
Vivaan Fernandes,01-03-2006,430380,Haryana,4,23,13,17,57,Pass
Aryan Singh,15-09-2005,676625,Rajasthan,12,11,21,3,47,Pass
Krishna Sharma,04-10-2005,785142,Uttar Pradesh,11,9,4,14,38,Pass
Vivaan Chopra,02-08-2005,563764,Andhra Pradesh,7,11,10,14,42,Pass
Kunal Chopra,21-04-2005,435237,Telangana,5,3,14,5,27,Pass
Yash Pillai,28-11-2005,671891,Bihar,12,20,9,3,44,Pass
Kunal Sharma,13-04-2006,240376,Uttar Pradesh,7,9,4,14,34,Pass
Yash D'Souza,05-07-2005,917609,Bihar,7,4,3,8,22,Pass
Yash Chopra,27-08-2005,296359,Madhya Pradesh,1,21,23,22,67,Pass
Mathew Khan,15-01-2005,272237,Madhya Pradesh,4,5,2,17,28,Pass
Aditya Khan,21-11-2004,424743,Madhya Pradesh,1,14,16,11,42,Pass
Aditya Fernandes,16-09-2005,661687,Delhi,0,18,4,2,24,Pass
Rohan Singh,26-04-2005,963829,Uttar Pradesh,13,9,4,14,40,Pass
Yash Reddy,03-01-2005,141017,Rajasthan,24,15,10,13,62,Pass
Balbir Chopra,18-10-2005,382108,Bihar,5,5,5,3,18,Pass
Peter Singh,08-03-2006,825088,Maharashtra,3,22,1,14,40,Pass
Zaid Chopra,29-04-2005,950520,Andhra Pradesh,6,1,21,20,48,Pass
Kunal Chopra,15-02-2006,841726,Rajasthan,23,7,19,16,65,Pass
Aditya Fernandes,19-05-2005,379338,Kerala,13,19,7,15,54,Pass
Vivaan Sharma,23-10-2005,939857,Uttar Pradesh,24,9,4,14,51,Pass
Raj Mehta,26-11-2005,941451,Gujarat,14,7,3,21,45,Pass
Rehan D'Souza,20-04-2006,508549,Uttarakhand,3,12,8,23,46,Pass
Yash Verma,10-04-2005,287880,Jammu & Kashmir + Ladakh,3,18,0,13,34,Pass
Rohan Singh,26-06-2005,526029,Punjab,14,12,4,20,50,Pass
David Sharma,31-03-2005,947027,Haryana,24,22,14,3,63,Pass
David Mehta,17-11-2005,853644,Bihar,1,3,20,14,38,Pass
Aditya Khan,03-06-2005,648411,Uttar Pradesh,12,9,4,14,39,Pass
Kunal Fernandes,25-11-2004,328287,Jammu & Kashmir + Ladakh,10,24,19,0,53,Pass
Rohan Pillai,30-09-2005,571099,Rajasthan,24,12,21,5,62,Pass
Raj Fernandes,11-03-2006,757504,Uttar Pradesh,5,9,4,14,32,Pass
John D'Souza,17-04-2005,783825,Madhya Pradesh,8,5,14,18,45,Pass
Imran Fernandes,22-02-2005,920294,Maharashtra,3,10,12,14,39,Pass
Ishaan Singh,08-03-2005,784143,Punjab,23,9,8,3,43,Pass
Ishaan Pillai,26-11-2004,357312,West Bengal,4,23,13,0,40,Pass
Aarav Sharma,13-10-2005,972723,Maharashtra,3,5,15,12,35,Pass
Vivaan D'Souza,30-01-2005,134282,Maharashtra,2,9,19,4,34,Pass
John Singh,18-11-2004,193586,Assam,11,20,1,9,41,Pass
Yash Chopra,11-08-2005,747755,Tamil Nadu,7,5,18,7,37,Pass
Aditya Reddy,15-01-2006,615381,Bihar,6,4,7,3,20,Pass
Aditya Pillai,28-02-2006,278260,Punjab,20,12,3,12,47,Pass
Krishna Sharma,23-11-2004,337018,West Bengal,1,11,13,21,46,Pass
Aditya Fernandes,08-12-2004,245481,Chhattisgarh,14,15,10,14,53,Pass
Ayaan Fernandes,30-06-2005,959118,Andhra Pradesh,23,8,10,6,47,Pass
Aryan Khan,18-10-2005,162828,Uttar Pradesh,10,9,4,14,37,Pass
Ishaan Sharma,10-01-2005,436671,Telangana,11,16,1,5,33,Pass
Rohan Sharma,20-03-2006,766938,Uttar Pradesh,10,9,4,14,37,Pass
Aditya Verma,03-04-2006,690704,Bihar,7,4,3,13,27,Pass
David Khan,20-02-2005,159519,Himachal Pradesh,5,9,6,6,26,Pass
Yash Fernandes,12-10-2005,877382,Uttar Pradesh,14,9,4,14,41,Pass
Yash Verma,03-07-2005,694455,Rajasthan,11,3,12,13,39,Pass
Sukhwinder Khan,10-03-2006,165193,Haryana,11,12,12,13,48,Pass
Aditya Reddy,02-06-2005,690138,Rajasthan,11,3,18,1,33,Pass
Vivaan D'Souza,21-11-2004,806609,Bihar,6,22,13,20,61,Pass
Ishaan Fernandes,28-07-2005,885215,Odisha,18,23,23,22,86,Pass
Balbir Pillai,14-08-2005,885875,Punjab,20,3,12,13,48,Pass
Sukhwinder Sharma,27-11-2005,414372,Uttarakhand,3,9,8,22,42,Pass
Raj Chopra,08-04-2005,150591,Rajasthan,9,17,16,7,49,Pass
Vivaan Verma,22-02-2006,469292,Uttar Pradesh,20,9,4,14,47,Pass
Yash D'Souza,14-04-2005,874267,Sikkim,12,14,23,10,59,Pass
Krishna Verma,27-08-2005,145734,Telangana,22,22,3,14,61,Pass
Aditya D'Souza,10-01-2006,333129,Rajasthan,16,12,9,0,37,Pass
Aarav Khan,05-07-2005,414419,Gujarat,22,4,19,5,50,Pass
Aarav Singh,24-03-2005,863737,Punjab,9,1,0,9,19,Pass
Raj Fernandes,28-06-2005,506600,Haryana,1,1,22,21,45,Pass
Aarav Chopra,27-12-2004,762099,Himachal Pradesh,6,6,13,20,45,Pass
Raj Khan,29-12-2004,400633,Gujarat,9,1,5,15,30,Pass
Vivaan D'Souza,20-06-2005,986461,Delhi,3,1,18,10,32,Pass
Peter Singh,05-03-2006,761523,Assam,6,5,2,16,29,Pass
Paul Fernandes,08-01-2006,908339,Punjab,4,22,8,15,49,Pass
Yash Singh,23-11-2005,270062,Tamil Nadu,0,16,22,4,42,Pass
Aryan Pillai,07-10-2005,460565,Kerala,4,12,23,19,58,Pass
Manpreet Singh,25-05-2005,430216,Maharashtra,0,13,22,8,43,Pass
Rohan D'Souza,10-01-2005,943546,Madhya Pradesh,1,13,19,23,56,Pass
Vivaan D'Souza,26-10-2005,787125,Madhya Pradesh,19,16,13,7,55,Pass
Aarav Chopra,19-07-2005,263575,Kerala,2,15,17,11,45,Pass
Aditya Sharma,27-10-2005,403539,Puducherry,2,17,16,3,38,Pass
Ishaan Fernandes,24-11-2004,487424,Rajasthan,21,6,24,0,51,Pass
Krishna Chopra,19-02-2006,410863,Uttar Pradesh,20,9,4,14,47,Pass
Aryan D'Souza,04-03-2005,563140,Tamil Nadu,18,5,17,18,58,Pass
Kunal Singh,05-09-2005,703996,Delhi,23,7,15,17,62,Pass
Aryan Khan,04-05-2006,423611,Bihar,9,12,7,8,36,Pass
Rohan Sharma,21-07-2005,185525,Uttar Pradesh,20,9,4,14,47,Pass
Rohan Mehta,10-05-2005,344626,Bihar,7,15,4,0,26,Pass
Vivaan Reddy,19-06-2005,340193,Rajasthan,23,2,2,4,31,Pass
Aryan Mehta,25-05-2005,722254,Bihar,16,14,7,6,43,Pass
Vivaan Sharma,24-11-2005,896351,Madhya Pradesh,12,3,13,1,29,Pass
Sukhwinder Chopra,06-06-2005,355190,Madhya Pradesh,1,5,7,19,32,Pass
Krishna Reddy,02-05-2005,126239,Jammu & Kashmir + Ladakh,11,22,7,14,54,Pass
Krishna Khan,15-12-2004,438340,Bihar,8,22,8,2,40,Pass
Krishna Verma,26-05-2005,238841,Bihar,3,19,9,20,51,Pass
Aryan Sharma,20-07-2005,790708,Kerala,5,19,16,21,61,Pass
Harjeet Reddy,18-02-2006,716155,Uttar Pradesh,10,9,4,14,37,Pass
Harjeet Chopra,05-01-2006,905621,West Bengal,3,20,24,20,67,Pass
John Khan,11-12-2005,791297,Tamil Nadu,13,24,9,5,51,Pass
Kunal Fernandes,01-12-2005,542065,Jharkhand,20,0,24,23,67,Pass
Kunal Singh,22-11-2004,589187,Uttar Pradesh,11,9,4,14,38,Pass
Balbir Pillai,08-06-2005,455839,Uttar Pradesh,22,9,4,14,49,Pass
Balbir Pillai,10-02-2005,853918,Puducherry,1,8,5,19,33,Pass
Kunal Chopra,11-09-2005,165480,Haryana,17,8,19,4,48,Pass
Raj Chopra,27-05-2005,582727,Haryana,12,8,1,24,45,Pass
Vivaan Singh,19-11-2005,175717,Bihar,4,12,15,9,40,Pass
Ishaan Khan,06-01-2005,821632,Jharkhand,4,15,24,24,67,Pass
Kunal Pillai,21-02-2006,569437,Madhya Pradesh,24,14,8,0,46,Pass
Harjeet Khan,03-05-2006,472954,Madhya Pradesh,15,8,9,4,36,Pass
Farhan Reddy,30-11-2005,982298,Rajasthan,2,5,3,16,26,Pass
Ishaan Pillai,09-12-2005,343142,Karnataka,8,11,18,7,44,Pass
Aryan Khan,06-07-2005,246350,Sikkim,5,3,12,24,44,Pass
Rohan Fernandes,21-01-2005,106829,Himachal Pradesh,24,9,6,19,58,Pass
Aryan Pillai,16-10-2005,842293,Chhattisgarh,23,4,12,5,44,Pass
Vivaan Singh,14-01-2005,492708,Jharkhand,24,7,23,13,67,Pass
Rohan Khan,06-04-2006,407021,Haryana,16,17,18,6,57,Pass
Krishna Mehta,23-10-2005,805224,Haryana,9,16,22,0,47,Pass
Sukhwinder Mehta,14-07-2005,460496,Rajasthan,4,9,12,5,30,Pass
Aditya Mehta,22-12-2005,407015,Kerala,14,7,19,10,50,Pass
Aditya Singh,10-04-2005,809988,Uttar Pradesh,0,9,4,14,27,Pass
Rohan Sharma,12-04-2005,684619,Andaman & Nicobar,7,9,9,7,32,Pass
Imran D'Souza,29-12-2005,996761,Haryana,12,15,19,12,58,Pass
Farhan Mehta,20-08-2005,694726,Telangana,10,7,15,4,36,Pass
Sukhwinder D'Souza,26-07-2005,985476,Jammu & Kashmir + Ladakh,8,5,24,11,48,Pass
Aditya Fernandes,23-07-2005,176388,Tamil Nadu,2,0,15,21,38,Pass
Aryan Singh,14-12-2005,866103,Maharashtra,2,13,4,3,22,Pass
Raj Khan,01-02-2005,469830,Kerala,20,9,21,17,67,Pass
Rohan Fernandes,02-01-2006,136397,Jharkhand,20,8,13,2,43,Pass
Kunal Reddy,03-11-2005,687969,Chhattisgarh,4,14,17,24,59,Pass
David Mehta,10-07-2005,571773,Odisha,13,13,5,6,37,Pass
Yash Verma,29-07-2005,931751,Tamil Nadu,16,19,0,14,49,Pass
Paul Sharma,29-04-2005,476209,Uttar Pradesh,22,9,4,14,49,Pass
Aditya Pillai,30-11-2004,223113,West Bengal,2,10,19,15,46,Pass
Vivaan Reddy,30-04-2006,302301,Bihar,14,2,6,15,37,Pass
Krishna Singh,22-11-2004,833433,Rajasthan,14,2,21,21,58,Pass
Peter Singh,13-04-2005,658042,Bihar,0,10,18,12,40,Pass
Raj Khan,01-12-2004,198880,Telangana,14,6,6,3,29,Pass
Vivaan Singh,05-06-2005,551906,West Bengal,3,10,19,16,48,Pass
Ishaan Reddy,11-09-2005,144863,Andhra Pradesh,19,8,8,2,37,Pass
Rohan Reddy,01-05-2006,835706,Gujarat,23,19,0,22,64,Pass
Rehan Khan,06-02-2006,505624,Tripura,23,0,4,12,39,Pass
Aarav Khan,11-12-2005,176754,Jammu & Kashmir + Ladakh,8,6,7,6,27,Pass
Balbir Khan,06-01-2006,483371,Jharkhand,3,20,7,13,43,Pass
Mathew Khan,01-09-2005,802634,Uttar Pradesh,8,9,4,14,35,Pass
Vivaan D'Souza,26-11-2004,646934,Rajasthan,19,14,20,0,53,Pass
Ishaan Mehta,07-04-2006,239537,Uttar Pradesh,9,9,4,14,36,Pass
Sukhwinder Khan,09-09-2005,386320,Andhra Pradesh,15,10,19,11,55,Pass
John Pillai,04-01-2005,380860,Uttar Pradesh,2,9,4,14,29,Pass
Aarav D'Souza,13-02-2005,515873,Andhra Pradesh,16,2,3,10,31,Pass
Aryan Reddy,16-03-2005,840447,Maharashtra,6,24,6,14,50,Pass
Rehan Reddy,30-09-2005,850419,Tamil Nadu,8,7,4,7,26,Pass
Aarav Pillai,27-07-2005,605756,Punjab,9,6,16,6,37,Pass
Gurpreet Singh,12-04-2005,606102,Uttar Pradesh,22,9,4,14,49,Pass
David Mehta,30-03-2006,322553,Punjab,1,3,9,0,13,Pass
Yash Sharma,22-04-2005,462756,Uttar Pradesh,5,9,4,14,32,Pass
Vivaan D'Souza,16-11-2005,409653,Uttar Pradesh,2,9,4,14,29,Pass
Yash Khan,30-12-2004,801332,Uttar Pradesh,10,9,4,14,37,Pass
Yash Mehta,17-08-2005,583302,Himachal Pradesh,4,23,4,4,35,Pass
Sukhwinder D'Souza,24-01-2005,393767,Bihar,3,20,3,5,31,Pass
Peter Verma,24-12-2004,653592,Delhi,16,19,22,20,77,Pass
Paul Singh,07-10-2005,544512,Uttar Pradesh,2,9,4,14,29,Pass
Harjeet Sharma,02-03-2005,838299,Bihar,0,6,4,24,34,Pass
Vivaan D'Souza,27-01-2005,780710,Telangana,14,6,14,6,40,Pass
Aarav Reddy,21-07-2005,389007,West Bengal,0,24,6,14,44,Pass
Aditya Khan,29-09-2005,852898,Uttar Pradesh,4,9,4,14,31,Pass
Aditya Singh,19-04-2006,903275,Haryana,4,18,0,24,46,Pass
Vivaan Khan,01-04-2006,240071,Gujarat,17,4,4,14,39,Pass
Raj Sharma,26-09-2005,808210,West Bengal,12,16,2,16,46,Pass
David Fernandes,18-04-2005,670464,Uttar Pradesh,5,9,4,14,32,Pass
Vivaan Pillai,30-11-2005,783626,Andhra Pradesh,20,11,2,23,56,Pass
Farhan Reddy,27-09-2005,573578,Rajasthan,6,5,13,3,27,Pass
Sukhwinder Khan,29-09-2005,650964,Andhra Pradesh,11,0,19,11,41,Pass
Rohan D'Souza,11-01-2006,406404,Bihar,3,24,3,6,36,Pass
Aarav Fernandes,30-04-2005,760504,Rajasthan,6,16,10,1,33,Pass
Mathew D'Souza,07-05-2006,264466,Uttar Pradesh,5,9,4,14,32,Pass
Rohan Verma,25-08-2005,729240,Madhya Pradesh,3,7,14,6,30,Pass
Krishna Sharma,15-05-2005,969159,West Bengal,22,9,3,3,37,Pass
Ayaan Verma,04-08-2005,180409,Punjab,3,12,12,0,27,Pass
Ishaan Mehta,16-04-2005,685007,Uttar Pradesh,2,9,4,14,29,Pass
Aryan Reddy,21-11-2004,980876,Haryana,11,7,15,1,34,Pass
Yash Singh,13-01-2006,818559,Manipur,3,5,3,24,35,Pass
Aryan Reddy,24-03-2006,838314,Uttar Pradesh,9,9,4,14,36,Pass
Zaid D'Souza,13-12-2005,969856,Madhya Pradesh,18,15,1,6,40,Pass
Krishna Verma,05-03-2006,555260,Chhattisgarh,22,5,15,17,59,Pass
Yash Fernandes,13-11-2004,537686,West Bengal,3,1,10,8,22,Pass
Aryan D'Souza,25-04-2006,864450,Madhya Pradesh,4,4,10,0,18,Pass
Raj Reddy,23-09-2005,332448,Andhra Pradesh,1,24,5,8,38,Pass
Rohan Mehta,07-11-2005,484487,Andhra Pradesh,15,15,13,15,58,Pass
Peter Mehta,21-03-2006,310313,Telangana,9,1,4,6,20,Pass
Aryan Fernandes,24-07-2005,610796,Karnataka,6,7,15,23,51,Pass
Aarav Reddy,17-11-2005,646456,Gujarat,0,21,8,4,33,Pass
Mathew Singh,16-07-2005,712118,Madhya Pradesh,21,8,4,20,53,Pass
Vivaan Khan,16-07-2005,562187,West Bengal,5,4,16,2,27,Pass
Aarav Sharma,16-06-2005,975184,Maharashtra,3,8,6,22,39,Pass
Raj Sharma,17-12-2005,321347,Odisha,22,10,8,4,44,Pass
Kunal Reddy,20-10-2005,289139,Maharashtra,2,6,21,0,29,Pass
Kunal Khan,07-06-2005,295785,Rajasthan,18,21,11,13,63,Pass
Yash Khan,15-09-2005,713349,Madhya Pradesh,1,16,14,11,42,Pass
Balbir Singh,01-03-2005,513540,Maharashtra,4,17,8,2,31,Pass
Yash Mehta,04-03-2005,384786,Kerala,22,10,19,8,59,Pass
Raj Verma,26-04-2005,305555,Maharashtra,3,14,9,12,38,Pass
Ishaan Singh,30-07-2005,210399,Andhra Pradesh,24,6,5,21,56,Pass
Gurpreet Chopra,14-03-2006,110522,Gujarat,23,15,24,2,64,Pass
Yash Khan,08-04-2005,429057,Tamil Nadu,20,5,5,22,52,Pass
Ishaan Mehta,02-06-2005,256690,Telangana,8,17,2,16,43,Pass
Manpreet Verma,02-01-2005,251756,Telangana,10,0,0,6,16,Pass
Peter Pillai,06-02-2006,542812,Madhya Pradesh,1,20,5,23,49,Pass
Aditya Verma,18-01-2005,267487,Maharashtra,3,16,14,13,46,Pass
Farhan Verma,02-06-2005,191757,Jharkhand,2,21,23,2,48,Pass
Rehan Singh,16-11-2005,250743,Jharkhand,1,24,24,22,71,Pass
Ishaan Pillai,11-11-2005,888631,Punjab,4,1,24,13,42,Pass
David Singh,05-11-2005,909762,Rajasthan,7,14,9,11,41,Pass
Aarav Chopra,15-04-2005,975310,West Bengal,19,3,7,8,37,Pass
Vivaan Singh,08-07-2005,328386,Jammu & Kashmir + Ladakh,7,12,23,12,54,Pass
Aryan Singh,25-04-2005,277942,Assam,7,14,17,7,45,Pass
Yash Pillai,27-08-2005,123116,Haryana,13,1,8,3,25,Pass
Raj Sharma,14-12-2004,276954,Bihar,5,11,15,2,33,Pass
Raj Mehta,10-02-2006,536543,Karnataka,23,24,10,3,60,Pass
Ishaan Reddy,27-03-2005,100664,Maharashtra,6,18,9,19,52,Pass
Ishaan Mehta,08-05-2005,992333,Chhattisgarh,18,20,15,8,61,Pass
Aarav Chopra,03-11-2005,290589,Uttar Pradesh,6,9,4,14,33,Pass
Raj Sharma,02-07-2005,487549,Telangana,7,13,12,3,35,Pass
Yash Chopra,21-03-2006,444760,Telangana,1,24,3,2,30,Pass
Aditya Pillai,21-11-2005,106484,Bihar,9,0,6,24,39,Pass
Farhan D'Souza,12-11-2005,632467,Madhya Pradesh,12,0,11,10,33,Pass
Harjeet Reddy,10-12-2004,293084,Uttarakhand,19,1,8,0,28,Pass
Aditya Chopra,23-02-2006,497540,Uttar Pradesh,13,9,4,14,40,Pass
Raj D'Souza,11-11-2004,586124,Punjab,12,5,21,2,40,Pass
Rohan Mehta,13-11-2004,996084,Rajasthan,0,19,0,9,28,Pass
Raj Khan,06-03-2006,388062,Madhya Pradesh,1,24,13,5,43,Pass
Ishaan D'Souza,26-02-2005,791729,Rajasthan,4,12,21,12,49,Pass
Yash Sharma,20-12-2005,926944,Karnataka,21,24,23,21,89,Pass
Krishna Sharma,08-07-2005,826645,Rajasthan,7,13,22,10,52,Pass
Yash Fernandes,09-05-2005,915295,Maharashtra,3,13,12,23,51,Pass
Kunal Pillai,01-10-2005,754418,Maharashtra,3,17,0,9,29,Pass
Krishna Fernandes,24-10-2005,811658,Madhya Pradesh,1,20,5,22,48,Pass
Kunal D'Souza,13-02-2006,185409,Punjab,1,7,4,24,36,Pass
Gurpreet Chopra,30-10-2005,938344,Maharashtra,3,1,13,13,30,Pass
Mathew Pillai,05-03-2006,153031,Uttar Pradesh,15,9,4,14,42,Pass
Yash Mehta,20-02-2006,627894,Maharashtra,6,11,9,24,50,Pass
Aryan Reddy,20-02-2005,803223,Uttarakhand,3,12,8,15,38,Pass
Kunal Singh,10-01-2005,242364,Bihar,16,3,10,9,38,Pass
Harjeet Sharma,04-08-2005,849514,Odisha,5,7,5,18,35,Pass
Krishna Singh,08-12-2004,487286,Bihar,12,2,10,20,44,Pass
Raj Sharma,28-11-2004,655237,Bihar,9,23,4,16,52,Pass
Yash Singh,29-10-2005,894423,Uttar Pradesh,6,9,4,14,33,Pass
Krishna Verma,04-06-2005,462010,Telangana,13,3,13,17,46,Pass
Sukhwinder Fernandes,25-03-2005,271478,Punjab,3,17,24,9,53,Pass
Aryan Mehta,02-05-2005,824825,Chhattisgarh,15,17,24,22,78,Pass
Aditya Sharma,25-12-2004,235655,Chhattisgarh,20,5,23,23,71,Pass
Aryan Reddy,09-01-2005,285866,Madhya Pradesh,9,3,23,13,48,Pass
Raj Pillai,19-06-2005,597758,Tamil Nadu,19,10,12,3,44,Pass
Ishaan Verma,29-06-2005,501580,Andhra Pradesh,18,3,5,8,34,Pass
Ishaan D'Souza,22-02-2006,613832,Punjab,11,0,22,5,38,Pass
Peter Mehta,06-11-2005,899897,Maharashtra,3,19,17,3,42,Pass
Aditya Singh,22-06-2005,741006,Madhya Pradesh,17,22,2,10,51,Pass
Balbir Chopra,26-11-2005,420071,West Bengal,3,21,15,22,61,Pass
Rohan Pillai,29-10-2005,184938,Gujarat,5,9,6,9,29,Pass
Sukhwinder Verma,17-08-2005,207804,Maharashtra,11,6,9,13,39,Pass
Raj Pillai,19-12-2005,349208,Punjab,7,7,15,11,40,Pass
Rohan D'Souza,30-11-2005,579921,Gujarat,5,7,13,19,44,Pass
Kunal Fernandes,05-02-2005,151516,Chhattisgarh,0,14,24,16,54,Pass
Ishaan Pillai,06-07-2005,195371,Bihar,9,18,3,8,38,Pass
Aryan Khan,27-09-2005,996183,Bihar,8,15,7,14,44,Pass
Kunal Khan,11-08-2005,804702,Odisha,4,10,9,14,37,Pass
Ishaan Pillai,05-05-2005,646148,Maharashtra,3,12,18,24,57,Pass
Raj Pillai,12-03-2005,795008,Maharashtra,11,0,4,23,38,Pass
Aditya Singh,06-06-2005,780213,West Bengal,3,18,10,7,38,Pass
Krishna Reddy,15-02-2006,754600,Bihar,3,23,9,9,44,Pass
Aditya Sharma,20-02-2006,381058,Maharashtra,24,18,1,1,44,Pass
Raj Mehta,21-05-2005,364189,Rajasthan,22,2,11,13,48,Pass
Raj Pillai,09-01-2006,835690,Karnataka,21,1,19,10,51,Pass
Balbir Verma,22-01-2005,110276,Kerala,3,10,4,20,37,Pass
Mathew Singh,12-12-2004,682212,Kerala,14,21,6,8,49,Pass
Aryan Singh,28-07-2005,558961,Telangana,3,3,15,6,27,Pass
Kunal Chopra,05-02-2005,488956,Punjab,8,3,19,17,47,Pass
Rohan Sharma,01-03-2006,684023,Telangana,24,8,9,2,43,Pass
Vivaan Khan,22-01-2006,801048,Andhra Pradesh,22,19,2,11,54,Pass
Harjeet Sharma,26-12-2004,984605,Haryana,9,17,2,15,43,Pass
Gurpreet Singh,08-06-2005,219813,Tamil Nadu,17,3,4,12,36,Pass
Manpreet Singh,02-03-2006,227771,Rajasthan,8,18,24,15,65,Pass
Aarav Fernandes,12-08-2005,199854,Rajasthan,17,17,11,14,59,Pass
Yash Fernandes,28-03-2006,351079,Maharashtra,0,1,10,24,35,Pass
David Verma,03-04-2005,774099,Andhra Pradesh,24,19,3,4,50,Pass
Sukhwinder Verma,27-04-2005,223536,Telangana,3,10,9,21,43,Pass
Krishna Mehta,15-03-2005,361683,Himachal Pradesh,9,8,8,9,34,Pass
Krishna Khan,13-09-2005,185406,Bihar,18,5,8,5,36,Pass
Ishaan Reddy,05-08-2005,607826,Assam,6,8,12,17,43,Pass
Raj Sharma,19-01-2005,562437,Uttar Pradesh,15,9,4,14,42,Pass
Rohan Reddy,07-10-2005,566703,Telangana,15,3,22,20,60,Pass
Manpreet Khan,18-01-2006,264805,Bihar,3,5,11,3,22,Pass
David Khan,08-05-2006,990194,Madhya Pradesh,1,4,17,19,41,Pass
Sukhwinder Reddy,31-05-2005,313358,Kerala,22,6,15,4,47,Pass
Paul Singh,12-11-2005,721864,Gujarat,8,7,7,8,30,Pass
Aarav Khan,01-09-2005,575385,Madhya Pradesh,1,19,17,3,40,Pass
Aryan Verma,30-04-2005,152090,Rajasthan,23,17,10,18,68,Pass
Rehan Pillai,03-04-2005,763090,Gujarat,5,11,6,9,31,Pass
Manpreet Reddy,23-11-2004,497845,Uttar Pradesh,7,9,4,14,34,Pass
Aarav Sharma,13-05-2005,549241,Jammu & Kashmir + Ladakh,16,23,20,0,59,Pass
Ayaan Pillai,24-10-2005,380107,Uttar Pradesh,11,9,4,14,38,Pass
Vivaan Sharma,27-01-2005,744629,Andhra Pradesh,0,9,5,11,25,Pass
Aditya Singh,22-03-2006,558908,Madhya Pradesh,1,5,24,9,39,Pass
Yash Verma,07-11-2005,985127,Himachal Pradesh,14,15,6,23,58,Pass
Vivaan Khan,09-02-2005,666103,West Bengal,3,22,13,16,54,Pass
Rohan Fernandes,11-02-2006,184911,Uttarakhand,6,21,8,8,43,Pass
Krishna Chopra,28-10-2005,326696,Maharashtra,6,12,17,19,54,Pass
Vivaan Mehta,07-03-2006,394967,Bihar,9,4,7,20,40,Pass
Kunal Reddy,01-08-2005,533840,Punjab,22,6,17,13,58,Pass
Aryan Mehta,10-05-2005,309428,Sikkim,1,11,9,19,40,Pass
Sukhwinder Singh,13-03-2006,917594,Chhattisgarh,16,23,12,5,56,Pass
Balbir Mehta,20-07-2005,426187,Telangana,12,21,3,17,53,Pass
Zaid D'Souza,05-04-2005,803004,Punjab,6,10,0,0,16,Pass
Farhan Sharma,25-10-2005,927678,Maharashtra,3,14,9,12,38,Pass
Kunal Chopra,16-10-2005,702405,Delhi,3,14,10,2,29,Pass
Rohan Reddy,08-04-2006,615199,Assam,9,2,21,9,41,Pass
Yash D'Souza,21-01-2006,793227,Rajasthan,10,22,18,4,54,Pass
Manpreet Mehta,10-02-2005,888063,Mizoram,4,8,4,11,27,Pass
Raj Pillai,17-02-2006,412195,Rajasthan,12,7,16,1,36,Pass
Raj Mehta,30-08-2005,408449,Karnataka,20,18,0,16,54,Pass
Yash Mehta,03-07-2005,528723,Meghalaya,11,11,5,11,38,Pass
Rohan Khan,27-11-2004,595843,Haryana,5,17,18,4,44,Pass
Manpreet Khan,07-04-2005,501110,Punjab,6,12,1,0,19,Pass
Balbir Mehta,26-01-2005,432177,Assam,8,16,4,9,37,Pass
Gurpreet Khan,13-02-2006,928665,Odisha,8,5,17,13,43,Pass
Aarav Verma,20-04-2005,312119,Maharashtra,7,0,19,15,41,Pass
Rohan Mehta,23-03-2005,982439,Rajasthan,2,19,1,21,43,Pass
Kunal Verma,29-12-2004,636122,Chhattisgarh,14,4,13,20,51,Pass
Raj Fernandes,27-10-2005,366573,Jharkhand,8,12,9,9,38,Pass
Aditya Sharma,23-12-2004,255376,Karnataka,24,19,7,11,61,Pass
David Chopra,30-04-2005,504976,Tamil Nadu,8,22,14,12,56,Pass
Kunal Sharma,23-07-2005,840275,Jammu & Kashmir + Ladakh,17,1,18,10,46,Pass
Rohan Reddy,17-03-2006,944430,Haryana,12,12,16,24,64,Pass
Imran Pillai,10-01-2006,209150,Rajasthan,23,7,5,13,48,Pass
Paul Mehta,26-12-2005,851822,Maharashtra,8,15,6,5,34,Pass
Ishaan Mehta,09-11-2004,674516,Bihar,9,0,16,3,28,Pass
Krishna Mehta,15-06-2005,245464,Kerala,22,18,10,7,57,Pass
Raj Reddy,21-03-2005,462649,Bihar,11,12,8,12,43,Pass
Raj Fernandes,17-03-2005,370072,Madhya Pradesh,6,21,11,5,43,Pass
Ishaan Singh,16-01-2005,602498,Haryana,0,17,15,22,54,Pass
Vivaan Singh,12-09-2005,832593,Haryana,2,15,1,19,37,Pass
Ishaan Sharma,22-01-2006,780357,Rajasthan,9,12,5,2,28,Pass
Krishna D'Souza,27-01-2005,362377,Punjab,7,10,3,24,44,Pass
Manpreet Pillai,22-02-2006,394695,Jammu & Kashmir + Ladakh,7,9,21,5,42,Pass
Rohan Khan,05-07-2005,511576,Gujarat,23,1,24,12,60,Pass
Peter Reddy,18-03-2006,984516,Rajasthan,1,7,11,20,39,Pass
Raj Chopra,05-02-2006,583002,Andhra Pradesh,10,8,0,14,32,Pass
Balbir Sharma,19-03-2006,474024,Delhi,23,1,21,8,53,Pass
Balbir Reddy,11-04-2006,972338,Andhra Pradesh,19,10,14,0,43,Pass
Aarav Singh,23-01-2005,131731,Punjab,23,12,8,6,49,Pass
David Khan,22-12-2005,217255,Jammu & Kashmir + Ladakh,21,5,11,1,38,Pass
Farhan D'Souza,18-12-2005,938299,Gujarat,5,5,7,11,28,Pass
Rohan Singh,04-03-2005,402452,Karnataka,2,22,10,8,42,Pass
Krishna Sharma,10-04-2006,769966,Tamil Nadu,10,13,20,5,48,Pass
Krishna Chopra,23-08-2005,404424,West Bengal,8,13,7,16,44,Pass
Vivaan Fernandes,12-09-2005,189432,Uttarakhand,6,18,8,15,47,Pass
Yash Chopra,18-01-2005,152883,Jharkhand,10,15,15,17,57,Pass
Aarav Pillai,20-08-2005,295672,Karnataka,7,8,23,13,51,Pass
Raj Pillai,16-07-2005,544150,West Bengal,3,4,13,0,20,Pass
Yash Singh,05-06-2005,288935,Maharashtra,3,24,18,12,57,Pass
Yash Singh,02-08-2005,379985,Kerala,9,0,3,24,36,Pass
Aditya Fernandes,17-07-2005,461832,West Bengal,1,7,8,8,24,Pass
Rohan Khan,10-10-2005,640329,Madhya Pradesh,1,21,3,3,28,Pass
Aarav Khan,29-01-2005,820937,Tripura,3,10,24,2,39,Pass
Vivaan Singh,28-03-2006,603389,Punjab,7,5,22,7,41,Pass
Raj Pillai,09-06-2005,653820,Bihar,18,23,0,3,44,Pass
Rehan Singh,25-03-2005,464733,Assam,7,11,5,12,35,Pass
Raj Verma,26-03-2005,653629,Bihar,7,11,15,4,37,Pass
Vivaan Chopra,26-07-2005,923641,Telangana,4,8,17,3,32,Pass
Peter Singh,21-03-2006,958688,Jharkhand,16,8,15,21,60,Pass
Aditya Khan,27-11-2005,206427,Uttar Pradesh,16,9,4,14,43,Pass
Aryan Fernandes,28-06-2005,704182,Bihar,13,13,16,3,45,Pass
Aryan Fernandes,03-11-2005,732804,Uttar Pradesh,12,9,4,14,39,Pass
Manpreet D'Souza,08-01-2005,287554,Rajasthan,21,5,18,3,47,Pass
Yash D'Souza,22-12-2004,183702,Karnataka,16,19,16,14,65,Pass
Ishaan Mehta,29-03-2005,381069,Kerala,12,22,16,5,55,Pass
Vivaan Reddy,11-04-2006,169775,Bihar,23,10,6,3,42,Pass
David Singh,05-04-2006,258556,Punjab,2,13,20,10,45,Pass
Farhan Sharma,11-04-2005,350914,Madhya Pradesh,11,11,7,2,31,Pass
Yash Mehta,27-03-2005,634202,Maharashtra,7,7,4,8,26,Pass
Rohan Singh,03-08-2005,618821,Uttar Pradesh,4,9,4,14,31,Pass
Ishaan Chopra,11-04-2006,145702,Odisha,13,15,5,14,47,Pass
Manpreet Mehta,19-01-2006,398868,Chhattisgarh,10,18,19,18,65,Pass
Kunal Chopra,01-12-2004,172653,Delhi,2,24,14,19,59,Pass
Aryan Pillai,01-01-2005,934863,Gujarat,9,19,8,11,47,Pass
David Sharma,11-07-2005,452379,Delhi,12,9,20,17,58,Pass
Aditya Singh,19-12-2005,120834,Andhra Pradesh,0,18,23,11,52,Pass
Kunal Singh,20-10-2005,701765,Tamil Nadu,21,18,16,10,65,Pass
Kunal Chopra,06-08-2005,266522,Uttar Pradesh,16,9,4,14,43,Pass
Vivaan Fernandes,29-09-2005,311005,Uttar Pradesh,21,9,4,14,48,Pass
Raj Reddy,17-02-2006,510999,Chhattisgarh,11,9,9,16,45,Pass
Aarav Chopra,14-12-2004,788039,Bihar,10,24,5,15,54,Pass
Ishaan Chopra,07-02-2006,800438,Uttar Pradesh,5,9,4,14,32,Pass
Peter Singh,24-02-2006,754062,Rajasthan,6,10,10,12,38,Pass
Rohan Singh,06-09-2005,480078,Uttar Pradesh,11,9,4,14,38,Pass
Ishaan Mehta,06-03-2005,142476,Bihar,3,9,7,19,38,Pass
Krishna Mehta,17-12-2005,799377,West Bengal,11,8,0,17,36,Pass
Kunal Singh,14-03-2006,173473,Jammu & Kashmir + Ladakh,7,17,9,11,44,Pass
John Reddy,29-11-2004,225206,Rajasthan,21,15,7,17,60,Pass
John Chopra,27-03-2005,418507,Andhra Pradesh,16,13,11,11,51,Pass
Rohan Fernandes,17-01-2005,319613,West Bengal,3,24,20,19,66,Pass
Manpreet Chopra,12-08-2005,926932,Uttar Pradesh,6,9,4,14,33,Pass
Ishaan Khan,26-07-2005,389270,Haryana,17,16,9,19,61,Pass
Raj Khan,16-01-2006,586091,Bihar,17,17,23,21,78,Pass
Ishaan Mehta,16-11-2004,139762,Assam,8,13,14,5,40,Pass
Krishna Singh,11-09-2005,271902,Kerala,0,8,11,17,36,Pass
Yash Chopra,21-05-2005,202822,Uttar Pradesh,9,9,4,14,36,Pass
Krishna Fernandes,27-05-2005,159085,West Bengal,2,3,7,6,18,Pass
Gurpreet Reddy,03-04-2006,588058,Madhya Pradesh,24,8,12,3,47,Pass
Peter Mehta,14-07-2005,976107,Sikkim,13,1,10,5,29,Pass
Krishna Mehta,20-05-2005,218113,Punjab,17,8,24,3,52,Pass
Vivaan Pillai,24-04-2006,726747,Tamil Nadu,24,17,4,12,57,Pass
Rohan Fernandes,04-08-2005,159723,Delhi,9,3,21,0,33,Pass
Balbir Sharma,10-10-2005,333307,Tamil Nadu,16,12,5,22,55,Pass
Gurpreet Singh,02-12-2004,263883,Andhra Pradesh,15,19,0,15,49,Pass
Aryan D'Souza,09-11-2004,105875,Rajasthan,16,7,18,15,56,Pass
Rohan Singh,08-06-2005,112567,Uttar Pradesh,4,9,4,14,31,Pass
Yash D'Souza,14-09-2005,872731,Jammu & Kashmir + Ladakh,24,2,18,12,56,Pass
Aditya Fernandes,27-02-2005,378352,Uttar Pradesh,24,9,4,14,51,Pass
Harjeet Mehta,18-02-2006,295300,Telangana,10,18,3,18,49,Pass
Yash D'Souza,21-04-2005,840869,Madhya Pradesh,22,22,0,9,53,Pass
Krishna Fernandes,18-03-2006,204425,Bihar,19,15,19,9,62,Pass
Aryan Chopra,11-12-2005,794385,Madhya Pradesh,1,19,23,3,46,Pass
Aryan Reddy,27-04-2005,123836,Gujarat,0,7,12,15,34,Pass
Yash Verma,07-12-2004,149731,Maharashtra,5,21,5,8,39,Pass
Yash Verma,24-12-2004,281627,Himachal Pradesh,6,13,2,23,44,Pass
Harjeet Fernandes,14-11-2005,121647,West Bengal,3,24,22,20,69,Pass
Rehan Fernandes,17-06-2005,890099,Maharashtra,6,21,22,21,70,Pass
Gurpreet Fernandes,09-03-2005,190088,Karnataka,15,12,0,13,40,Pass
Peter Sharma,11-09-2005,278222,Maharashtra,6,0,0,22,28,Pass
John Mehta,21-11-2004,712543,Bihar,14,11,5,9,39,Pass
Farhan Singh,14-12-2005,395807,Telangana,1,19,11,5,36,Pass
Farhan Sharma,13-01-2006,216699,Jammu & Kashmir + Ladakh,12,13,4,5,34,Pass
Harjeet Mehta,11-02-2005,632067,Uttar Pradesh,5,9,4,14,32,Pass
Aarav Chopra,23-03-2005,719678,West Bengal,3,12,20,5,40,Pass
Imran Sharma,25-12-2004,926838,Maharashtra,3,2,23,7,35,Pass
Sukhwinder Khan,15-04-2005,768217,Assam,8,9,15,15,47,Pass
Aditya Singh,24-12-2005,467195,Punjab,2,0,7,15,24,Pass
Manpreet Pillai,28-02-2005,581852,Bihar,0,21,12,13,46,Pass
Aryan Khan,04-01-2005,388235,Madhya Pradesh,11,5,13,17,46,Pass
Yash Khan,20-09-2005,740683,Maharashtra,5,2,13,14,34,Pass
Kunal Pillai,28-03-2005,685710,Haryana,23,9,9,17,58,Pass
Yash Sharma,22-11-2005,145688,Jharkhand,2,24,10,21,57,Pass
Raj D'Souza,03-07-2005,399701,Uttar Pradesh,4,9,4,14,31,Pass
Zaid Sharma,10-04-2005,540782,Maharashtra,0,14,14,0,28,Pass
Rohan Singh,11-04-2005,381533,Bihar,3,11,22,17,53,Pass
Raj Sharma,27-09-2005,624217,Rajasthan,11,0,24,8,43,Pass
Aryan Khan,30-09-2005,926313,West Bengal,7,17,5,22,51,Pass
Yash Khan,04-03-2005,107799,Punjab,3,20,16,7,46,Pass
Vivaan Singh,15-04-2005,379464,Andhra Pradesh,13,17,8,15,53,Pass
David Mehta,24-01-2005,680558,Uttar Pradesh,19,9,4,14,46,Pass
Vivaan Fernandes,04-12-2005,122595,Punjab,6,19,6,10,41,Pass
Yash Reddy,01-01-2006,892089,Rajasthan,2,24,14,16,56,Pass
John Fernandes,10-09-2005,688648,Madhya Pradesh,3,10,8,24,45,Pass
Imran Reddy,02-07-2005,432677,Rajasthan,9,16,16,9,50,Pass
Krishna Chopra,31-10-2005,678525,Karnataka,15,17,7,5,44,Pass
Raj Pillai,01-05-2005,436104,Assam,5,17,2,3,27,Pass
Aditya Pillai,23-10-2005,167277,Uttar Pradesh,3,9,4,14,30,Pass
Raj Verma,16-02-2006,624766,Uttarakhand,0,8,8,21,37,Pass
Ishaan Sharma,22-09-2005,943243,Uttar Pradesh,20,9,4,14,47,Pass
Ishaan Fernandes,01-02-2006,646181,Uttar Pradesh,20,9,4,14,47,Pass
Krishna Khan,23-03-2005,524125,Haryana,6,12,17,16,51,Pass
Ishaan Fernandes,13-04-2006,325097,Chhattisgarh,3,14,23,14,54,Pass
Krishna Mehta,14-07-2005,353737,Bihar,16,7,1,17,41,Pass
Mathew Khan,10-05-2005,394590,Karnataka,2,21,10,18,51,Pass
Kunal Reddy,22-05-2005,707224,Kerala,2,4,17,8,31,Pass
Yash Singh,22-04-2005,391123,Uttar Pradesh,5,9,4,14,32,Pass
Aditya Verma,20-11-2005,895074,Chhattisgarh,13,0,5,11,29,Pass
Ishaan Pillai,24-01-2006,854097,Uttarakhand,3,24,8,19,54,Pass
Ishaan Khan,21-11-2004,946694,Rajasthan,22,3,7,12,44,Pass
Vivaan Verma,21-02-2006,954238,Madhya Pradesh,6,8,6,24,44,Pass
Aarav Mehta,04-11-2005,931745,Bihar,3,5,20,19,47,Pass
Yash Khan,11-04-2006,139234,Jharkhand,15,14,6,13,48,Pass
Aryan Sharma,11-01-2005,118372,Karnataka,15,4,14,1,34,Pass
Yash Khan,20-07-2005,725057,Uttar Pradesh,21,9,4,14,48,Pass
Sukhwinder Verma,12-04-2005,447637,Punjab,6,18,3,19,46,Pass
Rohan Sharma,25-02-2006,911711,Assam,11,8,21,9,49,Pass
John Fernandes,18-11-2004,157518,Uttar Pradesh,0,9,4,14,27,Pass
Raj Sharma,20-03-2005,603617,Bihar,15,17,8,12,52,Pass
Yash Sharma,08-09-2005,845147,Uttar Pradesh,2,9,4,14,29,Pass
Aarav Chopra,02-10-2005,504264,Gujarat,13,5,1,8,27,Pass
Yash Chopra,26-05-2005,261860,Maharashtra,16,4,0,21,41,Pass
Yash Reddy,08-11-2004,130178,Gujarat,12,7,3,20,42,Pass
Kunal D'Souza,07-03-2006,152836,Madhya Pradesh,1,23,3,11,38,Pass
Raj Singh,12-12-2005,506257,Telangana,22,3,15,23,63,Pass
Harjeet Pillai,03-05-2005,975901,Bihar,11,14,20,17,62,Pass
Kunal Mehta,06-10-2005,212901,Kerala,4,12,15,21,52,Pass
Vivaan Chopra,23-12-2004,278900,Rajasthan,6,5,6,2,19,Pass
Gurpreet Reddy,12-07-2005,379314,Madhya Pradesh,7,5,19,17,48,Pass
Rohan Chopra,01-07-2005,660880,Gujarat,2,17,11,7,37,Pass
Raj Verma,09-04-2006,398609,Andhra Pradesh,14,6,13,16,49,Pass
Raj Pillai,05-01-2005,913260,Uttar Pradesh,2,9,4,14,29,Pass
Vivaan D'Souza,20-02-2005,267490,West Bengal,3,21,22,9,55,Pass
Harjeet Sharma,26-12-2005,301620,Jharkhand,23,18,17,0,58,Pass
Imran Khan,02-03-2006,733406,Bihar,3,3,17,16,39,Pass
Manpreet Singh,09-07-2005,669268,Delhi,4,19,10,1,34,Pass
Krishna Reddy,28-12-2005,125584,Bihar,21,18,13,21,73,Pass
Aditya Verma,29-01-2006,685683,Punjab,16,13,17,11,57,Pass
Aditya Khan,06-05-2006,812118,Uttar Pradesh,18,9,4,14,45,Pass
Aryan Verma,29-05-2005,699152,Andhra Pradesh,13,7,20,1,41,Pass
Aditya D'Souza,02-04-2005,552450,Maharashtra,3,22,12,16,53,Pass
Rohan Verma,12-11-2005,288044,Bihar,13,19,17,3,52,Pass
Krishna Reddy,26-01-2006,895939,West Bengal,12,8,3,17,40,Pass
Vivaan Fernandes,18-11-2004,684995,Gujarat,14,15,9,6,44,Pass
Farhan Fernandes,29-05-2005,225440,Maharashtra,6,7,7,23,43,Pass
Ishaan Mehta,27-07-2005,523368,Tamil Nadu,4,3,4,3,14,Pass
Rohan Mehta,26-08-2005,980339,Chhattisgarh,7,23,5,0,35,Pass
Krishna Singh,19-02-2005,739117,Uttar Pradesh,21,9,4,14,48,Pass
Aryan Pillai,04-10-2005,461410,Uttar Pradesh,19,9,4,14,46,Pass
Rohan Reddy,08-03-2005,326631,Kerala,2,11,8,22,43,Pass
Yash Sharma,19-04-2005,285947,Uttar Pradesh,3,9,4,14,30,Pass
Aryan D'Souza,01-03-2006,934315,Uttar Pradesh,18,9,4,14,45,Pass
Aarav Chopra,15-12-2004,621292,Bihar,23,5,12,1,41,Pass
Mathew D'Souza,18-05-2005,129357,Andhra Pradesh,4,13,1,3,21,Pass
Aryan Sharma,16-02-2005,580021,Maharashtra,3,19,8,7,37,Pass
Ishaan Sharma,09-03-2006,908895,Nagaland,24,14,21,18,77,Pass
Manpreet Verma,13-07-2005,109739,Bihar,20,15,12,5,52,Pass
Aarav D'Souza,28-07-2005,895219,Maharashtra,5,20,12,11,48,Pass
Aditya Reddy,05-05-2005,216892,Rajasthan,15,9,8,14,46,Pass
Aarav Reddy,26-07-2005,264997,Jharkhand,13,17,7,12,49,Pass
Aarav Sharma,09-11-2004,591138,Gujarat,4,18,10,1,33,Pass
Manpreet Mehta,16-04-2005,132483,Gujarat,9,19,4,19,51,Pass
Krishna Sharma,30-12-2005,944040,Uttar Pradesh,0,9,4,14,27,Pass
Aryan Sharma,31-05-2005,770873,Madhya Pradesh,1,3,22,16,42,Pass
Mathew Reddy,01-05-2005,398001,Tamil Nadu,9,1,12,2,24,Pass
Aarav Sharma,16-11-2005,988918,Meghalaya,9,0,4,24,37,Pass
Harjeet Fernandes,23-11-2005,207624,Maharashtra,18,13,12,2,45,Pass
Aditya Verma,23-05-2005,173287,Madhya Pradesh,3,23,12,12,50,Pass
Vivaan Singh,26-01-2005,457040,Uttar Pradesh,10,9,4,14,37,Pass
Vivaan Khan,29-11-2005,513219,Tripura,3,1,11,16,31,Pass
Krishna Chopra,06-09-2005,119814,Tamil Nadu,16,0,21,1,38,Pass
Sukhwinder D'Souza,24-07-2005,146641,Odisha,5,3,20,4,32,Pass
Sukhwinder Chopra,24-11-2005,796793,Andhra Pradesh,23,18,4,7,52,Pass
Harjeet Chopra,01-07-2005,339126,Rajasthan,19,8,5,19,51,Pass
Gurpreet Reddy,11-04-2005,837297,Maharashtra,16,3,5,12,36,Pass
Krishna D'Souza,19-04-2006,779429,Maharashtra,1,23,13,12,49,Pass
Yash D'Souza,28-03-2006,592755,Haryana,24,8,12,10,54,Pass
Peter Pillai,28-06-2005,143761,Bihar,6,16,9,6,37,Pass
Gurpreet D'Souza,06-04-2005,761744,Uttar Pradesh,12,9,4,14,39,Pass
Yash Singh,21-09-2005,534660,Uttarakhand,5,14,8,18,45,Pass
Gurpreet Fernandes,30-09-2005,881931,Uttar Pradesh,3,9,4,14,30,Pass
John Chopra,11-11-2005,994794,Chhattisgarh,10,1,5,21,37,Pass
Aryan Fernandes,24-04-2006,536009,West Bengal,1,14,16,14,45,Pass
Raj Sharma,30-07-2005,503373,Uttar Pradesh,2,9,4,14,29,Pass
Rohan Mehta,01-04-2005,207489,Delhi,24,16,19,24,83,Pass
Rohan D'Souza,05-05-2006,402791,Uttar Pradesh,20,9,4,14,47,Pass
Yash Mehta,25-06-2005,446370,Rajasthan,24,15,12,18,69,Pass
Aryan Chopra,15-04-2006,309458,Delhi,5,18,12,3,38,Pass
Raj Reddy,24-03-2006,906639,Chhattisgarh,17,21,13,4,55,Pass
Paul Fernandes,01-09-2005,713850,Odisha,20,23,14,20,77,Pass
Rohan Singh,21-12-2004,816957,Bihar,24,13,14,5,56,Pass
Yash Reddy,07-09-2005,197447,West Bengal,3,23,21,20,67,Pass
Aryan Pillai,26-02-2005,622831,Gujarat,2,12,2,4,20,Pass
Aditya Sharma,20-08-2005,527558,Kerala,4,6,24,24,58,Pass
Raj Pillai,27-05-2005,795102,Maharashtra,11,8,15,1,35,Pass
Aarav Sharma,03-12-2004,345000,Gujarat,17,19,1,1,38,Pass
Kunal Mehta,02-03-2005,503229,Maharashtra,1,21,15,6,43,Pass
Krishna Mehta,19-11-2004,194832,Uttar Pradesh,4,9,4,14,31,Pass
Yash D'Souza,17-01-2006,850749,Uttar Pradesh,2,9,4,14,29,Pass
Aarav Chopra,12-02-2006,655604,Bihar,12,15,5,5,37,Pass
Raj Verma,11-03-2006,855605,Tamil Nadu,10,9,13,8,40,Pass
John Khan,01-01-2006,752556,Rajasthan,8,0,19,8,35,Pass
Manpreet Singh,18-01-2006,236955,Madhya Pradesh,18,3,7,17,45,Pass
Rohan Sharma,29-09-2005,735315,West Bengal,3,12,22,24,61,Pass
Paul Fernandes,23-03-2006,344905,Telangana,3,7,23,17,50,Pass
Vivaan Chopra,30-05-2005,115864,Uttarakhand,3,8,8,8,27,Pass
Krishna Verma,25-06-2005,284803,Bihar,4,11,18,20,53,Pass
Kunal Singh,25-02-2005,458999,Gujarat,10,16,8,14,48,Pass
Mathew Pillai,18-05-2005,424186,West Bengal,7,7,15,3,32,Pass
Balbir Verma,06-10-2005,991552,Assam,0,7,11,15,33,Pass
Aditya D'Souza,24-10-2005,984786,Telangana,13,3,23,15,54,Pass
Yash Verma,04-02-2006,765185,Bihar,8,24,13,14,59,Pass
Aarav Sharma,23-02-2005,156136,Madhya Pradesh,1,13,20,23,57,Pass
Aryan Reddy,12-03-2006,803114,Gujarat,8,10,7,21,46,Pass
Balbir Singh,01-03-2005,902986,Bihar,7,24,24,20,75,Pass
Vivaan D'Souza,15-01-2005,311931,Telangana,24,13,3,5,45,Pass
Mathew Mehta,09-04-2005,476013,Jharkhand,17,12,22,15,66,Pass
Aryan Reddy,22-12-2004,125857,Jharkhand,23,13,14,11,61,Pass
Aarav Pillai,06-10-2005,210176,Jammu & Kashmir + Ladakh,14,5,18,14,51,Pass
Aarav Fernandes,04-05-2006,851899,Uttar Pradesh,2,9,4,14,29,Pass
Peter D'Souza,30-11-2004,658851,Rajasthan,15,0,2,12,29,Pass
Yash Chopra,28-05-2005,854022,Assam,7,17,18,0,42,Pass
Raj Reddy,20-09-2005,151638,Bihar,15,17,16,20,68,Pass
Aarav D'Souza,28-12-2005,170739,Uttar Pradesh,23,9,4,14,50,Pass
Paul Reddy,21-12-2004,355088,Jharkhand,7,7,6,6,26,Pass
Yash Mehta,22-09-2005,886579,Maharashtra,1,9,13,18,41,Pass
Farhan Chopra,16-09-2005,409499,Bihar,21,14,2,8,45,Pass
Harjeet Mehta,02-11-2005,797255,Uttar Pradesh,11,9,4,14,38,Pass
Krishna Mehta,01-05-2006,253799,Uttar Pradesh,16,9,4,14,43,Pass
Rohan Chopra,15-04-2005,241337,Uttar Pradesh,19,9,4,14,46,Pass
Manpreet Singh,24-07-2005,364425,Punjab,19,7,5,10,41,Pass
Vivaan Khan,02-12-2004,395727,West Bengal,3,6,22,13,44,Pass
Kunal Singh,19-12-2004,722910,Uttar Pradesh,4,9,4,14,31,Pass
Raj Mehta,14-12-2005,404358,Assam,8,9,23,5,45,Pass
Krishna Khan,09-10-2005,885662,Uttar Pradesh,10,9,4,14,37,Pass
Kunal Khan,09-10-2005,627652,Rajasthan,18,22,14,24,78,Pass
Ayaan Reddy,28-05-2005,468894,Uttar Pradesh,14,9,4,14,41,Pass
Peter Sharma,15-05-2005,982430,Rajasthan,16,13,10,6,45,Pass
Kunal Pillai,26-06-2005,358368,Uttar Pradesh,17,9,4,14,44,Pass
Harjeet D'Souza,07-03-2005,627314,Haryana,14,22,1,1,38,Pass
Yash Reddy,19-03-2005,779623,Uttar Pradesh,12,9,4,14,39,Pass
Raj D'Souza,23-06-2005,538861,West Bengal,12,0,4,12,28,Pass
Aryan Chopra,13-11-2004,601739,Punjab,19,18,6,16,59,Pass
Rohan Fernandes,08-11-2005,224611,Uttar Pradesh,16,9,4,14,43,Pass
Manpreet Singh,22-10-2005,132458,Haryana,14,18,23,3,58,Pass
Aditya Mehta,24-01-2005,875097,Uttarakhand,1,0,8,22,31,Pass
Rohan Chopra,15-08-2005,148148,Punjab,23,6,3,20,52,Pass
Peter Singh,19-04-2005,103418,West Bengal,14,0,1,5,20,Pass
Ishaan Singh,03-12-2005,870694,Bihar,13,10,6,19,48,Pass
Yash Sharma,30-01-2005,245347,Rajasthan,14,3,7,4,28,Pass
Ishaan Sharma,26-08-2005,758631,Kerala,12,4,2,19,37,Pass
Harjeet Verma,24-08-2005,495972,Maharashtra,3,11,23,15,52,Pass
Gurpreet Khan,02-08-2005,517040,Andhra Pradesh,8,17,0,11,36,Pass
Vivaan Fernandes,07-04-2006,606846,Maharashtra,3,16,5,17,41,Pass
John Sharma,09-02-2005,127854,Maharashtra,5,3,24,9,41,Pass
Aarav D'Souza,04-12-2004,927967,Tamil Nadu,3,2,21,4,30,Pass
Manpreet Pillai,28-03-2005,766397,West Bengal,15,15,12,9,51,Pass
Ishaan D'Souza,26-07-2005,827437,Andhra Pradesh,7,4,20,11,42,Pass
Aryan Singh,21-11-2004,490709,Assam,15,8,2,21,46,Pass
Aditya D'Souza,09-10-2005,423043,Maharashtra,7,14,13,12,46,Pass
Paul Pillai,14-12-2005,603707,Odisha,13,24,5,5,47,Pass
Aditya Sharma,30-01-2006,244018,Andhra Pradesh,22,6,5,0,33,Pass
Gurpreet Pillai,30-11-2005,659901,Telangana,20,15,13,3,51,Pass
John D'Souza,05-04-2006,350308,Haryana,16,4,21,15,56,Pass
Rehan Mehta,09-06-2005,192120,Uttar Pradesh,11,9,4,14,38,Pass
Yash D'Souza,25-06-2005,773080,Uttarakhand,3,20,8,5,36,Pass
Rohan Khan,01-08-2005,341264,Maharashtra,18,1,13,3,35,Pass
Rohan Mehta,17-12-2005,876199,Rajasthan,10,3,22,22,57,Pass
Vivaan Fernandes,29-01-2006,758012,Odisha,14,9,16,3,42,Pass
Kunal Pillai,08-08-2005,245786,Uttar Pradesh,2,9,4,14,29,Pass
Sukhwinder Chopra,18-01-2006,127105,Rajasthan,3,10,16,13,42,Pass
Raj Reddy,29-03-2005,278976,Odisha,17,5,10,6,38,Pass
Manpreet Reddy,20-05-2005,538903,Tripura,0,18,4,2,24,Pass
Aryan Reddy,09-05-2006,560159,Bihar,15,0,8,14,37,Pass
Aditya D'Souza,11-11-2005,326911,Bihar,8,9,10,7,34,Pass
Gurpreet Mehta,29-11-2005,225300,Maharashtra,5,1,8,19,33,Pass
Raj Reddy,04-07-2005,696511,Maharashtra,7,18,3,16,44,Pass
Aryan D'Souza,16-06-2005,367877,Haryana,17,20,17,15,69,Pass
Aryan Khan,20-01-2006,436955,Rajasthan,7,9,12,18,46,Pass
Ishaan Verma,23-01-2005,491870,West Bengal,12,13,17,4,46,Pass
Kunal Pillai,13-02-2005,383197,Himachal Pradesh,2,23,22,14,61,Pass
Krishna Verma,04-05-2006,345574,Rajasthan,9,9,13,2,33,Pass
David Fernandes,15-03-2006,424521,West Bengal,3,10,19,24,56,Pass
Aditya Singh,27-03-2005,746635,Delhi,10,15,16,13,54,Pass
Vivaan Sharma,14-05-2005,959093,Haryana,21,1,22,19,63,Pass
Rohan Mehta,05-03-2005,256323,Assam,6,9,18,3,36,Pass
Sukhwinder Verma,13-12-2005,325617,Uttarakhand,3,0,8,15,26,Pass
Yash Singh,17-04-2005,514814,Madhya Pradesh,1,3,12,23,39,Pass
Harjeet Singh,14-05-2005,774209,Punjab,5,22,7,20,54,Pass
Aryan Reddy,01-04-2005,314520,Jharkhand,17,19,10,18,64,Pass
Balbir Chopra,16-03-2006,175501,Punjab,24,4,11,10,49,Pass
Krishna Chopra,28-04-2006,838650,Punjab,7,20,15,13,55,Pass
Aarav D'Souza,17-11-2005,298212,Telangana,22,24,3,16,65,Pass
Paul D'Souza,13-02-2005,305910,Maharashtra,3,0,8,23,34,Pass
Yash Mehta,19-06-2005,779482,Maharashtra,3,13,17,11,44,Pass
Mathew Pillai,22-02-2006,748691,Bihar,9,18,6,15,48,Pass
Rohan D'Souza,16-08-2005,681887,Uttar Pradesh,3,9,4,14,30,Pass
Rohan Sharma,09-02-2005,838455,Maharashtra,19,9,18,2,48,Pass
Aryan Sharma,03-10-2005,253834,Rajasthan,19,13,4,2,38,Pass
Zaid Reddy,03-08-2005,262654,Rajasthan,1,4,11,13,29,Pass
Gurpreet Reddy,03-12-2005,941033,Haryana,8,14,11,0,33,Pass
Rohan Khan,15-12-2004,374511,Gujarat,23,13,3,15,54,Pass
Raj Mehta,20-10-2005,607755,Bihar,1,10,14,8,33,Pass
Sukhwinder Singh,19-02-2006,670316,Mizoram,4,3,10,8,25,Pass
Aditya Mehta,04-06-2005,180201,Madhya Pradesh,4,16,10,7,37,Pass
John Reddy,23-04-2005,751558,Uttar Pradesh,0,9,4,14,27,Pass
Rohan Khan,21-03-2006,574615,Bihar,20,7,3,21,51,Pass
Sukhwinder Pillai,12-05-2005,639990,Tripura,19,18,9,3,49,Pass
Aditya D'Souza,24-09-2005,517498,Tamil Nadu,15,24,24,13,76,Pass
Aditya Verma,01-03-2006,498773,Kerala,7,19,11,0,37,Pass
Yash Fernandes,09-06-2005,552377,Chhattisgarh,7,17,14,22,60,Pass
Rohan Sharma,04-12-2005,514891,Bihar,19,13,8,16,56,Pass
Kunal Mehta,13-01-2006,705232,Rajasthan,20,6,6,22,54,Pass
Aryan Khan,28-06-2005,226883,Andhra Pradesh,7,18,15,3,43,Pass
Kunal Sharma,31-12-2005,805749,Arunachal Pradesh,14,5,12,0,31,Pass
Vivaan D'Souza,30-03-2006,100960,Madhya Pradesh,1,15,3,20,39,Pass
Ishaan Fernandes,15-08-2005,509623,Madhya Pradesh,16,1,3,21,41,Pass
Kunal Verma,15-01-2006,803777,Tamil Nadu,3,3,17,0,23,Pass
Kunal Singh,27-11-2005,125085,West Bengal,3,8,22,16,49,Pass
Ishaan Fernandes,28-05-2005,821871,Uttar Pradesh,12,9,4,14,39,Pass
Aditya Fernandes,18-12-2005,499481,Madhya Pradesh,11,0,19,15,45,Pass
Harjeet Pillai,08-04-2005,693797,Maharashtra,3,24,1,22,50,Pass
Aditya Mehta,01-02-2005,290116,Rajasthan,13,21,3,12,49,Pass
John Mehta,18-09-2005,914787,Rajasthan,12,24,1,20,57,Pass
Rehan Pillai,16-07-2005,258563,West Bengal,3,15,0,21,39,Pass
Raj Reddy,16-03-2006,688062,Punjab,18,12,19,10,59,Pass
Krishna Singh,04-02-2005,398624,Jammu & Kashmir + Ladakh,8,1,14,18,41,Pass
Vivaan Chopra,02-10-2005,946323,Tamil Nadu,7,3,4,1,15,Pass
Krishna Singh,23-11-2004,815600,Madhya Pradesh,6,7,5,11,29,Pass
Ayaan Singh,15-05-2005,874956,Jharkhand,4,24,7,6,41,Pass
Yash Chopra,10-07-2005,909473,Tamil Nadu,3,12,23,0,38,Pass
Rohan Pillai,27-02-2006,908525,Rajasthan,18,20,15,8,61,Pass
Aryan Sharma,21-02-2006,610882,Maharashtra,23,0,8,9,40,Pass
Krishna D'Souza,22-03-2005,423090,Haryana,8,2,7,8,25,Pass
Vivaan Pillai,22-09-2005,756029,Bihar,15,7,9,9,40,Pass
Aryan Fernandes,15-12-2004,784728,Rajasthan,5,9,11,24,49,Pass
Yash Chopra,27-12-2005,731586,Uttarakhand,0,17,8,8,33,Pass
Aryan Khan,13-07-2005,979723,Tamil Nadu,17,3,13,16,49,Pass
Rohan Reddy,13-06-2005,413442,Karnataka,22,3,6,24,55,Pass
Yash Verma,06-06-2005,342902,Bihar,21,3,10,3,37,Pass
Vivaan D'Souza,10-07-2005,644428,Uttar Pradesh,16,9,4,14,43,Pass
Yash Fernandes,05-06-2005,495990,Madhya Pradesh,14,24,5,5,48,Pass
John Singh,20-04-2005,884732,West Bengal,3,18,10,24,55,Pass
Aryan Singh,27-04-2006,969760,Gujarat,7,14,19,6,46,Pass
Imran Singh,07-04-2006,669917,Rajasthan,3,0,9,1,13,Pass
Aditya Mehta,02-03-2006,877765,Madhya Pradesh,12,0,5,2,19,Pass
Aarav Khan,12-06-2005,422186,Madhya Pradesh,1,9,10,2,22,Pass
Imran Chopra,05-07-2005,440658,Odisha,1,13,16,4,34,Pass
Harjeet Mehta,17-04-2006,413752,Andhra Pradesh,21,16,10,7,54,Pass
Aditya Reddy,20-04-2005,170895,Madhya Pradesh,15,1,12,19,47,Pass
John Fernandes,02-07-2005,429433,Uttar Pradesh,0,9,4,14,27,Pass
Ayaan Singh,17-12-2005,446768,Delhi,6,13,24,1,44,Pass
Aarav Pillai,05-05-2006,239286,Rajasthan,8,24,19,1,52,Pass
Paul Pillai,17-03-2005,415789,Bihar,8,16,2,6,32,Pass
Sukhwinder Sharma,16-07-2005,154293,Bihar,21,16,8,9,54,Pass
Krishna D'Souza,06-05-2006,709953,Maharashtra,6,15,8,0,29,Pass
Rohan Reddy,02-02-2006,469029,Madhya Pradesh,16,24,14,0,54,Pass
Rehan Reddy,07-12-2005,378389,Telangana,17,3,11,16,47,Pass
Manpreet Mehta,03-10-2005,729035,Delhi,18,12,17,5,52,Pass
Aarav D'Souza,12-01-2005,510459,Gujarat,10,21,3,10,44,Pass
Manpreet Verma,19-12-2004,942927,Kerala,7,17,24,16,64,Pass
Ayaan Mehta,27-10-2005,727971,Uttar Pradesh,10,9,4,14,37,Pass
Yash Mehta,09-09-2005,594666,West Bengal,2,4,12,22,40,Pass
Kunal D'Souza,01-03-2005,253146,Haryana,10,11,0,1,22,Pass
Aarav Verma,22-05-2005,221962,West Bengal,3,24,11,19,57,Pass
Balbir Pillai,06-01-2005,148524,Andhra Pradesh,7,9,21,1,38,Pass
Vivaan Reddy,15-07-2005,568393,Meghalaya,5,6,5,5,21,Pass
Kunal Reddy,22-07-2005,596218,Uttarakhand,9,13,8,14,44,Pass
Aryan Singh,25-07-2005,413044,Jharkhand,12,1,5,4,22,Pass
Aryan D'Souza,09-03-2005,621420,Tamil Nadu,7,14,16,23,60,Pass
Raj Sharma,15-02-2005,146316,West Bengal,18,0,9,14,41,Pass
Farhan Khan,05-01-2005,398832,Uttar Pradesh,0,9,4,14,27,Pass
Vivaan Mehta,21-12-2005,906329,Telangana,3,9,19,11,42,Pass
Paul Singh,13-04-2006,781675,Assam,7,8,3,18,36,Pass
Ishaan Khan,18-04-2006,482287,Tamil Nadu,24,16,22,18,80,Pass
Vivaan Chopra,26-08-2005,392685,Uttarakhand,12,1,8,4,25,Pass
Balbir Mehta,08-10-2005,743499,Chhattisgarh,15,24,7,21,67,Pass
Krishna Chopra,06-03-2006,871590,Karnataka,1,5,6,7,19,Pass
Aditya Verma,03-02-2005,945598,Rajasthan,8,18,20,3,49,Pass
Aditya D'Souza,20-12-2004,320489,Punjab,3,17,12,24,56,Pass
Raj Sharma,04-05-2005,923626,Rajasthan,17,8,19,23,67,Pass
Krishna Singh,28-11-2004,326719,Rajasthan,8,2,13,2,25,Pass
Aarav Mehta,18-02-2006,396455,Bihar,13,22,8,21,64,Pass
Aditya Khan,24-12-2004,888010,Bihar,4,1,16,4,25,Pass
Zaid Fernandes,28-04-2005,573269,Madhya Pradesh,2,3,0,8,13,Pass
Yash Khan,23-12-2004,610684,Maharashtra,3,12,17,12,44,Pass
Yash Mehta,04-04-2005,943165,Uttar Pradesh,10,9,4,14,37,Pass
Aryan Reddy,07-05-2006,327188,Telangana,16,21,1,23,61,Pass
Vivaan D'Souza,16-04-2006,637431,Uttar Pradesh,19,9,4,14,46,Pass
Raj Sharma,23-12-2005,260416,Bihar,8,22,5,3,38,Pass
Aryan D'Souza,29-04-2006,964696,Karnataka,8,24,2,15,49,Pass
Rohan D'Souza,31-10-2005,576509,Maharashtra,6,17,1,12,36,Pass
Aryan Chopra,06-10-2005,726252,West Bengal,3,20,15,16,54,Pass
David Singh,22-07-2005,879355,Madhya Pradesh,1,8,17,3,29,Pass
Aditya Verma,28-04-2006,310990,West Bengal,1,14,17,20,52,Pass
Aryan Mehta,14-02-2006,370138,West Bengal,2,4,22,10,38,Pass
Aryan Mehta,15-02-2005,119736,Punjab,12,3,22,22,59,Pass
Kunal Sharma,18-11-2005,545023,West Bengal,7,19,11,15,52,Pass
John Fernandes,04-02-2005,476298,Maharashtra,3,19,17,14,53,Pass
Vivaan Sharma,09-08-2005,911440,West Bengal,1,6,16,11,34,Pass
Ishaan D'Souza,03-06-2005,889864,Uttar Pradesh,22,9,4,14,49,Pass
John Pillai,05-07-2005,538418,Bihar,22,17,8,14,61,Pass
Paul Sharma,30-04-2006,642117,Uttar Pradesh,23,9,4,14,50,Pass
Peter Khan,04-12-2005,938613,Gujarat,11,14,3,19,47,Pass
Aryan Chopra,23-06-2005,423056,Telangana,7,4,13,11,35,Pass
Ayaan Reddy,20-07-2005,504473,Punjab,6,5,10,17,38,Pass
Kunal Singh,20-12-2005,298390,Rajasthan,17,8,9,11,45,Pass
Rohan Khan,30-11-2005,643999,Maharashtra,8,5,16,6,35,Pass
Vivaan Fernandes,23-01-2005,295124,Rajasthan,2,24,4,1,31,Pass
Aryan Mehta,05-12-2005,941294,Bihar,13,4,4,23,44,Pass
Krishna D'Souza,21-12-2004,353012,West Bengal,18,12,7,15,52,Pass
Aryan Pillai,14-10-2005,957224,Gujarat,3,22,15,12,52,Pass
Aarav D'Souza,11-12-2004,988009,Jammu & Kashmir + Ladakh,8,1,4,23,36,Pass
Ishaan Singh,07-05-2005,452459,Maharashtra,9,0,14,24,47,Pass
Aarav Reddy,11-03-2005,197894,Maharashtra,3,24,24,24,75,Pass
Aarav Pillai,26-09-2005,443835,Chhattisgarh,19,2,19,16,56,Pass
Raj Reddy,06-07-2005,177276,Rajasthan,16,10,1,18,45,Pass
Vivaan Khan,03-05-2005,407161,Uttar Pradesh,21,9,4,14,48,Pass
Yash Sharma,19-01-2006,415285,Bihar,1,2,23,5,31,Pass
Aditya Khan,04-02-2005,615084,Uttar Pradesh,10,9,4,14,37,Pass
Rohan Chopra,06-03-2006,577117,Uttarakhand,11,12,8,2,33,Pass
Krishna Reddy,25-10-2005,148287,West Bengal,3,9,23,22,57,Pass
Mathew D'Souza,06-07-2005,833726,Telangana,21,3,21,11,56,Pass
Rohan Verma,17-10-2005,907714,Gujarat,12,7,21,1,41,Pass
Yash Reddy,20-03-2006,879872,Chhattisgarh,16,22,23,15,76,Pass
Raj Sharma,05-04-2006,415903,Bihar,10,4,20,10,44,Pass
Farhan Sharma,29-04-2006,234466,Odisha,5,7,22,10,44,Pass
Krishna Pillai,20-03-2005,700314,Uttar Pradesh,12,9,4,14,39,Pass
Aditya Pillai,21-02-2005,129510,Chhattisgarh,18,2,6,17,43,Pass
Manpreet Mehta,01-04-2005,178451,Rajasthan,24,0,17,0,41,Pass
Yash Reddy,22-11-2005,994772,Rajasthan,8,8,19,10,45,Pass
Krishna Mehta,19-11-2005,740965,Maharashtra,5,22,1,13,41,Pass
Gurpreet Verma,29-11-2004,177256,Assam,14,9,7,13,43,Pass
Aarav Mehta,13-01-2006,835393,Tamil Nadu,23,6,9,5,43,Pass
Rohan Khan,29-12-2005,818714,Assam,11,4,2,8,25,Pass
David Mehta,12-03-2005,478092,Punjab,1,9,19,11,40,Pass
Rohan Fernandes,26-04-2006,314524,Rajasthan,11,0,5,6,22,Pass
John Khan,12-09-2005,771347,Andhra Pradesh,15,21,10,11,57,Pass
Kunal Singh,29-10-2005,202837,Gujarat,10,12,15,23,60,Pass
Ishaan Verma,10-06-2005,366281,Chhattisgarh,14,3,2,13,32,Pass
Sukhwinder Fernandes,19-12-2004,116001,Uttar Pradesh,3,9,4,14,30,Pass
Krishna Pillai,30-05-2005,510940,Rajasthan,24,21,5,2,52,Pass
Harjeet Sharma,12-04-2006,823090,Chhattisgarh,0,5,1,11,17,Pass
Imran Fernandes,26-12-2004,904737,Gujarat,19,18,16,11,64,Pass
Aryan Fernandes,14-05-2005,611478,Andhra Pradesh,11,14,15,15,55,Pass
Mathew Khan,27-03-2006,348236,Rajasthan,12,1,16,22,51,Pass
Mathew Singh,01-09-2005,708678,Uttar Pradesh,20,9,4,14,47,Pass
Vivaan Mehta,16-10-2005,816337,Tamil Nadu,11,10,18,10,49,Pass
Rehan Pillai,22-05-2005,346906,Bihar,22,12,6,14,54,Pass
Yash Chopra,23-08-2005,539935,Bihar,0,23,8,15,46,Pass
Vivaan Chopra,23-09-2005,375027,West Bengal,2,16,13,2,33,Pass
David Sharma,21-01-2005,413818,Gujarat,7,0,20,12,39,Pass
Paul Singh,04-04-2006,574546,Tripura,7,11,14,7,39,Pass
Ishaan Verma,21-01-2006,219896,Uttar Pradesh,17,9,4,14,44,Pass
Sukhwinder Sharma,13-12-2005,148523,Odisha,5,8,8,5,26,Pass
Rohan Verma,17-02-2005,830054,Karnataka,3,2,15,3,23,Pass
Kunal Chopra,02-01-2006,947338,Uttar Pradesh,19,9,4,14,46,Pass
Ishaan Chopra,15-04-2006,872605,Haryana,0,3,5,16,24,Pass
Aryan Sharma,06-01-2005,264946,Assam,8,7,20,3,38,Pass
Krishna Singh,08-04-2006,671410,Haryana,17,9,14,17,57,Pass
Aditya Reddy,27-07-2005,710041,Jharkhand,6,12,2,11,31,Pass
Manpreet Fernandes,29-11-2005,262222,Uttar Pradesh,14,9,4,14,41,Pass
Yash Mehta,17-01-2005,251318,Gujarat,18,12,7,4,41,Pass
Yash Reddy,20-02-2005,519395,Bihar,1,9,5,3,18,Pass
Raj Fernandes,15-05-2005,398176,Madhya Pradesh,1,5,3,14,23,Pass
Yash Khan,28-11-2005,751179,Punjab,5,24,13,14,56,Pass
Yash Verma,05-01-2006,579166,Sikkim,15,5,3,7,30,Pass
David Fernandes,17-07-2005,977805,Kerala,18,1,11,12,42,Pass
Ishaan Pillai,02-02-2006,946929,Himachal Pradesh,24,13,12,16,65,Pass
Yash Mehta,13-01-2006,412129,Maharashtra,12,5,6,2,25,Pass
Vivaan Mehta,12-03-2006,953148,Haryana,4,17,11,16,48,Pass
Kunal Verma,19-03-2006,237102,Goa,12,7,8,7,34,Pass
Aditya Reddy,10-11-2005,909759,Odisha,15,14,19,5,53,Pass
Balbir Reddy,03-03-2005,851156,Uttar Pradesh,21,9,4,14,48,Pass
Kunal Pillai,16-04-2005,988062,Uttar Pradesh,5,9,4,14,32,Pass
Raj Khan,16-12-2004,832251,Uttar Pradesh,23,9,4,14,50,Pass
Vivaan Singh,05-08-2005,409555,Uttar Pradesh,9,9,4,14,36,Pass
Vivaan Fernandes,12-04-2005,748322,Andaman & Nicobar,7,9,7,9,32,Pass
Kunal Singh,22-08-2005,215177,Odisha,3,5,11,9,28,Pass
Aryan D'Souza,19-04-2005,966186,Assam,6,2,7,8,23,Pass
Rohan Verma,23-03-2005,456047,Madhya Pradesh,1,3,21,21,46,Pass
Raj Sharma,13-12-2005,208984,Gujarat,7,1,13,6,27,Pass
Aarav D'Souza,04-03-2006,484347,Rajasthan,17,6,4,4,31,Pass
Aditya Reddy,23-02-2005,156919,Gujarat,5,20,19,14,58,Pass
Rohan D'Souza,08-09-2005,814404,Maharashtra,5,21,7,14,47,Pass
Sukhwinder Fernandes,20-05-2005,767230,Punjab,2,0,17,10,29,Pass
Mathew Chopra,23-04-2005,835296,Andhra Pradesh,16,10,10,18,54,Pass
Aditya Chopra,29-09-2005,452610,Kerala,20,18,1,2,41,Pass
Gurpreet Pillai,01-12-2004,944545,Bihar,4,7,7,9,27,Pass
Manpreet Reddy,10-12-2005,347609,Rajasthan,7,18,21,19,65,Pass
Paul Singh,18-02-2005,532014,Bihar,16,11,9,23,59,Pass
Balbir Fernandes,04-06-2005,412856,Rajasthan,5,17,16,24,62,Pass
Raj D'Souza,03-11-2005,962539,Madhya Pradesh,2,6,13,1,22,Pass
Vivaan Pillai,26-03-2006,776190,Karnataka,2,7,7,8,24,Pass
Peter Pillai,14-10-2005,626427,Bihar,7,7,6,18,38,Pass
Ishaan Verma,29-04-2005,547579,Punjab,13,7,15,1,36,Pass
Kunal Chopra,11-03-2005,594478,Punjab,4,10,14,14,42,Pass
Raj Sharma,21-03-2005,813466,Tamil Nadu,19,9,4,0,32,Pass
David Mehta,11-11-2004,291233,Kerala,12,22,3,5,42,Pass
Rohan Singh,22-04-2005,537752,Bihar,5,14,3,4,26,Pass
Rohan Mehta,01-07-2005,845988,Manipur,0,20,22,3,45,Pass
Yash D'Souza,26-01-2005,811090,Madhya Pradesh,1,22,13,24,60,Pass
Aarav Fernandes,27-11-2005,980320,Bihar,3,19,3,19,44,Pass
Kunal Khan,13-09-2005,432106,Karnataka,9,23,14,8,54,Pass
Aditya Sharma,21-10-2005,795682,Madhya Pradesh,7,1,6,19,33,Pass
Aarav Mehta,03-08-2005,200532,Haryana,8,18,4,23,53,Pass
Yash Mehta,14-04-2006,670467,Rajasthan,0,8,7,0,15,Pass
Vivaan Mehta,18-01-2006,466658,Telangana,4,20,3,23,50,Pass
Ishaan D'Souza,20-12-2005,503012,Himachal Pradesh,5,6,7,9,27,Pass
Aarav Sharma,15-12-2005,539599,West Bengal,3,16,9,22,50,Pass
Kunal Verma,24-04-2006,235521,Maharashtra,2,24,6,3,35,Pass
Harjeet Pillai,10-01-2006,132952,Andhra Pradesh,9,8,4,4,25,Pass
Mathew Reddy,19-02-2005,330312,Telangana,21,15,8,3,47,Pass
Raj Chopra,22-01-2005,731264,Tripura,20,13,24,3,60,Pass
Aditya Fernandes,06-05-2006,386871,Andhra Pradesh,15,13,3,9,40,Pass
Aditya Verma,09-02-2006,722516,Rajasthan,18,13,16,18,65,Pass
Aarav D'Souza,21-07-2005,562206,West Bengal,3,15,24,24,66,Pass
Krishna Khan,28-05-2005,683860,Uttar Pradesh,11,9,4,14,38,Pass
Yash Khan,14-12-2005,468200,Maharashtra,3,21,10,17,51,Pass
Rohan Sharma,08-05-2006,798327,Delhi,6,23,23,3,55,Pass
Mathew Verma,27-12-2005,352775,Madhya Pradesh,7,19,2,9,37,Pass
Sukhwinder Chopra,21-12-2004,976668,Punjab,3,24,2,23,52,Pass
Gurpreet Mehta,05-01-2006,137882,Tamil Nadu,10,5,13,18,46,Pass
Paul Khan,21-01-2006,918140,Rajasthan,7,6,23,4,40,Pass
Rohan Mehta,24-08-2005,835189,Tamil Nadu,24,23,16,15,78,Pass
Manpreet Fernandes,11-02-2006,189720,Punjab,13,13,15,2,43,Pass
Gurpreet Verma,27-06-2005,667659,Bihar,14,24,9,21,68,Pass
Krishna D'Souza,11-04-2005,889501,Bihar,15,8,6,7,36,Pass
Ayaan Khan,27-11-2005,431431,Chhattisgarh,18,9,2,10,39,Pass
Vivaan Khan,15-10-2005,382388,Jharkhand,6,0,15,2,23,Pass
Aditya Fernandes,21-03-2005,608525,Bihar,9,8,8,17,42,Pass
Raj D'Souza,31-10-2005,299045,Jharkhand,23,6,23,3,55,Pass
Imran Sharma,18-03-2006,462199,Telangana,15,16,3,15,49,Pass
Kunal D'Souza,14-11-2005,161491,Uttar Pradesh,6,9,4,14,33,Pass
Kunal Reddy,31-03-2005,599183,Rajasthan,3,9,11,1,24,Pass
Krishna Sharma,17-06-2005,145589,Rajasthan,3,21,19,6,49,Pass
Sukhwinder D'Souza,15-03-2006,388617,Uttar Pradesh,11,9,4,14,38,Pass
Krishna Fernandes,03-08-2005,382303,Maharashtra,6,21,0,6,33,Pass
Kunal Verma,03-01-2006,472971,Madhya Pradesh,7,19,21,6,53,Pass
Yash Khan,19-02-2005,737107,Maharashtra,9,22,8,7,46,Pass
Rohan Singh,05-03-2006,865056,West Bengal,3,23,14,16,56,Pass
Yash Mehta,11-10-2005,657964,Odisha,3,5,20,11,39,Pass
Aditya Khan,20-10-2005,539734,Tamil Nadu,24,22,1,4,51,Pass
Kunal Sharma,08-09-2005,838401,Haryana,21,16,5,15,57,Pass
Aryan Chopra,20-01-2006,847937,Arunachal Pradesh,6,5,12,10,33,Pass
Krishna Chopra,24-06-2005,534880,Rajasthan,9,18,18,1,46,Pass
Aryan Mehta,18-12-2004,332047,Madhya Pradesh,6,16,4,16,42,Pass
Krishna Pillai,26-05-2005,536483,Andhra Pradesh,8,10,3,7,28,Pass
Gurpreet D'Souza,02-05-2006,431880,Meghalaya,12,4,7,7,30,Pass
Harjeet Singh,13-04-2006,631799,Telangana,10,13,5,5,33,Pass
Ishaan Singh,22-11-2005,137205,Andhra Pradesh,19,7,20,0,46,Pass
Kunal Reddy,10-01-2006,224253,Rajasthan,24,14,11,19,68,Pass
Aditya Verma,21-02-2005,930637,Karnataka,6,13,6,19,44,Pass
Ishaan Mehta,22-02-2006,511803,Bihar,7,17,1,19,44,Pass
Gurpreet Singh,14-03-2005,274966,Karnataka,1,21,23,6,51,Pass
Krishna Verma,17-12-2004,532154,Bihar,5,24,4,21,54,Pass
Yash Fernandes,26-04-2006,186672,Uttar Pradesh,15,9,4,14,42,Pass
Ishaan Sharma,08-06-2005,534734,Maharashtra,6,7,0,13,26,Pass
Sukhwinder Singh,13-04-2006,561402,Chhattisgarh,9,10,6,19,44,Pass
Zaid Reddy,16-08-2005,575973,Bihar,12,19,6,15,52,Pass
Ishaan Chopra,13-02-2005,481287,Bihar,2,3,24,13,42,Pass
Aarav Pillai,05-01-2006,507176,Rajasthan,9,3,16,4,32,Pass
Ishaan Verma,17-09-2005,526028,Tripura,1,12,20,17,50,Pass
Vivaan D'Souza,29-11-2005,878678,Chhattisgarh,8,7,11,3,29,Pass
Aditya Fernandes,29-05-2005,212786,Haryana,5,8,14,16,43,Pass
Ishaan Pillai,21-12-2005,696919,Maharashtra,8,9,8,11,36,Pass
Aarav Pillai,31-01-2005,176643,Jharkhand,5,5,5,5,20,Pass
Paul Mehta,06-02-2006,466317,Uttar Pradesh,5,9,4,14,32,Pass
Yash D'Souza,01-10-2005,759759,Haryana,8,6,11,0,25,Pass
Ishaan Chopra,10-03-2006,531791,Sikkim,14,6,5,3,28,Pass
Manpreet Verma,14-02-2006,466740,West Bengal,7,3,19,13,42,Pass
Yash Verma,01-11-2005,483044,Odisha,10,7,15,6,38,Pass
Paul Sharma,24-02-2006,582105,Gujarat,12,6,14,0,32,Pass
Sukhwinder D'Souza,18-03-2006,747696,Uttar Pradesh,5,9,4,14,32,Pass
Aarav Verma,31-03-2005,247763,Jharkhand,5,14,9,17,45,Pass
Aarav Chopra,07-05-2005,888498,Punjab,10,11,4,9,34,Pass
Manpreet Mehta,19-06-2005,255910,Haryana,6,6,20,20,52,Pass
Ishaan Verma,17-03-2006,835434,Odisha,13,3,11,14,41,Pass
Ayaan Fernandes,15-08-2005,346374,Bihar,10,16,17,2,45,Pass
Balbir Chopra,12-09-2005,641089,Maharashtra,3,23,16,13,55,Pass
Krishna Reddy,06-10-2005,641855,Uttar Pradesh,21,9,4,14,48,Pass
Aarav Mehta,13-12-2004,974661,Tamil Nadu,7,11,2,12,32,Pass
Mathew Singh,31-03-2005,975459,Telangana,4,3,19,13,39,Pass
Peter Sharma,30-01-2006,724338,Haryana,10,3,3,15,31,Pass
Mathew D'Souza,02-01-2006,115249,Telangana,3,23,1,19,46,Pass
Mathew Chopra,28-11-2004,921314,Uttar Pradesh,5,9,4,14,32,Pass
Krishna Khan,30-03-2006,598521,Maharashtra,3,8,21,18,50,Pass
Farhan Pillai,31-07-2005,362313,Karnataka,0,16,4,4,24,Pass
David Khan,18-02-2006,709318,West Bengal,3,11,24,10,48,Pass
Rohan Singh,23-03-2006,107547,Bihar,17,17,0,18,52,Pass
Kunal Chopra,26-04-2006,748810,Jharkhand,7,7,11,9,34,Pass
Sukhwinder Singh,12-01-2005,988698,Uttar Pradesh,18,9,4,14,45,Pass
Aditya D'Souza,08-05-2005,670298,Karnataka,15,21,2,20,58,Pass
Ishaan Sharma,20-09-2005,490984,Uttar Pradesh,3,9,4,14,30,Pass
Harjeet Fernandes,14-12-2004,184190,West Bengal,3,12,16,24,55,Pass
Sukhwinder Sharma,30-07-2005,159022,West Bengal,4,11,12,24,51,Pass
Rohan Mehta,07-09-2005,191472,Jammu & Kashmir + Ladakh,3,1,1,1,6,Pass
Rohan Mehta,03-03-2005,573372,Gujarat,23,11,4,7,45,Pass
Imran Chopra,28-07-2005,976158,Madhya Pradesh,22,14,5,9,50,Pass
Krishna Khan,30-05-2005,351443,Rajasthan,19,1,19,13,52,Pass
Ishaan Khan,19-11-2004,301980,Rajasthan,4,24,5,8,41,Pass
Aditya Mehta,30-04-2005,545288,Himachal Pradesh,22,5,0,15,42,Pass
Peter Mehta,26-01-2005,703847,Bihar,16,5,3,9,33,Pass
Gurpreet Khan,06-10-2005,530012,Jharkhand,14,10,23,5,52,Pass
Kunal Mehta,01-04-2005,844365,Jharkhand,5,19,5,0,29,Pass
Aditya D'Souza,06-08-2005,320570,Uttar Pradesh,3,9,4,14,30,Pass
Ayaan Verma,03-04-2005,942469,Uttar Pradesh,21,9,4,14,48,Pass
Sukhwinder Sharma,01-07-2005,289087,Rajasthan,8,4,13,17,42,Pass
Raj D'Souza,20-12-2005,631418,Haryana,7,14,13,24,58,Pass
Kunal Fernandes,10-02-2006,652832,Uttarakhand,13,5,8,0,26,Pass
Aditya Pillai,01-12-2004,818103,Odisha,23,19,24,21,87,Pass
Paul Sharma,31-03-2005,693945,Uttar Pradesh,0,9,4,14,27,Pass
Aditya Fernandes,08-10-2005,484045,Andhra Pradesh,6,15,3,0,24,Pass
Vivaan Reddy,04-10-2005,522800,Uttar Pradesh,5,9,4,14,32,Pass
Vivaan Sharma,02-05-2005,460831,Punjab,24,0,16,3,43,Pass
Aryan Reddy,30-12-2004,139349,Haryana,16,8,17,20,61,Pass
Aryan Khan,11-10-2005,318445,Uttar Pradesh,4,9,4,14,31,Pass
Ishaan Reddy,28-04-2006,644986,Madhya Pradesh,1,3,23,12,39,Pass
Rohan Sharma,06-10-2005,833841,Madhya Pradesh,21,11,14,2,48,Pass
Aarav Verma,16-11-2004,650563,Jharkhand,16,5,14,2,37,Pass
Gurpreet D'Souza,31-12-2004,676503,Madhya Pradesh,7,3,10,4,24,Pass
Aryan Mehta,15-10-2005,764547,Jammu & Kashmir + Ladakh,9,16,7,17,49,Pass
Aditya Chopra,04-05-2006,543887,Uttar Pradesh,19,9,4,14,46,Pass
Sukhwinder Fernandes,14-03-2005,543389,Odisha,19,4,12,3,38,Pass
Krishna Fernandes,11-05-2005,919961,Bihar,0,17,16,22,55,Pass
Aditya Verma,14-12-2004,385727,Bihar,23,5,12,7,47,Pass
Aryan Mehta,07-02-2005,559780,Chhattisgarh,17,20,6,15,58,Pass
Rohan D'Souza,12-04-2006,488927,Uttar Pradesh,13,9,4,14,40,Pass
Yash D'Souza,24-01-2006,296251,West Bengal,7,0,0,12,19,Pass
Mathew Chopra,16-10-2005,946627,Tamil Nadu,23,20,8,14,65,Pass
Rohan Chopra,19-03-2006,305497,Uttar Pradesh,24,9,4,14,51,Pass
Aryan Reddy,29-11-2004,773052,Gujarat,5,3,2,8,18,Pass
Krishna D'Souza,05-03-2005,764394,Karnataka,3,1,1,19,24,Pass
Yash D'Souza,30-11-2005,218486,Karnataka,3,6,17,22,48,Pass
Manpreet D'Souza,30-11-2005,896188,Tamil Nadu,2,18,0,17,37,Pass
Krishna Chopra,19-08-2005,571390,Maharashtra,3,21,12,16,52,Pass
Peter Chopra,19-10-2005,771952,Madhya Pradesh,12,1,23,16,52,Pass
Aryan Pillai,23-01-2005,410513,Delhi,1,2,19,23,45,Pass
Harjeet Sharma,10-10-2005,425170,Andhra Pradesh,6,6,1,20,33,Pass
Rehan Mehta,26-11-2005,431262,West Bengal,11,3,12,5,31,Pass
Aarav Sharma,07-12-2005,745237,Assam,5,8,14,13,40,Pass
Balbir Singh,22-04-2005,161922,Tripura,1,12,3,20,36,Pass
Rohan D'Souza,20-01-2006,595362,Bihar,11,4,10,0,25,Pass
Krishna Reddy,24-12-2005,416454,Bihar,20,14,2,19,55,Pass
Raj D'Souza,04-06-2005,337931,Bihar,7,13,10,8,38,Pass
Balbir Pillai,13-04-2006,609416,Gujarat,6,16,12,18,52,Pass
Manpreet Khan,11-05-2005,321100,Haryana,13,2,24,7,46,Pass
Zaid Fernandes,20-04-2006,966790,Madhya Pradesh,14,13,1,0,28,Pass
Rohan Pillai,26-03-2005,767714,Rajasthan,15,11,12,10,48,Pass
Aryan Chopra,21-10-2005,224337,Jammu & Kashmir + Ladakh,3,20,0,21,44,Pass
Balbir Reddy,22-07-2005,612430,West Bengal,10,24,1,12,47,Pass
Raj Reddy,04-11-2005,367969,West Bengal,7,3,12,18,40,Pass
Zaid Khan,03-07-2005,208488,Manipur,5,1,0,7,13,Pass
Raj Sharma,26-08-2005,974837,Assam,2,6,8,22,38,Pass
Sukhwinder Chopra,10-09-2005,252585,Rajasthan,2,19,6,20,47,Pass
Aryan Sharma,19-06-2005,592697,Uttar Pradesh,6,9,4,14,33,Pass
Aditya Sharma,08-11-2005,652630,Karnataka,19,4,7,2,32,Pass
Ishaan Chopra,10-03-2005,869633,Himachal Pradesh,3,5,19,17,44,Pass
Aryan Fernandes,31-01-2006,237100,Telangana,3,15,12,6,36,Pass
Aryan Singh,23-03-2006,101355,Andhra Pradesh,3,18,16,12,49,Pass
Manpreet Singh,22-10-2005,154472,Punjab,12,3,17,15,47,Pass
Peter Reddy,10-01-2005,600970,Maharashtra,3,4,13,19,39,Pass
Aarav Sharma,26-04-2006,716283,Punjab,2,4,5,21,32,Pass
Kunal Fernandes,27-06-2005,738069,Gujarat,18,11,11,9,49,Pass
Aarav Khan,02-06-2005,142699,Bihar,21,23,0,14,58,Pass
Paul Verma,08-01-2006,886755,Rajasthan,3,20,6,3,32,Pass
Vivaan Chopra,03-01-2005,743836,Andhra Pradesh,23,6,18,5,52,Pass
Aryan Fernandes,01-09-2005,577600,Tamil Nadu,18,18,15,5,56,Pass
Raj D'Souza,18-12-2005,992273,Uttar Pradesh,15,9,4,14,42,Pass
Gurpreet Chopra,14-05-2005,987147,Madhya Pradesh,3,21,0,17,41,Pass
Raj Pillai,19-11-2004,892999,Madhya Pradesh,17,12,2,1,32,Pass
Gurpreet Pillai,20-01-2006,280568,Telangana,2,16,8,3,29,Pass
Peter D'Souza,05-08-2005,514812,Maharashtra,6,9,0,23,38,Pass
Krishna Khan,27-11-2004,235607,Uttar Pradesh,15,9,4,14,42,Pass
Ishaan Khan,18-11-2005,162585,Puducherry,6,13,13,4,36,Pass
Raj Fernandes,26-11-2004,332273,Uttar Pradesh,12,9,4,14,39,Pass
Harjeet Verma,27-05-2005,213427,Uttar Pradesh,10,9,4,14,37,Pass
Peter D'Souza,26-10-2005,293663,Tamil Nadu,5,23,21,7,56,Pass
Rohan Reddy,25-11-2004,562300,Tamil Nadu,15,12,6,0,33,Pass
Aarav Chopra,11-02-2006,153982,Rajasthan,20,13,16,19,68,Pass
Yash Reddy,24-08-2005,261184,Haryana,9,18,12,17,56,Pass
Krishna Sharma,27-01-2006,967906,Andhra Pradesh,15,13,9,21,58,Pass
Aditya Verma,13-03-2005,692118,Rajasthan,2,2,7,15,26,Pass
Harjeet Chopra,09-05-2005,742233,Maharashtra,22,4,3,10,39,Pass
Vivaan Khan,27-08-2005,733917,Punjab,12,20,5,14,51,Pass
Kunal Reddy,06-01-2005,361246,Madhya Pradesh,23,11,10,7,51,Pass
Krishna Khan,25-08-2005,661502,Madhya Pradesh,1,19,3,19,42,Pass
Paul Fernandes,22-05-2005,972996,Rajasthan,19,9,12,10,50,Pass
Vivaan Reddy,25-01-2006,496119,Rajasthan,13,19,20,22,74,Pass
Krishna D'Souza,14-09-2005,233351,Rajasthan,0,10,17,12,39,Pass
Vivaan Khan,10-04-2005,165950,Madhya Pradesh,15,20,14,2,51,Pass
Balbir Fernandes,15-01-2006,612372,Andhra Pradesh,9,18,24,7,58,Pass
Farhan Khan,11-11-2005,538591,Uttarakhand,3,11,8,15,37,Pass
Balbir Mehta,14-08-2005,263034,Rajasthan,19,15,12,17,63,Pass
Farhan Sharma,14-04-2006,564278,Maharashtra,4,14,13,4,35,Pass
Aryan Singh,23-10-2005,763187,Maharashtra,3,19,8,8,38,Pass
Rohan Verma,05-03-2005,580761,West Bengal,22,11,19,1,53,Pass
Manpreet Singh,22-08-2005,383812,Maharashtra,3,21,0,24,48,Pass
David Fernandes,28-04-2006,905993,Jharkhand,0,13,19,2,34,Pass
Harjeet Khan,16-11-2004,873723,Andhra Pradesh,14,22,5,2,43,Pass
Aditya Khan,12-12-2004,194389,Punjab,19,2,20,8,49,Pass
Raj Verma,04-12-2005,511198,Rajasthan,22,22,11,1,56,Pass
Yash Sharma,02-09-2005,873597,Telangana,15,3,18,11,47,Pass
Vivaan Mehta,27-01-2005,818197,Uttarakhand,9,4,8,16,37,Pass
Krishna Chopra,07-04-2006,608948,Haryana,18,7,8,10,43,Pass
Aarav Reddy,05-09-2005,536041,Maharashtra,10,13,5,5,33,Pass
Manpreet Singh,19-03-2006,446302,Andhra Pradesh,10,5,15,12,42,Pass
Vivaan Singh,04-06-2005,424162,Tamil Nadu,21,0,4,23,48,Pass
Raj Singh,09-11-2005,864747,Andhra Pradesh,12,16,1,17,46,Pass
Aarav Fernandes,10-03-2005,128331,Rajasthan,10,16,16,0,42,Pass
Balbir Fernandes,03-12-2004,532004,Telangana,18,3,8,0,29,Pass
Aditya Reddy,20-04-2005,235676,Rajasthan,5,14,12,0,31,Pass
Raj Reddy,17-04-2005,919743,West Bengal,10,21,4,9,44,Pass
Krishna Chopra,19-11-2005,972310,Uttar Pradesh,4,9,4,14,31,Pass
John Verma,19-01-2005,357526,Madhya Pradesh,5,13,22,15,55,Pass
Balbir Verma,13-10-2005,659981,West Bengal,5,22,13,8,48,Pass
Ishaan Khan,04-07-2005,358181,Madhya Pradesh,9,8,6,3,26,Pass
Harjeet Pillai,16-07-2005,410213,Manipur,7,19,12,2,40,Pass
Harjeet Mehta,03-01-2006,367342,Uttar Pradesh,15,9,4,14,42,Pass
Rohan Fernandes,04-04-2006,172986,Tamil Nadu,11,15,19,24,69,Pass
Ishaan Sharma,31-12-2004,365325,Tamil Nadu,0,5,13,23,41,Pass
Sukhwinder Mehta,11-09-2005,621959,Andhra Pradesh,19,11,8,7,45,Pass
Gurpreet Singh,01-01-2005,228941,Bihar,14,24,14,24,76,Pass
Kunal Chopra,22-07-2005,464926,Tamil Nadu,21,5,11,11,48,Pass
Paul Mehta,30-11-2004,266564,Jammu & Kashmir + Ladakh,24,11,19,10,64,Pass
Gurpreet D'Souza,02-12-2005,921075,Karnataka,21,12,3,20,56,Pass
Ishaan D'Souza,03-04-2005,451747,Tamil Nadu,15,20,1,6,42,Pass
Aarav Fernandes,10-02-2006,531359,Gujarat,21,2,15,15,53,Pass
Balbir Fernandes,04-11-2005,688261,Telangana,6,20,13,3,42,Pass
John Fernandes,21-11-2004,735023,Telangana,24,13,3,4,44,Pass
Vivaan Sharma,28-03-2005,853231,Madhya Pradesh,1,13,17,3,34,Pass
Peter Mehta,10-04-2005,734605,Bihar,18,1,8,22,49,Pass
Yash Pillai,12-09-2005,366765,Jharkhand,3,5,17,3,28,Pass
Aryan Fernandes,28-01-2005,675781,Maharashtra,8,9,9,13,39,Pass
Aarav Chopra,24-08-2005,725673,Uttar Pradesh,16,9,4,14,43,Pass
Aditya Singh,12-02-2006,757756,Maharashtra,22,3,12,8,45,Pass
Manpreet Chopra,03-03-2006,178814,Madhya Pradesh,24,10,0,3,37,Pass
Aarav Chopra,02-12-2004,286758,Andhra Pradesh,19,1,1,11,32,Pass
Harjeet Sharma,02-04-2006,707003,Tamil Nadu,24,18,0,14,56,Pass
Aarav D'Souza,04-04-2006,758184,Kerala,17,17,20,6,60,Pass
Vivaan Fernandes,11-12-2005,880892,Maharashtra,8,3,20,2,33,Pass
Krishna Singh,06-08-2005,341628,Assam,9,1,7,23,40,Pass
Vivaan Khan,09-03-2005,393485,Chhattisgarh,18,19,11,20,68,Pass
Ishaan Verma,02-02-2006,773574,Rajasthan,2,17,14,9,42,Pass
Aarav Pillai,18-10-2005,889890,Gujarat,8,6,23,2,39,Pass
Sukhwinder Singh,31-03-2005,548915,West Bengal,14,1,17,11,43,Pass
Aryan Mehta,13-12-2004,477088,Gujarat,2,2,14,19,37,Pass
Aditya Khan,03-04-2005,608713,Andhra Pradesh,4,0,13,14,31,Pass
Aarav Chopra,26-10-2005,467056,Uttar Pradesh,22,9,4,14,49,Pass
Harjeet D'Souza,05-12-2005,804173,Uttarakhand,3,17,8,11,39,Pass
Aarav Chopra,25-05-2005,783930,Maharashtra,3,18,3,23,47,Pass
Aarav Mehta,12-04-2006,707644,Uttarakhand,3,24,8,19,54,Pass
Krishna Sharma,18-02-2005,482235,West Bengal,0,6,13,19,38,Pass
Raj Pillai,12-02-2005,608954,Rajasthan,23,2,23,0,48,Pass
Krishna Mehta,17-08-2005,100820,Maharashtra,3,23,9,6,41,Pass
Aryan Reddy,06-11-2005,747377,Tamil Nadu,16,10,5,5,36,Pass
Aryan Sharma,20-12-2004,430874,West Bengal,10,8,15,9,42,Pass
John Verma,01-03-2006,613424,Karnataka,19,8,18,14,59,Pass
Aarav Khan,18-02-2006,671889,Himachal Pradesh,3,2,11,18,34,Pass
Aarav Fernandes,30-05-2005,235235,Karnataka,12,24,4,4,44,Pass
John Reddy,18-02-2005,450204,Maharashtra,3,14,22,17,56,Pass
Aryan Verma,11-07-2005,501818,Maharashtra,19,0,12,16,47,Pass
Sukhwinder Khan,25-12-2005,277432,Bihar,7,9,6,17,39,Pass
Kunal Mehta,20-11-2004,373268,Telangana,15,8,0,4,27,Pass
David Fernandes,13-12-2004,501181,Madhya Pradesh,10,9,10,5,34,Pass
Kunal Pillai,26-10-2005,730666,Bihar,21,10,2,6,39,Pass
David Singh,26-10-2005,440356,Andhra Pradesh,4,20,2,14,40,Pass
Zaid Fernandes,25-05-2005,357855,Manipur,4,20,9,7,40,Pass
Kunal Sharma,16-06-2005,231278,Tripura,1,12,8,5,26,Pass
Paul Mehta,29-03-2005,610620,Madhya Pradesh,20,9,17,5,51,Pass
Aryan D'Souza,11-04-2005,829713,Haryana,19,10,5,7,41,Pass
Aditya D'Souza,14-11-2004,538772,Kerala,16,21,24,2,63,Pass
Rohan Verma,08-10-2005,139144,Delhi,4,8,23,21,56,Pass
Vivaan Mehta,26-08-2005,139146,Rajasthan,11,21,17,16,65,Pass
Krishna D'Souza,12-01-2006,131623,Telangana,12,13,17,3,45,Pass
Raj D'Souza,18-02-2006,325872,Assam,8,1,6,20,35,Pass
Farhan Singh,17-09-2005,861135,Haryana,17,10,3,21,51,Pass
Peter Singh,21-09-2005,965661,Uttar Pradesh,10,9,4,14,37,Pass
Krishna Pillai,30-01-2005,178988,West Bengal,2,7,6,14,29,Pass
Rohan Fernandes,18-09-2005,694339,Andhra Pradesh,7,12,0,3,22,Pass
Rohan D'Souza,04-08-2005,985597,Bihar,8,18,2,23,51,Pass
Kunal Pillai,08-07-2005,361275,Kerala,18,16,8,9,51,Pass
Balbir Verma,04-03-2005,197216,Punjab,16,22,6,13,57,Pass
Vivaan Pillai,15-03-2005,915507,Meghalaya,6,7,7,9,29,Pass
Raj Pillai,15-02-2006,633172,Chhattisgarh,14,1,2,6,23,Pass
David Fernandes,25-12-2004,123087,Meghalaya,20,13,2,3,38,Pass
Vivaan Mehta,21-05-2005,657630,Rajasthan,5,10,0,7,22,Pass
Yash Singh,30-03-2006,837475,Uttar Pradesh,7,9,4,14,34,Pass
Manpreet D'Souza,19-06-2005,102308,Assam,6,9,15,13,43,Pass
Vivaan Chopra,07-05-2005,518594,Tamil Nadu,14,9,1,15,39,Pass
John Khan,06-01-2006,113934,West Bengal,0,16,4,6,26,Pass
Aditya Singh,23-03-2006,893345,Uttar Pradesh,3,9,4,14,30,Pass
Rohan D'Souza,16-09-2005,841620,Delhi,19,1,0,20,40,Pass
Aarav D'Souza,03-07-2005,732925,Uttar Pradesh,9,9,4,14,36,Pass
Aryan D'Souza,20-11-2004,899890,Madhya Pradesh,20,9,14,2,45,Pass
Raj Chopra,08-05-2005,580253,Rajasthan,7,22,1,7,37,Pass
Kunal Fernandes,03-07-2005,938229,Uttar Pradesh,3,9,4,14,30,Pass
Rohan Mehta,10-06-2005,208225,Rajasthan,7,6,22,15,50,Pass
Ayaan Pillai,05-02-2006,209068,Tamil Nadu,24,3,5,5,37,Pass
Yash Sharma,28-02-2005,866919,Odisha,12,12,10,3,37,Pass
David Mehta,19-11-2005,269122,Telangana,14,0,3,24,41,Pass
John Chopra,14-07-2005,297715,Odisha,6,16,3,8,33,Pass
Mathew Pillai,02-02-2006,373626,Bihar,22,15,7,10,54,Pass
Raj D'Souza,18-11-2005,583944,Andhra Pradesh,11,17,22,3,53,Pass
Kunal Khan,09-12-2005,219879,Bihar,1,12,4,3,20,Pass
Aarav D'Souza,08-03-2005,936225,Jharkhand,20,18,3,13,54,Pass
Yash Fernandes,24-02-2005,423552,Odisha,17,22,24,21,84,Pass
Aarav Sharma,03-02-2005,160385,Rajasthan,14,21,13,2,50,Pass
Raj Mehta,07-12-2005,890639,Madhya Pradesh,21,4,6,8,39,Pass
Vivaan D'Souza,06-06-2005,138003,Telangana,20,3,23,2,48,Pass
Kunal Reddy,13-04-2005,639839,Madhya Pradesh,10,8,7,16,41,Pass
Kunal Chopra,17-02-2005,393170,Madhya Pradesh,6,0,16,20,42,Pass
Ishaan Fernandes,19-05-2005,574243,Karnataka,3,7,8,6,24,Pass
Mathew Reddy,10-03-2006,601788,Chhattisgarh,17,11,19,8,55,Pass
Vivaan Pillai,28-11-2004,147052,Uttar Pradesh,3,9,4,14,30,Pass
Krishna Khan,19-08-2005,193941,Assam,3,1,20,7,31,Pass
Ishaan Sharma,20-04-2005,754277,Tripura,1,13,20,1,35,Pass
Yash Singh,18-02-2006,403808,Rajasthan,2,10,0,2,14,Pass
Gurpreet Pillai,06-06-2005,974399,Gujarat,1,1,7,18,27,Pass
Sukhwinder Chopra,13-08-2005,139837,Uttar Pradesh,14,9,4,14,41,Pass
Ishaan Singh,04-03-2006,160168,Madhya Pradesh,11,19,9,16,55,Pass
Raj Mehta,11-01-2006,899556,Punjab,9,5,16,8,38,Pass
Ishaan Singh,12-03-2005,636646,Bihar,4,2,23,10,39,Pass
Yash Sharma,28-12-2004,127583,West Bengal,15,1,15,1,32,Pass
Zaid Sharma,25-11-2005,581857,Haryana,22,24,8,0,54,Pass
Aarav Singh,21-09-2005,821065,Madhya Pradesh,1,16,2,12,31,Pass
Krishna Sharma,17-12-2004,197198,Maharashtra,3,3,16,18,40,Pass
Kunal Fernandes,25-04-2005,198311,Uttar Pradesh,2,9,4,14,29,Pass
Ishaan Chopra,09-03-2006,546020,Uttar Pradesh,15,9,4,14,42,Pass
Aryan Chopra,15-03-2006,491620,Uttar Pradesh,14,9,4,14,41,Pass
Aryan Fernandes,27-03-2005,442570,Madhya Pradesh,1,2,24,23,50,Pass
Krishna Khan,14-12-2004,863893,Bihar,22,8,7,8,45,Pass
Aryan Verma,05-06-2005,719251,Bihar,21,7,12,10,50,Pass
Kunal Fernandes,05-10-2005,511947,Uttar Pradesh,8,9,4,14,35,Pass
Ishaan Chopra,05-12-2005,228668,Maharashtra,16,2,15,4,37,Pass
Raj Singh,08-07-2005,264453,Arunachal Pradesh,7,7,6,9,29,Pass
Vivaan Reddy,13-08-2005,557789,Chhattisgarh,13,5,23,7,48,Pass
Rohan Fernandes,27-11-2005,808931,Bihar,1,12,4,23,40,Pass
Harjeet Khan,18-02-2005,895186,Uttar Pradesh,5,9,4,14,32,Pass
Aarav Fernandes,09-08-2005,570010,Himachal Pradesh,23,10,15,2,50,Pass
Ishaan Khan,01-05-2006,496674,Bihar,22,18,7,19,66,Pass
Aditya Singh,27-11-2005,884265,Bihar,22,11,1,4,38,Pass
Ishaan Khan,12-02-2006,560140,Telangana,3,19,14,11,47,Pass
Kunal Fernandes,04-04-2005,442437,Uttar Pradesh,21,9,4,14,48,Pass
Mathew Chopra,15-03-2005,771256,Kerala,6,24,9,21,60,Pass
Aarav Verma,24-04-2005,597379,Uttar Pradesh,3,9,4,14,30,Pass
Aditya Chopra,31-10-2005,492240,Rajasthan,1,19,24,11,55,Pass
Paul Verma,02-01-2005,810161,Maharashtra,3,23,4,22,52,Pass
Harjeet D'Souza,01-07-2005,735439,Jharkhand,11,21,8,21,61,Pass
Rohan Sharma,19-07-2005,737380,Rajasthan,14,23,2,22,61,Pass
Aditya Khan,31-12-2005,319168,Kerala,17,6,4,16,43,Pass
Manpreet Sharma,08-03-2006,775224,Rajasthan,11,16,10,21,58,Pass
Rohan Verma,20-12-2005,794628,Uttar Pradesh,11,9,4,14,38,Pass
Aryan Fernandes,09-10-2005,749169,Bihar,5,8,12,12,37,Pass
Yash Singh,11-04-2006,162581,Uttarakhand,4,11,8,9,32,Pass
Rehan Chopra,27-02-2006,111668,Odisha,10,13,3,2,28,Pass
Ishaan Sharma,16-06-2005,175866,Madhya Pradesh,19,14,16,4,53,Pass
Manpreet Sharma,15-04-2006,344800,Gujarat,9,11,12,5,37,Pass
Ishaan Singh,07-02-2005,770522,Kerala,4,16,23,6,49,Pass
Ishaan Pillai,18-09-2005,399879,Punjab,10,24,3,24,61,Pass
Raj D'Souza,17-09-2005,880037,Rajasthan,20,17,8,8,53,Pass
Balbir Reddy,22-12-2004,163102,Uttar Pradesh,16,9,4,14,43,Pass
Sukhwinder Verma,28-06-2005,207369,Tripura,21,11,1,7,40,Pass
Raj Verma,23-03-2006,392408,Tamil Nadu,3,11,3,21,38,Pass
Rohan Verma,29-03-2005,745592,Andhra Pradesh,9,21,15,9,54,Pass
John Singh,30-12-2005,539325,Haryana,11,1,11,11,34,Pass
Raj Sharma,07-12-2005,385132,Andhra Pradesh,0,4,18,0,22,Pass
Ishaan Verma,21-09-2005,496919,Uttar Pradesh,17,9,4,14,44,Pass
David Chopra,01-06-2005,844898,Haryana,5,23,17,23,68,Pass
Balbir D'Souza,03-12-2005,144930,West Bengal,0,6,9,24,39,Pass
Vivaan Khan,03-04-2006,250414,Tamil Nadu,22,7,18,15,62,Pass
Aryan Khan,28-04-2005,746597,Maharashtra,5,22,8,2,37,Pass
Krishna Reddy,29-11-2005,695659,Maharashtra,17,13,7,4,41,Pass
Balbir Verma,07-03-2005,741355,Tripura,3,18,13,7,41,Pass
Aarav Sharma,24-01-2006,836111,Uttarakhand,3,10,8,8,29,Pass
Aryan Fernandes,22-10-2005,755011,Madhya Pradesh,1,24,4,14,43,Pass
Rohan D'Souza,15-11-2004,696669,Rajasthan,5,14,22,16,57,Pass
Raj D'Souza,24-03-2005,467948,Kerala,13,2,18,3,36,Pass
Krishna Verma,24-05-2005,614923,Jharkhand,21,7,1,9,38,Pass
Aarav Verma,15-04-2006,846396,Rajasthan,5,23,24,23,75,Pass
Mathew D'Souza,02-01-2006,940701,Gujarat,20,15,8,4,47,Pass
Aditya Singh,23-01-2006,104832,Uttar Pradesh,14,9,4,14,41,Pass
Gurpreet D'Souza,05-06-2005,135687,Bihar,21,24,4,16,65,Pass
Yash D'Souza,02-11-2005,544036,Rajasthan,20,21,11,13,65,Pass
Aarav Verma,16-12-2004,133186,Jharkhand,5,8,11,17,41,Pass
Ayaan Mehta,12-02-2005,496307,Odisha,1,1,18,8,28,Pass
Paul Mehta,27-10-2005,992635,Gujarat,13,12,12,19,56,Pass
Farhan D'Souza,16-12-2005,679765,Punjab,2,10,19,16,47,Pass
Krishna Reddy,22-05-2005,513145,Kerala,1,23,21,13,58,Pass
Aarav Mehta,26-03-2005,244258,Tamil Nadu,6,12,20,18,56,Pass
Yash Singh,24-12-2005,599582,Andhra Pradesh,12,5,21,15,53,Pass
Balbir Sharma,07-01-2006,462363,Karnataka,21,10,23,4,58,Pass
Vivaan Chopra,26-07-2005,713977,Uttar Pradesh,0,9,4,14,27,Pass
Mathew Chopra,13-04-2005,179100,Telangana,0,22,10,0,32,Pass
Ishaan Khan,23-02-2006,682264,Haryana,6,20,23,9,58,Pass
John Singh,08-12-2005,701843,Bihar,15,11,9,24,59,Pass
Aryan Fernandes,08-04-2006,569811,Maharashtra,13,19,5,6,43,Pass
Rohan Mehta,29-01-2005,824591,Bihar,15,10,5,6,36,Pass
Aarav Singh,16-02-2005,841984,Odisha,7,3,0,21,31,Pass
Raj Reddy,19-11-2004,134824,West Bengal,3,18,8,21,50,Pass
Zaid Fernandes,07-01-2005,389915,Uttarakhand,7,8,8,21,44,Pass
Sukhwinder Chopra,14-11-2004,193175,Maharashtra,6,22,7,8,43,Pass
Harjeet Reddy,21-03-2005,662385,Chhattisgarh,10,20,3,15,48,Pass
Gurpreet Verma,05-12-2004,904383,Punjab,5,21,9,23,58,Pass
Ishaan Singh,18-01-2006,271125,Assam,4,19,8,6,37,Pass
Imran Khan,08-01-2005,197181,Madhya Pradesh,1,8,1,18,28,Pass
Vivaan Singh,06-02-2005,660723,Rajasthan,2,15,12,12,41,Pass
Zaid Fernandes,21-01-2005,220289,Jharkhand,3,13,21,13,50,Pass
Vivaan Pillai,20-12-2004,347991,Tamil Nadu,10,15,4,14,43,Pass
Zaid Khan,25-12-2004,713375,West Bengal,3,20,24,8,55,Pass
Raj Sharma,13-07-2005,694734,Mizoram,6,5,11,19,41,Pass
Rohan Chopra,12-11-2005,348878,Himachal Pradesh,5,16,11,8,40,Pass
Rohan Singh,09-07-2005,880790,Arunachal Pradesh,7,7,6,9,29,Pass
Ayaan Chopra,14-11-2005,957920,Kerala,3,9,16,19,47,Pass
Raj Mehta,26-03-2006,614472,West Bengal,7,7,15,19,48,Pass
Vivaan Fernandes,29-04-2005,936491,Jammu & Kashmir + Ladakh,10,7,8,5,30,Pass
Paul Singh,19-10-2005,481040,Madhya Pradesh,1,8,3,5,17,Pass
Paul Chopra,18-10-2005,258059,Bihar,5,24,0,14,43,Pass
Yash Singh,17-10-2005,688720,Telangana,13,3,22,18,56,Pass
Aarav Reddy,16-04-2006,937054,Gujarat,18,21,5,3,47,Pass
Kunal Pillai,18-12-2005,185392,Bihar,17,4,6,2,29,Pass
Aarav Verma,29-01-2006,248882,Jharkhand,18,18,18,9,63,Pass
Rohan Pillai,15-03-2005,148727,West Bengal,2,9,13,5,29,Pass
Aryan Chopra,15-05-2005,932832,Madhya Pradesh,12,10,7,21,50,Pass
Rohan Verma,06-07-2005,882601,West Bengal,3,15,14,4,36,Pass
Aarav Fernandes,17-01-2005,537020,Madhya Pradesh,16,12,15,1,44,Pass
Aryan Fernandes,16-07-2005,886688,Madhya Pradesh,7,5,0,14,26,Pass
Balbir Chopra,19-11-2004,165315,Karnataka,4,5,6,7,22,Pass
Raj Fernandes,18-05-2005,124837,Uttar Pradesh,1,9,4,14,28,Pass
Aryan Pillai,28-08-2005,216330,Kerala,17,14,21,12,64,Pass
Mathew Verma,17-04-2006,989439,Himachal Pradesh,20,13,6,6,45,Pass
Rehan Khan,22-10-2005,231090,West Bengal,5,1,17,13,36,Pass
Yash Reddy,14-12-2004,467802,Bihar,15,23,7,22,67,Pass
Gurpreet Reddy,24-03-2005,471166,Rajasthan,14,2,8,18,42,Pass
Aditya D'Souza,16-06-2005,955104,Uttar Pradesh,14,9,4,14,41,Pass
Kunal Pillai,16-11-2005,556997,Haryana,13,16,2,4,35,Pass
Kunal Sharma,26-10-2005,551056,West Bengal,1,22,3,1,27,Pass
Vivaan Singh,13-03-2006,495003,Delhi,5,5,22,19,51,Pass
Rohan Verma,31-10-2005,158544,Telangana,12,14,3,14,43,Pass
Aarav Sharma,25-09-2005,439935,Uttar Pradesh,22,9,4,14,49,Pass
Krishna Fernandes,23-10-2005,769920,Manipur,9,7,12,8,36,Pass
Raj Pillai,25-03-2005,505261,Uttar Pradesh,15,9,4,14,42,Pass
John Chopra,20-03-2006,383723,Kerala,16,19,24,5,64,Pass
Yash Singh,30-05-2005,734063,Jharkhand,13,2,21,1,37,Pass
Rohan Mehta,01-03-2005,835452,Madhya Pradesh,0,19,10,3,32,Pass
Gurpreet Pillai,18-04-2005,842348,West Bengal,18,8,1,17,44,Pass
Aryan D'Souza,17-08-2005,681365,Haryana,8,3,14,14,39,Pass
Mathew Pillai,24-07-2005,236508,Rajasthan,2,12,13,10,37,Pass
Aditya Singh,30-06-2005,397021,West Bengal,3,20,23,21,67,Pass
Krishna D'Souza,25-04-2005,791687,Odisha,3,12,2,21,38,Pass
Rohan Chopra,15-03-2006,144718,West Bengal,9,12,21,7,49,Pass
Vivaan D'Souza,10-08-2005,956635,Kerala,1,6,17,1,25,Pass
Ishaan Fernandes,26-08-2005,513819,Haryana,19,21,17,12,69,Pass
Rehan Reddy,23-01-2005,462743,West Bengal,24,6,13,11,54,Pass
Raj Chopra,19-06-2005,432080,Punjab,10,17,4,19,50,Pass
Rohan Verma,14-11-2004,555188,Rajasthan,3,1,11,15,30,Pass
Aarav Reddy,18-02-2006,667977,Madhya Pradesh,8,1,8,2,19,Pass
Yash Singh,01-04-2005,422251,Maharashtra,2,6,15,23,46,Pass
Aarav Mehta,04-05-2005,346523,Uttar Pradesh,19,9,4,14,46,Pass
Ishaan Singh,07-10-2005,790963,Telangana,2,19,20,3,44,Pass
Vivaan Chopra,13-02-2006,700784,Delhi,20,1,23,6,50,Pass
Ishaan Khan,10-01-2006,393400,Assam,17,8,3,22,50,Pass
Aarav Verma,07-11-2004,530978,Haryana,16,12,12,10,50,Pass
Raj Pillai,09-12-2004,833947,West Bengal,2,0,5,12,19,Pass
Rehan Verma,07-02-2005,752273,Uttar Pradesh,3,9,4,14,30,Pass
Aryan Singh,21-12-2004,611554,Punjab,4,0,0,4,8,Pass
Krishna Pillai,18-03-2006,951308,Uttar Pradesh,21,9,4,14,48,Pass
Aditya D'Souza,03-10-2005,970475,Maharashtra,6,2,16,1,25,Pass
Farhan Verma,21-12-2004,514172,West Bengal,19,8,9,7,43,Pass
Rohan Mehta,01-11-2005,514685,Uttar Pradesh,3,9,4,14,30,Pass
Aditya Singh,24-03-2005,202036,Maharashtra,17,4,0,11,32,Pass
Raj D'Souza,14-12-2005,388823,Haryana,20,11,22,5,58,Pass
Harjeet Reddy,22-01-2005,636455,Uttar Pradesh,9,9,4,14,36,Pass
Mathew Singh,25-11-2005,693863,Uttar Pradesh,0,9,4,14,27,Pass
Balbir Pillai,08-03-2005,458539,Uttar Pradesh,22,9,4,14,49,Pass
Krishna Reddy,17-01-2005,989800,Punjab,11,22,23,2,58,Pass
Vivaan Pillai,02-10-2005,893097,Uttar Pradesh,13,9,4,14,40,Pass
Vivaan Pillai,23-02-2006,837059,Uttar Pradesh,6,9,4,14,33,Pass
Aditya Verma,01-08-2005,110235,Andhra Pradesh,16,9,12,17,54,Pass
Zaid Khan,23-03-2005,479995,Uttar Pradesh,12,9,4,14,39,Pass
Aryan Sharma,17-10-2005,993702,Maharashtra,3,21,15,14,53,Pass
Aditya Mehta,24-12-2004,944372,Madhya Pradesh,12,13,0,15,40,Pass
Aditya Mehta,20-04-2005,650286,Odisha,24,3,1,13,41,Pass
Aryan Fernandes,06-09-2005,832508,Uttar Pradesh,0,9,4,14,27,Pass
Yash Reddy,16-02-2006,140892,Karnataka,23,16,0,6,45,Pass
Farhan Sharma,06-09-2005,665927,Uttar Pradesh,20,9,4,14,47,Pass
Vivaan Verma,27-02-2006,833288,Tamil Nadu,22,3,9,0,34,Pass
Zaid D'Souza,13-01-2006,696311,Gujarat,1,16,2,22,41,Pass
Raj Mehta,16-04-2006,479094,Uttarakhand,21,10,8,4,43,Pass
Aarav Singh,01-01-2006,699433,Uttarakhand,11,3,8,11,33,Pass
Sukhwinder Sharma,16-11-2005,526451,Rajasthan,6,23,20,18,67,Pass
David Sharma,03-04-2005,918004,Daman & Diu / D&N Haveli,7,6,5,18,36,Pass
Raj Singh,20-04-2005,608591,Jharkhand,12,15,17,10,54,Pass
Harjeet Pillai,07-12-2005,111558,Tamil Nadu,0,12,22,23,57,Pass
Kunal Mehta,22-03-2006,789488,Telangana,7,20,16,0,43,Pass
Aditya D'Souza,10-04-2005,830527,Uttar Pradesh,4,9,4,14,31,Pass
Rohan Reddy,26-11-2005,200835,Bihar,20,22,5,20,67,Pass
Balbir Chopra,21-10-2005,891952,Andhra Pradesh,19,12,9,12,52,Pass
Aryan Reddy,25-08-2005,349082,Puducherry,24,22,6,22,74,Pass
Aryan D'Souza,08-02-2005,475632,Uttarakhand,11,22,8,0,41,Pass
Yash Reddy,12-09-2005,673246,Tamil Nadu,0,1,2,3,6,Pass
Kunal Reddy,09-05-2005,261980,Uttar Pradesh,19,9,4,14,46,Pass
Yash D'Souza,13-07-2005,282093,Gujarat,14,6,11,23,54,Pass
Ishaan Fernandes,24-05-2005,508414,Kerala,9,9,13,1,32,Pass
Rohan Khan,17-10-2005,916110,Bihar,21,19,11,16,67,Pass
Krishna D'Souza,03-01-2005,330438,West Bengal,21,1,10,10,42,Pass
Aditya Fernandes,02-02-2006,570137,Bihar,7,9,3,3,22,Pass
Yash Pillai,03-02-2006,449416,Maharashtra,3,4,15,9,31,Pass
Kunal Sharma,30-04-2006,211377,Maharashtra,3,23,23,15,64,Pass
Aditya Fernandes,02-11-2005,510845,Haryana,8,2,0,20,30,Pass
Aditya Pillai,21-01-2005,420476,Rajasthan,21,17,10,22,70,Pass
Raj D'Souza,24-01-2006,546225,Bihar,15,3,6,18,42,Pass
Vivaan Mehta,20-01-2005,677207,Andhra Pradesh,1,17,20,3,41,Pass
Ishaan Verma,13-09-2005,209796,Haryana,10,15,5,12,42,Pass
Rohan Reddy,27-08-2005,798369,Jharkhand,0,5,21,9,35,Pass
Raj Sharma,14-12-2005,304269,Rajasthan,7,7,22,15,51,Pass
Aryan Verma,09-09-2005,112857,West Bengal,6,22,4,10,42,Pass
Vivaan Mehta,10-11-2004,367793,Gujarat,10,2,4,2,18,Pass
Sukhwinder Chopra,22-02-2006,481939,Bihar,24,18,1,17,60,Pass
Raj Singh,30-07-2005,514859,Rajasthan,24,17,19,7,67,Pass
Kunal Pillai,04-01-2006,650557,Uttar Pradesh,22,9,4,14,49,Pass
Raj Khan,29-12-2004,196158,Madhya Pradesh,3,13,12,10,38,Pass
Yash Khan,15-10-2005,724326,West Bengal,3,21,10,9,43,Pass
Sukhwinder Verma,07-11-2005,951001,Kerala,21,19,16,7,63,Pass
Aryan Sharma,15-06-2005,338207,Manipur,6,9,2,11,28,Pass
Raj Fernandes,30-01-2006,715870,Manipur,9,16,0,24,49,Pass
Imran Mehta,17-01-2006,939328,Rajasthan,16,0,19,22,57,Pass
Balbir Fernandes,04-02-2006,233085,Bihar,20,10,7,20,57,Pass
Aditya Chopra,21-06-2005,296521,Tamil Nadu,0,14,18,7,39,Pass
Kunal Mehta,23-11-2005,952683,West Bengal,3,11,8,24,46,Pass
Aarav Singh,17-01-2005,787302,Uttar Pradesh,19,9,4,14,46,Pass
Krishna Singh,08-11-2004,107438,Uttar Pradesh,16,9,4,14,43,Pass
Aditya Reddy,30-07-2005,161284,Rajasthan,6,11,13,3,33,Pass
Vivaan Fernandes,23-02-2005,235046,Punjab,10,1,6,21,38,Pass
Kunal Fernandes,24-01-2006,420447,Punjab,7,23,10,10,50,Pass
Aarav Pillai,26-12-2005,587437,Chhattisgarh,2,20,24,6,52,Pass
Rohan Khan,22-07-2005,683161,Tamil Nadu,13,23,5,5,46,Pass
Rohan D'Souza,09-05-2006,428461,Rajasthan,8,18,17,18,61,Pass
Aditya Singh,27-12-2004,627363,Haryana,5,24,2,10,41,Pass
Kunal Chopra,06-12-2005,640945,Maharashtra,15,20,8,0,43,Pass
David Fernandes,17-04-2006,297979,Andhra Pradesh,24,21,7,1,53,Pass
Krishna D'Souza,06-06-2005,752995,Uttar Pradesh,16,9,4,14,43,Pass
Ishaan D'Souza,27-11-2005,494319,Uttar Pradesh,2,9,4,14,29,Pass
Yash Verma,07-01-2005,387407,Punjab,14,8,7,7,36,Pass
Gurpreet Mehta,24-12-2005,922119,Uttar Pradesh,13,9,4,14,40,Pass
Rohan Singh,13-05-2005,218613,Jammu & Kashmir + Ladakh,24,9,18,11,62,Pass
Krishna Chopra,28-08-2005,771850,Telangana,1,6,0,22,29,Pass
Aditya Fernandes,28-01-2006,265227,Madhya Pradesh,1,1,21,24,47,Pass
Aarav Khan,26-03-2006,821941,Bihar,20,4,10,21,55,Pass
Aditya Chopra,04-09-2005,600795,Jharkhand,24,12,2,16,54,Pass
Aryan Reddy,18-04-2005,313961,Chhattisgarh,12,17,18,5,52,Pass
Raj Sharma,09-01-2005,734931,Madhya Pradesh,1,1,22,17,41,Pass
Peter Reddy,01-02-2005,800458,Tamil Nadu,10,1,8,23,42,Pass
Aditya Chopra,27-04-2006,505431,Jharkhand,8,15,14,10,47,Pass
Aditya Pillai,31-10-2005,153795,Assam,2,6,18,19,45,Pass
Vivaan D'Souza,10-06-2005,337762,Rajasthan,22,13,23,2,60,Pass
Mathew Khan,07-11-2005,307408,Punjab,21,16,9,3,49,Pass
Kunal Khan,11-06-2005,676185,Kerala,9,5,21,9,44,Pass
Harjeet Chopra,28-01-2006,379278,Madhya Pradesh,1,13,1,14,29,Pass
Krishna Pillai,26-10-2005,104187,Maharashtra,6,2,14,9,31,Pass
Ishaan D'Souza,27-07-2005,322675,Rajasthan,21,15,5,3,44,Pass
Sukhwinder Pillai,03-05-2005,311089,Madhya Pradesh,1,21,9,1,32,Pass
Raj Mehta,24-02-2006,287571,Bihar,0,21,22,2,45,Pass
Krishna Sharma,13-09-2005,890640,Maharashtra,3,19,24,4,50,Pass
Rohan Verma,11-04-2005,121489,West Bengal,13,0,4,5,22,Pass
Aditya Khan,25-02-2006,815738,Punjab,10,14,9,8,41,Pass
Zaid Verma,17-11-2005,655815,West Bengal,13,11,8,17,49,Pass
Yash Pillai,05-01-2006,278065,Uttar Pradesh,6,9,4,14,33,Pass
Harjeet Chopra,08-08-2005,668627,Gujarat,13,19,0,1,33,Pass
Ishaan Khan,09-02-2005,618657,Tamil Nadu,7,15,16,24,62,Pass
Rohan Mehta,16-05-2005,878149,Bihar,13,9,16,6,44,Pass
Paul Mehta,07-03-2006,690698,West Bengal,1,6,23,20,50,Pass
Rehan Reddy,17-11-2004,770166,Bihar,6,7,9,18,40,Pass
Rohan Fernandes,11-08-2005,657844,Jharkhand,1,10,12,20,43,Pass
Aryan Sharma,29-03-2005,463234,Kerala,7,11,9,12,39,Pass
Kunal Khan,04-01-2006,692833,Jammu & Kashmir + Ladakh,10,20,3,18,51,Pass
Kunal Singh,19-09-2005,886652,West Bengal,3,10,17,3,33,Pass
Aryan Verma,08-10-2005,799165,Rajasthan,21,10,2,10,43,Pass
Harjeet Fernandes,24-06-2005,740940,Manipur,0,7,3,13,23,Pass
Sukhwinder Pillai,09-12-2004,725189,West Bengal,8,13,5,8,34,Pass
Kunal Reddy,02-11-2005,148751,Karnataka,13,17,19,13,62,Pass
Paul Chopra,11-11-2005,581403,Rajasthan,6,16,18,8,48,Pass
Harjeet Sharma,22-06-2005,734146,Uttarakhand,5,14,5,11,35,Pass
Kunal Verma,08-02-2005,665028,Andaman & Nicobar,10,6,15,9,40,Pass
Aditya Verma,26-03-2006,788600,Gujarat,23,14,21,15,73,Pass
Yash Fernandes,18-02-2006,376189,West Bengal,14,7,16,12,49,Pass
Aryan Chopra,26-06-2005,928553,Rajasthan,3,23,8,21,55,Pass
Harjeet Reddy,10-09-2005,187485,Uttar Pradesh,6,9,4,14,33,Pass
Sukhwinder Verma,23-11-2004,708884,Gujarat,20,5,8,5,38,Pass
Kunal Chopra,02-05-2005,906661,Bihar,10,15,9,4,38,Pass
Aryan Chopra,06-07-2005,721722,Uttar Pradesh,12,9,4,14,39,Pass
Aryan Mehta,21-12-2005,657742,Uttar Pradesh,16,9,4,14,43,Pass
David Fernandes,04-07-2005,612645,Bihar,2,2,22,5,31,Pass
Raj Khan,23-08-2005,654652,Punjab,4,17,21,0,42,Pass
Harjeet Verma,30-11-2005,794293,Punjab,2,5,4,11,22,Pass
Kunal Verma,21-07-2005,322696,Maharashtra,24,3,13,2,42,Pass
Aditya Reddy,19-10-2005,681934,Rajasthan,4,0,2,10,16,Pass
Rohan D'Souza,24-03-2005,497094,West Bengal,8,11,17,11,47,Pass
Aditya Verma,12-01-2006,279512,Maharashtra,19,7,3,11,40,Pass
Aryan Singh,20-07-2005,359209,Rajasthan,23,2,16,17,58,Pass
Paul Fernandes,08-02-2005,263781,Madhya Pradesh,18,13,9,12,52,Pass
Balbir Chopra,13-12-2004,454463,Tamil Nadu,21,19,2,5,47,Pass
Aarav Singh,03-09-2005,615613,Tamil Nadu,10,11,2,20,43,Pass
Krishna Mehta,30-03-2006,559993,Meghalaya,8,12,5,5,30,Pass
Aarav Verma,07-12-2005,751441,Bihar,22,10,8,16,56,Pass
Sukhwinder Chopra,20-10-2005,665316,Punjab,7,11,0,16,34,Pass
Krishna Singh,13-02-2005,941567,Delhi,20,3,15,9,47,Pass
Kunal Reddy,25-03-2006,911883,Rajasthan,22,12,11,17,62,Pass
Gurpreet D'Souza,31-03-2006,839309,Bihar,1,24,13,20,58,Pass
Imran Reddy,02-11-2005,219801,Bihar,0,12,17,15,44,Pass
Aarav Khan,21-05-2005,610980,Chhattisgarh,10,16,20,19,65,Pass
Paul Sharma,04-01-2006,900467,Bihar,5,4,5,1,15,Pass
Ishaan Chopra,26-11-2004,420628,Maharashtra,4,21,16,1,42,Pass
Ishaan Khan,21-07-2005,844116,Tamil Nadu,7,22,9,2,40,Pass
Balbir Khan,17-05-2005,784853,Madhya Pradesh,8,8,10,11,37,Pass
Krishna Singh,05-09-2005,569569,Himachal Pradesh,7,11,24,13,55,Pass
David Sharma,05-01-2006,553368,Maharashtra,3,12,24,13,52,Pass
Aarav Sharma,29-01-2005,516014,Maharashtra,3,7,19,19,48,Pass
Krishna Khan,10-10-2005,373231,Kerala,4,24,9,23,60,Pass
Ishaan Chopra,11-02-2006,154349,Uttar Pradesh,7,9,4,14,34,Pass
Kunal Verma,19-01-2006,708102,Maharashtra,0,21,8,4,33,Pass
Aryan Chopra,30-09-2005,112211,West Bengal,12,21,3,10,46,Pass
Vivaan Mehta,19-06-2005,980981,West Bengal,13,8,8,6,35,Pass
Aryan D'Souza,26-11-2005,459012,West Bengal,3,21,18,19,61,Pass
Krishna Sharma,12-12-2004,718102,Bihar,5,20,8,18,51,Pass
Yash Sharma,22-03-2005,173190,Bihar,23,19,8,3,53,Pass
Harjeet Singh,09-11-2005,239260,Karnataka,22,6,9,14,51,Pass
Aarav Chopra,17-01-2006,163338,Rajasthan,0,12,10,23,45,Pass
Balbir Fernandes,28-06-2005,971335,Rajasthan,12,14,16,21,63,Pass
Harjeet Sharma,22-08-2005,317658,Tamil Nadu,22,14,10,19,65,Pass
Aditya Singh,01-03-2006,446397,Rajasthan,20,13,2,9,44,Pass
Ishaan Pillai,26-01-2005,744084,Tamil Nadu,10,9,4,6,29,Pass
Sukhwinder Fernandes,06-03-2005,786930,Jammu & Kashmir + Ladakh,9,11,18,18,56,Pass
Gurpreet Khan,08-02-2006,790308,Himachal Pradesh,20,5,8,10,43,Pass
Aarav Reddy,27-09-2005,436021,Himachal Pradesh,3,2,10,8,23,Pass
Manpreet D'Souza,27-04-2006,723632,Karnataka,22,1,12,16,51,Pass
Rohan Singh,30-10-2005,604744,Gujarat,13,16,10,4,43,Pass
Raj D'Souza,01-09-2005,403922,Delhi,23,12,18,9,62,Pass
Imran D'Souza,31-03-2005,821330,Uttar Pradesh,3,9,4,14,30,Pass
Gurpreet Chopra,19-02-2005,149240,West Bengal,6,3,15,19,43,Pass
Kunal Singh,03-05-2006,113253,Gujarat,7,16,11,19,53,Pass
Krishna Mehta,19-11-2005,132384,Punjab,14,16,1,3,34,Pass
John Verma,22-01-2006,331796,Odisha,11,11,5,19,46,Pass
Aarav Verma,08-04-2005,370696,Punjab,18,16,3,23,60,Pass
David Verma,08-12-2004,467479,Kerala,22,4,22,5,53,Pass
Raj Pillai,21-05-2005,533022,Bihar,22,1,17,1,41,Pass
John D'Souza,23-01-2005,660764,West Bengal,3,16,24,22,65,Pass
Yash Fernandes,04-03-2006,770817,Andaman & Nicobar,3,6,17,11,37,Pass
Balbir Khan,29-11-2004,498877,Rajasthan,2,2,23,21,48,Pass
Aryan Mehta,10-11-2004,773159,Bihar,11,22,8,2,43,Pass
Rohan Sharma,02-11-2005,934229,Kerala,13,14,15,22,64,Pass
Aarav Chopra,05-04-2006,407415,Madhya Pradesh,14,10,6,13,43,Pass
Kunal D'Souza,30-03-2005,263113,Rajasthan,18,6,21,4,49,Pass
Aryan Sharma,08-03-2006,920234,Jharkhand,17,0,22,3,42,Pass
Krishna Chopra,12-05-2005,274645,Uttar Pradesh,5,9,4,14,32,Pass
Raj Khan,24-03-2006,453741,Odisha,2,4,18,15,39,Pass
Sukhwinder Reddy,17-12-2004,148876,Mizoram,4,7,4,14,29,Pass
Manpreet Reddy,02-08-2005,646318,West Bengal,3,17,9,24,53,Pass
Raj Mehta,16-01-2005,778139,Maharashtra,16,21,8,2,47,Pass
Peter Pillai,13-02-2006,454163,Punjab,4,3,15,21,43,Pass
David Pillai,10-11-2005,280700,Uttar Pradesh,6,9,4,14,33,Pass
John Singh,12-12-2005,729383,Jharkhand,6,7,9,15,37,Pass
Yash Fernandes,25-12-2004,745872,Madhya Pradesh,1,8,1,17,27,Pass
Vivaan Reddy,05-02-2005,909620,Karnataka,12,7,15,6,40,Pass
Yash Chopra,10-10-2005,254102,Maharashtra,0,15,3,20,38,Pass
Raj Chopra,16-05-2005,831794,Tamil Nadu,23,8,15,13,59,Pass
David Pillai,01-05-2006,251266,Bihar,4,11,3,4,22,Pass
Yash Verma,04-12-2005,944094,Maharashtra,3,9,12,11,35,Pass
Rohan Mehta,19-11-2004,345961,Uttar Pradesh,21,9,4,14,48,Pass
Yash D'Souza,24-10-2005,610593,Haryana,6,15,11,19,51,Pass
Raj Pillai,29-07-2005,938109,Meghalaya,9,7,11,12,39,Pass
Krishna D'Souza,04-01-2005,256119,Uttar Pradesh,6,9,4,14,33,Pass
Ishaan Singh,15-09-2005,841264,Uttar Pradesh,5,9,4,14,32,Pass
Aarav Pillai,18-07-2005,666727,Rajasthan,12,24,21,11,68,Pass
Vivaan Verma,04-01-2006,539476,Tamil Nadu,13,12,9,12,46,Pass
Ishaan Khan,02-09-2005,129830,Kerala,3,0,11,22,36,Pass
Yash Khan,08-05-2005,888020,Andhra Pradesh,3,13,1,7,24,Pass
Raj Singh,14-01-2006,921411,Madhya Pradesh,1,1,19,23,44,Pass
John Verma,30-09-2005,335428,Andhra Pradesh,23,1,3,21,48,Pass
Yash Chopra,22-11-2004,103610,Karnataka,4,9,9,7,29,Pass
Aditya Singh,19-02-2005,842692,Bihar,12,24,9,16,61,Pass
Rohan D'Souza,26-04-2006,792701,Jharkhand,11,21,3,8,43,Pass
Kunal Fernandes,18-12-2004,821611,Madhya Pradesh,1,24,21,13,59,Pass
Aarav Reddy,16-03-2005,501538,Odisha,22,7,3,3,35,Pass
Yash D'Souza,16-01-2006,586781,Tamil Nadu,4,16,20,17,57,Pass
Aarav Mehta,10-03-2006,685807,Uttar Pradesh,24,9,4,14,51,Pass
Aarav Khan,19-11-2004,269277,Rajasthan,20,1,22,4,47,Pass
Zaid Fernandes,16-02-2005,547808,Bihar,12,2,3,11,28,Pass
Krishna Fernandes,09-09-2005,951743,Uttar Pradesh,9,9,4,14,36,Pass
Sukhwinder Mehta,14-02-2005,103681,Bihar,21,6,0,1,28,Pass
Kunal Reddy,08-01-2006,119201,Telangana,18,19,23,3,63,Pass
Aarav D'Souza,08-02-2005,605020,Punjab,15,5,24,5,49,Pass
Peter Verma,25-09-2005,649187,Tamil Nadu,10,11,14,4,39,Pass
Rohan Mehta,09-02-2005,953354,Odisha,0,3,19,5,27,Pass
Ayaan Verma,21-09-2005,977537,Karnataka,4,0,21,5,30,Pass
Aditya Khan,21-05-2005,476390,Haryana,22,17,9,9,57,Pass
Manpreet Chopra,01-05-2005,265427,Rajasthan,7,16,9,23,55,Pass
Rohan D'Souza,09-11-2005,424734,Assam,3,12,18,9,42,Pass
Rohan Verma,21-11-2004,153851,Andhra Pradesh,14,3,15,2,34,Pass
Balbir Singh,01-09-2005,814957,Rajasthan,7,1,24,22,54,Pass
Ishaan Sharma,25-01-2005,795590,Arunachal Pradesh,7,9,8,17,41,Pass
Ishaan Chopra,21-08-2005,513319,Andhra Pradesh,15,19,1,6,41,Pass
Yash Fernandes,26-02-2005,306606,Uttarakhand,5,22,8,6,41,Pass
Yash Sharma,02-04-2006,665022,Maharashtra,0,1,23,4,28,Pass
Raj Fernandes,22-04-2005,179682,Manipur,0,15,13,2,30,Pass
Ishaan Khan,25-06-2005,482520,Telangana,7,3,22,8,40,Pass
Mathew Fernandes,30-04-2005,110855,Haryana,20,17,10,21,68,Pass
Ishaan Reddy,01-05-2006,387739,Bihar,1,15,4,15,35,Pass
Ishaan Mehta,03-08-2005,973394,Rajasthan,11,9,12,12,44,Pass
Kunal Verma,09-07-2005,832237,Madhya Pradesh,1,3,20,18,42,Pass
Aryan Chopra,12-09-2005,619584,Uttar Pradesh,9,9,4,14,36,Pass
Aryan Verma,21-09-2005,231341,Rajasthan,6,2,13,21,42,Pass
Mathew D'Souza,22-12-2004,408252,Tamil Nadu,12,1,19,5,37,Pass
Paul Pillai,08-05-2005,306310,Uttar Pradesh,3,9,4,14,30,Pass
Paul Fernandes,29-03-2006,794334,Telangana,16,12,20,2,50,Pass
Aarav Sharma,15-03-2006,823449,Telangana,15,15,11,5,46,Pass
Manpreet Fernandes,30-04-2005,276673,Tamil Nadu,24,5,17,5,51,Pass
Mathew Chopra,23-08-2005,334047,Rajasthan,12,11,13,2,38,Pass
Aditya Verma,23-12-2005,997074,Maharashtra,3,23,1,6,33,Pass
Ishaan D'Souza,02-11-2005,155061,Haryana,4,24,4,8,40,Pass
Ishaan Fernandes,21-05-2005,654150,West Bengal,5,17,9,19,50,Pass
Krishna Chopra,29-08-2005,467561,Gujarat,11,16,13,14,54,Pass
Vivaan Verma,28-11-2004,451753,Madhya Pradesh,14,0,18,1,33,Pass
Krishna Chopra,05-01-2005,237516,Madhya Pradesh,1,5,3,17,26,Pass
Aditya D'Souza,22-11-2004,259935,Andhra Pradesh,7,3,21,23,54,Pass
Ishaan Reddy,06-02-2006,163693,Andhra Pradesh,6,19,12,2,39,Pass
Paul Chopra,27-11-2004,953613,Bihar,11,14,5,8,38,Pass
Krishna Verma,01-02-2005,978084,Kerala,3,5,5,18,31,Pass
Kunal Khan,16-07-2005,134319,Punjab,12,5,23,13,53,Pass
Kunal Chopra,28-06-2005,948104,Andhra Pradesh,21,6,8,4,39,Pass
Aryan Pillai,30-05-2005,640323,Jharkhand,3,19,12,14,48,Pass
Rehan Khan,24-08-2005,668367,Uttar Pradesh,23,9,4,14,50,Pass
Ishaan Verma,03-05-2006,180572,Tamil Nadu,14,18,23,16,71,Pass
Peter Mehta,27-11-2004,385323,Punjab,3,17,22,7,49,Pass
Krishna Reddy,25-08-2005,272489,West Bengal,14,3,13,8,38,Pass
Raj Mehta,29-11-2005,171858,Gujarat,6,4,14,10,34,Pass
Vivaan D'Souza,26-09-2005,684001,Delhi,14,17,17,5,53,Pass
Krishna Khan,23-09-2005,429673,Uttar Pradesh,17,9,4,14,44,Pass
Rohan Mehta,03-01-2005,352037,Chhattisgarh,21,17,20,14,72,Pass
Aryan Sharma,24-11-2004,889899,Rajasthan,19,1,3,16,39,Pass
Raj Verma,04-03-2006,383430,Jharkhand,18,12,9,24,63,Pass
Aditya Reddy,19-11-2004,886525,West Bengal,0,0,24,19,43,Pass
Raj D'Souza,19-09-2005,958537,West Bengal,9,6,9,11,35,Pass
Mathew Khan,18-11-2005,943637,Maharashtra,5,18,12,4,39,Pass
Ayaan Sharma,13-02-2006,741424,West Bengal,3,14,21,9,47,Pass
Raj Mehta,22-07-2005,691441,Jammu & Kashmir + Ladakh,17,7,21,20,65,Pass
Gurpreet Verma,11-02-2005,939274,Uttar Pradesh,16,9,4,14,43,Pass
Ishaan D'Souza,02-01-2005,404435,Rajasthan,6,8,5,17,36,Pass
Raj Pillai,03-03-2005,956370,Madhya Pradesh,6,17,6,6,35,Pass
Krishna Verma,28-04-2005,978164,Rajasthan,8,19,5,10,42,Pass
John Reddy,03-02-2006,149356,Maharashtra,8,22,22,14,66,Pass
Ayaan Reddy,24-12-2004,724031,Delhi,23,20,1,22,66,Pass
Aditya Fernandes,23-04-2006,466134,Tamil Nadu,16,9,3,19,47,Pass
Aarav Fernandes,29-04-2005,614887,Madhya Pradesh,9,13,11,4,37,Pass
Sukhwinder Mehta,14-03-2006,868590,Punjab,4,15,16,8,43,Pass
Kunal Fernandes,19-11-2005,448217,Bihar,22,21,4,12,59,Pass
Balbir Reddy,16-03-2005,890183,West Bengal,13,23,12,1,49,Pass
Krishna Khan,03-12-2004,678781,Andhra Pradesh,0,11,13,14,38,Pass
Yash Singh,16-01-2005,288392,Uttar Pradesh,11,9,4,14,38,Pass
Paul Reddy,20-09-2005,596273,Uttar Pradesh,10,9,4,14,37,Pass
Aditya Fernandes,08-04-2005,532790,Uttar Pradesh,16,9,4,14,43,Pass
Aryan Verma,31-01-2005,915016,Uttar Pradesh,3,9,4,14,30,Pass
Vivaan Fernandes,01-12-2005,426096,Kerala,15,5,10,10,40,Pass
David Chopra,02-05-2006,115919,Haryana,12,16,21,9,58,Pass
Vivaan Pillai,15-05-2005,279071,Maharashtra,6,21,4,22,53,Pass
Harjeet Mehta,23-04-2005,152613,Goa,9,7,5,17,38,Pass
Harjeet Chopra,04-09-2005,356068,Maharashtra,3,23,4,3,33,Pass
Krishna Reddy,23-06-2005,466645,Andhra Pradesh,6,7,4,17,34,Pass
Krishna Khan,05-04-2006,931734,Madhya Pradesh,11,15,16,2,44,Pass
Aarav Singh,29-11-2004,174830,Maharashtra,12,0,14,0,26,Pass
Yash Chopra,23-01-2005,321973,Uttarakhand,5,10,8,6,29,Pass
Kunal Fernandes,11-10-2005,981818,Maharashtra,22,2,0,9,33,Pass
Aarav Reddy,31-12-2004,169473,Maharashtra,2,1,24,22,49,Pass
Yash Verma,27-02-2005,960056,West Bengal,3,12,23,23,61,Pass
Aarav Verma,24-01-2006,751625,Uttar Pradesh,13,9,4,14,40,Pass
Vivaan Singh,24-07-2005,523924,Uttar Pradesh,14,9,4,14,41,Pass
Aarav Reddy,09-12-2004,959912,Uttar Pradesh,4,9,4,14,31,Pass
Vivaan Khan,05-04-2005,375484,Odisha,21,3,0,15,39,Pass
Harjeet Mehta,13-12-2004,464808,Tamil Nadu,4,15,17,24,60,Pass
Yash D'Souza,03-02-2005,138401,Bihar,14,4,15,12,45,Pass
Kunal Khan,03-07-2005,932546,Chhattisgarh,17,19,18,10,64,Pass
Ayaan Pillai,27-02-2005,727351,Odisha,11,6,0,13,30,Pass
Rohan Verma,23-06-2005,149612,Telangana,3,12,6,16,37,Pass
Rohan Mehta,28-02-2005,686273,Uttar Pradesh,3,9,4,14,30,Pass
Krishna Mehta,22-01-2005,136557,Himachal Pradesh,5,11,11,8,35,Pass
Ishaan Singh,03-11-2005,638107,Chhattisgarh,23,24,24,18,89,Pass
Aryan Khan,19-09-2005,407426,West Bengal,24,19,4,7,54,Pass
Aarav Pillai,18-10-2005,864029,Tamil Nadu,8,23,0,20,51,Pass
Kunal Mehta,03-03-2005,570290,Uttarakhand,5,11,8,6,30,Pass
Aryan Sharma,03-06-2005,769046,Haryana,1,6,17,5,29,Pass
Ishaan Mehta,11-08-2005,893703,Rajasthan,19,19,24,13,75,Pass
Mathew Sharma,02-01-2006,619688,Karnataka,3,11,16,9,39,Pass
Vivaan Reddy,08-12-2005,366462,Assam,8,13,16,4,41,Pass
Sukhwinder Verma,04-12-2005,520952,Assam,0,15,23,3,41,Pass
David Pillai,05-04-2005,345783,Rajasthan,7,21,21,12,61,Pass
Raj Mehta,17-04-2006,718554,Rajasthan,15,7,22,20,64,Pass
Ishaan Sharma,03-04-2006,904871,Tamil Nadu,5,7,21,15,48,Pass
Aryan D'Souza,28-07-2005,121933,Bihar,3,7,18,9,37,Pass
Raj Singh,28-04-2006,934396,Tamil Nadu,22,16,6,7,51,Pass
Aditya Fernandes,28-12-2005,495064,Andhra Pradesh,7,6,7,23,43,Pass
Aryan Verma,22-01-2005,574602,Punjab,10,3,19,24,56,Pass
Yash Chopra,28-07-2005,704963,Manipur,7,4,20,8,39,Pass
Aarav D'Souza,21-06-2005,829703,Assam,6,8,12,16,42,Pass
Rehan Reddy,05-03-2006,340332,Madhya Pradesh,5,17,17,12,51,Pass
Krishna Pillai,05-10-2005,687946,Punjab,3,16,24,12,55,Pass
Aditya Verma,10-11-2005,457420,Uttar Pradesh,4,9,4,14,31,Pass
Aarav Pillai,24-09-2005,558132,West Bengal,6,6,16,8,36,Pass
Vivaan Sharma,14-12-2004,714743,Bihar,21,23,18,12,74,Pass
Manpreet Verma,21-03-2006,176319,Andhra Pradesh,13,13,11,23,60,Pass
Ishaan Pillai,29-05-2005,311814,Telangana,5,19,0,22,46,Pass
Paul Fernandes,08-04-2005,370090,Maharashtra,15,9,12,8,44,Pass
Rohan Chopra,31-12-2004,490269,Manipur,1,22,8,6,37,Pass
Raj Verma,10-08-2005,593562,Assam,6,2,5,22,35,Pass
Raj Singh,18-01-2006,330448,Maharashtra,3,17,6,12,38,Pass
Kunal Mehta,04-02-2006,460993,Rajasthan,4,7,22,16,49,Pass
Aarav Fernandes,23-05-2005,785019,Haryana,3,14,10,15,42,Pass
Kunal Singh,13-12-2005,835468,Delhi,5,13,11,12,41,Pass
David Singh,03-10-2005,352603,Meghalaya,0,8,9,5,22,Pass
Aarav Reddy,01-12-2005,869303,Tamil Nadu,0,16,3,1,20,Pass
Aarav Pillai,03-01-2006,572214,Rajasthan,7,11,15,20,53,Pass
Aryan Sharma,16-06-2005,888540,West Bengal,3,6,18,21,48,Pass
Peter Khan,14-11-2005,284848,Madhya Pradesh,1,24,23,3,51,Pass
Krishna Khan,10-02-2005,988436,Maharashtra,3,16,13,18,50,Pass
John D'Souza,09-07-2005,226998,Madhya Pradesh,1,8,3,15,27,Pass
Krishna Khan,29-01-2006,615376,Punjab,9,7,18,23,57,Pass
Aryan D'Souza,12-03-2005,958518,Rajasthan,5,19,23,13,60,Pass
Kunal Verma,26-02-2005,973055,Madhya Pradesh,5,11,10,18,44,Pass
Kunal Sharma,10-12-2004,505198,Tamil Nadu,8,20,3,7,38,Pass
Aryan Verma,14-02-2005,317681,Tripura,3,19,18,21,61,Pass
Aditya Mehta,17-08-2005,256319,Rajasthan,7,8,19,3,37,Pass
Krishna Reddy,02-01-2006,645909,Bihar,5,6,13,3,27,Pass
Aditya Sharma,31-07-2005,678174,Tamil Nadu,18,1,15,6,40,Pass
Vivaan Chopra,14-11-2005,589196,Maharashtra,5,24,19,4,52,Pass
Aditya Reddy,13-03-2005,590918,Maharashtra,3,5,22,13,43,Pass
Rohan Sharma,15-12-2005,980244,Odisha,8,7,8,1,24,Pass
Yash Sharma,19-03-2005,880433,Haryana,17,11,12,22,62,Pass
Harjeet Mehta,20-04-2005,304771,West Bengal,0,1,19,3,23,Pass
Yash Verma,18-07-2005,854487,Jharkhand,23,1,21,7,52,Pass
Yash Chopra,27-11-2004,696760,Bihar,9,11,8,5,33,Pass
Yash Singh,21-08-2005,948365,Karnataka,23,2,24,12,61,Pass
Kunal Verma,12-07-2005,144051,Maharashtra,3,14,23,8,48,Pass
Kunal D'Souza,04-03-2006,385232,Bihar,11,20,6,14,51,Pass
Ishaan Singh,24-12-2005,948926,Jammu & Kashmir + Ladakh,15,1,13,13,42,Pass
Yash Chopra,01-02-2006,566285,Tamil Nadu,10,4,10,17,41,Pass
Aditya Khan,08-04-2005,614954,Rajasthan,2,9,13,4,28,Pass
Rehan Fernandes,24-01-2006,462914,Uttar Pradesh,23,9,4,14,50,Pass
John Mehta,20-02-2006,661700,Rajasthan,2,5,12,0,19,Pass
Aditya Mehta,27-09-2005,116023,Punjab,18,14,11,6,49,Pass
Ishaan Pillai,01-03-2005,577170,Tripura,8,4,2,20,34,Pass
Krishna Fernandes,18-02-2006,699607,Madhya Pradesh,22,7,4,11,44,Pass
Aditya Sharma,04-03-2005,530492,Madhya Pradesh,16,0,7,6,29,Pass
Raj Fernandes,15-01-2005,833959,Uttar Pradesh,10,9,4,14,37,Pass
Farhan D'Souza,25-02-2005,770654,Punjab,11,21,1,4,37,Pass
Krishna Khan,09-02-2005,677026,Uttar Pradesh,12,9,4,14,39,Pass
Manpreet Khan,08-11-2005,669582,Maharashtra,3,19,20,21,63,Pass
Peter Pillai,19-03-2006,670701,Punjab,5,18,3,23,49,Pass
Balbir Chopra,14-05-2005,164900,Gujarat,16,6,15,7,44,Pass
Aryan Singh,29-07-2005,499485,Haryana,18,12,19,13,62,Pass
Vivaan Mehta,27-02-2005,126152,Assam,2,18,11,10,41,Pass
Aryan Khan,07-09-2005,882249,Himachal Pradesh,23,19,2,17,61,Pass
Kunal Khan,21-02-2005,541897,Maharashtra,1,20,11,4,36,Pass
Ishaan Fernandes,12-11-2004,319458,Punjab,19,18,0,2,39,Pass
Aditya Verma,02-07-2005,189608,Tamil Nadu,4,24,5,8,41,Pass
Rehan Khan,09-04-2006,333332,Himachal Pradesh,1,16,8,0,25,Pass
Manpreet Verma,07-11-2004,533885,Madhya Pradesh,19,18,1,17,55,Pass
Yash Reddy,30-03-2006,472871,Bihar,15,7,9,14,45,Pass
Raj Chopra,10-12-2005,240756,Bihar,18,22,7,15,62,Pass
Manpreet Chopra,13-01-2005,306374,Nagaland,11,2,11,12,36,Pass
Raj D'Souza,16-01-2006,445727,Odisha,24,3,8,21,56,Pass
Yash Verma,22-12-2004,578689,Kerala,4,22,23,12,61,Pass
Aryan Mehta,25-01-2005,292720,Gujarat,0,7,8,15,30,Pass
Paul Chopra,20-04-2006,885325,Madhya Pradesh,4,0,9,4,17,Pass
Sukhwinder Pillai,08-01-2005,218677,Uttar Pradesh,16,9,4,14,43,Pass
Aditya Reddy,02-11-2005,416233,Rajasthan,19,7,17,17,60,Pass
Krishna Mehta,02-04-2005,570028,Tamil Nadu,9,16,22,19,66,Pass
Krishna Sharma,16-07-2005,587044,Assam,3,22,5,9,39,Pass
Rehan Chopra,29-05-2005,492311,Andhra Pradesh,8,18,2,1,29,Pass
Gurpreet D'Souza,10-09-2005,984934,Haryana,6,9,12,12,39,Pass
Raj Pillai,19-11-2005,924152,Karnataka,7,20,10,8,45,Pass
Peter Chopra,11-04-2005,787974,Madhya Pradesh,15,4,18,15,52,Pass
Mathew Singh,15-05-2005,694799,Haryana,15,6,10,7,38,Pass
Yash Reddy,07-04-2005,416950,Uttar Pradesh,23,9,4,14,50,Pass
Raj Mehta,11-11-2004,366120,Uttar Pradesh,13,9,4,14,40,Pass
Raj Verma,03-06-2005,558730,Haryana,10,1,18,12,41,Pass
Yash D'Souza,09-04-2006,472277,Gujarat,12,3,6,21,42,Pass
Aarav Verma,10-04-2006,421551,West Bengal,13,15,13,5,46,Pass
Harjeet Reddy,16-11-2005,287975,Bihar,23,4,2,11,40,Pass
Yash Pillai,16-04-2006,157098,Uttar Pradesh,1,9,4,14,28,Pass
Aryan Chopra,07-12-2005,401800,Bihar,17,10,3,24,54,Pass
Ayaan Verma,03-01-2006,579490,Maharashtra,12,1,2,11,26,Pass
Aryan Pillai,05-12-2004,365248,Bihar,3,13,19,2,37,Pass
Vivaan Fernandes,18-04-2005,862535,Bihar,23,23,1,3,50,Pass
Manpreet Singh,25-10-2005,120335,West Bengal,3,8,8,24,43,Pass
Kunal D'Souza,15-02-2005,717053,Uttar Pradesh,15,9,4,14,42,Pass
Sukhwinder Singh,29-10-2005,439975,Uttarakhand,5,16,8,6,35,Pass
Peter Mehta,28-07-2005,475288,Mizoram,4,2,7,5,18,Pass
Gurpreet Chopra,29-01-2006,582653,Andhra Pradesh,20,11,15,13,59,Pass
Aditya Mehta,14-01-2005,346051,Madhya Pradesh,6,3,4,5,18,Pass
Raj Sharma,29-10-2005,918771,Andhra Pradesh,9,5,10,13,37,Pass
Aryan Pillai,05-05-2006,455328,Uttar Pradesh,13,9,4,14,40,Pass
Aryan Verma,03-07-2005,787138,Bihar,18,14,7,12,51,Pass
Imran Singh,11-11-2005,518357,Maharashtra,9,0,12,0,21,Pass
Harjeet D'Souza,24-11-2004,512028,Telangana,6,11,3,13,33,Pass
Gurpreet Chopra,04-01-2006,897849,Uttar Pradesh,7,9,4,14,34,Pass
Gurpreet Pillai,26-11-2005,113644,Uttar Pradesh,11,9,4,14,38,Pass
Balbir Reddy,31-01-2006,120758,Madhya Pradesh,0,15,13,11,39,Pass
Krishna Mehta,09-05-2005,711032,Meghalaya,11,6,6,9,32,Pass
Kunal Sharma,15-12-2004,723242,Uttar Pradesh,9,9,4,14,36,Pass
Raj Verma,09-11-2005,358843,Chhattisgarh,2,7,11,6,26,Pass
Harjeet Verma,11-06-2005,248950,Odisha,3,4,8,14,29,Pass
Aryan Khan,08-09-2005,246555,Rajasthan,2,14,8,17,41,Pass
Harjeet Khan,03-05-2005,100439,Tamil Nadu,13,5,3,23,44,Pass
Rohan Pillai,13-03-2006,496115,Gujarat,8,5,13,11,37,Pass
Yash D'Souza,05-05-2005,134029,Uttar Pradesh,1,9,4,14,28,Pass
Ishaan Singh,11-06-2005,180004,Maharashtra,3,8,5,20,36,Pass
Harjeet Pillai,18-12-2004,951423,Chhattisgarh,24,15,0,1,40,Pass
Aarav Khan,13-06-2005,806684,Puducherry,5,6,11,10,32,Pass
Raj Chopra,15-12-2005,400582,Uttar Pradesh,5,9,4,14,32,Pass
Yash Pillai,01-12-2004,990545,Gujarat,5,14,2,2,23,Pass
Krishna Singh,15-02-2006,894674,West Bengal,10,12,16,7,45,Pass
Aryan Pillai,31-03-2006,204001,West Bengal,20,1,13,8,42,Pass
Raj Khan,26-07-2005,984883,Kerala,24,2,19,4,49,Pass
Aarav Reddy,11-10-2005,707492,Punjab,14,6,12,1,33,Pass
Aryan Fernandes,07-03-2006,404042,Uttar Pradesh,9,9,4,14,36,Pass
Raj Singh,17-03-2006,730328,Gujarat,22,9,17,12,60,Pass
Gurpreet Sharma,13-04-2005,167573,Uttar Pradesh,8,9,4,14,35,Pass
Mathew Fernandes,27-12-2004,659112,Andhra Pradesh,19,5,17,19,60,Pass
Aryan Chopra,11-10-2005,561844,Himachal Pradesh,13,8,15,8,44,Pass
Kunal Fernandes,11-05-2005,567279,Madhya Pradesh,3,11,9,1,24,Pass
John Verma,14-04-2005,872822,Andhra Pradesh,10,18,19,12,59,Pass
Sukhwinder Fernandes,28-03-2006,143086,Uttar Pradesh,0,9,4,14,27,Pass
Vivaan Singh,26-06-2005,723810,Uttar Pradesh,13,9,4,14,40,Pass
Kunal Pillai,12-11-2005,422919,Maharashtra,11,1,9,15,36,Pass
Raj D'Souza,26-09-2005,325095,Rajasthan,10,15,20,8,53,Pass
Vivaan Pillai,09-03-2006,605351,Jharkhand,13,19,18,14,64,Pass
David D'Souza,10-10-2005,389983,Madhya Pradesh,22,19,5,3,49,Pass
Rohan Verma,22-04-2006,700395,Bihar,19,19,5,7,50,Pass
Aditya D'Souza,17-01-2006,873931,Maharashtra,13,13,16,13,55,Pass
David Chopra,23-01-2005,522480,Bihar,17,1,10,1,29,Pass
Aryan Reddy,25-04-2006,799902,Punjab,4,3,5,4,16,Pass
Aditya Khan,07-04-2006,541082,West Bengal,1,5,19,7,32,Pass
David Singh,15-12-2005,316059,West Bengal,12,13,0,13,38,Pass
Peter Pillai,30-01-2006,390628,Tamil Nadu,13,14,16,5,48,Pass
Aditya Fernandes,14-11-2005,834703,Nagaland,24,13,3,3,43,Pass
Ishaan Reddy,11-01-2006,983854,Punjab,9,7,3,6,25,Pass
Gurpreet D'Souza,19-04-2005,329317,Bihar,23,7,9,5,44,Pass
Rohan Khan,01-10-2005,777102,Tamil Nadu,1,21,5,11,38,Pass
Yash D'Souza,16-11-2004,196467,Odisha,15,17,22,3,57,Pass
Yash Khan,25-09-2005,815309,Rajasthan,0,14,7,5,26,Pass
Aarav Reddy,24-08-2005,940636,Uttar Pradesh,19,9,4,14,46,Pass
Yash Mehta,12-04-2005,495555,Haryana,2,1,17,6,26,Pass
Rohan Khan,02-02-2005,684207,Meghalaya,22,11,4,7,44,Pass
Vivaan Khan,20-04-2006,503662,West Bengal,2,20,14,9,45,Pass
Yash Sharma,15-09-2005,337302,Uttar Pradesh,0,9,4,14,27,Pass
Krishna Sharma,14-02-2005,975427,Tamil Nadu,9,14,12,5,40,Pass
Aarav Reddy,13-11-2005,312357,Andhra Pradesh,10,15,20,6,51,Pass
Aarav D'Souza,24-11-2005,776091,Uttar Pradesh,9,9,4,14,36,Pass
David Singh,11-10-2005,382228,Maharashtra,3,3,24,8,38,Pass
Vivaan D'Souza,08-05-2006,280932,Odisha,8,11,1,1,21,Pass
Kunal Mehta,31-03-2005,433422,Rajasthan,4,17,22,13,56,Pass
Krishna Khan,01-02-2005,249003,Punjab,10,6,2,6,24,Pass
Harjeet Mehta,26-12-2004,945516,Maharashtra,3,23,23,3,52,Pass
Rohan D'Souza,21-01-2005,754176,Bihar,12,0,5,17,34,Pass
Vivaan Fernandes,22-04-2006,941613,West Bengal,17,8,3,3,31,Pass
Yash Chopra,08-02-2006,306797,West Bengal,3,11,16,6,36,Pass
Aarav Singh,23-07-2005,152203,Himachal Pradesh,14,6,13,13,46,Pass
Kunal Singh,30-06-2005,165041,Uttar Pradesh,18,9,4,14,45,Pass
Krishna Fernandes,09-12-2005,841778,Goa,6,2,10,7,25,Pass
Aarav Fernandes,21-11-2004,586673,Bihar,1,12,7,1,21,Pass
Aarav Mehta,08-11-2005,776004,Uttar Pradesh,7,9,4,14,34,Pass
Vivaan Reddy,15-08-2005,103215,Rajasthan,18,9,23,20,70,Pass
Krishna Singh,04-05-2006,898690,Himachal Pradesh,7,19,6,6,38,Pass
Raj D'Souza,31-03-2005,842645,Andhra Pradesh,4,22,5,24,55,Pass
Vivaan Chopra,03-12-2005,467152,Maharashtra,6,1,2,12,21,Pass
Aarav Sharma,12-09-2005,464245,Assam,19,7,6,10,42,Pass
Vivaan Mehta,18-11-2005,627110,Tamil Nadu,18,6,18,15,57,Pass
Balbir Verma,12-09-2005,327690,Madhya Pradesh,7,0,11,23,41,Pass
John Fernandes,18-04-2005,796557,Bihar,19,13,8,16,56,Pass
Aditya Singh,14-02-2006,300261,Odisha,17,16,3,3,39,Pass
Rohan Chopra,11-01-2005,765035,Odisha,22,3,14,15,54,Pass
Kunal Reddy,09-04-2006,434808,Haryana,2,24,3,4,33,Pass
Raj Sharma,17-12-2004,138770,Tripura,18,23,23,3,67,Pass
Ayaan Khan,01-11-2005,363626,Madhya Pradesh,1,3,6,19,29,Pass
Harjeet Khan,31-01-2006,713126,Uttar Pradesh,19,9,4,14,46,Pass
Aditya Verma,12-04-2005,354681,Haryana,23,13,10,17,63,Pass
Gurpreet Fernandes,05-09-2005,580293,Rajasthan,18,6,15,13,52,Pass
Aditya Reddy,24-12-2004,622912,Himachal Pradesh,1,8,14,22,45,Pass
Aryan Khan,14-12-2005,761398,Gujarat,6,13,22,14,55,Pass
Harjeet Sharma,16-07-2005,814798,Madhya Pradesh,1,16,5,16,38,Pass
Balbir Mehta,25-04-2006,322143,Telangana,21,13,2,4,40,Pass
Kunal D'Souza,18-01-2005,731852,West Bengal,18,0,23,10,51,Pass
Ishaan Reddy,03-12-2004,610692,West Bengal,3,22,15,13,53,Pass
Vivaan Khan,29-03-2006,312828,Maharashtra,12,9,14,1,36,Pass
Aarav Pillai,03-04-2006,613641,Bihar,24,1,9,17,51,Pass
Aryan Mehta,23-12-2005,232716,Uttar Pradesh,16,9,4,14,43,Pass
Sukhwinder Sharma,12-06-2005,866465,Odisha,3,11,15,21,50,Pass
Balbir Chopra,17-11-2004,990857,Bihar,14,4,13,3,34,Pass
Sukhwinder D'Souza,11-09-2005,515161,Telangana,21,12,21,3,57,Pass
Kunal Singh,22-05-2005,557324,Uttar Pradesh,4,9,4,14,31,Pass
Krishna Sharma,15-10-2005,916151,Kerala,0,10,16,4,30,Pass
Aditya Pillai,20-12-2005,651919,Uttar Pradesh,7,9,4,14,34,Pass
Aryan D'Souza,21-05-2005,609300,Maharashtra,16,6,18,5,45,Pass
John Khan,01-03-2005,101624,Telangana,6,10,3,11,30,Pass
Sukhwinder Verma,01-07-2005,186680,Rajasthan,10,1,16,2,29,Pass
Sukhwinder Mehta,08-03-2006,168218,Jharkhand,6,16,18,7,47,Pass
Aarav Sharma,08-08-2005,160462,Punjab,8,22,16,3,49,Pass
Manpreet Fernandes,18-11-2005,547410,Uttar Pradesh,4,9,4,14,31,Pass
Krishna Singh,03-04-2005,229426,Karnataka,13,20,2,11,46,Pass
Rohan D'Souza,23-12-2005,738772,Haryana,9,10,8,7,34,Pass
Krishna Sharma,18-05-2005,267411,Odisha,4,1,9,16,30,Pass
Yash Fernandes,13-12-2004,913299,Rajasthan,22,14,3,11,50,Pass
Gurpreet Fernandes,01-02-2005,426637,Punjab,20,6,2,1,29,Pass
Krishna Khan,30-09-2005,778366,Punjab,22,22,3,14,61,Pass
Kunal Pillai,30-12-2005,151279,West Bengal,22,3,9,11,45,Pass
Kunal Khan,18-11-2005,783487,Maharashtra,0,24,6,9,39,Pass
Vivaan Singh,05-10-2005,443445,Delhi,13,18,20,1,52,Pass
Paul Khan,03-07-2005,364200,Maharashtra,18,4,13,2,37,Pass
Ishaan Reddy,15-01-2006,946129,Telangana,18,16,1,2,37,Pass
Rehan Sharma,10-02-2005,176558,Gujarat,12,24,6,24,66,Pass
Rohan Chopra,18-03-2005,987347,Meghalaya,3,7,3,23,36,Pass
Kunal Pillai,26-04-2006,531650,Assam,16,6,5,11,38,Pass
Aditya Reddy,06-04-2006,291910,Maharashtra,3,19,1,14,37,Pass
Krishna Singh,29-06-2005,533194,Telangana,4,24,4,6,38,Pass
Raj Fernandes,03-01-2005,616467,Andhra Pradesh,9,16,22,9,56,Pass
Kunal Khan,25-01-2006,308805,Punjab,6,10,7,6,29,Pass
Raj Khan,05-05-2006,582794,Maharashtra,21,2,3,21,47,Pass
Kunal Sharma,07-01-2005,387520,Uttar Pradesh,3,9,4,14,30,Pass
Aditya Mehta,04-02-2005,143057,Uttar Pradesh,13,9,4,14,40,Pass
Raj Chopra,01-02-2005,623820,West Bengal,8,21,4,6,39,Pass
John Pillai,07-05-2006,513264,Andhra Pradesh,15,13,15,11,54,Pass
Sukhwinder D'Souza,06-04-2006,287092,Bihar,18,4,1,8,31,Pass
Vivaan Sharma,27-07-2005,219957,Madhya Pradesh,21,5,18,1,45,Pass
Balbir D'Souza,03-10-2005,316139,Gujarat,23,17,22,23,85,Pass
Ishaan Fernandes,20-08-2005,206178,Madhya Pradesh,3,16,24,12,55,Pass
Vivaan Mehta,18-09-2005,671001,Gujarat,22,15,9,18,64,Pass
Vivaan Mehta,26-11-2004,854553,Haryana,10,5,11,16,42,Pass
Yash Khan,02-06-2005,240550,Rajasthan,17,13,22,21,73,Pass
Aditya Chopra,18-03-2005,414730,Uttar Pradesh,1,9,4,14,28,Pass
Peter Chopra,03-03-2005,240079,Telangana,5,6,4,3,18,Pass
Balbir Mehta,21-02-2005,570739,Maharashtra,3,20,24,9,56,Pass
Rohan Khan,26-08-2005,481514,Andhra Pradesh,8,21,3,10,42,Pass
Krishna Chopra,08-11-2004,907306,Karnataka,21,11,9,4,45,Pass
Raj Chopra,24-02-2005,807298,Odisha,15,2,6,1,24,Pass
Balbir Reddy,23-12-2004,149521,Punjab,12,3,24,24,63,Pass
Aarav Verma,25-08-2005,560637,Maharashtra,5,7,17,14,43,Pass
Aryan Reddy,13-11-2004,343544,Maharashtra,3,18,22,9,52,Pass
Aditya Pillai,10-07-2005,730905,Uttar Pradesh,7,9,4,14,34,Pass
Kunal Sharma,11-02-2006,604684,Uttar Pradesh,18,9,4,14,45,Pass
Mathew Reddy,25-05-2005,115052,Maharashtra,24,6,8,11,49,Pass
Raj Sharma,31-01-2005,139087,Rajasthan,17,21,24,2,64,Pass
Ayaan Singh,24-05-2005,428427,Tamil Nadu,4,11,19,8,42,Pass
Ishaan Khan,24-04-2006,957006,Tamil Nadu,17,0,8,7,32,Pass
Kunal Singh,07-10-2005,600149,Bihar,20,9,6,13,48,Pass
Peter Chopra,24-03-2006,568976,Himachal Pradesh,19,10,16,12,57,Pass
Yash Khan,29-11-2005,846435,Maharashtra,3,24,18,20,65,Pass
Raj Sharma,02-12-2005,920996,Maharashtra,3,18,13,13,47,Pass
Peter Verma,05-05-2006,420791,Rajasthan,19,0,19,15,53,Pass
Vivaan Khan,06-03-2005,708187,Gujarat,17,5,20,0,42,Pass
Rohan Reddy,29-05-2005,387052,Uttar Pradesh,9,9,4,14,36,Pass
Imran Singh,05-04-2005,978833,Uttar Pradesh,8,9,4,14,35,Pass
Rohan Sharma,13-04-2005,289465,Bihar,7,11,19,2,39,Pass
Raj Mehta,22-07-2005,175329,Maharashtra,3,22,0,21,46,Pass
Yash Pillai,01-09-2005,843181,Bihar,21,19,5,9,54,Pass
Peter Sharma,13-07-2005,556653,Tamil Nadu,15,5,8,6,34,Pass
Zaid Pillai,06-10-2005,282657,Haryana,13,24,6,2,45,Pass
Kunal Singh,12-11-2004,587998,West Bengal,10,10,0,7,27,Pass
Kunal Verma,26-08-2005,302532,Maharashtra,1,14,14,14,43,Pass
Vivaan Mehta,23-01-2005,535916,West Bengal,7,9,16,16,48,Pass
Balbir D'Souza,08-11-2005,531805,West Bengal,9,3,18,9,39,Pass
Aarav Verma,27-01-2006,579679,Madhya Pradesh,14,11,6,4,35,Pass
Aditya Khan,11-04-2006,190807,Uttar Pradesh,15,9,4,14,42,Pass
Raj Khan,12-04-2006,421063,Uttar Pradesh,4,9,4,14,31,Pass
Paul Fernandes,07-03-2005,561690,Maharashtra,4,5,23,10,42,Pass
Aryan Fernandes,11-12-2005,877505,Andhra Pradesh,15,4,3,9,31,Pass
Aarav Chopra,25-12-2005,331603,Rajasthan,14,20,9,6,49,Pass
Raj D'Souza,26-02-2005,303388,Maharashtra,4,3,13,17,37,Pass
Krishna Khan,28-08-2005,581630,Himachal Pradesh,23,20,4,0,47,Pass
Yash Verma,16-01-2005,615496,Assam,5,5,1,21,32,Pass
Aryan Singh,09-04-2006,166325,Gujarat,11,21,18,1,51,Pass
Ishaan Sharma,04-02-2005,570755,Telangana,12,3,24,12,51,Pass
Aryan Chopra,20-12-2005,589691,Punjab,11,20,11,6,48,Pass
Raj Sharma,14-11-2005,324771,Bihar,20,0,17,3,40,Pass
Kunal D'Souza,12-05-2005,236176,Rajasthan,24,9,13,21,67,Pass
Rohan Reddy,22-09-2005,181121,Telangana,3,22,21,19,65,Pass
Aryan Mehta,06-02-2005,222696,Rajasthan,3,1,1,2,7,Pass
Harjeet Verma,18-10-2005,181635,Madhya Pradesh,6,7,18,0,31,Pass
Paul Chopra,09-04-2005,449977,Karnataka,18,13,19,9,59,Pass
Vivaan D'Souza,17-09-2005,879255,Tamil Nadu,12,14,11,11,48,Pass
Krishna Sharma,05-04-2005,719356,Telangana,13,3,1,24,41,Pass
Aditya D'Souza,12-07-2005,431894,Rajasthan,9,17,8,13,47,Pass
Vivaan Pillai,27-12-2005,626457,Rajasthan,14,16,10,1,41,Pass
Ishaan Chopra,04-02-2005,287042,Uttar Pradesh,3,9,4,14,30,Pass
Yash Mehta,11-05-2005,417721,Telangana,13,11,3,21,48,Pass
Yash Mehta,29-05-2005,349364,Uttar Pradesh,3,9,4,14,30,Pass
Manpreet Fernandes,25-03-2005,245863,Bihar,21,20,4,2,47,Pass
Yash Chopra,14-02-2006,354116,Kerala,13,7,7,19,46,Pass
Aditya Mehta,15-04-2005,410890,Punjab,0,19,5,2,26,Pass
Raj Pillai,19-03-2005,222745,Jharkhand,13,11,2,7,33,Pass
Raj D'Souza,12-09-2005,151946,West Bengal,7,16,13,15,51,Pass
Vivaan Singh,29-04-2005,246454,Haryana,10,13,18,24,65,Pass
Manpreet Singh,23-03-2006,391737,Haryana,5,3,4,4,16,Pass
Krishna D'Souza,08-01-2006,338860,Assam,8,7,23,16,54,Pass
Sukhwinder Reddy,04-01-2005,743937,Meghalaya,12,9,6,24,51,Pass
Balbir Khan,21-01-2006,845804,Madhya Pradesh,12,7,23,0,42,Pass
Aditya Reddy,08-06-2005,193414,West Bengal,8,7,9,10,34,Pass
Imran Verma,19-08-2005,238373,Chhattisgarh,17,14,11,9,51,Pass
Raj Khan,09-05-2005,923174,Rajasthan,11,18,4,10,43,Pass
Ishaan Khan,15-02-2006,784031,Uttar Pradesh,8,9,4,14,35,Pass
Aditya Mehta,31-12-2005,190632,Telangana,14,24,2,3,43,Pass
Balbir Singh,28-03-2006,100902,Bihar,8,21,7,8,44,Pass
Aditya Pillai,16-01-2006,589983,Chhattisgarh,20,7,12,12,51,Pass
Yash Reddy,10-01-2005,922358,Haryana,0,23,5,5,33,Pass
Raj D'Souza,08-05-2005,137943,Uttar Pradesh,7,9,4,14,34,Pass
Krishna Sharma,03-01-2005,520242,Madhya Pradesh,2,3,24,1,30,Pass
Raj Reddy,07-05-2005,506830,Andhra Pradesh,15,18,11,11,55,Pass
Aditya Verma,22-11-2005,155824,West Bengal,4,14,14,7,39,Pass
Kunal Mehta,27-02-2006,566290,West Bengal,22,8,12,6,48,Pass
Aryan Sharma,22-11-2004,399213,Delhi,1,20,5,14,40,Pass
Farhan Pillai,24-02-2006,192537,Delhi,16,12,11,16,55,Pass
Ishaan Mehta,30-12-2004,419605,Bihar,13,21,8,23,65,Pass
Aditya Pillai,10-08-2005,517124,Uttar Pradesh,16,9,4,14,43,Pass
Ishaan D'Souza,28-09-2005,733143,West Bengal,3,15,21,23,62,Pass
Aarav Sharma,24-01-2005,191002,Bihar,24,22,9,3,58,Pass
Kunal Verma,17-04-2006,377556,Gujarat,7,14,19,23,63,Pass
Aarav D'Souza,18-03-2006,838500,Maharashtra,3,23,21,13,60,Pass
Raj Khan,19-07-2005,911663,Bihar,15,13,9,12,49,Pass
Kunal Khan,26-01-2005,105342,Assam,3,1,6,7,17,Pass
Krishna D'Souza,10-04-2005,615958,Tamil Nadu,13,16,17,0,46,Pass
Gurpreet Singh,22-04-2006,561391,Tamil Nadu,10,13,17,5,45,Pass
Aryan Mehta,26-12-2005,407879,Uttar Pradesh,16,9,4,14,43,Pass
Mathew Pillai,23-07-2005,353808,Uttar Pradesh,22,9,4,14,49,Pass
Zaid Fernandes,04-11-2005,328247,Andhra Pradesh,17,7,3,9,36,Pass
Krishna Fernandes,30-07-2005,472209,Chhattisgarh,1,19,23,3,46,Pass
Yash Singh,07-06-2005,496890,Tamil Nadu,12,16,5,9,42,Pass
Krishna Reddy,06-12-2004,601553,Uttar Pradesh,22,9,4,14,49,Pass
Aditya Sharma,09-11-2005,517047,Bihar,5,4,9,12,30,Pass
Rohan D'Souza,26-12-2005,212539,Rajasthan,9,0,2,20,31,Pass
Yash Sharma,29-12-2005,784218,Punjab,12,21,11,13,57,Pass
Ishaan Verma,11-10-2005,885502,Maharashtra,3,6,15,13,37,Pass
David Verma,16-03-2006,253633,Madhya Pradesh,1,19,13,17,50,Pass
Kunal Pillai,09-05-2005,711474,Bihar,19,15,6,21,61,Pass
Kunal Pillai,23-02-2006,143999,Odisha,9,3,5,18,35,Pass
Aryan Pillai,21-10-2005,394957,Uttar Pradesh,9,9,4,14,36,Pass
Aditya Verma,20-04-2005,409004,Bihar,15,10,4,13,42,Pass
Krishna Mehta,06-10-2005,410155,Rajasthan,21,19,22,24,86,Pass
Aryan Sharma,28-12-2004,514423,Haryana,23,23,0,16,62,Pass
Raj D'Souza,11-02-2005,998912,West Bengal,3,9,13,10,35,Pass
Vivaan D'Souza,05-10-2005,691253,Himachal Pradesh,8,3,15,3,29,Pass
Aryan Mehta,26-03-2006,410005,Manipur,23,22,1,4,50,Pass
Rehan Singh,10-11-2005,208375,Tamil Nadu,14,5,10,16,45,Pass
Aryan Sharma,12-11-2004,603669,Uttar Pradesh,17,9,4,14,44,Pass
Raj Pillai,31-03-2006,819376,Odisha,12,3,17,11,43,Pass
Aryan D'Souza,21-03-2005,914549,Maharashtra,19,15,7,3,44,Pass
Aarav Singh,22-12-2004,876702,Gujarat,16,19,8,10,53,Pass
John Singh,06-04-2005,527730,Uttar Pradesh,13,9,4,14,40,Pass
Aditya Khan,24-06-2005,115122,Uttarakhand,5,0,8,6,19,Pass
Manpreet Sharma,27-10-2005,757308,Uttar Pradesh,9,9,4,14,36,Pass
Vivaan Khan,01-04-2006,728966,Gujarat,9,13,13,7,42,Pass
Rohan Pillai,09-08-2005,200327,Madhya Pradesh,4,23,11,10,48,Pass
Krishna Chopra,19-04-2006,940524,Assam,7,16,2,16,41,Pass
David Reddy,08-08-2005,923588,Assam,5,11,21,6,43,Pass
Sukhwinder Verma,23-03-2006,179458,Maharashtra,3,3,21,5,32,Pass
Mathew Chopra,10-03-2005,446644,Andhra Pradesh,24,21,11,16,72,Pass
Rohan Fernandes,15-12-2005,949465,Andhra Pradesh,11,18,4,21,54,Pass
Aditya Sharma,11-11-2004,212636,Bihar,23,24,9,17,73,Pass
Yash Pillai,23-01-2006,230630,Gujarat,9,10,2,0,21,Pass
Aditya Khan,04-05-2005,287909,Punjab,3,18,10,17,48,Pass
Balbir Singh,19-12-2005,152067,Uttar Pradesh,11,9,4,14,38,Pass
Aarav Chopra,01-10-2005,612487,Bihar,21,2,6,20,49,Pass
Aarav Reddy,11-12-2005,796272,Bihar,16,15,2,0,33,Pass
Gurpreet Mehta,28-02-2005,540990,Uttar Pradesh,10,9,4,14,37,Pass
Aarav Singh,05-06-2005,850678,West Bengal,18,5,21,8,52,Pass
Aditya Fernandes,22-03-2005,987736,Rajasthan,10,8,6,3,27,Pass
Aditya Chopra,04-04-2005,574946,Punjab,12,16,23,4,55,Pass
Krishna D'Souza,07-02-2005,300838,Chhattisgarh,7,8,14,21,50,Pass
David D'Souza,04-01-2006,822554,West Bengal,3,12,21,24,60,Pass
Harjeet Sharma,11-08-2005,159424,Tamil Nadu,9,17,16,0,42,Pass
Peter Sharma,14-03-2006,436041,Uttar Pradesh,18,9,4,14,45,Pass
Raj Sharma,24-01-2005,858382,Maharashtra,3,15,11,19,48,Pass
Raj Khan,11-05-2005,567480,Bihar,14,1,7,22,44,Pass
Aditya Sharma,03-05-2006,948634,Himachal Pradesh,5,16,5,17,43,Pass
Aryan Singh,01-05-2006,443881,Rajasthan,23,11,12,16,62,Pass
Ishaan Singh,15-12-2005,614850,Haryana,16,13,16,14,59,Pass
Kunal Chopra,30-12-2005,911494,Uttar Pradesh,14,9,4,14,41,Pass
Yash Pillai,30-08-2005,190060,Haryana,21,22,21,8,72,Pass
Gurpreet Fernandes,30-03-2005,184204,West Bengal,10,0,6,17,33,Pass
Yash Fernandes,15-08-2005,949221,Karnataka,14,0,14,13,41,Pass
Krishna Mehta,21-03-2005,348602,Uttar Pradesh,24,9,4,14,51,Pass
Sukhwinder Pillai,10-04-2006,925858,Maharashtra,3,22,7,24,56,Pass
Vivaan Sharma,17-10-2005,935168,Bihar,9,14,3,7,33,Pass
Kunal Khan,13-12-2005,824301,Uttar Pradesh,1,9,4,14,28,Pass
Aarav Singh,15-08-2005,557848,Tripura,11,11,16,14,52,Pass
Kunal Khan,16-10-2005,391960,Uttar Pradesh,18,9,4,14,45,Pass
Gurpreet Mehta,05-05-2005,822710,Bihar,0,23,5,6,34,Pass
Mathew Khan,26-02-2006,982605,Maharashtra,9,9,19,11,48,Pass
Aditya Fernandes,23-09-2005,555253,Tamil Nadu,6,15,5,14,40,Pass
David Pillai,29-12-2005,217355,Maharashtra,3,16,18,16,53,Pass
Rohan Fernandes,21-06-2005,544552,Telangana,19,12,3,15,49,Pass
Aryan Fernandes,18-02-2006,944411,Bihar,20,6,8,14,48,Pass
Vivaan Mehta,07-12-2004,162049,Karnataka,4,7,8,9,28,Pass
Aryan Verma,08-11-2005,379642,Telangana,8,3,22,3,36,Pass
Krishna Chopra,13-02-2006,767107,Andhra Pradesh,18,17,18,4,57,Pass
Aarav Verma,26-01-2005,804576,Tamil Nadu,5,19,11,24,59,Pass
Sukhwinder Chopra,10-04-2006,533914,West Bengal,9,18,6,8,41,Pass
Aryan Khan,01-05-2005,410057,Punjab,19,21,4,15,59,Pass
Aryan Verma,30-12-2004,303405,West Bengal,0,5,24,22,51,Pass
John Pillai,24-03-2006,261656,Bihar,12,1,8,19,40,Pass
Kunal Pillai,28-01-2005,195672,Uttar Pradesh,3,9,4,24,40,Pass
Gurpreet Verma,09-04-2005,162957,Telangana,19,3,8,1,31,Pass
Krishna Chopra,30-07-2005,564042,Bihar,20,23,1,17,61,Pass
Gurpreet Verma,17-03-2005,839221,Assam,9,5,11,21,46,Pass
Imran Chopra,22-10-2005,237476,Uttarakhand,5,5,8,6,24,Pass
Aditya Mehta,14-01-2005,824082,Kerala,6,18,15,6,45,Pass
Ishaan Singh,28-11-2004,475334,Himachal Pradesh,19,9,11,14,53,Pass
Kunal Sharma,27-02-2006,916389,Uttar Pradesh,10,9,4,4,27,Pass
Aditya Sharma,29-10-2005,928926,Bihar,19,14,6,4,43,Pass
Mathew Singh,17-05-2005,464740,Tamil Nadu,6,20,8,11,45,Pass
Gurpreet D'Souza,09-09-2005,318699,Haryana,2,16,24,6,48,Pass
Ishaan Sharma,23-04-2005,733841,Tamil Nadu,18,7,7,8,40,Pass
Aarav Sharma,04-03-2006,624102,Bihar,24,3,6,19,52,Pass
Raj Mehta,22-10-2005,486782,Rajasthan,22,23,3,11,59,Pass
Aarav Mehta,14-07-2005,269022,Uttar Pradesh,10,9,4,6,29,Pass
Kunal D'Souza,07-09-2005,730719,West Bengal,5,10,12,16,43,Pass
Rohan Sharma,27-06-2005,102870,Jharkhand,5,6,7,8,26,Pass
Yash Mehta,18-02-2006,601799,Arunachal Pradesh,9,9,9,24,51,Pass
Yash Singh,10-07-2005,311116,Madhya Pradesh,22,11,9,6,48,Pass
Krishna Chopra,07-12-2005,587792,Bihar,12,10,10,3,35,Pass
Raj Fernandes,09-04-2005,884537,Karnataka,7,12,11,3,33,Pass
John Fernandes,18-11-2004,486656,West Bengal,16,6,15,4,41,Pass
Raj Fernandes,27-06-2005,889593,Jammu & Kashmir + Ladakh,23,24,8,2,57,Pass
Krishna Verma,25-04-2005,531851,Punjab,3,7,17,8,35,Pass
Gurpreet Pillai,17-02-2005,888732,Maharashtra,1,21,6,17,45,Pass
Aditya Mehta,23-02-2006,107044,Rajasthan,4,17,8,13,42,Pass
Rohan Chopra,07-06-2005,926802,Maharashtra,11,19,5,4,39,Pass
Raj Pillai,11-11-2005,363908,Bihar,3,12,22,2,39,Pass
Manpreet Sharma,07-03-2005,742207,Andhra Pradesh,12,2,4,0,18,Pass
Balbir Pillai,12-02-2006,870580,Uttar Pradesh,6,9,4,19,38,Pass
Raj Chopra,20-01-2005,812800,Maharashtra,3,9,23,22,57,Pass
Zaid Reddy,04-05-2006,400294,Uttar Pradesh,21,9,4,16,50,Pass
Aarav Mehta,08-11-2005,831707,Rajasthan,20,22,3,11,56,Pass
Kunal Chopra,23-11-2004,800378,Karnataka,21,12,8,13,54,Pass
John Khan,06-03-2005,364421,Rajasthan,8,14,6,9,37,Pass
Aryan Chopra,01-01-2005,186387,Maharashtra,14,23,6,4,47,Pass
Krishna Khan,11-12-2004,923382,Assam,2,10,20,11,43,Pass
Peter Singh,30-03-2005,322959,Madhya Pradesh,10,6,8,10,34,Pass
Aditya Mehta,28-11-2005,722466,Karnataka,18,0,2,21,41,Pass
John Singh,01-04-2006,407119,Bihar,9,6,21,5,41,Pass
Raj Chopra,15-02-2006,520176,Haryana,22,19,6,17,64,Pass
Rohan Mehta,07-04-2006,883268,Tamil Nadu,21,5,1,24,51,Pass
Harjeet Verma,20-04-2005,505067,Chhattisgarh,9,16,23,0,48,Pass
Manpreet D'Souza,28-02-2006,388915,West Bengal,3,3,23,16,45,Pass
Aryan Mehta,05-02-2005,957640,Telangana,19,11,3,17,50,Pass
Aarav Fernandes,26-05-2005,389591,Punjab,24,3,1,22,50,Pass
Krishna Mehta,17-05-2005,746021,Himachal Pradesh,7,7,6,5,25,Pass
Manpreet Singh,19-03-2005,752441,Uttar Pradesh,11,9,4,2,26,Pass
Kunal Singh,08-01-2006,707415,Maharashtra,3,21,20,20,64,Pass
Kunal Mehta,28-04-2006,212879,Daman & Diu / D&N Haveli,8,9,6,8,31,Pass
Zaid Reddy,09-02-2005,241902,West Bengal,9,16,6,3,34,Pass
Aarav Fernandes,10-03-2005,987153,Bihar,14,1,6,24,45,Pass
John Mehta,19-07-2005,902310,Maharashtra,3,13,8,11,35,Pass
Aditya Sharma,01-11-2005,520714,Assam,8,8,9,16,41,Pass
Aarav Singh,12-01-2005,863123,Meghalaya,6,5,18,2,31,Pass
Vivaan Pillai,31-03-2006,672895,Telangana,9,12,22,3,46,Pass
David Chopra,12-11-2004,449479,Haryana,18,2,5,19,44,Pass
Raj Pillai,07-05-2006,528726,Bihar,15,19,6,20,60,Pass
Yash Reddy,24-12-2004,282035,Madhya Pradesh,1,12,20,6,39,Pass
Krishna Khan,05-01-2005,407247,Bihar,12,8,8,14,42,Pass
Yash Mehta,23-07-2005,638981,Uttar Pradesh,11,9,4,8,32,Pass
Raj Fernandes,14-02-2005,314626,Karnataka,12,16,14,6,48,Pass
Aarav Singh,06-12-2005,526573,Tamil Nadu,17,22,17,4,60,Pass
Balbir Sharma,08-06-2005,319980,Bihar,11,17,9,24,61,Pass
Aarav Fernandes,18-10-2005,813419,Rajasthan,3,23,13,17,56,Pass
Yash Singh,30-05-2005,805637,Bihar,13,1,12,12,38,Pass
Yash Reddy,21-10-2005,442643,Punjab,24,23,2,8,57,Pass
Balbir D'Souza,03-01-2006,908373,Chhattisgarh,18,3,4,21,46,Pass
Ishaan Verma,27-11-2005,715016,Maharashtra,24,3,0,15,42,Pass
Harjeet Fernandes,13-06-2005,668122,Manipur,4,13,14,13,44,Pass
Raj Pillai,07-05-2005,511612,Maharashtra,6,4,11,17,38,Pass
Raj Khan,11-10-2005,509291,Odisha,18,19,24,17,78,Pass
Aditya Pillai,08-12-2004,469768,Nagaland,4,10,4,9,27,Pass
Vivaan Fernandes,14-08-2005,767768,Bihar,11,23,13,0,47,Pass
Aditya Khan,25-04-2005,444166,Uttar Pradesh,6,9,4,10,29,Pass
Vivaan Mehta,14-11-2005,603778,Uttar Pradesh,18,9,4,12,43,Pass
Krishna Mehta,24-01-2005,355218,Bihar,22,3,6,6,37,Pass
Ishaan Reddy,02-08-2005,269241,Uttar Pradesh,2,9,4,13,28,Pass
Manpreet Khan,23-02-2005,294389,Tamil Nadu,10,1,18,12,41,Pass
Ishaan Sharma,13-03-2006,418501,Madhya Pradesh,1,6,19,24,50,Pass
Kunal Pillai,21-10-2005,302450,Maharashtra,5,1,14,0,20,Pass
Krishna D'Souza,21-08-2005,204736,Uttar Pradesh,22,9,4,11,46,Pass
Aditya Reddy,31-12-2004,433313,Kerala,4,22,24,8,58,Pass
Aryan Singh,16-04-2005,557560,Karnataka,17,11,11,16,55,Pass
Manpreet Sharma,06-10-2005,841680,Himachal Pradesh,20,9,1,12,42,Pass
Aarav D'Souza,07-12-2005,847267,Daman & Diu / D&N Haveli,7,1,1,12,21,Fail
Ishaan Reddy,11-02-2005,505530,Maharashtra,3,17,23,20,63,Pass
Ayaan Singh,18-03-2005,328772,Karnataka,9,14,8,15,46,Pass
Yash Khan,05-01-2006,437904,Karnataka,17,4,16,23,60,Pass
Ayaan D'Souza,21-02-2005,819082,Maharashtra,5,2,15,2,24,Pass
Rohan Reddy,04-04-2005,188721,Mizoram,5,4,4,2,15,Pass
Kunal Mehta,13-11-2004,989877,Rajasthan,0,5,9,19,33,Pass
Aditya Fernandes,29-06-2005,776624,Maharashtra,3,22,6,18,49,Pass
Raj Mehta,13-03-2006,877697,Punjab,16,11,2,14,43,Pass
Rehan Verma,26-11-2005,984565,Rajasthan,9,6,8,12,35,Pass
Aditya Verma,24-02-2005,442291,Rajasthan,8,23,21,5,57,Pass
Aditya Mehta,16-05-2005,832040,Bihar,13,17,4,22,56,Pass
Kunal D'Souza,19-04-2005,264735,Jammu & Kashmir + Ladakh,12,22,1,16,51,Pass
Manpreet Singh,02-11-2005,541643,Odisha,14,13,6,5,38,Pass
Yash Khan,22-11-2005,593059,Punjab,13,19,2,5,39,Pass
Rohan Verma,20-11-2005,998175,Haryana,21,14,17,12,64,Pass
Yash D'Souza,20-01-2006,192600,Punjab,12,13,19,9,53,Pass
Balbir Pillai,03-12-2004,819570,West Bengal,0,10,2,17,29,Pass
Aditya Fernandes,07-06-2005,129074,Bihar,22,21,9,4,56,Pass
John Verma,30-08-2005,811386,Uttar Pradesh,13,9,4,2,28,Pass
Aditya Sharma,09-04-2005,100514,Punjab,24,3,12,16,55,Pass
Vivaan Chopra,03-10-2005,468742,Odisha,2,23,3,8,36,Pass
Aditya Verma,20-11-2004,497879,Jammu & Kashmir + Ladakh,3,10,5,2,20,Pass
Raj Chopra,11-04-2006,268672,Punjab,13,1,4,13,31,Pass
John Pillai,07-03-2005,468905,Rajasthan,1,23,18,0,42,Pass
Kunal Reddy,05-01-2006,525931,Jharkhand,6,17,23,3,49,Pass
Kunal Khan,12-03-2005,187726,Rajasthan,1,19,2,16,38,Pass
Sukhwinder Chopra,13-08-2005,988261,Haryana,16,3,22,13,54,Pass
Aditya Singh,04-09-2005,964252,Assam,8,6,19,16,49,Pass
Vivaan Mehta,29-03-2005,546415,Bihar,9,24,8,8,49,Pass
Aryan D'Souza,07-06-2005,991048,Madhya Pradesh,1,1,21,17,40,Pass
Balbir Singh,12-02-2006,263516,Bihar,17,18,2,8,45,Pass
Ishaan D'Souza,23-02-2005,346620,Telangana,19,10,3,10,42,Pass
Ishaan D'Souza,04-08-2005,684654,Assam,8,8,17,20,53,Pass
Manpreet Singh,11-07-2005,919483,Rajasthan,1,24,6,0,31,Pass
John Verma,01-01-2005,852807,Chhattisgarh,8,8,22,9,47,Pass
Krishna D'Souza,20-07-2005,777518,Jharkhand,0,2,10,19,31,Pass
Kunal Mehta,13-08-2005,266785,Jharkhand,22,18,19,5,64,Pass
Aditya Sharma,11-10-2005,720717,Haryana,1,0,23,17,41,Pass
Mathew D'Souza,12-02-2005,252804,Jammu & Kashmir + Ladakh,7,22,2,18,49,Pass
Kunal Sharma,14-02-2006,942694,Jammu & Kashmir + Ladakh,5,5,12,5,27,Pass
Mathew Khan,06-03-2005,535870,Madhya Pradesh,9,4,20,13,46,Pass
Vivaan D'Souza,23-06-2005,870956,Maharashtra,3,12,19,9,43,Pass
Harjeet Pillai,14-10-2005,881780,Uttar Pradesh,23,9,4,13,49,Pass
Aditya Sharma,18-09-2005,858251,Maharashtra,6,12,1,4,23,Pass
Peter Pillai,02-04-2006,851763,Andhra Pradesh,18,10,11,0,39,Pass
Vivaan Mehta,03-03-2006,325350,Rajasthan,15,5,1,17,38,Pass
Ishaan Khan,11-01-2005,686162,Rajasthan,17,9,18,22,66,Pass
Manpreet Chopra,01-10-2005,756930,Uttar Pradesh,0,9,4,12,25,Pass
Ishaan D'Souza,06-06-2005,517878,West Bengal,3,11,22,18,54,Pass
Kunal Fernandes,26-05-2005,799971,Uttar Pradesh,3,9,4,13,29,Pass
Vivaan Mehta,27-04-2006,123833,Gujarat,7,20,5,20,52,Pass
Rohan Fernandes,03-12-2004,167294,Andhra Pradesh,14,12,9,15,50,Pass
Peter Singh,04-04-2006,706978,Bihar,15,13,9,8,45,Pass
Gurpreet Singh,23-02-2005,491052,Bihar,12,19,8,1,40,Pass
Aryan D'Souza,23-11-2004,845826,Andhra Pradesh,17,1,3,24,45,Pass
Aditya Sharma,18-04-2005,890938,Madhya Pradesh,5,12,21,5,43,Pass
Vivaan Verma,25-12-2005,713003,Karnataka,9,18,16,13,56,Pass
Aryan Chopra,05-08-2005,762749,Chhattisgarh,6,20,2,8,36,Pass
Peter Singh,04-09-2005,526459,Uttar Pradesh,24,9,4,10,47,Pass
Peter Fernandes,16-07-2005,888464,Uttar Pradesh,6,9,4,1,20,Pass
Aryan Verma,20-04-2006,135133,Kerala,12,19,9,3,43,Pass
Harjeet Pillai,04-04-2005,969314,Bihar,15,5,5,23,48,Pass
Vivaan Fernandes,14-04-2006,192736,Uttar Pradesh,10,9,4,16,39,Pass
Kunal Singh,09-02-2006,329514,Assam,5,6,16,11,38,Pass
Imran D'Souza,13-05-2005,880083,Chhattisgarh,20,9,8,16,53,Pass
Aarav Pillai,03-08-2005,831923,Uttar Pradesh,3,9,4,4,20,Pass
Aditya Sharma,09-06-2005,783918,West Bengal,10,18,22,0,50,Pass
Aditya D'Souza,22-10-2005,559370,Bihar,18,22,3,10,53,Pass
Aarav Sharma,16-01-2006,109659,Madhya Pradesh,9,2,22,0,33,Pass
Peter Mehta,02-11-2005,740687,Himachal Pradesh,23,5,15,13,56,Pass
Gurpreet Fernandes,09-11-2005,567798,Uttarakhand,5,6,8,6,25,Pass
Krishna Verma,24-12-2004,795007,Bihar,10,9,5,19,43,Pass
Kunal Pillai,09-01-2005,723897,Uttar Pradesh,0,9,4,7,20,Pass
Aryan Chopra,29-03-2005,318976,Telangana,24,3,0,24,51,Pass
Gurpreet Verma,24-01-2005,630551,Bihar,14,8,9,6,37,Pass
Aryan Mehta,09-08-2005,425415,Rajasthan,22,8,10,15,55,Pass
Aarav Khan,14-01-2006,357315,Jharkhand,3,0,16,8,27,Pass
Vivaan Verma,24-04-2006,504136,Bihar,19,24,8,18,69,Pass
Gurpreet D'Souza,04-07-2005,366933,Assam,10,14,6,12,42,Pass
Peter Chopra,15-04-2005,482288,Rajasthan,17,0,6,0,23,Pass
Aarav Pillai,28-04-2006,583042,Maharashtra,6,6,9,18,39,Pass
Vivaan Fernandes,15-09-2005,187342,Andhra Pradesh,5,19,1,21,46,Pass
Yash Reddy,22-06-2005,907902,Uttar Pradesh,12,9,4,2,27,Pass
Raj D'Souza,04-04-2005,104486,Chhattisgarh,9,0,10,4,23,Pass
Yash Verma,01-12-2004,240093,Telangana,2,12,11,20,45,Pass
Kunal Mehta,01-10-2005,449702,Maharashtra,12,1,23,11,47,Pass
Rehan Singh,13-02-2005,331031,Madhya Pradesh,1,23,12,21,57,Pass
Rehan D'Souza,09-03-2006,742560,Madhya Pradesh,1,4,22,20,47,Pass
Aditya Reddy,15-03-2005,977982,Assam,7,20,2,16,45,Pass
Aarav Verma,14-12-2004,855937,Delhi,8,0,5,9,22,Pass
Yash Mehta,27-03-2006,781006,West Bengal,3,5,19,24,51,Pass
Aditya Pillai,10-08-2005,294386,Maharashtra,3,22,18,18,61,Pass
Kunal Fernandes,03-12-2004,738480,Uttar Pradesh,18,9,4,10,41,Pass
Aarav Fernandes,14-11-2004,216777,Telangana,12,3,11,20,46,Pass
Vivaan Singh,20-01-2005,738254,Bihar,19,0,23,1,43,Pass
Manpreet Pillai,22-08-2005,956898,Uttarakhand,5,19,8,6,38,Pass
Vivaan Sharma,20-03-2005,646591,Telangana,17,4,3,22,46,Pass
Ishaan D'Souza,01-01-2006,757551,Haryana,15,23,3,12,53,Pass
Yash D'Souza,21-08-2005,818645,Haryana,17,19,10,3,49,Pass
Rehan Khan,19-03-2006,633281,Uttar Pradesh,13,9,4,16,42,Pass
Aditya Chopra,13-12-2004,384917,Madhya Pradesh,17,10,7,20,54,Pass
Manpreet Fernandes,17-03-2006,558491,Karnataka,11,9,11,2,33,Pass
Krishna Reddy,11-03-2006,796309,Manipur,10,17,14,3,44,Pass
Rohan Verma,13-02-2006,741881,Madhya Pradesh,6,18,4,5,33,Pass
Krishna Verma,18-03-2005,215960,Punjab,16,21,3,12,52,Pass
Yash Sharma,29-01-2005,527882,Jharkhand,17,2,2,12,33,Pass
Vivaan Singh,19-04-2006,507701,West Bengal,6,0,6,1,13,Pass
Paul Chopra,18-10-2005,686733,Punjab,21,16,23,3,63,Pass
Rohan Pillai,20-06-2005,110180,Haryana,2,16,24,6,48,Pass
Vivaan Mehta,01-06-2005,561516,Madhya Pradesh,22,0,1,6,29,Pass
Raj Khan,31-05-2005,786257,Telangana,12,6,9,14,41,Pass
Ishaan Chopra,26-04-2006,891291,Haryana,2,16,10,3,31,Pass
Yash Pillai,28-02-2005,989023,Haryana,0,4,15,17,36,Pass
Kunal Sharma,17-12-2004,618546,Madhya Pradesh,3,19,0,23,45,Pass
Krishna Pillai,15-07-2005,665529,Manipur,4,11,21,13,49,Pass
Harjeet Sharma,07-10-2005,323040,Uttar Pradesh,3,9,4,21,37,Pass
Aryan Mehta,26-04-2006,620176,Assam,5,8,2,5,20,Pass
Paul Singh,21-12-2004,765447,Madhya Pradesh,7,7,2,18,34,Pass
Krishna Verma,25-09-2005,162859,Rajasthan,23,6,9,21,59,Pass
Aditya Mehta,17-02-2005,949154,Uttar Pradesh,3,9,4,24,40,Pass
Aditya Fernandes,04-12-2005,239326,Rajasthan,14,7,20,9,50,Pass
Krishna Pillai,05-01-2006,425692,Bihar,24,11,5,23,63,Pass
Raj D'Souza,26-04-2005,565694,Bihar,1,17,16,5,39,Pass
Manpreet Verma,05-02-2005,968901,Kerala,20,6,8,15,49,Pass
Aarav Khan,24-09-2005,757182,Uttar Pradesh,11,9,4,2,26,Pass
Krishna Sharma,29-12-2005,939669,Uttarakhand,5,23,8,6,42,Pass
Raj Pillai,09-05-2005,606796,Uttar Pradesh,3,9,4,6,22,Pass
Kunal Pillai,09-03-2005,357289,Haryana,2,13,16,11,42,Pass
Peter Sharma,17-02-2006,829267,Odisha,11,16,4,9,40,Pass
Kunal Fernandes,03-05-2005,345828,Uttar Pradesh,14,9,4,4,31,Pass
Imran Fernandes,20-02-2005,706898,Tamil Nadu,6,15,5,19,45,Pass
Raj Chopra,14-12-2005,889650,Chhattisgarh,13,19,4,24,60,Pass
Rohan Mehta,28-12-2004,699244,Bihar,19,7,6,5,37,Pass
Raj Verma,09-04-2005,129188,Bihar,10,5,5,20,40,Pass
Raj Khan,05-06-2005,185745,Bihar,10,9,15,20,54,Pass
Aditya Mehta,22-12-2004,686851,Maharashtra,24,0,3,15,42,Pass
Kunal Singh,30-11-2005,846269,Gujarat,8,7,20,21,56,Pass
Rohan Chopra,15-04-2005,325627,Bihar,6,1,22,6,35,Pass
Ishaan Verma,17-07-2005,113475,Tamil Nadu,2,22,19,4,47,Pass
Yash Chopra,06-06-2005,620774,Tamil Nadu,23,12,17,17,69,Pass
Vivaan Pillai,24-11-2004,282129,Chhattisgarh,22,7,16,6,51,Pass
Krishna Singh,31-07-2005,899829,Telangana,5,24,11,3,43,Pass
Zaid Khan,14-10-2005,166113,Punjab,24,1,3,13,41,Pass
Raj Chopra,02-09-2005,274671,Haryana,19,16,9,24,68,Pass
Aryan D'Souza,13-04-2006,918618,Tamil Nadu,18,21,3,5,47,Pass
Rehan Pillai,19-04-2006,101123,Odisha,3,1,22,1,27,Pass
Kunal Pillai,10-01-2006,809401,Rajasthan,11,0,7,18,36,Pass
Krishna Chopra,23-07-2005,185925,Jammu & Kashmir + Ladakh,3,16,20,6,45,Pass
Aarav Fernandes,11-01-2006,385798,Jharkhand,23,0,17,23,63,Pass
Aarav Fernandes,12-03-2006,291569,Madhya Pradesh,18,24,11,1,54,Pass
Balbir Singh,08-12-2005,537862,Rajasthan,4,1,11,4,20,Pass
Raj Fernandes,20-12-2005,161734,Uttar Pradesh,2,9,4,15,30,Pass
Ishaan Sharma,10-10-2005,621997,Haryana,17,7,18,24,66,Pass
Manpreet Fernandes,27-01-2005,510207,Uttar Pradesh,9,9,4,7,29,Pass
David Mehta,02-01-2006,107420,Punjab,21,15,15,4,55,Pass
Yash Reddy,22-12-2004,215889,Arunachal Pradesh,13,14,6,12,45,Pass
Aarav Chopra,16-08-2005,593476,Bihar,21,1,3,7,32,Pass
Rohan Sharma,18-10-2005,104088,Bihar,15,17,9,0,41,Pass
Peter Verma,11-08-2005,694792,Bihar,19,7,17,24,67,Pass
Sukhwinder Sharma,06-02-2005,659691,Punjab,14,22,15,7,58,Pass
Aryan Fernandes,22-12-2004,619094,Arunachal Pradesh,13,14,9,9,45,Pass
Raj Pillai,30-09-2005,402316,Madhya Pradesh,1,10,20,13,44,Pass
Raj Chopra,03-01-2006,636235,Telangana,15,13,19,3,50,Pass
Sukhwinder Verma,28-05-2005,811916,Odisha,3,1,12,11,27,Pass
Aditya Mehta,06-08-2005,654140,Uttar Pradesh,17,9,4,1,31,Pass
Rohan Pillai,06-04-2006,346362,Uttar Pradesh,3,9,4,10,26,Pass
Rohan Pillai,18-02-2006,286311,Andhra Pradesh,12,17,6,21,56,Pass
Aditya Sharma,03-05-2006,725578,Tamil Nadu,2,6,17,14,39,Pass
Aditya Reddy,28-05-2005,443771,Tamil Nadu,5,22,5,1,33,Pass
Raj Fernandes,14-09-2005,228913,Uttar Pradesh,21,9,4,24,58,Pass
Raj Verma,09-03-2005,201562,Maharashtra,3,3,17,15,38,Pass
Raj Reddy,06-01-2005,223054,Rajasthan,13,20,13,16,62,Pass
Manpreet Khan,06-12-2005,378292,West Bengal,3,19,11,19,52,Pass
Manpreet Chopra,03-08-2005,664171,Bihar,6,4,15,15,40,Pass
Rohan Sharma,28-01-2005,534594,Jharkhand,15,3,17,2,37,Pass
Krishna Chopra,31-01-2006,815182,Maharashtra,15,0,12,2,29,Pass
Krishna D'Souza,22-06-2005,479206,Tamil Nadu,13,13,1,7,34,Pass
Aditya Verma,18-12-2005,851553,Odisha,22,11,5,5,43,Pass
Ishaan Verma,07-03-2005,145184,Chhattisgarh,0,15,16,19,50,Pass
Yash D'Souza,10-11-2005,461183,Arunachal Pradesh,5,10,7,15,37,Pass
Kunal Singh,02-03-2006,750482,Telangana,7,8,3,20,38,Pass
Yash Sharma,13-02-2006,865469,Andhra Pradesh,6,16,4,2,28,Pass
Zaid Khan,03-01-2006,709214,Uttar Pradesh,3,9,4,24,40,Pass
Gurpreet Mehta,27-09-2005,362006,Assam,3,11,17,1,32,Pass
Gurpreet D'Souza,16-06-2005,353659,West Bengal,21,8,10,5,44,Pass
Raj D'Souza,12-12-2005,604271,Andhra Pradesh,20,6,24,0,50,Pass
Balbir Mehta,05-12-2004,285664,Chhattisgarh,13,2,24,17,56,Pass
Harjeet Reddy,02-03-2005,166910,Karnataka,19,4,24,12,59,Pass
Rohan Verma,27-07-2005,518332,Bihar,21,14,9,5,49,Pass
Imran Chopra,12-11-2004,189849,Tamil Nadu,4,5,4,8,21,Pass
Gurpreet Pillai,09-08-2005,310291,Odisha,23,12,8,3,46,Pass
Vivaan Chopra,08-05-2005,838513,Uttar Pradesh,5,9,4,0,18,Pass
Balbir Verma,16-04-2006,435265,Bihar,19,15,3,24,61,Pass
Gurpreet Verma,09-04-2006,390589,Gujarat,8,18,20,3,49,Pass
Yash D'Souza,30-07-2005,308388,Madhya Pradesh,1,2,18,4,25,Pass
Yash Fernandes,31-12-2004,452037,Rajasthan,5,0,1,0,6,Pass
Gurpreet Singh,10-01-2006,131008,Andhra Pradesh,6,17,17,11,51,Pass
Raj Reddy,04-01-2005,694684,Uttar Pradesh,3,9,4,2,18,Pass
Ayaan Singh,11-06-2005,792948,Bihar,11,9,13,8,41,Pass
Vivaan Khan,31-08-2005,711749,Bihar,22,13,8,8,51,Pass
Aditya Khan,21-04-2005,387668,Tripura,19,15,24,3,61,Pass
Ishaan Singh,23-10-2005,735710,Haryana,24,23,5,8,60,Pass
Paul Khan,24-11-2004,428980,Haryana,3,0,20,20,43,Pass
Ayaan Chopra,02-10-2005,832678,Assam,1,0,16,6,23,Pass
Aarav Fernandes,09-03-2006,450265,Madhya Pradesh,1,23,18,0,42,Pass
Aditya Mehta,28-01-2005,697901,Bihar,14,2,15,4,35,Pass
Yash Mehta,27-12-2005,375116,Uttar Pradesh,2,9,4,16,31,Pass
Krishna Singh,02-03-2006,876997,Madhya Pradesh,10,4,21,9,44,Pass
Ishaan Verma,19-06-2005,365853,Bihar,12,15,5,16,48,Pass
Krishna Reddy,28-10-2005,233565,Bihar,7,18,10,16,51,Pass
Raj Sharma,15-05-2005,223679,Andhra Pradesh,19,8,5,22,54,Pass
Imran Singh,27-11-2004,871788,Andhra Pradesh,11,10,16,9,46,Pass
Imran Chopra,07-12-2004,344218,Uttar Pradesh,23,9,4,12,48,Pass
Kunal Verma,13-06-2005,210850,Rajasthan,12,8,13,10,43,Pass
Rohan Chopra,20-04-2006,364465,Karnataka,4,8,7,15,34,Pass
John Pillai,28-01-2006,343026,Haryana,12,16,10,23,61,Pass
Farhan Chopra,21-09-2005,966961,Bihar,13,21,8,24,66,Pass
Ishaan Fernandes,07-05-2006,113105,Maharashtra,6,2,22,6,36,Pass
Aditya Sharma,09-08-2005,173754,Rajasthan,21,0,16,12,49,Pass
Vivaan Fernandes,11-03-2005,812326,Karnataka,8,11,7,21,47,Pass
Kunal Singh,14-02-2006,220425,Haryana,16,12,19,10,57,Pass
David Chopra,11-03-2006,647191,Rajasthan,16,21,22,16,75,Pass
Yash Fernandes,25-03-2006,788624,Assam,10,8,23,8,49,Pass
John Chopra,14-02-2006,540945,Bihar,8,14,10,12,44,Pass
Farhan Khan,22-07-2005,267339,Andhra Pradesh,1,17,8,18,44,Pass
Gurpreet Sharma,19-04-2006,187936,Haryana,2,6,7,19,34,Pass
Balbir Fernandes,03-09-2005,204266,Arunachal Pradesh,15,6,0,15,36,Pass
Sukhwinder Pillai,02-06-2005,173939,Rajasthan,21,1,16,24,62,Pass
Aarav Reddy,18-01-2006,617626,Tamil Nadu,12,8,22,5,47,Pass
Yash Reddy,23-06-2005,887193,Bihar,5,11,3,24,43,Pass
Aryan D'Souza,11-11-2005,650794,Haryana,6,11,22,24,63,Pass
Yash Mehta,22-08-2005,813774,Maharashtra,3,23,7,4,37,Pass
Rohan Mehta,28-03-2006,117281,Jharkhand,15,10,3,16,44,Pass
Ishaan Singh,16-10-2005,864284,Tamil Nadu,20,20,3,17,60,Pass
Krishna Pillai,21-03-2006,833213,Bihar,16,24,5,8,53,Pass
Harjeet Pillai,17-03-2005,720405,Tamil Nadu,19,5,12,12,48,Pass
Ishaan Reddy,17-01-2005,519741,Rajasthan,8,18,2,1,29,Pass
Zaid Reddy,15-10-2005,641063,Tamil Nadu,5,23,18,11,57,Pass
Yash Chopra,10-01-2005,358141,Uttar Pradesh,23,9,4,11,47,Pass
Yash Reddy,07-08-2005,278303,Punjab,4,19,4,16,43,Pass
David Sharma,08-07-2005,532593,Daman & Diu / D&N Haveli,4,10,5,4,23,Pass
Aditya Khan,23-03-2006,633237,Karnataka,18,16,24,8,66,Pass
Krishna Sharma,11-11-2005,800123,Uttar Pradesh,10,9,4,17,40,Pass
Gurpreet Sharma,23-10-2005,758641,Bihar,2,9,11,9,31,Pass
Aryan Mehta,23-12-2004,845117,Uttar Pradesh,10,9,4,15,38,Pass
Aarav Khan,09-11-2004,214152,West Bengal,9,14,2,23,48,Pass
Sukhwinder Khan,03-03-2005,160510,Telangana,21,3,16,13,53,Pass
Aarav Sharma,06-05-2006,342162,West Bengal,3,14,13,14,44,Pass
Manpreet Khan,02-03-2005,118044,Odisha,11,6,1,21,39,Pass
Farhan D'Souza,14-10-2005,308574,Assam,17,5,6,14,42,Pass
Aditya D'Souza,08-08-2005,729642,Rajasthan,17,4,14,12,47,Pass
Rohan Fernandes,06-03-2006,797126,Uttar Pradesh,1,9,4,1,15,Pass
Balbir Singh,05-06-2005,369162,Andhra Pradesh,18,1,18,1,38,Pass
Vivaan Pillai,02-04-2005,794822,Bihar,10,1,7,24,42,Pass
Rohan Mehta,14-04-2005,460602,Himachal Pradesh,9,11,24,7,51,Pass
Krishna Chopra,28-11-2004,831576,Rajasthan,5,3,6,2,16,Pass
Yash D'Souza,14-11-2004,581868,Bihar,24,7,12,15,58,Pass
Balbir Singh,02-11-2005,792928,Rajasthan,17,24,11,6,58,Pass
Raj Sharma,20-10-2005,857506,Telangana,3,18,14,6,41,Pass
Krishna Pillai,29-11-2004,719710,Maharashtra,19,6,2,14,41,Pass
Manpreet Chopra,16-02-2005,327110,Rajasthan,4,5,13,12,34,Pass
Rohan Chopra,12-05-2005,825082,Puducherry,0,5,6,21,32,Pass
Aditya Reddy,06-02-2005,324676,Chhattisgarh,4,18,22,17,61,Pass
Manpreet Verma,03-04-2005,820374,Uttar Pradesh,20,9,4,4,37,Pass
Yash D'Souza,23-11-2005,564517,Andhra Pradesh,9,6,19,20,54,Pass
Raj Pillai,21-11-2004,818558,Bihar,23,13,22,9,67,Pass
Manpreet Fernandes,25-01-2005,756649,Rajasthan,8,23,20,9,60,Pass
Rohan Chopra,07-11-2005,373618,Bihar,16,11,8,7,42,Pass
John Chopra,28-07-2005,681943,West Bengal,8,15,4,9,36,Pass
Raj Verma,09-06-2005,381779,Bihar,22,14,3,1,40,Pass
Aditya Fernandes,19-09-2005,539845,Rajasthan,23,16,1,16,56,Pass
Peter Pillai,22-11-2005,192706,Delhi,14,21,3,0,38,Pass
John Verma,13-03-2005,194450,Assam,11,2,14,5,32,Pass
Aarav Khan,17-03-2005,534281,Maharashtra,3,24,20,24,71,Pass
Raj Chopra,15-02-2006,593487,Karnataka,1,21,13,21,56,Pass
Rohan Pillai,19-04-2006,887884,Bihar,21,9,6,13,49,Pass
Kunal Reddy,09-09-2005,571202,Uttarakhand,5,9,8,6,28,Pass
Aditya Reddy,27-04-2006,861885,Madhya Pradesh,1,19,17,19,56,Pass
Kunal D'Souza,27-04-2005,698380,Maharashtra,3,12,1,23,39,Pass
Yash Pillai,19-12-2004,590214,Maharashtra,18,14,10,5,47,Pass
Farhan Khan,06-09-2005,620737,Bihar,10,15,1,11,37,Pass
Aditya Singh,08-09-2005,914124,Rajasthan,4,14,19,9,46,Pass
Aarav Singh,06-03-2006,279215,Gujarat,15,13,15,18,61,Pass
Krishna Fernandes,25-01-2006,958278,Karnataka,21,5,19,8,53,Pass
Mathew Chopra,19-02-2006,195444,Tamil Nadu,11,4,19,6,40,Pass
Aarav Mehta,18-12-2004,617461,Punjab,17,1,7,4,29,Pass
Krishna Pillai,14-12-2004,966519,Telangana,0,5,10,1,16,Pass
David Chopra,15-11-2005,575598,Karnataka,15,19,2,24,60,Pass
Aditya Pillai,15-06-2005,701289,Rajasthan,6,7,12,21,46,Pass
Manpreet Fernandes,21-12-2005,294281,West Bengal,3,18,22,14,57,Pass
Yash Sharma,22-10-2005,296559,Maharashtra,3,23,20,20,66,Pass
Aditya Chopra,26-05-2005,264846,Bihar,6,18,11,18,53,Pass
Sukhwinder Khan,22-08-2005,751605,Uttar Pradesh,15,9,4,18,46,Pass
Vivaan Fernandes,15-12-2004,138749,Maharashtra,22,17,2,4,45,Pass
Vivaan Pillai,02-05-2005,295171,Punjab,20,12,3,20,55,Pass
Rohan D'Souza,02-03-2006,997142,Arunachal Pradesh,11,5,11,19,46,Pass
Paul Mehta,30-01-2005,892539,Rajasthan,22,19,13,11,65,Pass
Aditya Verma,21-10-2005,763946,Maharashtra,3,2,24,19,48,Pass
Aryan D'Souza,14-06-2005,775973,Uttar Pradesh,0,9,4,9,22,Pass
Krishna Khan,02-09-2005,747983,Andhra Pradesh,23,9,8,23,63,Pass
Balbir Chopra,09-02-2005,465404,Bihar,13,24,2,11,50,Pass
Ishaan Chopra,07-02-2006,955685,West Bengal,10,15,8,21,54,Pass
Rohan D'Souza,13-07-2005,485219,Sikkim,8,0,13,8,29,Pass
Rohan Sharma,25-07-2005,619908,Tamil Nadu,15,5,22,6,48,Pass
Yash Singh,23-12-2005,161708,Kerala,17,5,14,11,47,Pass
Aarav Sharma,27-07-2005,189938,Rajasthan,3,19,14,20,56,Pass
Vivaan D'Souza,26-11-2004,992731,Uttar Pradesh,14,9,4,3,30,Pass
Gurpreet Khan,27-01-2006,241346,Rajasthan,13,9,14,13,49,Pass
Ayaan Sharma,20-01-2006,357423,Bihar,18,17,12,6,53,Pass
Ishaan Fernandes,04-09-2005,993423,Haryana,22,13,8,15,58,Pass
Mathew Chopra,13-02-2006,325264,Punjab,24,3,15,5,47,Pass
Ishaan Khan,07-05-2005,153972,Rajasthan,21,1,4,5,31,Pass
Raj Khan,08-12-2005,786120,Jharkhand,12,4,19,18,53,Pass
Aryan Sharma,20-09-2005,224566,Assam,18,3,10,8,39,Pass
Kunal Khan,05-05-2006,284201,Rajasthan,9,19,20,2,50,Pass
Balbir Pillai,21-08-2005,757544,Haryana,16,12,7,17,52,Pass
Aryan Mehta,23-01-2006,674002,Telangana,22,6,7,1,36,Pass
Krishna Verma,05-09-2005,794410,Himachal Pradesh,8,8,22,17,55,Pass
Rohan Chopra,10-04-2006,151563,Madhya Pradesh,5,19,8,13,45,Pass
Zaid D'Souza,23-03-2006,654998,Rajasthan,22,3,8,1,34,Pass
Aarav Verma,08-02-2006,668592,Maharashtra,3,17,11,12,43,Pass
Balbir Mehta,09-11-2005,172019,Tamil Nadu,9,5,16,22,52,Pass
Kunal Khan,19-03-2005,713151,Uttar Pradesh,11,9,4,12,36,Pass
Aditya Verma,09-12-2005,371025,Rajasthan,17,11,15,8,51,Pass
Raj Pillai,10-01-2006,942923,Rajasthan,11,15,13,11,50,Pass
Peter Fernandes,27-04-2006,196000,Haryana,8,15,2,6,31,Pass
Yash Singh,24-01-2005,305752,Andhra Pradesh,11,20,15,7,53,Pass
John D'Souza,06-03-2006,435044,Tamil Nadu,7,9,5,22,43,Pass
Peter Pillai,05-02-2005,874255,Maharashtra,14,12,2,11,39,Pass
Aryan Singh,27-03-2005,165348,Uttar Pradesh,1,12,4,13,30,Pass
Balbir Fernandes,09-11-2004,694274,Manipur,4,22,11,15,52,Pass
Zaid Singh,17-01-2006,539522,Uttar Pradesh,20,16,4,9,49,Pass
David Pillai,27-11-2005,885202,Chhattisgarh,12,3,2,7,24,Pass
Ayaan Mehta,04-02-2005,665073,Rajasthan,18,11,5,21,55,Pass
Sukhwinder Khan,05-03-2005,313826,Gujarat,3,21,4,20,48,Pass
Krishna D'Souza,04-01-2006,478820,Telangana,23,2,15,20,60,Pass
Zaid Mehta,04-08-2005,573939,Karnataka,4,23,16,9,52,Pass
Kunal Chopra,02-04-2005,899246,Andhra Pradesh,20,5,5,3,33,Pass
Aarav Chopra,27-04-2006,910239,Tamil Nadu,14,13,22,5,54,Pass
Krishna Khan,11-10-2005,494428,Rajasthan,0,6,21,0,27,Pass
Vivaan Reddy,13-12-2005,735983,Uttar Pradesh,23,18,4,11,56,Pass
Yash Singh,18-03-2005,927702,Haryana,6,15,13,18,52,Pass
Aarav Fernandes,30-01-2005,204748,West Bengal,3,12,14,21,50,Pass
Raj D'Souza,04-04-2006,611151,Rajasthan,0,7,12,6,25,Pass
Krishna Mehta,25-09-2005,829092,Assam,10,10,14,3,37,Pass
Krishna Sharma,03-10-2005,872499,Bihar,17,9,9,20,55,Pass
Ishaan Khan,13-04-2006,632353,Gujarat,2,16,1,23,42,Pass
Krishna Mehta,20-12-2005,221109,Odisha,18,15,6,5,44,Pass
Rehan Mehta,04-11-2005,992869,Uttar Pradesh,4,19,4,19,46,Pass
Ishaan Mehta,30-12-2004,377958,Kerala,11,18,7,23,59,Pass
Raj Singh,20-07-2005,570092,Rajasthan,8,2,23,4,37,Pass
Peter Sharma,24-06-2005,157595,West Bengal,20,9,3,22,54,Pass
Aryan Singh,05-07-2005,736167,Uttar Pradesh,5,13,4,22,44,Pass
Aarav Sharma,12-08-2005,900632,Gujarat,6,10,2,20,38,Pass
Yash Khan,06-02-2006,593478,Jharkhand,4,19,15,12,50,Pass
Raj Pillai,14-01-2005,561006,Maharashtra,9,3,5,17,34,Pass
Harjeet Singh,02-03-2005,973595,Telangana,12,10,9,4,35,Pass
Aditya Reddy,23-04-2005,759761,Tamil Nadu,9,2,2,21,34,Pass
Rohan Reddy,27-10-2005,389912,Bihar,5,23,2,3,33,Pass
Krishna Chopra,21-09-2005,588671,Tamil Nadu,19,6,15,20,60,Pass
David Singh,23-06-2005,716355,Madhya Pradesh,16,9,0,12,37,Pass
Aryan D'Souza,02-05-2005,626315,Odisha,3,9,18,18,48,Pass
Aditya Khan,03-08-2005,340180,Bihar,23,19,6,0,48,Pass
Aryan Chopra,07-12-2005,696420,Andhra Pradesh,22,2,24,21,69,Pass
Ishaan Khan,16-06-2005,662659,Uttar Pradesh,1,18,4,10,33,Pass
David Reddy,01-09-2005,707052,Himachal Pradesh,10,18,18,15,61,Pass
Krishna Khan,06-04-2005,864231,Himachal Pradesh,9,3,18,10,40,Pass
Aryan D'Souza,20-04-2006,177669,Haryana,9,9,22,10,50,Pass
Kunal Reddy,07-01-2005,389862,Rajasthan,9,22,7,5,43,Pass
Vivaan Chopra,27-08-2005,489441,Kerala,13,3,19,11,46,Pass
Yash Sharma,20-02-2006,502027,Maharashtra,11,10,3,0,24,Pass
Rohan Chopra,26-05-2005,771807,Maharashtra,0,6,16,3,25,Pass
Zaid Verma,25-12-2004,620094,Bihar,15,13,13,10,51,Pass
Harjeet Khan,31-08-2005,489787,Haryana,2,20,6,8,36,Pass
Raj Singh,23-04-2006,367981,Tamil Nadu,15,6,19,6,46,Pass
Rohan Singh,14-11-2004,588483,Maharashtra,3,11,23,19,56,Pass
Kunal Sharma,13-01-2006,146189,Odisha,6,22,6,14,48,Pass
David Verma,28-08-2005,180814,West Bengal,3,19,9,20,51,Pass
Krishna Fernandes,11-12-2005,746540,Karnataka,5,4,18,9,36,Pass
Raj Singh,30-01-2006,548157,Bihar,17,6,5,15,43,Pass
Ishaan Fernandes,24-02-2005,949814,Uttar Pradesh,5,2,4,18,29,Pass
Rohan D'Souza,05-10-2005,448665,Uttar Pradesh,20,23,4,3,50,Pass
Rohan Fernandes,31-05-2005,632519,Madhya Pradesh,13,5,9,5,32,Pass
Manpreet Chopra,14-02-2005,596924,Bihar,22,0,5,15,42,Pass
Balbir Sharma,21-06-2005,458717,Rajasthan,13,10,16,11,50,Pass
Ishaan Chopra,24-12-2005,664987,Tamil Nadu,2,21,5,23,51,Pass
Krishna Chopra,27-04-2005,312496,Tamil Nadu,7,9,21,14,51,Pass
Sukhwinder Singh,15-02-2006,726707,Gujarat,13,11,7,20,51,Pass
Mathew Sharma,13-06-2005,515140,West Bengal,3,7,22,17,49,Pass
Aryan Mehta,17-04-2005,844386,Punjab,9,6,23,19,57,Pass
Paul Reddy,19-03-2006,893524,West Bengal,11,11,1,4,27,Pass
Krishna Fernandes,09-03-2006,147326,Punjab,5,2,17,5,29,Pass
Krishna Singh,29-07-2005,455456,Andhra Pradesh,14,15,2,5,36,Pass
Aditya Verma,14-01-2005,926698,Bihar,9,10,21,1,41,Pass
Krishna Pillai,03-10-2005,703440,Tamil Nadu,13,3,21,4,41,Pass
Raj Chopra,11-02-2005,290286,Gujarat,9,1,4,8,22,Pass
Raj Pillai,15-04-2005,628234,Maharashtra,21,13,7,8,49,Pass
Krishna Reddy,26-01-2006,200959,Uttar Pradesh,2,22,4,3,31,Pass
Yash Fernandes,22-08-2005,377318,Kerala,4,21,16,14,55,Pass
Raj Verma,15-11-2005,877643,Uttarakhand,5,22,8,6,41,Pass
Krishna Singh,27-08-2005,817421,Himachal Pradesh,9,1,21,3,34,Pass
Balbir Pillai,28-11-2005,957731,Uttar Pradesh,13,14,4,16,47,Pass
Kunal Mehta,08-11-2005,388080,Andhra Pradesh,23,18,18,4,63,Pass
Yash Mehta,12-12-2005,724383,Gujarat,24,1,21,7,53,Pass
Rohan Verma,01-09-2005,793922,Tamil Nadu,8,4,17,17,46,Pass
Manpreet Fernandes,04-03-2006,139989,Meghalaya,14,9,6,5,34,Pass
Imran Pillai,21-10-2005,319512,Haryana,3,23,16,21,63,Pass
Yash Reddy,28-07-2005,902751,Haryana,2,22,12,0,36,Pass
Aryan Mehta,08-01-2006,365888,Madhya Pradesh,3,5,17,0,25,Pass
Aarav Fernandes,13-07-2005,610779,West Bengal,13,5,15,7,40,Pass
Aditya Reddy,28-04-2006,843327,Bihar,0,9,4,4,17,Pass
Kunal Mehta,22-04-2005,582195,Arunachal Pradesh,12,9,14,17,52,Pass
Raj Chopra,04-01-2006,825551,Madhya Pradesh,1,23,17,16,57,Pass
Ishaan Singh,11-02-2005,105997,Bihar,3,17,8,17,45,Pass
Aditya Khan,13-12-2005,922237,Jharkhand,0,9,15,5,29,Pass
Rohan Pillai,02-07-2005,273266,Madhya Pradesh,6,12,22,11,51,Pass
Aditya Verma,03-04-2006,917280,Bihar,13,17,3,19,52,Pass
Zaid Verma,10-02-2006,771890,Karnataka,24,17,7,12,60,Pass
Aryan Fernandes,09-12-2005,255469,Bihar,13,10,6,9,38,Pass
Kunal Mehta,14-02-2006,940237,Rajasthan,22,2,9,22,55,Pass
Krishna Reddy,17-05-2005,246400,Gujarat,16,18,4,16,54,Pass
Aryan D'Souza,13-03-2005,914281,Bihar,14,7,18,24,63,Pass
David Verma,01-01-2005,131271,West Bengal,3,21,23,19,66,Pass
Yash D'Souza,26-12-2005,868584,Uttar Pradesh,3,16,4,15,38,Pass
Krishna D'Souza,13-06-2005,583301,Maharashtra,22,3,11,12,48,Pass
Rehan Sharma,04-11-2005,302835,Jharkhand,14,10,17,16,57,Pass
Raj Reddy,13-10-2005,924673,Arunachal Pradesh,0,0,14,21,35,Pass
Aditya Verma,08-11-2004,471902,Uttar Pradesh,2,0,4,21,27,Pass
Balbir Reddy,08-01-2005,317576,Jharkhand,4,22,12,6,44,Pass
Vivaan Reddy,10-02-2006,641322,Bihar,3,6,5,20,34,Pass
Gurpreet Verma,17-04-2005,643868,West Bengal,3,3,20,16,42,Pass
Rohan Reddy,24-11-2004,340817,Chhattisgarh,21,24,7,4,56,Pass
Yash Pillai,09-12-2005,312117,Punjab,19,5,20,2,46,Pass
Rohan Singh,09-10-2005,678271,Rajasthan,9,5,16,8,38,Pass
Mathew D'Souza,15-01-2005,763289,Bihar,23,4,7,19,53,Pass
Rohan Chopra,30-03-2005,909795,Gujarat,4,14,9,21,48,Pass
Aditya Khan,01-05-2005,119551,Maharashtra,3,3,20,14,40,Pass
Aditya Pillai,06-11-2005,973576,Bihar,13,4,23,1,41,Pass
Aditya D'Souza,12-01-2006,298664,Uttar Pradesh,2,6,4,14,26,Pass
Rohan D'Souza,11-11-2005,790861,Bihar,24,20,9,24,77,Pass
Imran Verma,06-09-2005,819121,Uttarakhand,5,15,16,6,42,Pass
Aditya D'Souza,22-02-2005,399148,Telangana,0,22,1,18,41,Pass
Aarav D'Souza,11-03-2006,923108,Chhattisgarh,22,23,8,7,60,Pass
Rohan Verma,09-04-2006,254257,Punjab,17,0,21,17,55,Pass
Aarav Singh,14-04-2006,980023,Bihar,22,13,12,9,56,Pass
Rohan Pillai,16-08-2005,458859,Maharashtra,10,5,5,23,43,Pass
Vivaan Mehta,16-11-2004,631257,Bihar,0,7,19,2,28,Pass
Rohan D'Souza,19-04-2006,394632,Andhra Pradesh,5,23,6,17,51,Pass
Krishna Khan,07-08-2005,589452,Jammu & Kashmir + Ladakh,23,1,14,8,46,Pass
Yash Khan,13-04-2005,570328,Maharashtra,11,5,12,9,37,Pass
Ishaan Singh,08-06-2005,125574,Punjab,7,17,6,3,33,Pass
Kunal Verma,01-03-2005,368260,Rajasthan,21,12,5,10,48,Pass
Aditya Fernandes,22-02-2006,710081,Uttar Pradesh,6,2,4,6,18,Pass
Rohan Khan,13-07-2005,223731,Haryana,14,1,15,2,32,Pass
Peter Verma,25-11-2004,916038,Haryana,1,10,4,0,15,Pass
Mathew Khan,16-04-2005,428202,Uttar Pradesh,16,11,4,13,44,Pass
Yash Verma,26-08-2005,301522,Rajasthan,13,24,19,16,72,Pass
Balbir Fernandes,18-12-2004,713689,Rajasthan,22,14,14,11,61,Pass
Raj Mehta,27-12-2005,368095,Telangana,9,5,19,5,38,Pass
Aarav Chopra,26-10-2005,185134,Himachal Pradesh,11,0,3,20,34,Pass
Krishna Mehta,28-10-2005,513985,Maharashtra,15,14,11,2,42,Pass
Kunal Mehta,17-08-2005,436407,Bihar,9,3,2,14,28,Pass
Kunal Sharma,05-12-2004,954444,Uttar Pradesh,17,16,4,9,46,Pass
Raj Fernandes,30-12-2005,868243,Gujarat,1,15,6,23,45,Pass
Sukhwinder Chopra,25-03-2006,542428,Tamil Nadu,19,10,6,16,51,Pass
Aryan Singh,15-08-2005,809015,Uttar Pradesh,19,20,4,12,55,Pass
Aarav Pillai,26-03-2006,582602,Maharashtra,3,22,4,10,39,Pass
Kunal Verma,08-07-2005,855616,Bihar,13,15,5,18,51,Pass
Raj Khan,27-11-2004,350050,Madhya Pradesh,21,16,6,7,50,Pass
Rohan Pillai,04-12-2005,873593,Bihar,24,23,12,9,68,Pass
Rehan Chopra,07-05-2006,829026,Gujarat,11,0,4,21,36,Pass
Kunal Chopra,09-01-2006,191505,Bihar,9,13,7,6,35,Pass
Rohan Fernandes,17-03-2006,864818,Karnataka,11,9,17,19,56,Pass
Paul Pillai,22-03-2006,801135,Tamil Nadu,14,1,10,5,30,Pass
Kunal Khan,11-11-2004,176454,Odisha,5,2,8,11,26,Pass
Kunal Verma,12-12-2005,833145,Kerala,16,21,20,0,57,Pass
Manpreet Verma,04-04-2005,243026,Bihar,15,9,11,20,55,Pass
Vivaan Verma,28-05-2005,437528,Odisha,12,11,11,2,36,Pass
Gurpreet Reddy,16-02-2006,878851,Madhya Pradesh,0,10,13,9,32,Pass
Harjeet Khan,14-04-2005,490785,Tamil Nadu,7,5,18,22,52,Pass
Kunal Sharma,10-11-2004,197967,Delhi,15,7,7,17,46,Pass
Aryan D'Souza,24-02-2005,153047,Bihar,7,10,9,13,39,Pass
Manpreet D'Souza,17-07-2005,461221,Maharashtra,2,9,5,1,17,Pass
Krishna Khan,13-02-2006,258137,Punjab,3,14,19,13,49,Pass
Manpreet Reddy,20-05-2005,136837,Uttar Pradesh,14,3,4,18,39,Pass
Aditya Sharma,13-03-2005,778605,Jammu & Kashmir + Ladakh,1,14,19,5,39,Pass
Rohan Chopra,19-12-2004,503096,Haryana,5,20,7,4,36,Pass
Aryan Reddy,01-05-2006,450659,Madhya Pradesh,10,5,23,15,53,Pass
Manpreet Chopra,29-06-2005,435063,Tamil Nadu,13,24,21,14,72,Pass
Aarav Fernandes,12-12-2004,513847,Maharashtra,3,19,6,10,38,Pass
Vivaan Mehta,29-12-2004,708596,Delhi,24,23,7,24,78,Pass
Sukhwinder Mehta,27-02-2005,254811,Uttar Pradesh,21,24,4,17,66,Pass
Vivaan Reddy,11-04-2006,170473,Maharashtra,3,22,12,15,52,Pass
Gurpreet Sharma,27-11-2004,360895,Madhya Pradesh,5,6,18,14,43,Pass
Rohan Fernandes,09-12-2005,886121,Madhya Pradesh,5,21,19,9,54,Pass
Aarav Mehta,14-02-2005,301750,Chhattisgarh,11,20,23,8,62,Pass
Krishna Singh,01-04-2006,251376,Tamil Nadu,9,16,10,8,43,Pass
Mathew Sharma,24-09-2005,357950,Bihar,18,7,0,24,49,Pass
Kunal Sharma,27-05-2005,650418,Rajasthan,17,14,20,20,71,Pass
Harjeet D'Souza,18-03-2005,350882,Maharashtra,3,12,24,11,50,Pass
Balbir Mehta,16-02-2006,514222,West Bengal,4,15,21,8,48,Pass
Balbir Fernandes,22-12-2004,982541,Andhra Pradesh,7,19,6,22,54,Pass
Ishaan Sharma,06-03-2005,611695,Madhya Pradesh,2,16,23,9,50,Pass
Balbir Chopra,18-08-2005,679199,Andhra Pradesh,11,6,20,11,48,Pass
Raj Mehta,02-11-2005,511730,Madhya Pradesh,3,13,9,14,39,Pass
John Verma,22-01-2005,631166,Tripura,9,10,3,23,45,Pass
Kunal Verma,13-12-2005,381289,Jammu & Kashmir + Ladakh,9,15,16,15,55,Pass
John Sharma,26-03-2006,126209,Punjab,0,7,20,12,39,Pass
Ishaan Verma,18-03-2005,969066,Rajasthan,11,11,17,19,58,Pass
Harjeet Fernandes,06-07-2005,476605,Odisha,23,22,2,9,56,Pass
Kunal Khan,29-01-2006,294742,Gujarat,0,17,5,2,24,Pass
Aryan Mehta,26-09-2005,405686,Chhattisgarh,4,22,3,4,33,Pass
Yash Sharma,26-11-2005,379245,Bihar,1,13,19,6,39,Pass
Ishaan Sharma,31-03-2005,954468,Punjab,22,0,2,14,38,Pass
Manpreet Khan,30-03-2006,511276,Bihar,21,15,9,3,48,Pass
Aditya Pillai,03-04-2006,520477,Andhra Pradesh,19,1,1,17,38,Pass
Kunal D'Souza,12-04-2006,510851,Madhya Pradesh,10,21,6,17,54,Pass
Kunal Pillai,03-03-2006,209487,Bihar,24,13,24,16,77,Pass
Yash Chopra,07-01-2005,297101,Bihar,2,20,7,17,46,Pass
John Khan,19-01-2005,154268,Assam,10,8,8,8,34,Pass
Manpreet Verma,16-07-2005,745492,Gujarat,12,12,16,6,46,Pass
Vivaan Mehta,26-09-2005,880247,Telangana,22,3,11,1,37,Pass
Rohan Khan,01-12-2005,177317,Haryana,15,20,5,0,40,Pass
Aditya Reddy,13-02-2005,224781,Delhi,5,22,21,23,71,Pass
Raj Chopra,17-03-2006,183540,Maharashtra,11,18,0,1,30,Pass
Krishna Fernandes,02-06-2005,868033,Punjab,13,12,11,16,52,Pass
Aditya Khan,13-11-2005,631125,Uttarakhand,5,15,18,6,44,Pass
Aarav Sharma,09-01-2006,799311,Maharashtra,3,16,21,15,55,Pass
Aarav Singh,11-03-2006,709547,Tamil Nadu,15,10,23,17,65,Pass
Vivaan Pillai,06-02-2005,122394,Punjab,23,3,3,18,47,Pass
Raj Mehta,29-05-2005,419864,Rajasthan,15,20,23,17,75,Pass
Aryan Verma,24-06-2005,761069,Gujarat,20,21,5,21,67,Pass
Sukhwinder Fernandes,23-04-2006,122535,Andhra Pradesh,0,3,12,23,38,Pass
Aryan Reddy,09-04-2006,840199,Delhi,8,16,0,4,28,Pass
Gurpreet D'Souza,06-03-2005,549349,Telangana,1,24,3,19,47,Pass
Harjeet Pillai,08-05-2006,771784,Tamil Nadu,0,6,5,7,18,Pass
Paul Singh,29-09-2005,990936,Punjab,14,3,5,16,38,Pass
Vivaan Verma,11-03-2005,652171,Madhya Pradesh,1,11,16,15,43,Pass
Balbir Reddy,04-12-2005,463307,Maharashtra,3,17,21,23,64,Pass
Vivaan Verma,29-04-2005,796992,Gujarat,2,8,9,2,21,Pass
Aryan Mehta,18-11-2005,490520,Daman & Diu / D&N Haveli,9,9,8,16,42,Pass
Harjeet Mehta,16-04-2005,851809,Bihar,17,24,10,16,67,Pass
Yash Chopra,22-01-2006,962109,Manipur,8,4,21,0,33,Pass
Rohan Pillai,14-12-2005,769395,Karnataka,10,23,18,16,67,Pass
Krishna D'Souza,09-10-2005,806507,Maharashtra,7,4,20,4,35,Pass
Aarav Reddy,14-02-2006,834958,Uttar Pradesh,3,19,4,16,42,Pass
Aditya D'Souza,07-02-2005,821637,Gujarat,14,7,21,2,44,Pass
Aditya Sharma,29-03-2005,875837,West Bengal,3,23,19,18,63,Pass
Manpreet Mehta,11-02-2005,724668,Rajasthan,5,10,5,20,40,Pass
Ishaan Singh,31-05-2005,141607,West Bengal,3,13,13,24,53,Pass
Aryan Khan,23-04-2005,375435,Bihar,23,4,23,0,50,Pass
Krishna Mehta,23-03-2005,598899,Bihar,11,12,2,3,28,Pass
Krishna Singh,11-05-2005,495292,Odisha,23,5,6,6,40,Pass
Aryan Verma,24-10-2005,673463,Uttarakhand,5,20,4,6,35,Pass
Yash Verma,27-04-2006,957639,Andhra Pradesh,24,6,12,9,51,Pass
Rohan Chopra,22-12-2005,218604,Bihar,6,3,13,23,45,Pass
Raj Chopra,15-08-2005,574466,Uttarakhand,5,16,22,24,67,Pass
Krishna Singh,07-04-2005,958386,Uttar Pradesh,17,9,4,8,38,Pass
Paul Pillai,05-04-2006,423824,Rajasthan,20,8,22,13,63,Pass
Ishaan Fernandes,08-01-2005,371788,Madhya Pradesh,23,2,1,22,48,Pass
Ishaan Chopra,30-05-2005,940896,Kerala,20,24,8,0,52,Pass
Gurpreet Singh,29-11-2004,426437,Odisha,8,7,5,9,29,Pass
Harjeet Khan,06-02-2005,599576,Telangana,2,9,20,12,43,Pass
Farhan Fernandes,26-02-2005,787849,Andhra Pradesh,6,9,7,12,34,Pass
Aditya D'Souza,09-03-2005,342149,West Bengal,3,16,23,16,58,Pass
Kunal Singh,13-07-2005,667335,Telangana,12,17,16,3,48,Pass
Sukhwinder Khan,23-07-2005,736950,Jammu & Kashmir + Ladakh,19,14,14,13,60,Pass
Paul Mehta,20-01-2005,137930,Rajasthan,19,4,9,5,37,Pass
Aditya Chopra,23-11-2005,386860,Bihar,24,17,22,21,84,Pass
Krishna Chopra,19-12-2005,884701,Uttar Pradesh,0,19,4,12,35,Pass
Rohan D'Souza,02-10-2005,217648,Rajasthan,14,6,11,7,38,Pass
Aarav Mehta,24-01-2006,840016,Uttar Pradesh,16,8,4,5,33,Pass
Vivaan Fernandes,02-06-2005,726497,Bihar,18,0,13,8,39,Pass
Rohan D'Souza,24-06-2005,926934,Rajasthan,18,14,16,4,52,Pass
Ishaan Reddy,11-06-2005,235495,Haryana,9,1,7,17,34,Pass
Raj Reddy,10-07-2005,107595,West Bengal,3,21,11,20,55,Pass
Aditya Khan,19-11-2005,643727,Haryana,15,8,6,12,41,Pass
Rohan Verma,13-03-2005,608169,Tamil Nadu,10,5,2,0,17,Pass
Kunal Reddy,21-11-2005,976911,Bihar,16,19,13,17,65,Pass
Sukhwinder Sharma,08-06-2005,580185,Maharashtra,3,20,15,15,53,Pass
Harjeet Fernandes,31-01-2006,242383,Uttar Pradesh,6,6,4,4,20,Pass
Ishaan Fernandes,16-02-2005,756529,Uttar Pradesh,23,4,4,20,51,Pass
Raj Reddy,12-11-2005,917216,Manipur,4,20,12,15,51,Pass
Kunal Mehta,29-09-2005,785166,Madhya Pradesh,15,11,12,4,42,Pass
Aryan Khan,11-12-2004,860136,Bihar,22,1,2,10,35,Pass
Aryan Reddy,18-03-2005,932816,Rajasthan,4,15,12,22,53,Pass
Ishaan Sharma,30-03-2005,929577,Delhi,16,17,13,22,68,Pass
Vivaan Reddy,15-05-2005,862248,Maharashtra,3,9,19,4,35,Pass
Ishaan Mehta,11-03-2005,293931,Bihar,12,7,7,5,31,Pass
Balbir Fernandes,12-06-2005,544991,Nagaland,5,6,4,9,24,Pass
Aryan Khan,02-04-2006,740289,Rajasthan,8,5,17,23,53,Pass
Aditya Fernandes,11-10-2005,363825,Uttarakhand,5,0,3,8,16,Pass
Yash Khan,18-03-2006,475925,Bihar,24,13,17,12,66,Pass
Rohan Reddy,16-07-2005,241545,Uttar Pradesh,16,20,4,24,64,Pass
Vivaan Sharma,07-01-2006,626229,West Bengal,9,10,2,0,21,Pass
Rohan Mehta,05-04-2005,496647,Uttar Pradesh,5,15,4,7,31,Pass
Aryan Singh,06-03-2006,435035,Rajasthan,16,5,11,5,37,Pass
Ishaan Sharma,14-07-2005,943846,West Bengal,7,23,6,1,37,Pass
Rohan D'Souza,20-02-2005,726088,West Bengal,18,21,8,1,48,Pass
Yash Reddy,26-02-2006,461676,Karnataka,22,4,23,13,62,Pass
Vivaan Sharma,28-01-2005,890345,Maharashtra,12,6,12,14,44,Pass
Aditya D'Souza,15-06-2005,252206,Assam,3,7,19,2,31,Pass
Yash Verma,06-05-2005,708088,Tamil Nadu,2,8,23,0,33,Pass
Peter D'Souza,09-05-2005,876889,Rajasthan,19,10,3,11,43,Pass
Manpreet Fernandes,30-03-2006,715532,Uttar Pradesh,7,9,4,15,35,Pass
Aryan Reddy,08-04-2006,799790,Jammu & Kashmir + Ladakh,21,19,1,13,54,Pass
Harjeet Pillai,05-05-2006,325275,Jharkhand,5,6,23,11,45,Pass
Peter Mehta,24-11-2004,778875,Madhya Pradesh,1,12,22,21,56,Pass
Harjeet Reddy,11-05-2005,367056,Madhya Pradesh,13,16,9,14,52,Pass
Aditya Reddy,15-12-2005,493570,Punjab,11,6,11,8,36,Pass
Aditya Sharma,04-03-2005,415157,Chhattisgarh,16,23,12,14,65,Pass
Imran Chopra,18-09-2005,723282,Uttar Pradesh,12,12,4,22,50,Pass
Ayaan Sharma,30-12-2005,490440,Jharkhand,8,3,17,2,30,Pass
Raj Singh,05-11-2005,768713,Uttar Pradesh,14,20,4,5,43,Pass
Yash Singh,28-10-2005,370856,Rajasthan,8,14,5,3,30,Pass
Kunal Pillai,06-03-2006,610392,Uttar Pradesh,0,3,4,21,28,Pass
Manpreet Mehta,07-04-2005,143620,Punjab,18,24,3,18,63,Pass
Vivaan Verma,31-03-2006,417113,Haryana,0,9,13,2,24,Pass
Farhan Sharma,01-05-2005,119203,Jharkhand,22,14,21,8,65,Pass
Aryan Sharma,06-11-2005,944660,Rajasthan,16,8,24,12,60,Pass
Manpreet Khan,05-10-2005,657802,Assam,5,8,8,17,38,Pass
Ishaan Mehta,13-01-2005,465822,Haryana,15,24,5,9,53,Pass
Aryan Khan,18-06-2005,332177,Rajasthan,18,24,3,12,57,Pass
Kunal Fernandes,12-06-2005,601147,Karnataka,5,17,16,15,53,Pass
Sukhwinder Khan,05-04-2005,353851,Madhya Pradesh,2,19,14,20,55,Pass
Ayaan Sharma,18-07-2005,738145,Rajasthan,9,4,11,17,41,Pass
Mathew Khan,27-12-2004,634671,Rajasthan,23,22,20,9,74,Pass
Rohan Reddy,03-06-2005,987410,Kerala,22,16,18,1,57,Pass
Aditya D'Souza,11-01-2006,593399,Gujarat,20,2,1,5,28,Pass
Peter Chopra,12-11-2004,926665,Uttar Pradesh,5,16,4,11,36,Pass
Aarav Verma,17-01-2006,951519,Bihar,23,8,23,9,63,Pass
Ishaan Fernandes,11-10-2005,397389,Bihar,7,11,16,2,36,Pass
Kunal Fernandes,11-11-2005,576022,Telangana,5,5,16,16,42,Pass
Aditya Pillai,20-11-2005,365440,Gujarat,3,14,5,12,34,Pass
Vivaan Chopra,30-06-2005,381358,Assam,6,6,10,14,36,Pass
Aditya Mehta,23-01-2005,845824,Bihar,4,17,3,2,26,Pass
Raj Khan,24-01-2005,336790,Tamil Nadu,5,22,12,14,53,Pass
Aditya Reddy,01-03-2006,462667,Uttar Pradesh,3,15,4,9,31,Pass
Vivaan D'Souza,29-09-2005,336918,Karnataka,24,14,15,6,59,Pass
Aryan Singh,03-12-2005,602635,Chhattisgarh,9,6,21,10,46,Pass
Yash Chopra,02-05-2005,745096,West Bengal,3,22,21,2,48,Pass
Aditya Khan,10-12-2004,346998,Himachal Pradesh,8,7,6,11,32,Pass
Raj Singh,23-06-2005,473842,Uttarakhand,5,6,1,21,33,Pass
Yash Reddy,11-03-2006,238419,Bihar,20,24,9,9,62,Pass
Kunal Verma,28-08-2005,183975,West Bengal,5,12,17,15,49,Pass
Yash Verma,07-12-2004,512342,Madhya Pradesh,8,9,0,19,36,Pass
Ishaan D'Souza,21-08-2005,450503,Karnataka,18,1,5,5,29,Pass
Kunal Chopra,28-05-2005,221999,Maharashtra,6,17,12,0,35,Pass
John Fernandes,20-02-2005,307239,Haryana,5,6,24,5,40,Pass
Kunal Mehta,24-01-2006,297096,Telangana,18,0,2,18,38,Pass
Aryan D'Souza,07-03-2005,535265,Tamil Nadu,12,4,13,8,37,Pass
Aditya Reddy,29-12-2004,399578,Himachal Pradesh,14,1,16,15,46,Pass
Gurpreet D'Souza,13-06-2005,133007,Jammu & Kashmir + Ladakh,4,4,16,22,46,Pass
Yash Chopra,07-11-2005,820030,Kerala,22,1,7,24,54,Pass
Yash Verma,09-03-2006,272405,Andhra Pradesh,7,22,6,8,43,Pass
Rohan Fernandes,17-10-2005,499962,Jammu & Kashmir + Ladakh,9,1,7,4,21,Pass
Harjeet Verma,18-02-2005,311042,Gujarat,2,5,7,7,21,Pass
Krishna Singh,23-01-2006,602727,Uttar Pradesh,6,15,4,23,48,Pass
Balbir Verma,25-04-2005,232799,Punjab,0,1,15,22,38,Pass
Yash Singh,13-04-2006,565464,Uttar Pradesh,4,3,4,18,29,Pass
Raj D'Souza,25-01-2005,434183,Uttar Pradesh,9,18,4,14,45,Pass
Yash Pillai,16-12-2004,850935,Bihar,12,11,22,21,66,Pass
David Chopra,25-02-2005,292323,Maharashtra,3,14,12,7,36,Pass
Aryan Chopra,04-10-2005,468948,Uttar Pradesh,2,11,4,23,40,Pass
Balbir Singh,14-07-2005,264031,Gujarat,1,10,22,22,55,Pass
John Singh,01-02-2006,648219,Assam,7,8,8,23,46,Pass
Kunal Pillai,31-05-2005,883859,Odisha,3,0,13,19,35,Pass
Yash Singh,11-03-2005,227234,Assam,12,5,17,12,46,Pass
Vivaan Reddy,27-12-2005,287500,Tamil Nadu,23,8,21,24,76,Pass
Aarav D'Souza,12-05-2005,389574,Tamil Nadu,2,24,1,15,42,Pass
Krishna Khan,12-08-2005,553302,Bihar,13,1,16,11,41,Pass
Ishaan Khan,17-10-2005,329865,Maharashtra,4,24,9,1,38,Pass
Rohan Chopra,24-10-2005,326673,Uttar Pradesh,13,3,4,5,25,Pass
Ishaan Singh,04-09-2005,659803,Himachal Pradesh,0,14,0,24,38,Pass
Aarav Verma,05-10-2005,655914,Kerala,14,5,1,16,36,Pass
Paul Reddy,24-07-2005,969919,Tamil Nadu,11,9,4,8,32,Pass
Sukhwinder Verma,13-12-2005,210632,Kerala,9,3,5,12,29,Pass
Rohan Mehta,07-05-2006,918491,Jammu & Kashmir + Ladakh,6,1,21,6,34,Pass
Krishna Mehta,03-08-2005,606208,West Bengal,3,24,16,17,60,Pass
Ishaan Khan,13-10-2005,948602,Haryana,14,13,24,14,65,Pass
Krishna Verma,04-09-2005,323914,Rajasthan,20,3,16,2,41,Pass
Yash D'Souza,22-06-2005,426201,Haryana,21,18,9,1,49,Pass
Ishaan Sharma,30-09-2005,545519,Gujarat,2,21,3,11,37,Pass
David Fernandes,08-01-2006,720378,Gujarat,10,16,3,11,40,Pass
Krishna Pillai,02-05-2006,300868,Kerala,22,6,8,12,48,Pass
Krishna Singh,16-12-2005,801164,Bihar,13,11,17,13,54,Pass
Rehan Singh,04-12-2004,730429,West Bengal,3,7,19,21,50,Pass
Krishna Pillai,24-12-2005,925169,Haryana,5,11,16,11,43,Pass
Aditya Chopra,10-10-2005,850522,Delhi,14,3,3,11,31,Pass
Aarav Mehta,03-01-2005,186693,Andhra Pradesh,3,11,3,19,36,Pass
Yash Chopra,09-06-2005,466852,Rajasthan,22,14,7,17,60,Pass
Rohan Pillai,03-02-2005,396836,Madhya Pradesh,15,2,23,8,48,Pass
Krishna D'Souza,23-12-2005,724396,Haryana,5,4,3,5,17,Pass
Balbir Sharma,11-11-2004,310716,Telangana,7,8,21,13,49,Pass
Vivaan Pillai,21-12-2005,888716,Haryana,0,22,12,19,53,Pass
Krishna Reddy,08-05-2005,745874,Assam,9,2,13,7,31,Pass
Harjeet Verma,09-03-2005,645852,Bihar,15,17,2,17,51,Pass
John Khan,13-08-2005,286417,Rajasthan,4,15,11,3,33,Pass
Balbir Chopra,26-01-2006,603837,Rajasthan,0,18,7,24,49,Pass
Yash Verma,01-02-2005,622226,Himachal Pradesh,19,6,18,5,48,Pass
Vivaan Mehta,15-01-2006,383001,Madhya Pradesh,9,10,11,3,33,Pass
Raj Verma,22-11-2004,855753,Uttar Pradesh,3,1,4,1,9,Pass
Krishna D'Souza,05-09-2005,138321,Punjab,11,8,10,22,51,Pass
Yash Singh,11-04-2006,269152,Punjab,5,5,6,12,28,Pass
Aryan Pillai,27-08-2005,554532,Uttarakhand,5,15,24,18,62,Pass
Gurpreet Sharma,21-04-2005,484655,Madhya Pradesh,13,12,10,14,49,Pass
Vivaan Mehta,19-02-2005,681775,Uttar Pradesh,3,16,4,13,36,Pass
David D'Souza,09-07-2005,706677,Madhya Pradesh,1,7,18,24,50,Pass
Ishaan Khan,16-07-2005,647175,Punjab,10,5,16,8,39,Pass
Gurpreet Fernandes,11-03-2006,965960,Maharashtra,6,11,11,19,47,Pass
Gurpreet Verma,04-07-2005,982223,Karnataka,23,5,15,16,59,Pass
Harjeet Reddy,16-11-2005,330602,Telangana,21,2,3,5,31,Pass
Yash Mehta,23-05-2005,168674,Bihar,3,5,15,14,37,Pass
Gurpreet Reddy,16-03-2005,675704,Madhya Pradesh,8,1,20,13,42,Pass
Raj Khan,22-02-2005,130768,Rajasthan,3,9,6,4,22,Pass
Vivaan Singh,13-02-2006,366777,Bihar,5,12,10,11,38,Pass
Raj Reddy,03-05-2006,887826,Andhra Pradesh,21,0,21,4,46,Pass
Paul Pillai,16-05-2005,757802,Maharashtra,3,20,22,9,54,Pass
Peter Singh,11-12-2005,694439,Uttar Pradesh,8,17,4,24,53,Pass
Raj Fernandes,10-11-2004,397574,Punjab,6,15,13,1,35,Pass
Rohan Pillai,16-07-2005,222175,Odisha,5,22,20,2,49,Pass
John D'Souza,27-12-2004,925479,Punjab,3,13,8,20,44,Pass
Mathew Chopra,20-03-2006,752463,Odisha,16,2,9,16,43,Pass
Rohan Mehta,26-02-2005,809185,Odisha,24,3,22,3,52,Pass
Rohan Pillai,17-02-2005,292918,Uttar Pradesh,11,22,4,4,41,Pass
Sukhwinder Mehta,06-03-2005,167856,Kerala,24,15,11,12,62,Pass
Aryan Reddy,04-12-2004,748350,Andhra Pradesh,19,7,3,8,37,Pass
Rohan Mehta,07-12-2005,968904,Uttar Pradesh,0,16,4,24,44,Pass
Vivaan Reddy,27-10-2005,268195,Uttar Pradesh,13,16,4,22,55,Pass
Krishna Khan,03-02-2006,663550,Odisha,18,6,3,6,33,Pass
Krishna Singh,11-04-2006,576393,Uttar Pradesh,2,19,4,22,47,Pass
Rohan Sharma,15-11-2005,427703,Bihar,15,18,18,12,63,Pass
Manpreet Singh,11-10-2005,411913,Delhi,13,1,22,11,47,Pass
Raj Reddy,19-11-2005,123452,Uttar Pradesh,9,7,4,6,26,Pass
Aarav Sharma,13-12-2005,266900,Haryana,3,2,1,23,29,Pass
Krishna Khan,21-10-2005,751310,Delhi,7,23,20,9,59,Pass
Ishaan Pillai,06-01-2006,701909,Madhya Pradesh,15,16,6,16,53,Pass
Kunal Reddy,28-12-2004,176148,Gujarat,23,1,17,0,41,Pass
Aarav D'Souza,13-08-2005,397985,Rajasthan,24,11,11,4,50,Pass
Krishna Chopra,30-06-2005,295863,Kerala,0,1,10,5,16,Pass
Raj Reddy,01-12-2004,305399,Jharkhand,10,4,12,11,37,Pass
Aryan Singh,10-04-2005,637856,Bihar,19,17,16,14,66,Pass
Rohan Singh,24-03-2006,875948,Uttar Pradesh,11,24,4,6,45,Pass
Gurpreet Mehta,25-04-2005,748752,Uttar Pradesh,13,14,4,12,43,Pass
Rohan Sharma,05-12-2004,651843,Karnataka,3,14,5,24,46,Pass
Raj Singh,24-11-2005,530093,Assam,12,7,4,19,42,Pass
Vivaan Sharma,28-02-2006,400487,Gujarat,19,5,24,9,57,Pass
Kunal Khan,23-04-2005,600242,Jharkhand,24,9,3,13,49,Pass
Yash Reddy,11-02-2006,505884,Uttar Pradesh,2,13,4,20,39,Pass
Zaid D'Souza,08-04-2006,980837,Manipur,4,16,2,19,41,Pass
Rohan Sharma,24-01-2006,502171,Delhi,22,8,0,19,49,Pass
Zaid D'Souza,18-04-2006,913422,Madhya Pradesh,16,2,17,10,45,Pass
Vivaan Verma,07-04-2005,215596,Rajasthan,17,11,2,12,42,Pass
Aryan Sharma,30-10-2005,742606,West Bengal,3,24,24,0,51,Pass
David Singh,31-01-2006,959511,Bihar,6,12,12,5,35,Pass
Krishna Reddy,23-01-2006,790896,Haryana,12,13,19,0,44,Pass
Aarav Mehta,27-02-2006,529856,Bihar,2,16,11,12,41,Pass
Manpreet Sharma,30-06-2005,551385,Gujarat,15,3,9,11,38,Pass
Krishna Fernandes,05-05-2006,847671,Bihar,12,10,20,11,53,Pass
Aditya Verma,25-07-2005,196412,West Bengal,10,5,0,20,35,Pass
Vivaan Singh,25-02-2005,248377,Rajasthan,7,11,18,15,51,Pass
David Fernandes,05-06-2005,672213,West Bengal,2,4,6,22,34,Pass
Gurpreet Khan,11-11-2004,967333,Telangana,10,16,13,9,48,Pass
Aryan Singh,28-09-2005,898751,Himachal Pradesh,11,14,22,14,61,Pass
Aditya Mehta,22-09-2005,562503,Maharashtra,21,0,8,3,32,Pass
Zaid Singh,26-06-2005,686118,Bihar,2,0,9,20,31,Pass
Ishaan Khan,27-01-2006,309763,Delhi,21,20,0,10,51,Fail
Vivaan Fernandes,06-01-2006,532856,Jharkhand,1,13,17,20,51,Pass
Yash Reddy,20-05-2005,746367,Uttarakhand,3,14,19,23,59,Pass
Ishaan Verma,14-04-2006,567769,Madhya Pradesh,14,3,14,11,42,Pass
Aditya Singh,29-03-2005,950971,Tamil Nadu,24,5,22,3,54,Pass
Aditya Pillai,26-10-2005,184493,Chhattisgarh,8,20,19,13,60,Pass
Rohan D'Souza,17-12-2004,744042,Chhattisgarh,6,4,12,5,27,Pass
Rohan Chopra,14-04-2005,603492,Rajasthan,14,20,12,17,63,Pass
Aditya Khan,15-10-2005,882956,Maharashtra,3,17,4,21,45,Pass
Zaid Pillai,25-08-2005,442100,Telangana,10,3,23,18,54,Pass
Ishaan Sharma,09-01-2005,704966,Tamil Nadu,2,12,2,24,40,Pass
Vivaan Mehta,07-06-2005,747258,Telangana,3,20,4,20,47,Pass
Krishna Sharma,04-06-2005,315749,Jharkhand,18,19,6,24,67,Pass
Aditya Khan,06-04-2005,329953,Uttar Pradesh,6,18,4,22,50,Pass
Aarav Reddy,11-06-2005,394750,Delhi,6,18,23,6,53,Fail
Aryan Fernandes,10-02-2006,591410,Chhattisgarh,15,15,6,22,58,Pass
Kunal Fernandes,14-11-2004,767626,Jammu & Kashmir + Ladakh,2,4,5,15,26,Pass
Aditya Reddy,08-02-2006,162621,Madhya Pradesh,13,7,8,0,28,Pass
Yash Singh,26-01-2005,386468,Bihar,0,12,10,17,39,Pass
Krishna Sharma,29-05-2005,511337,Karnataka,3,23,14,10,50,Pass
Krishna Fernandes,13-02-2006,984440,Andhra Pradesh,4,15,24,14,57,Pass
Rohan D'Souza,13-11-2004,452814,Karnataka,18,4,11,0,33,Pass
Sukhwinder Mehta,07-03-2006,283407,Maharashtra,15,7,12,10,44,Pass
Ishaan Singh,26-05-2005,279717,Maharashtra,3,20,3,16,42,Pass
Sukhwinder Mehta,28-03-2005,978017,Jharkhand,20,16,0,19,55,Pass
Vivaan Mehta,21-07-2005,237672,Karnataka,13,19,15,9,56,Pass
Aditya Chopra,18-02-2006,643385,Bihar,11,22,22,6,61,Pass
Rehan Pillai,21-06-2005,762760,Punjab,0,20,18,15,53,Pass
Ishaan Chopra,28-07-2005,908198,Uttar Pradesh,14,8,4,11,37,Pass
Farhan Verma,03-04-2006,897464,Maharashtra,3,4,18,20,45,Pass
Kunal Chopra,23-11-2004,596815,Himachal Pradesh,17,0,5,9,31,Pass
Aryan Pillai,17-04-2006,144361,Madhya Pradesh,9,14,10,20,53,Pass
Raj Singh,05-05-2005,985545,Madhya Pradesh,9,5,24,17,55,Pass
Ayaan Chopra,24-07-2005,689489,Bihar,17,0,3,6,26,Pass
Krishna Mehta,19-11-2005,253690,Uttar Pradesh,14,11,4,2,31,Pass
Rohan Reddy,25-12-2004,975623,Assam,13,7,22,7,49,Pass
Harjeet D'Souza,06-12-2004,360184,Rajasthan,9,1,7,2,19,Pass
Aryan Pillai,28-12-2005,594107,Tamil Nadu,23,20,5,3,51,Pass
Paul Chopra,05-02-2006,112551,Karnataka,10,14,4,15,43,Pass
Yash Pillai,11-03-2006,296055,Rajasthan,15,18,23,11,67,Pass
Yash Verma,13-04-2005,423356,Punjab,3,20,5,7,35,Pass
Rohan Fernandes,04-01-2006,345919,Manipur,4,19,8,8,39,Pass
Balbir Mehta,01-09-2005,924768,Jammu & Kashmir + Ladakh,1,6,1,3,11,Pass
Rohan Reddy,01-11-2005,174325,West Bengal,17,9,15,3,44,Pass
Ishaan Pillai,23-10-2005,206964,Kerala,4,8,17,18,47,Pass
David Reddy,04-12-2005,397369,Jharkhand,19,22,3,15,59,Pass
Raj Mehta,12-08-2005,879112,Maharashtra,11,2,2,0,15,Pass
Kunal D'Souza,26-12-2004,236511,Madhya Pradesh,8,5,17,20,50,Pass
Aryan Mehta,20-12-2004,428710,Karnataka,0,1,24,16,41,Pass
Krishna Singh,16-02-2006,363353,Punjab,8,5,24,3,40,Pass
Krishna Fernandes,22-01-2006,403794,Karnataka,4,24,14,15,57,Pass
Vivaan Sharma,01-04-2005,224789,Uttar Pradesh,21,17,4,15,57,Pass
Krishna Mehta,25-07-2005,121000,Andhra Pradesh,0,4,6,7,17,Pass
Raj Fernandes,01-04-2006,246021,West Bengal,3,3,24,23,53,Pass
Harjeet Chopra,11-02-2005,225577,Jammu & Kashmir + Ladakh,4,16,17,18,55,Pass
Harjeet Singh,20-05-2005,228616,Gujarat,22,6,2,9,39,Pass
Kunal Singh,02-01-2005,946654,Andhra Pradesh,16,2,14,20,52,Pass
Rohan Pillai,06-05-2006,699524,Maharashtra,18,11,3,11,43,Pass
Ishaan Khan,05-05-2006,788578,Uttar Pradesh,2,16,4,6,28,Pass
Aarav Khan,12-08-2005,765197,Haryana,13,1,16,6,36,Pass
Aditya Mehta,26-04-2006,222747,Andhra Pradesh,13,11,4,10,38,Pass
Ishaan D'Souza,02-08-2005,752638,Rajasthan,2,15,18,12,47,Pass
Rohan Singh,01-03-2006,947804,Maharashtra,7,15,7,14,43,Pass
Farhan D'Souza,16-11-2004,552663,Meghalaya,17,5,5,14,41,Pass
Manpreet Mehta,14-04-2005,333289,Andhra Pradesh,9,9,13,20,51,Pass
Yash Chopra,20-04-2006,981640,Maharashtra,9,1,13,10,33,Pass
Kunal Singh,08-11-2004,340848,Madhya Pradesh,21,2,2,0,25,Pass
Ishaan Singh,01-10-2005,420002,Madhya Pradesh,10,3,10,4,27,Pass
Rohan Sharma,09-01-2005,419690,Madhya Pradesh,7,17,3,18,45,Pass
John Chopra,26-10-2005,839759,Uttar Pradesh,9,8,4,21,42,Pass
Aryan D'Souza,08-06-2005,990320,Maharashtra,3,21,22,8,54,Pass
Kunal Sharma,29-07-2005,534448,Haryana,10,2,18,16,46,Pass
Peter Sharma,18-04-2005,829636,Karnataka,9,15,4,6,34,Pass
Ayaan Chopra,04-04-2006,702705,Bihar,10,24,18,11,63,Pass
Vivaan Reddy,30-03-2006,793055,Odisha,24,7,5,3,39,Pass
Kunal Fernandes,15-02-2005,462740,Rajasthan,6,22,18,7,53,Pass
Kunal Mehta,11-11-2004,200622,Haryana,23,10,24,20,77,Pass
Ishaan Pillai,19-02-2006,260713,Arunachal Pradesh,6,13,11,6,36,Pass
Gurpreet Verma,14-01-2006,784876,Haryana,0,22,19,3,44,Pass
Aditya Chopra,28-07-2005,787840,Odisha,10,14,8,22,54,Pass
Harjeet Singh,02-09-2005,795049,Gujarat,18,24,8,16,66,Pass
Ishaan Reddy,01-01-2006,982424,Maharashtra,3,11,2,17,33,Pass
Paul Pillai,15-12-2004,373434,Punjab,2,15,3,20,40,Pass
Aarav Chopra,08-06-2005,436410,Rajasthan,17,11,20,8,56,Pass
Raj Verma,05-03-2005,487360,Bihar,15,13,21,23,72,Pass
Kunal Sharma,24-03-2005,106212,West Bengal,3,12,24,7,46,Pass
Krishna Khan,14-11-2005,781894,Uttar Pradesh,15,4,4,15,38,Pass
Ishaan Singh,08-04-2005,617818,Uttar Pradesh,1,24,4,10,39,Pass
Raj Sharma,06-03-2006,330371,Maharashtra,5,11,6,24,46,Pass
Raj Mehta,12-01-2005,702314,Tamil Nadu,17,10,13,8,48,Pass
Ayaan D'Souza,10-03-2006,591116,Jammu & Kashmir + Ladakh,4,20,17,18,59,Pass
Raj Verma,16-08-2005,805114,Bihar,16,3,3,20,42,Pass
Yash Pillai,11-12-2004,586778,Bihar,15,24,21,18,78,Pass
Yash Mehta,17-04-2006,239993,Uttar Pradesh,2,22,4,21,49,Pass
Raj Pillai,05-05-2006,125173,Tamil Nadu,9,9,18,21,57,Pass
Yash Pillai,24-08-2005,275826,Madhya Pradesh,18,20,7,0,45,Pass
John Khan,10-09-2005,184687,Madhya Pradesh,22,7,0,4,33,Pass
Kunal Chopra,09-08-2005,380569,Odisha,6,17,14,0,37,Pass
Gurpreet Khan,06-06-2005,924502,Assam,5,8,3,24,40,Pass
Kunal Mehta,01-05-2005,601219,Karnataka,13,17,6,2,38,Pass
Zaid Pillai,20-01-2006,433095,Uttarakhand,8,9,3,10,30,Pass
Raj Reddy,11-01-2005,354483,West Bengal,11,16,1,12,40,Pass
Zaid Reddy,12-08-2005,227250,Uttar Pradesh,3,20,4,21,48,Pass
Kunal Reddy,16-11-2005,634495,Andhra Pradesh,5,23,17,8,53,Pass
Krishna Reddy,06-02-2006,841427,Uttar Pradesh,2,3,4,13,22,Pass
Yash Fernandes,10-02-2005,118251,Telangana,23,3,4,5,35,Pass
Sukhwinder Verma,11-10-2005,262180,Tripura,8,3,17,2,30,Pass
Ishaan Mehta,18-04-2005,120235,Assam,7,8,14,22,51,Pass
Peter Chopra,16-01-2005,727003,Haryana,16,6,16,11,49,Pass
Gurpreet Mehta,23-04-2005,247750,Andaman & Nicobar,6,13,13,9,41,Pass
Aditya Chopra,08-08-2005,372968,Gujarat,12,14,0,6,32,Pass
Aarav Mehta,30-08-2005,229645,Tamil Nadu,16,22,10,23,71,Pass
Kunal Verma,31-10-2005,643362,Rajasthan,9,20,17,18,64,Pass
Manpreet Singh,25-05-2005,119812,Maharashtra,3,11,23,20,57,Pass
Harjeet Singh,22-03-2006,853674,Tamil Nadu,5,9,13,17,44,Pass
Aditya Reddy,24-12-2005,555463,Uttar Pradesh,13,3,4,2,22,Pass
Raj Mehta,10-12-2004,168723,Bihar,21,1,18,16,56,Pass
Mathew Mehta,04-12-2005,503975,Gujarat,4,18,3,8,33,Pass
Krishna D'Souza,22-12-2005,700379,Uttarakhand,10,2,14,6,32,Pass
Vivaan Singh,16-07-2005,649920,Uttar Pradesh,15,18,4,3,40,Pass
Gurpreet Mehta,14-02-2006,313419,Tamil Nadu,0,4,10,3,17,Pass
Krishna Reddy,06-01-2006,638605,Uttar Pradesh,1,0,4,1,6,Pass
Sukhwinder Chopra,13-11-2004,685199,Assam,13,6,7,13,39,Pass
Vivaan Verma,14-04-2005,132967,Haryana,21,7,23,6,57,Pass
Aditya Fernandes,27-01-2005,509931,Maharashtra,16,16,8,7,47,Pass
Aarav Mehta,22-01-2005,662899,Andhra Pradesh,19,13,2,3,37,Pass
Rohan Verma,23-01-2006,656288,Uttar Pradesh,5,22,4,3,34,Pass
Ishaan Verma,07-07-2005,601434,Tamil Nadu,10,10,18,8,46,Pass
Rohan Fernandes,23-11-2005,692287,Bihar,12,19,21,14,66,Pass
Sukhwinder D'Souza,31-05-2005,740768,Maharashtra,6,19,6,4,35,Pass
Aarav Reddy,31-03-2005,130358,Bihar,6,16,22,19,63,Pass
Krishna Verma,04-05-2006,692691,Uttar Pradesh,20,19,4,20,63,Pass
Yash Pillai,17-05-2005,137293,Punjab,19,3,17,1,40,Pass
Aryan Khan,08-06-2005,847595,Uttarakhand,18,7,2,12,39,Pass
Ishaan Pillai,25-12-2004,880724,Jharkhand,4,11,1,12,28,Pass
Sukhwinder Sharma,09-05-2005,499677,Chhattisgarh,1,14,8,3,26,Pass
Gurpreet Mehta,21-01-2005,861352,Karnataka,20,9,9,19,57,Pass
Rohan Reddy,05-11-2005,948221,Bihar,13,20,3,21,57,Pass
Raj Khan,17-01-2006,383639,Uttar Pradesh,16,12,4,13,45,Pass
Aarav Khan,06-04-2006,625637,Madhya Pradesh,17,0,13,20,50,Pass
Aryan Fernandes,15-08-2005,180278,Rajasthan,9,19,7,24,59,Pass
Aditya Sharma,17-02-2006,878009,Uttar Pradesh,19,6,4,10,39,Pass
Mathew Verma,11-05-2005,634064,Punjab,3,8,1,17,29,Pass
Krishna Chopra,14-12-2004,800109,Maharashtra,3,15,23,2,43,Pass
Krishna Reddy,29-04-2006,778864,Tamil Nadu,14,12,23,5,54,Pass
Vivaan Mehta,09-11-2004,325314,Bihar,18,7,19,8,52,Pass
Yash Sharma,09-08-2005,641370,Punjab,3,17,17,20,57,Pass
Balbir Pillai,05-06-2005,359226,Telangana,20,13,3,6,42,Pass
Ishaan Verma,17-12-2005,644034,Uttar Pradesh,23,6,4,13,46,Pass
Krishna Reddy,18-02-2006,645191,Kerala,17,23,15,4,59,Pass
Ishaan Mehta,27-05-2005,553901,West Bengal,3,17,3,19,42,Pass
Krishna Chopra,14-08-2005,737680,Punjab,6,24,2,17,49,Pass
Aryan Pillai,28-08-2005,164062,Jammu & Kashmir + Ladakh,8,22,7,0,37,Pass
Aryan Sharma,15-06-2005,891320,Maharashtra,3,15,6,22,46,Pass
Krishna Reddy,27-02-2005,795506,Rajasthan,17,0,2,15,34,Pass
Ishaan Sharma,12-10-2005,700362,Haryana,16,1,23,6,46,Pass
Aditya Pillai,12-05-2005,149378,West Bengal,12,12,11,13,48,Pass
Zaid Khan,04-10-2005,402918,Delhi,6,17,14,13,50,Fail
Aditya D'Souza,12-01-2006,530321,Odisha,21,5,3,5,34,Pass
Vivaan D'Souza,15-02-2006,681746,Tamil Nadu,23,10,13,20,66,Pass
Aditya Mehta,02-12-2004,117985,Bihar,16,4,8,18,46,Pass
Krishna Mehta,26-08-2005,714844,Karnataka,18,5,19,24,66,Pass
Sukhwinder Fernandes,27-01-2005,750514,Madhya Pradesh,1,16,19,21,57,Pass
Gurpreet Khan,27-11-2004,710649,Rajasthan,3,19,12,1,35,Pass
Ishaan Khan,05-04-2006,900104,Madhya Pradesh,19,0,6,20,45,Pass
Aditya Khan,22-04-2005,703978,Haryana,8,13,0,10,31,Pass
Manpreet D'Souza,26-05-2005,826122,Bihar,23,16,15,1,55,Pass
Raj Verma,31-01-2006,757341,Punjab,4,16,19,16,55,Pass
Ishaan Verma,18-05-2005,747444,Bihar,24,21,6,18,69,Pass
Zaid Reddy,13-11-2004,924571,Punjab,14,21,1,6,42,Pass
Vivaan Reddy,20-02-2005,542910,Punjab,10,3,6,6,25,Pass
Aarav Reddy,23-04-2005,110245,Rajasthan,10,10,11,23,54,Pass
Ishaan Singh,21-01-2006,786868,Rajasthan,19,24,2,2,47,Pass
Paul Chopra,22-03-2006,769825,Bihar,17,1,22,24,64,Pass
Aditya Pillai,18-11-2005,531840,Andhra Pradesh,5,20,24,2,51,Pass
Yash Reddy,13-09-2005,638819,Andhra Pradesh,14,20,23,1,58,Pass
Vivaan Verma,19-03-2005,371436,Bihar,17,11,6,11,45,Pass
Ishaan Pillai,19-02-2005,151176,Tamil Nadu,24,17,0,10,51,Pass
Ishaan Sharma,27-05-2005,918563,Bihar,9,2,12,20,43,Pass
Ishaan Khan,16-07-2005,434011,Tamil Nadu,2,19,5,16,42,Pass
Ayaan D'Souza,12-04-2005,172779,Bihar,13,21,20,12,66,Pass
Aryan Sharma,15-09-2005,877710,Bihar,4,19,11,11,45,Pass
Krishna Mehta,14-06-2005,905213,Tamil Nadu,6,10,4,15,35,Pass
Krishna D'Souza,11-02-2005,717610,Jammu & Kashmir + Ladakh,12,13,17,24,66,Pass
Yash D'Souza,15-02-2006,503953,West Bengal,4,5,6,2,17,Pass
Aditya Sharma,22-11-2005,575854,Tamil Nadu,11,7,7,1,26,Pass
Aditya Fernandes,05-11-2005,520372,Assam,6,19,7,3,35,Pass
Ishaan Singh,09-05-2005,954629,Bihar,8,13,5,18,44,Pass
Aryan Singh,27-05-2005,226785,Maharashtra,3,0,23,19,45,Pass
Aryan Khan,06-04-2006,328628,Odisha,12,3,6,21,42,Pass
David Reddy,24-03-2006,696717,Uttarakhand,6,23,4,4,37,Pass
Aarav D'Souza,25-05-2005,306404,Uttar Pradesh,14,16,4,12,46,Pass
Yash Chopra,09-03-2005,668603,Haryana,12,2,9,10,33,Pass
David Sharma,06-01-2006,986595,Karnataka,4,23,17,18,62,Pass
Yash Reddy,10-08-2005,836604,Tamil Nadu,22,5,1,14,42,Pass
Ishaan Reddy,15-04-2006,786715,Uttar Pradesh,4,22,4,23,53,Pass
Gurpreet Verma,06-02-2005,245729,Karnataka,0,10,14,11,35,Pass
Aryan Sharma,01-07-2005,226115,Telangana,8,1,6,8,23,Pass
Raj Pillai,19-04-2005,948700,Haryana,12,0,23,11,46,Pass
Manpreet D'Souza,07-01-2006,219360,Bihar,1,16,17,5,39,Pass
Ishaan Fernandes,01-06-2005,871583,Karnataka,5,4,18,10,37,Pass
Yash Verma,19-02-2006,624934,Uttar Pradesh,12,5,4,5,26,Pass
Ishaan Pillai,28-12-2004,594741,Uttarakhand,9,4,7,24,44,Pass
Balbir D'Souza,25-04-2006,429036,Chhattisgarh,4,11,7,18,40,Pass
Mathew Singh,08-12-2004,662363,Tamil Nadu,5,20,14,18,57,Pass
Kunal Verma,24-12-2004,866384,Karnataka,2,9,8,17,36,Pass
Kunal Pillai,29-11-2004,564252,Uttar Pradesh,18,8,4,2,32,Pass
Gurpreet Singh,22-03-2006,824241,Jharkhand,8,5,2,8,23,Pass
Rehan Reddy,11-09-2005,752747,Tamil Nadu,4,17,10,14,45,Pass
Krishna Verma,10-04-2006,565672,Gujarat,16,8,6,5,35,Pass
Vivaan Pillai,01-07-2005,223397,Uttar Pradesh,4,19,4,23,50,Pass
Rohan Chopra,15-04-2006,595107,Madhya Pradesh,6,24,5,12,47,Pass
Rohan Fernandes,20-01-2006,520670,Uttar Pradesh,9,16,4,6,35,Pass
Rohan Sharma,07-08-2005,299482,Maharashtra,12,1,2,23,38,Pass
Aarav Chopra,08-07-2005,441980,Rajasthan,15,11,22,22,70,Pass
Sukhwinder Verma,08-04-2006,503116,Tamil Nadu,17,5,10,17,49,Pass
Sukhwinder Reddy,11-04-2006,992083,Jharkhand,17,2,11,14,44,Pass
Vivaan Verma,08-06-2005,977594,Punjab,4,13,19,15,51,Pass
Balbir Mehta,21-11-2005,251964,Chhattisgarh,22,21,12,19,74,Pass
Ishaan Mehta,16-06-2005,428846,Tamil Nadu,21,17,8,13,59,Pass
Raj Chopra,04-12-2004,959795,Odisha,3,13,24,7,47,Pass
Yash D'Souza,08-02-2005,122955,Bihar,17,11,0,1,29,Pass
Aarav Chopra,07-05-2006,292273,Jharkhand,5,2,20,0,27,Pass
Aditya D'Souza,02-01-2006,644044,West Bengal,16,23,5,9,53,Pass
Rohan Khan,07-05-2005,731492,Maharashtra,22,6,20,0,48,Pass
Balbir D'Souza,07-02-2005,694137,Punjab,12,6,24,12,54,Pass
Manpreet D'Souza,09-06-2005,157994,Uttarakhand,13,3,3,15,34,Pass
Vivaan Singh,12-11-2005,173688,Gujarat,20,15,15,4,54,Pass
Raj Fernandes,01-11-2005,491384,Rajasthan,6,12,10,2,30,Pass
Aditya Khan,05-11-2005,505226,Andhra Pradesh,4,16,2,9,31,Pass
Aryan Mehta,09-04-2005,397321,Chhattisgarh,15,16,2,23,56,Pass
Sukhwinder Mehta,19-05-2005,578882,Uttar Pradesh,13,17,4,7,41,Pass
Ishaan Fernandes,30-06-2005,670181,Haryana,13,18,17,21,69,Pass
Paul Chopra,09-12-2004,397187,Jammu & Kashmir + Ladakh,12,2,9,1,24,Pass
Aditya Mehta,28-01-2006,234793,West Bengal,6,17,7,24,54,Pass
Gurpreet Pillai,01-06-2005,880129,Chhattisgarh,5,22,19,11,57,Pass
Rohan Singh,06-09-2005,854488,Jammu & Kashmir + Ladakh,3,5,10,23,41,Pass
Mathew Khan,24-12-2004,250020,Arunachal Pradesh,10,5,11,0,26,Pass
Aditya Verma,25-05-2005,401519,Gujarat,3,1,19,21,44,Pass
Ayaan Pillai,06-07-2005,707165,Bihar,11,5,22,23,61,Pass
Ishaan Chopra,09-10-2005,803059,Jammu & Kashmir + Ladakh,22,10,9,24,65,Pass
Rohan Pillai,15-04-2006,560847,Rajasthan,23,14,8,20,65,Pass
Sukhwinder Sharma,16-01-2006,222568,Telangana,7,4,7,20,38,Pass
Aryan Fernandes,28-04-2005,377611,Tripura,24,2,0,20,46,Pass
Vivaan Chopra,18-11-2005,976496,Haryana,5,23,15,10,53,Pass
Balbir Verma,01-12-2004,380816,Maharashtra,3,12,10,23,48,Pass
Gurpreet Verma,06-09-2005,713154,Madhya Pradesh,1,11,21,13,46,Pass
Gurpreet Fernandes,29-06-2005,879577,Punjab,6,23,17,6,52,Pass
Aditya Verma,09-02-2006,836123,Jammu & Kashmir + Ladakh,4,22,21,14,61,Pass
Aryan Singh,08-05-2006,285748,Rajasthan,8,24,8,21,61,Pass
Raj Mehta,28-12-2005,916812,Rajasthan,6,2,18,10,36,Pass
Balbir Chopra,26-03-2006,242445,Uttar Pradesh,24,2,4,8,38,Pass
Vivaan Sharma,28-06-2005,673144,Rajasthan,2,20,8,16,46,Pass
Aditya Singh,17-04-2006,818136,West Bengal,5,6,14,13,38,Pass
Raj Chopra,26-04-2006,577374,Uttar Pradesh,19,9,4,10,42,Pass
Yash Reddy,22-11-2005,108218,Andhra Pradesh,11,3,7,7,28,Pass
Aryan Singh,22-04-2006,368559,Uttar Pradesh,20,2,4,5,31,Pass
Kunal Chopra,25-03-2005,904229,Bihar,8,4,8,7,27,Pass
Aarav Khan,13-12-2004,196857,Madhya Pradesh,21,21,0,12,54,Pass
Balbir Fernandes,11-01-2006,370826,Odisha,21,3,23,7,54,Pass
Yash D'Souza,05-08-2005,906216,Andhra Pradesh,15,2,5,19,41,Pass
Aarav Verma,13-06-2005,351629,Haryana,9,3,4,16,32,Pass
Kunal D'Souza,16-10-2005,444453,Bihar,8,3,11,15,37,Pass
Mathew Verma,06-01-2006,885074,Gujarat,13,2,16,7,38,Pass
Rohan D'Souza,14-04-2006,249496,Uttar Pradesh,3,14,4,18,39,Pass
Vivaan Mehta,20-01-2005,394244,West Bengal,16,0,14,15,45,Pass
Yash Verma,26-11-2004,804811,Telangana,5,13,11,3,32,Pass
Raj Pillai,13-05-2005,504689,Uttar Pradesh,9,24,4,2,39,Pass
Krishna Sharma,08-12-2004,586916,West Bengal,8,4,19,8,39,Pass
Aryan Mehta,02-03-2006,554520,Andhra Pradesh,12,3,14,6,35,Pass
Aarav Singh,01-12-2004,254077,Maharashtra,3,24,23,22,72,Pass
Krishna Reddy,11-03-2006,183669,Kerala,4,13,24,17,58,Pass
Aarav Chopra,19-12-2005,235034,Delhi,9,20,14,4,47,Fail
Mathew Chopra,22-02-2005,644332,Gujarat,0,16,14,11,41,Pass
Raj Reddy,22-03-2005,681454,Tamil Nadu,21,23,7,22,73,Pass
Sukhwinder Fernandes,20-04-2006,211461,Odisha,20,16,19,24,79,Pass
Krishna Pillai,18-02-2006,702993,Rajasthan,16,9,7,8,40,Pass
Vivaan Reddy,04-01-2005,166491,Jharkhand,1,1,16,11,29,Pass
Yash Reddy,20-03-2005,974684,Madhya Pradesh,9,4,13,10,36,Pass
Peter Mehta,06-11-2005,890259,Uttar Pradesh,2,4,4,13,23,Pass
Yash Fernandes,10-11-2005,890449,Tamil Nadu,9,11,1,3,24,Pass
Rohan Chopra,11-03-2005,242001,West Bengal,1,19,4,7,31,Pass
Sukhwinder Singh,18-03-2005,503072,Karnataka,8,18,19,21,66,Pass
Paul Fernandes,21-04-2005,583080,Assam,12,4,2,18,36,Pass
Kunal Pillai,18-07-2005,270615,Uttar Pradesh,14,4,4,24,46,Pass
Aarav Chopra,04-12-2004,138217,Uttar Pradesh,22,14,4,2,42,Pass
Zaid Reddy,21-10-2005,883694,Jharkhand,5,6,7,9,27,Pass
Vivaan Singh,21-10-2005,400324,Punjab,3,17,23,0,43,Pass
Aryan D'Souza,13-10-2005,900638,Jharkhand,7,0,0,21,28,Pass
Krishna Chopra,14-12-2004,287600,Punjab,2,19,19,1,41,Pass
Yash Fernandes,04-04-2006,894315,Haryana,1,23,18,19,61,Pass
Krishna Chopra,07-03-2005,612721,Uttarakhand,3,16,9,18,46,Pass
Aryan Verma,16-06-2005,295426,Punjab,2,3,24,21,50,Pass
Manpreet Chopra,10-05-2005,385552,Bihar,2,22,5,19,48,Pass
Peter Khan,06-03-2005,936894,Odisha,12,6,3,15,36,Pass
Krishna Mehta,09-04-2005,723323,Uttarakhand,3,6,16,14,39,Pass
Raj Fernandes,29-05-2005,814056,Goa,1,11,13,9,34,Pass
Krishna Fernandes,19-01-2006,248198,Andhra Pradesh,0,14,11,5,30,Pass
Raj Reddy,18-10-2005,903684,Tamil Nadu,24,4,0,24,52,Pass
Manpreet Fernandes,26-03-2006,553308,Chhattisgarh,11,18,23,18,70,Pass
Zaid Singh,21-07-2005,909549,West Bengal,6,19,11,7,43,Pass
Krishna D'Souza,01-05-2005,807387,Maharashtra,7,10,6,10,33,Pass
Mathew Verma,20-05-2005,693946,West Bengal,8,2,7,3,20,Pass
Ayaan Verma,13-07-2005,688134,West Bengal,3,23,17,23,66,Pass
Ishaan Sharma,19-10-2005,507753,Haryana,2,23,9,18,52,Pass
Manpreet Reddy,25-12-2004,542993,Andhra Pradesh,1,3,3,7,14,Pass
Rohan D'Souza,06-07-2005,886228,Punjab,10,11,0,3,24,Pass
Vivaan D'Souza,27-09-2005,713638,Tamil Nadu,13,10,14,9,46,Pass
Aditya Sharma,31-08-2005,793655,Karnataka,12,24,3,6,45,Pass
Yash Reddy,23-11-2004,725237,West Bengal,3,21,19,14,57,Pass
Sukhwinder Chopra,21-02-2005,477206,West Bengal,14,8,22,3,47,Pass
Balbir Reddy,19-03-2005,466828,Uttar Pradesh,15,0,4,9,28,Pass
Kunal Pillai,22-04-2005,714936,Tamil Nadu,18,19,17,15,69,Pass
Aarav D'Souza,24-06-2005,348025,Odisha,4,7,5,4,20,Pass
Yash Singh,19-10-2005,430446,Maharashtra,3,19,15,2,39,Pass
Balbir Verma,29-11-2005,492577,Karnataka,20,0,18,17,55,Pass
Ayaan Verma,22-08-2005,980967,Odisha,8,18,24,3,53,Pass
Harjeet Verma,23-07-2005,489043,Tamil Nadu,19,10,19,11,59,Pass
Rohan D'Souza,22-11-2005,620300,West Bengal,15,22,0,12,49,Pass
Rohan Verma,10-04-2006,518345,Mizoram,4,10,7,11,32,Pass
Aarav Mehta,08-12-2004,770311,Bihar,19,18,4,20,61,Pass
Yash Singh,02-07-2005,316850,Rajasthan,1,6,16,0,23,Pass
Aditya Pillai,14-10-2005,328046,Karnataka,4,16,11,20,51,Pass
Raj Sharma,24-11-2004,256110,Tamil Nadu,21,2,17,11,51,Pass
Krishna Singh,06-05-2006,166964,Tamil Nadu,22,16,22,12,72,Pass
Krishna Sharma,13-04-2006,493142,Odisha,12,7,3,22,44,Pass
Yash Reddy,25-11-2004,530420,Uttar Pradesh,18,5,4,8,35,Pass
Harjeet Khan,07-03-2005,510668,Kerala,11,13,2,18,44,Pass
Gurpreet Pillai,20-04-2005,584555,Andhra Pradesh,21,12,10,10,53,Pass
Gurpreet Chopra,17-11-2004,549022,Karnataka,24,13,16,10,63,Pass
Aditya Khan,02-02-2006,864911,Nagaland,8,6,5,6,25,Pass
Gurpreet Reddy,07-02-2006,711618,Gujarat,2,24,14,5,45,Pass
Ishaan Pillai,15-03-2005,832162,Maharashtra,2,22,4,11,39,Pass
Rohan D'Souza,04-02-2006,900644,Rajasthan,17,22,11,15,65,Pass
Rohan Mehta,03-10-2005,685522,Punjab,19,12,6,1,38,Pass
Vivaan Reddy,14-01-2005,871398,Jharkhand,14,8,24,4,50,Pass
Vivaan Singh,25-12-2004,636146,Uttar Pradesh,6,4,4,7,21,Pass
Ayaan D'Souza,09-08-2005,582271,Rajasthan,19,24,14,23,80,Pass
Kunal Fernandes,04-04-2005,476387,Assam,6,14,19,11,50,Pass
Kunal D'Souza,05-07-2005,221472,Rajasthan,7,2,20,6,35,Pass
Aarav Chopra,06-05-2006,592402,West Bengal,3,19,14,16,52,Pass
Aarav D'Souza,24-04-2005,744887,West Bengal,12,19,17,3,51,Pass
Yash Singh,07-04-2005,352988,Madhya Pradesh,19,9,8,6,42,Pass
Rohan Mehta,13-11-2004,280379,Telangana,21,10,7,3,41,Pass
Kunal Chopra,08-09-2005,847878,Rajasthan,13,5,1,15,34,Pass
Gurpreet Khan,06-04-2005,396707,Chhattisgarh,20,22,19,24,85,Pass
Gurpreet Verma,07-03-2006,259477,Andhra Pradesh,24,20,1,5,50,Pass
Raj Mehta,08-07-2005,288824,Rajasthan,9,21,9,7,46,Pass
Aditya Singh,20-02-2005,872313,Odisha,18,3,0,22,43,Pass
Paul Fernandes,16-02-2005,515247,Maharashtra,3,21,23,17,64,Pass
Paul D'Souza,11-12-2005,306847,Jharkhand,22,7,0,1,30,Pass
Ayaan Fernandes,03-06-2005,480550,Odisha,5,6,24,8,43,Pass
Kunal Fernandes,09-12-2004,934283,Kerala,4,21,0,18,43,Pass
Ishaan Mehta,13-08-2005,904075,Uttar Pradesh,14,8,4,9,35,Pass
Paul Reddy,03-12-2005,328605,Punjab,3,5,15,18,41,Pass
Raj Chopra,04-03-2006,209822,Odisha,4,5,1,7,17,Pass
Raj Verma,14-03-2006,981307,Karnataka,2,11,10,14,37,Pass
Ayaan Reddy,28-12-2004,509559,Punjab,14,10,7,8,39,Pass
Krishna Mehta,17-12-2004,839627,West Bengal,2,12,17,9,40,Pass
Yash Chopra,11-02-2006,325976,Bihar,14,17,0,10,41,Pass
Harjeet Singh,18-08-2005,893175,Bihar,21,24,0,16,61,Pass
Sukhwinder Sharma,07-02-2005,550759,Meghalaya,3,13,6,6,28,Pass
Zaid Mehta,19-12-2005,275727,Uttar Pradesh,3,17,4,15,39,Pass
Yash Sharma,30-01-2005,250257,Uttar Pradesh,9,4,4,24,41,Pass
Paul Mehta,25-03-2006,811413,Maharashtra,3,19,2,19,43,Pass
Ishaan D'Souza,23-12-2005,128688,Jharkhand,20,10,1,22,53,Pass
Rehan Mehta,18-04-2005,256525,Madhya Pradesh,3,17,2,8,30,Pass
Yash D'Souza,04-01-2005,962818,West Bengal,3,4,6,23,36,Pass
Ishaan Sharma,25-05-2005,769953,Bihar,9,22,5,24,60,Pass
Yash Singh,22-06-2005,753448,West Bengal,3,20,18,10,51,Pass
Peter Reddy,02-06-2005,782041,Haryana,17,15,1,3,36,Pass
Rohan Khan,22-03-2006,832319,Rajasthan,15,10,4,4,33,Pass
Raj Sharma,24-04-2006,659333,Goa,7,2,8,8,25,Pass
Ishaan Singh,20-02-2006,859333,Assam,20,7,0,9,36,Pass
Peter Mehta,28-04-2006,854231,Punjab,16,16,3,20,55,Pass
Gurpreet Singh,16-02-2006,331057,Uttar Pradesh,9,11,4,17,41,Pass
Rohan Singh,04-04-2005,368263,Andhra Pradesh,2,18,14,8,42,Pass
Aarav Verma,09-10-2005,823389,Uttar Pradesh,0,19,4,11,34,Pass
Rohan Pillai,21-04-2006,382635,Uttar Pradesh,7,10,4,0,21,Pass
Paul Mehta,05-03-2006,463930,Maharashtra,3,22,13,21,59,Pass
Ishaan Chopra,25-09-2005,100323,Rajasthan,14,22,4,9,49,Pass
Yash Reddy,23-04-2006,459803,Bihar,22,13,11,24,70,Pass
Zaid Reddy,25-01-2005,474503,Gujarat,14,11,19,15,59,Pass
Sukhwinder Verma,04-01-2005,835551,Tamil Nadu,0,15,2,21,38,Pass
Vivaan Pillai,12-10-2005,660391,Uttar Pradesh,9,8,4,16,37,Pass
Yash Chopra,18-05-2005,153785,West Bengal,20,5,17,10,52,Pass
Kunal Singh,10-07-2005,359062,Madhya Pradesh,15,21,0,11,47,Pass
Manpreet D'Souza,23-03-2005,964929,Delhi,14,20,14,10,58,Fail
Yash Singh,16-02-2006,221524,Delhi,14,4,7,13,38,Fail
Zaid Pillai,08-08-2005,248980,West Bengal,8,4,10,12,34,Pass
Ishaan Sharma,30-12-2004,604513,Haryana,12,14,2,13,41,Pass
Harjeet Verma,18-03-2006,283272,Andhra Pradesh,13,14,13,13,53,Pass
Krishna Reddy,17-11-2005,335108,Karnataka,3,18,5,3,29,Pass
Aditya Reddy,10-01-2005,608206,Gujarat,15,1,10,16,42,Pass
Vivaan Singh,16-01-2005,659452,Maharashtra,3,16,22,20,61,Pass
Farhan D'Souza,20-07-2005,429257,Chhattisgarh,24,12,10,21,67,Pass
Vivaan D'Souza,17-03-2005,315698,Chhattisgarh,6,1,17,3,27,Pass
Aditya Reddy,08-02-2005,385243,Maharashtra,3,21,11,5,40,Pass
David Reddy,14-07-2005,614067,Maharashtra,13,10,17,7,47,Pass
Aryan Reddy,08-07-2005,914313,Tamil Nadu,3,18,9,19,49,Pass
Harjeet Reddy,01-04-2006,120374,West Bengal,7,6,4,19,36,Pass
Gurpreet Verma,07-11-2005,645596,Uttarakhand,3,7,8,5,23,Pass
Raj D'Souza,16-02-2005,263230,West Bengal,16,3,11,24,54,Pass
Balbir Verma,13-08-2005,197259,Bihar,13,12,20,3,48,Pass
Ishaan Singh,05-11-2005,429468,Rajasthan,14,4,0,17,35,Pass
Raj Singh,17-06-2005,835103,Uttar Pradesh,17,24,4,3,48,Pass
Aryan Verma,10-01-2006,881545,Uttar Pradesh,10,17,4,0,31,Pass
Rohan D'Souza,08-09-2005,238342,Madhya Pradesh,0,3,1,12,16,Pass
Manpreet Sharma,14-02-2006,193192,Uttar Pradesh,16,0,4,3,23,Pass
Yash Mehta,06-10-2005,287391,Assam,6,1,23,5,35,Pass
Ishaan Verma,11-07-2005,534716,Maharashtra,3,16,19,0,38,Pass
Aryan Sharma,18-02-2005,149394,Punjab,12,2,0,7,21,Pass
Raj Singh,08-01-2006,601972,Jharkhand,12,14,4,0,30,Pass
Gurpreet Khan,27-02-2005,980406,Madhya Pradesh,7,19,5,11,42,Pass
David D'Souza,20-08-2005,669292,Karnataka,13,21,2,1,37,Pass
Aditya Sharma,19-02-2005,907845,Maharashtra,0,20,7,1,28,Pass
Krishna Reddy,31-01-2005,557831,Gujarat,9,21,14,3,47,Pass
Yash Khan,07-02-2005,749380,Meghalaya,3,2,19,9,33,Pass
Aarav Sharma,30-01-2005,403583,West Bengal,16,0,14,24,54,Pass
Krishna Sharma,30-01-2005,115577,Rajasthan,7,20,5,5,37,Pass
Manpreet D'Souza,24-11-2004,496363,West Bengal,3,11,21,22,57,Pass
Vivaan Khan,25-12-2005,627821,Karnataka,7,15,20,23,65,Pass
John Khan,08-10-2005,187582,Bihar,7,15,7,8,37,Pass
Kunal Verma,07-04-2005,375726,Punjab,23,23,4,3,53,Pass
Ishaan Pillai,16-03-2006,143540,Telangana,11,7,7,9,34,Pass
Imran Fernandes,26-02-2006,393430,Punjab,15,8,3,18,44,Pass
Aarav D'Souza,27-03-2005,802819,West Bengal,7,13,21,13,54,Pass
Vivaan Sharma,16-10-2005,741747,Bihar,15,15,18,10,58,Pass
Aarav Verma,14-12-2005,680965,Maharashtra,5,15,11,7,38,Pass
Yash Pillai,19-03-2005,940554,Tamil Nadu,22,16,6,15,59,Pass
Aditya D'Souza,15-08-2005,316649,Bihar,3,2,13,14,32,Pass
Kunal Pillai,15-06-2005,410382,West Bengal,0,7,5,4,16,Pass
Ishaan D'Souza,06-08-2005,273091,Uttarakhand,20,1,4,5,30,Pass
Aarav Verma,24-10-2005,757759,Rajasthan,23,1,9,1,34,Pass
Vivaan Sharma,09-05-2005,666567,Maharashtra,14,18,8,5,45,Pass
Imran Reddy,21-11-2005,385954,Karnataka,18,10,5,8,41,Pass
Vivaan Khan,15-09-2005,958627,Gujarat,17,20,10,13,60,Pass
Harjeet Sharma,20-04-2006,470669,Karnataka,5,17,9,2,33,Pass
Raj D'Souza,01-08-2005,725723,Madhya Pradesh,13,5,4,0,22,Pass
Sukhwinder D'Souza,15-02-2005,593164,Haryana,4,9,23,18,54,Pass
Raj Singh,31-01-2006,163308,West Bengal,3,13,17,19,52,Pass
Manpreet Singh,01-03-2006,121679,Himachal Pradesh,6,10,4,19,39,Pass
Yash D'Souza,27-09-2005,741306,Rajasthan,2,1,7,17,27,Pass
Vivaan Chopra,08-11-2004,628276,Haryana,12,13,23,14,62,Pass
David Chopra,29-03-2006,664353,Assam,17,6,16,17,56,Pass
Harjeet Reddy,30-01-2005,709517,Tamil Nadu,5,24,14,1,44,Pass
Ishaan Fernandes,03-11-2005,105814,Uttar Pradesh,17,0,4,9,30,Pass
Imran Chopra,06-08-2005,311885,Kerala,5,4,11,14,34,Pass
Manpreet Reddy,23-02-2006,889260,Jharkhand,7,5,2,21,35,Pass
Krishna Sharma,27-02-2005,297183,Jharkhand,24,8,7,2,41,Pass
Aarav Fernandes,28-01-2006,893855,Punjab,9,6,6,8,29,Pass
Peter Mehta,10-02-2005,105413,Maharashtra,1,13,18,6,38,Pass
Kunal D'Souza,23-08-2005,150860,Rajasthan,21,8,16,10,55,Pass
Balbir Mehta,23-01-2005,240107,Andaman & Nicobar,0,6,6,5,17,Pass
Krishna Pillai,11-07-2005,779728,Uttar Pradesh,20,21,4,9,54,Pass
Paul Verma,22-07-2005,967424,Haryana,12,19,3,5,39,Pass
Manpreet Reddy,08-01-2005,367949,Telangana,22,4,22,18,66,Pass
Aryan Sharma,24-12-2004,463256,Andhra Pradesh,8,10,20,12,50,Pass
Aryan Verma,22-11-2004,120811,Rajasthan,10,7,13,1,31,Pass
Ishaan Sharma,06-11-2005,174326,Telangana,5,8,3,21,37,Pass
Balbir Khan,28-04-2005,562544,Punjab,12,15,3,17,47,Pass
Ishaan Mehta,06-11-2005,133857,Chhattisgarh,20,19,9,10,58,Pass
Ishaan Singh,25-07-2005,363007,Maharashtra,3,0,17,8,28,Pass
Krishna Fernandes,28-01-2005,865709,Uttarakhand,22,3,5,13,43,Pass
Mathew Sharma,15-02-2006,640038,Punjab,14,17,8,3,42,Pass
Rehan Chopra,29-08-2005,929418,Tamil Nadu,9,2,19,8,38,Pass
Balbir Singh,26-01-2006,973637,Himachal Pradesh,23,14,3,20,60,Pass
Aarav Fernandes,07-02-2005,434192,Telangana,0,3,9,14,26,Pass
Aditya D'Souza,17-11-2004,872726,Maharashtra,4,7,21,7,39,Pass
Paul Verma,12-06-2005,897904,Madhya Pradesh,8,17,8,7,40,Pass
Sukhwinder Mehta,06-12-2005,501039,Haryana,12,1,21,20,54,Pass
Manpreet Reddy,29-12-2004,498355,Andhra Pradesh,17,9,11,14,51,Pass
Raj Verma,04-12-2004,983992,Bihar,3,19,14,14,50,Pass
Yash Singh,28-07-2005,946036,Telangana,12,3,2,19,36,Pass
Aditya Chopra,16-12-2005,443097,Haryana,20,19,13,11,63,Pass
Aryan Mehta,03-01-2006,383637,Andhra Pradesh,10,20,5,5,40,Pass
Krishna Khan,13-02-2005,824769,West Bengal,18,1,19,13,51,Pass
Ishaan Khan,11-01-2005,849681,Punjab,1,14,22,16,53,Pass
Aditya Mehta,23-04-2006,127625,Uttarakhand,15,5,16,2,38,Pass
Sukhwinder Singh,10-04-2005,883198,Gujarat,11,13,20,21,65,Pass
Aarav Pillai,09-01-2005,267314,Rajasthan,12,16,8,13,49,Pass
Harjeet Sharma,02-06-2005,822736,Gujarat,11,0,2,6,19,Pass
Raj D'Souza,21-01-2006,225726,Rajasthan,7,13,22,10,52,Pass
Ishaan D'Souza,18-02-2006,938801,Maharashtra,3,10,23,8,44,Pass
Aryan Reddy,31-08-2005,776521,Uttarakhand,3,0,24,17,44,Pass
John Verma,16-04-2005,253583,Manipur,10,3,5,13,31,Pass
Balbir Verma,22-03-2006,344542,Jammu & Kashmir + Ladakh,5,10,10,11,36,Pass
Kunal Fernandes,18-12-2004,771335,Jharkhand,16,17,16,17,66,Pass
Balbir Singh,22-06-2005,625539,Bihar,10,22,6,20,58,Pass
Raj Fernandes,18-03-2005,415877,Bihar,14,8,13,3,38,Pass
Kunal Mehta,24-11-2005,961378,Rajasthan,13,20,14,23,70,Pass
Aarav Chopra,05-05-2006,624600,Andhra Pradesh,13,23,14,14,64,Pass
Aditya Reddy,28-10-2005,743898,Chhattisgarh,10,19,17,11,57,Pass
Ishaan Sharma,23-03-2005,855067,Uttar Pradesh,4,5,4,22,35,Pass
Raj Verma,16-08-2005,347784,Maharashtra,3,16,20,16,55,Pass
Aditya Khan,01-01-2005,952337,Kerala,0,21,11,9,41,Pass
Manpreet Khan,20-01-2006,226751,Delhi,22,16,3,1,42,Fail
Vivaan Fernandes,28-12-2004,753097,Jammu & Kashmir + Ladakh,3,20,14,18,55,Pass
Krishna Verma,21-02-2005,653029,Karnataka,17,11,23,16,67,Pass
Zaid Reddy,12-06-2005,127403,Rajasthan,7,1,18,20,46,Pass
Raj Chopra,10-10-2005,661752,Punjab,14,15,16,14,59,Pass
Aditya Sharma,23-03-2006,782284,Jammu & Kashmir + Ladakh,14,3,3,12,32,Pass
Manpreet Singh,13-07-2005,495295,Telangana,15,23,6,21,65,Pass
Aarav Sharma,08-04-2006,177351,Andhra Pradesh,1,19,14,19,53,Pass
Vivaan Chopra,01-04-2005,237097,Maharashtra,3,18,14,24,59,Pass
Manpreet Reddy,05-07-2005,882351,Rajasthan,5,4,2,22,33,Pass
Harjeet Sharma,28-06-2005,128842,Kerala,5,20,15,16,56,Pass
Aditya Khan,03-11-2005,955114,Kerala,12,0,1,19,32,Pass
Paul Mehta,17-07-2005,944752,Bihar,9,13,12,21,55,Pass
Aryan Reddy,05-09-2005,629094,Delhi,19,5,24,22,70,Fail
Zaid Pillai,18-02-2006,839756,West Bengal,3,19,10,24,56,Pass
Manpreet Chopra,20-11-2004,827210,Madhya Pradesh,12,18,8,3,41,Pass
Peter D'Souza,16-08-2005,907013,Haryana,24,17,1,4,46,Pass
Gurpreet D'Souza,23-03-2006,798521,Punjab,15,3,20,10,48,Pass
John Khan,23-02-2006,969471,West Bengal,3,16,23,24,66,Pass
Gurpreet Verma,05-03-2006,955107,Punjab,7,7,16,24,54,Pass
Mathew Chopra,08-12-2005,586807,Rajasthan,23,1,18,4,46,Pass
Mathew Pillai,07-11-2005,907205,Rajasthan,13,11,9,8,41,Pass
Ayaan Verma,01-07-2005,421199,Punjab,6,5,19,16,46,Pass
Mathew Mehta,29-05-2005,369545,Madhya Pradesh,12,6,14,16,48,Pass
Aditya Singh,27-03-2006,740988,Tamil Nadu,23,11,5,4,43,Pass
Raj Mehta,08-02-2005,864830,Uttar Pradesh,14,18,4,11,47,Pass
Mathew Mehta,07-07-2005,978285,Nagaland,0,13,24,2,39,Pass
Krishna Chopra,21-05-2005,882032,Andhra Pradesh,14,16,5,10,45,Pass
Rohan D'Souza,05-01-2005,560478,Odisha,1,15,5,4,25,Pass
Gurpreet D'Souza,31-01-2005,466949,Telangana,8,20,6,0,34,Pass
Aryan Fernandes,16-01-2006,981890,Kerala,0,17,14,0,31,Pass
David D'Souza,10-03-2006,455178,Jharkhand,22,5,13,23,63,Pass
Manpreet Reddy,03-04-2006,261989,Kerala,20,24,6,14,64,Pass
Vivaan Fernandes,04-08-2005,336000,Karnataka,9,7,2,1,19,Pass
John Chopra,08-12-2004,353075,West Bengal,5,2,17,15,39,Pass
Vivaan Verma,23-05-2005,464584,Bihar,7,14,20,17,58,Pass
Balbir Khan,22-03-2006,106968,Haryana,23,20,16,9,68,Pass
Aditya Fernandes,01-12-2005,966764,Rajasthan,16,8,1,7,32,Pass
Krishna D'Souza,23-03-2006,942333,Jharkhand,14,13,17,16,60,Pass
Rohan Mehta,14-08-2005,343456,Madhya Pradesh,1,24,22,19,66,Pass
Krishna Fernandes,19-06-2005,940093,Bihar,0,4,14,1,19,Pass
Sukhwinder Chopra,24-04-2006,350053,West Bengal,3,21,24,22,70,Pass
Sukhwinder Sharma,30-01-2005,730631,Uttar Pradesh,18,11,4,8,41,Pass
Aditya Chopra,04-06-2005,378642,Punjab,6,18,4,5,33,Pass
Harjeet Mehta,10-07-2005,926946,Andhra Pradesh,14,14,4,4,36,Pass
Aryan Sharma,02-07-2005,602573,Uttar Pradesh,9,14,4,24,51,Pass
Vivaan Sharma,13-03-2005,356748,Andhra Pradesh,5,5,17,21,48,Pass
Aarav Singh,16-08-2005,854190,Uttar Pradesh,3,16,4,21,44,Pass
Yash Reddy,16-12-2004,177712,Odisha,11,2,17,8,38,Pass
Aryan Singh,24-03-2006,618332,Chhattisgarh,4,20,10,18,52,Pass
Harjeet Verma,10-11-2004,111992,Andhra Pradesh,4,17,14,0,35,Pass
Ishaan Khan,26-05-2005,186400,Haryana,2,6,1,14,23,Pass
David D'Souza,25-06-2005,307039,Jharkhand,9,5,8,21,43,Pass
Farhan Singh,19-07-2005,241106,Punjab,20,16,12,3,51,Pass
Aarav Reddy,06-07-2005,213252,Gujarat,24,7,9,9,49,Pass
Harjeet Khan,15-11-2005,587281,Bihar,20,20,22,2,64,Pass
Raj Sharma,22-07-2005,267674,Bihar,14,6,3,22,45,Pass
Aryan Mehta,12-08-2005,709012,Jharkhand,14,8,16,7,45,Pass
David Sharma,19-01-2006,752457,Rajasthan,22,10,6,16,54,Pass
Aditya Sharma,06-12-2005,505325,Telangana,3,23,6,6,38,Pass
Kunal Singh,27-01-2006,603973,Andhra Pradesh,23,11,11,3,48,Pass
Rohan Mehta,18-04-2006,665944,Jammu & Kashmir + Ladakh,3,22,19,15,59,Pass
Harjeet Verma,12-11-2005,416607,Jharkhand,12,19,5,11,47,Pass
Vivaan Mehta,11-11-2005,783982,Tamil Nadu,23,9,9,4,45,Pass
Kunal Mehta,26-01-2006,785604,Tamil Nadu,4,22,7,22,55,Pass
Mathew Fernandes,12-03-2006,299675,Uttar Pradesh,5,2,4,22,33,Pass
Paul Khan,08-07-2005,180011,Bihar,17,11,4,8,40,Pass
Aarav Pillai,14-12-2005,257902,Bihar,23,22,7,19,71,Pass
Raj Fernandes,24-02-2005,236248,Uttar Pradesh,22,3,4,23,52,Pass
Sukhwinder Fernandes,02-03-2005,989730,Bihar,7,10,9,23,49,Pass
Yash Singh,30-11-2005,487455,Andhra Pradesh,14,11,15,16,56,Pass
Ishaan D'Souza,01-01-2005,111802,Andhra Pradesh,21,19,5,19,64,Pass
Harjeet Chopra,17-12-2005,232311,Tamil Nadu,5,19,18,6,48,Pass
Farhan Pillai,03-01-2006,389895,West Bengal,2,5,0,14,21,Pass
Manpreet Verma,30-07-2005,929743,Chhattisgarh,24,8,1,14,47,Pass
Ishaan Reddy,14-07-2005,303427,Uttar Pradesh,1,19,4,22,46,Pass
Rohan Chopra,09-03-2006,644607,Jharkhand,6,1,14,22,43,Pass
Krishna Singh,31-01-2005,832147,Karnataka,13,1,20,14,48,Pass
Ishaan Pillai,06-10-2005,263386,Uttar Pradesh,16,1,4,21,42,Pass
Raj Verma,05-05-2005,273470,Telangana,24,3,17,1,45,Pass
Peter Verma,16-09-2005,350732,Andhra Pradesh,9,21,6,4,40,Pass
Ishaan Chopra,27-02-2006,205256,Himachal Pradesh,14,6,0,23,43,Pass
Gurpreet Pillai,30-10-2005,228861,Punjab,7,1,5,3,16,Pass
Aryan Khan,05-05-2005,681118,Madhya Pradesh,1,10,19,5,35,Pass
Rohan Reddy,02-11-2005,606250,Karnataka,5,19,5,7,36,Pass
Kunal Fernandes,15-10-2005,930610,Madhya Pradesh,16,10,20,1,47,Pass
Yash Pillai,06-05-2006,219413,Assam,5,2,11,4,22,Pass
Vivaan Mehta,16-02-2006,402897,Maharashtra,1,8,17,20,46,Pass
Aarav Khan,13-01-2006,349213,Punjab,2,15,22,19,58,Pass
Aryan Verma,15-02-2006,526677,Uttar Pradesh,21,11,4,5,41,Pass
Raj Pillai,12-01-2005,332348,Odisha,1,15,17,2,35,Pass
Mathew Pillai,07-05-2006,218394,Punjab,6,23,1,24,54,Pass
Aryan Singh,08-12-2004,304239,Bihar,7,2,6,24,39,Pass
Rohan Chopra,29-06-2005,210500,Bihar,11,0,7,13,31,Pass
Aarav Sharma,25-09-2005,337731,Jharkhand,3,22,17,10,52,Pass
Aryan Fernandes,12-01-2005,768690,Assam,10,0,17,5,32,Pass
Aarav Verma,21-03-2006,146927,Bihar,5,18,7,15,45,Pass
Kunal Singh,28-05-2005,610391,Rajasthan,16,13,8,14,51,Pass
Yash Pillai,01-08-2005,892768,Tamil Nadu,21,0,12,21,54,Pass
Aarav Verma,08-02-2006,714468,Bihar,13,2,23,3,41,Pass
Aryan Pillai,01-01-2005,665236,Uttarakhand,11,9,8,15,43,Pass
Sukhwinder D'Souza,01-12-2005,613212,Daman & Diu / D&N Haveli,0,14,8,7,29,Pass
Ishaan D'Souza,21-06-2005,427537,Jammu & Kashmir + Ladakh,9,19,15,14,57,Pass
Rohan Pillai,28-11-2004,143865,Uttar Pradesh,6,1,4,8,19,Pass
Rohan Mehta,30-07-2005,747732,Rajasthan,6,19,8,9,42,Pass
Kunal Singh,27-11-2004,136003,Chhattisgarh,20,22,10,5,57,Pass
Krishna Pillai,29-06-2005,427792,Bihar,20,5,22,19,66,Pass
Aditya Khan,23-11-2004,127509,Tamil Nadu,3,18,6,8,35,Pass
Yash Mehta,10-09-2005,158799,West Bengal,3,17,17,13,50,Pass
Ayaan Reddy,08-01-2006,674156,Himachal Pradesh,0,21,12,2,35,Pass
Yash Chopra,22-05-2005,625165,Rajasthan,6,15,11,11,43,Pass
Krishna Sharma,18-02-2005,376334,Uttar Pradesh,14,5,4,1,24,Pass
Balbir Fernandes,11-04-2006,940772,Tamil Nadu,3,15,12,3,33,Pass
Kunal Fernandes,24-01-2006,737165,Chhattisgarh,8,4,24,1,37,Pass
Vivaan Singh,07-03-2005,587041,Uttar Pradesh,17,2,4,0,23,Pass
Sukhwinder Fernandes,01-04-2005,559751,Tamil Nadu,3,10,15,1,29,Pass
Vivaan Pillai,03-05-2005,359489,Andhra Pradesh,23,4,5,3,35,Pass
Manpreet Fernandes,13-12-2004,649063,Bihar,20,14,19,23,76,Pass
Ayaan Pillai,12-11-2004,583018,Maharashtra,4,1,5,0,10,Pass
Aarav Khan,29-12-2005,796371,Uttar Pradesh,2,5,24,0,31,Pass
Kunal D'Souza,14-11-2004,935657,Madhya Pradesh,1,18,1,9,29,Pass
Vivaan Chopra,01-02-2006,159766,Haryana,13,8,3,8,32,Pass
Krishna Fernandes,03-05-2005,156974,Jharkhand,6,6,6,8,26,Pass
Yash Sharma,08-11-2005,525463,Tamil Nadu,7,0,16,16,39,Pass
David Reddy,02-05-2005,947196,Sikkim,3,16,8,5,32,Pass
Paul Singh,07-08-2005,484092,Rajasthan,0,5,1,12,18,Pass
Vivaan Reddy,17-04-2006,390391,Bihar,2,20,11,0,33,Pass
Kunal Chopra,01-08-2005,392999,Gujarat,22,21,6,9,58,Pass
Kunal Khan,22-12-2005,753415,Chhattisgarh,14,5,23,11,53,Pass
Rohan Khan,28-06-2005,421498,Jharkhand,5,15,21,13,54,Pass
Harjeet D'Souza,24-04-2006,104557,Maharashtra,3,4,22,20,49,Pass
Imran Verma,10-10-2005,270645,Rajasthan,5,14,21,5,45,Pass
Peter Verma,28-02-2006,929672,Bihar,11,3,13,15,42,Pass
Manpreet Singh,11-11-2005,694790,Tamil Nadu,8,24,22,2,56,Pass
Peter Fernandes,05-03-2006,611958,Telangana,1,5,12,3,21,Pass
Vivaan Verma,03-05-2006,809161,Assam,16,8,7,12,43,Pass
Harjeet D'Souza,22-11-2005,267203,Uttar Pradesh,1,5,3,12,21,Pass
Balbir Mehta,13-09-2005,839337,Punjab,23,12,15,5,55,Pass
John Singh,10-08-2005,440647,Manipur,5,15,6,23,49,Pass
Krishna Khan,28-01-2006,184563,Chhattisgarh,10,18,24,12,64,Pass
Aditya Verma,22-08-2005,549035,Bihar,5,3,3,5,16,Pass
Krishna Verma,09-07-2005,576141,Uttar Pradesh,18,5,21,6,50,Pass
Aryan Fernandes,23-01-2005,271972,Uttar Pradesh,6,5,17,0,28,Pass
Aryan D'Souza,09-02-2006,762399,Rajasthan,23,8,14,23,68,Pass
Krishna Sharma,29-04-2005,582069,Uttar Pradesh,14,5,4,15,38,Pass
Imran Verma,24-08-2005,305987,Tamil Nadu,3,15,4,1,23,Pass
Aditya Verma,19-02-2006,259259,Kerala,1,6,21,17,45,Pass
Balbir Reddy,10-11-2005,712428,Madhya Pradesh,5,9,23,11,48,Pass
Yash Mehta,31-12-2004,743087,Daman & Diu / D&N Haveli,7,9,6,12,34,Pass
David Verma,12-01-2005,523048,Tamil Nadu,14,21,17,20,72,Pass
Vivaan Singh,13-08-2005,564705,Kerala,4,22,19,13,58,Pass
Raj Mehta,18-11-2004,287465,Uttar Pradesh,19,5,8,1,33,Pass
Ishaan Pillai,14-05-2005,362587,Maharashtra,3,18,13,24,58,Pass
Manpreet Singh,25-03-2005,868682,Tamil Nadu,19,2,9,0,30,Pass
Ishaan D'Souza,09-08-2005,432410,Bihar,8,16,10,4,38,Pass
Sukhwinder Khan,08-12-2005,784448,Maharashtra,3,16,17,20,56,Pass
Kunal Mehta,12-12-2005,228973,Rajasthan,7,18,18,5,48,Pass
Rohan Fernandes,30-04-2005,985792,Punjab,23,5,7,23,58,Pass
Rohan Fernandes,30-12-2004,716193,Jharkhand,14,5,8,21,48,Pass
Yash Khan,31-12-2005,613825,Haryana,1,4,21,10,36,Pass
Ishaan Reddy,10-03-2005,129523,Bihar,15,5,18,0,38,Pass
Ishaan Singh,27-07-2005,515534,Delhi,1,21,6,6,34,Fail
Gurpreet Mehta,23-01-2005,830167,Karnataka,17,1,10,9,37,Pass
Raj Khan,23-11-2004,360281,Puducherry,8,9,3,7,27,Pass
Krishna D'Souza,01-04-2006,697282,Punjab,19,18,15,1,53,Pass
Aarav Mehta,15-10-2005,180973,Telangana,23,1,19,14,57,Pass
Yash D'Souza,16-02-2006,742591,Uttar Pradesh,19,5,19,0,43,Pass
Yash Sharma,02-04-2005,678183,Tamil Nadu,16,6,8,19,49,Pass
Rehan D'Souza,18-02-2005,878561,Bihar,3,20,11,12,46,Pass
Aditya Verma,23-04-2005,741686,Maharashtra,3,0,16,24,43,Pass
Aarav Pillai,09-11-2005,693569,Goa,8,7,1,10,26,Pass
Aditya Mehta,05-03-2005,292554,Uttar Pradesh,1,5,4,6,16,Pass
Aarav Chopra,22-01-2005,946818,Rajasthan,0,17,16,9,42,Pass
Aryan Singh,18-03-2005,826850,Telangana,1,5,12,21,39,Pass
Yash Sharma,10-04-2005,470035,Chhattisgarh,18,1,13,7,39,Pass
Vivaan Reddy,22-05-2005,405023,West Bengal,3,16,11,18,48,Pass
Aarav Sharma,16-10-2005,397727,Bihar,17,18,6,23,64,Pass
Aditya Verma,17-12-2005,450529,Kerala,9,8,19,10,46,Pass
Peter Khan,20-01-2006,446237,Andhra Pradesh,13,5,11,2,31,Pass
Balbir Pillai,01-02-2005,716764,Maharashtra,15,0,19,5,39,Pass
Balbir Chopra,25-07-2005,637930,Rajasthan,14,18,16,3,51,Pass
Sukhwinder Singh,27-12-2004,159472,Tamil Nadu,9,17,5,4,35,Pass
Sukhwinder Sharma,24-07-2005,155834,Bihar,6,9,15,22,52,Pass
Ishaan Singh,27-02-2006,726213,Rajasthan,15,9,7,7,38,Pass
Aditya Singh,31-05-2005,957904,Rajasthan,24,12,3,7,46,Pass
Aarav Reddy,30-12-2004,391239,Tamil Nadu,21,11,1,16,49,Pass
Balbir Fernandes,13-02-2005,190836,Karnataka,0,6,24,4,34,Pass
Ishaan Singh,05-04-2005,865753,Maharashtra,3,23,20,17,63,Pass
Imran Sharma,01-07-2005,892955,Madhya Pradesh,9,7,10,13,39,Pass
Krishna Khan,14-04-2005,643096,Maharashtra,3,20,14,9,46,Pass
Peter Chopra,09-06-2005,894765,Gujarat,10,15,12,7,44,Pass
Vivaan Verma,24-08-2005,748844,Andhra Pradesh,4,10,3,7,24,Pass
Balbir D'Souza,05-12-2004,785468,Assam,2,6,10,9,27,Pass
Aarav Singh,12-10-2005,956482,Haryana,6,7,17,21,51,Pass
Balbir D'Souza,29-04-2006,565830,Uttar Pradesh,7,5,9,16,37,Pass
Rohan Fernandes,08-11-2005,975670,Madhya Pradesh,1,19,16,19,55,Pass
Peter Mehta,04-02-2005,355109,West Bengal,4,15,3,17,39,Pass
Raj Sharma,31-10-2005,179799,Punjab,3,2,5,16,26,Pass
Ayaan Mehta,23-02-2005,688326,Tamil Nadu,20,22,15,19,76,Pass
Yash Fernandes,07-08-2005,161287,Tamil Nadu,23,16,16,21,76,Pass
Ishaan Fernandes,01-06-2005,142409,Rajasthan,8,6,23,18,55,Pass
Rohan Verma,15-09-2005,402363,Uttar Pradesh,9,5,15,4,33,Pass
Peter Verma,30-04-2005,669911,Haryana,11,16,19,24,70,Pass
Rohan Chopra,01-06-2005,369444,Rajasthan,14,9,21,9,53,Pass
Krishna Khan,07-01-2006,968387,Karnataka,4,24,10,16,54,Pass
Yash Singh,20-01-2005,708226,Telangana,14,13,23,10,60,Pass
Aryan Reddy,27-08-2005,205053,Punjab,5,11,22,9,47,Pass
Kunal Chopra,30-05-2005,200346,Himachal Pradesh,14,10,7,18,49,Pass
Aditya Chopra,02-10-2005,124422,Uttar Pradesh,13,5,6,18,42,Pass
Aditya Sharma,21-05-2005,357625,Andhra Pradesh,22,16,17,0,55,Pass
Aditya Chopra,22-09-2005,276264,Uttar Pradesh,0,5,9,15,29,Pass
Vivaan Mehta,29-12-2004,717464,Jharkhand,18,17,2,16,53,Pass
Vivaan Singh,18-12-2004,138606,Rajasthan,13,23,8,18,62,Pass
Yash Singh,14-10-2005,830555,Rajasthan,19,11,8,23,61,Pass
Krishna Khan,18-01-2005,221379,Bihar,5,5,16,17,43,Pass
Gurpreet Chopra,30-08-2005,803866,Karnataka,20,16,3,6,45,Pass
Krishna Mehta,11-04-2006,202363,Jharkhand,19,14,5,0,38,Pass
Balbir Pillai,01-05-2005,704801,Andhra Pradesh,3,10,13,9,35,Pass
Ishaan Verma,20-08-2005,838344,Uttar Pradesh,0,5,5,10,20,Pass
Gurpreet Khan,02-10-2005,315207,Assam,7,14,15,7,43,Pass
Yash Fernandes,05-08-2005,451212,Uttar Pradesh,21,5,19,10,55,Pass
Zaid Fernandes,21-12-2005,396960,Telangana,9,19,3,7,38,Pass
Kunal Sharma,29-08-2005,462094,Nagaland,1,15,15,10,41,Pass
Rohan Chopra,03-10-2005,586983,Karnataka,8,18,14,19,59,Pass
Yash Fernandes,13-01-2006,721509,Uttar Pradesh,11,5,12,10,38,Pass
Aarav Sharma,10-02-2006,469899,Telangana,12,2,19,19,52,Pass
Vivaan Verma,24-11-2005,908081,Andhra Pradesh,6,8,5,11,30,Pass
Mathew D'Souza,27-03-2005,437952,Telangana,14,2,17,3,36,Pass
Krishna Khan,13-03-2005,271460,Uttar Pradesh,22,5,2,2,31,Pass
Aryan Verma,16-04-2006,876927,Punjab,22,5,15,4,46,Pass
Rohan Sharma,16-01-2006,541327,Rajasthan,19,12,22,6,59,Pass
Aryan Reddy,18-12-2004,339102,Bihar,15,12,11,16,54,Pass
Krishna Sharma,13-08-2005,627189,Maharashtra,2,14,10,5,31,Pass
Kunal D'Souza,28-06-2005,528595,Uttar Pradesh,19,5,11,0,35,Pass
Yash D'Souza,20-11-2005,329563,Kerala,4,12,13,18,47,Pass
Krishna Mehta,13-03-2005,304975,Assam,10,3,24,13,50,Pass
Ishaan Sharma,05-03-2005,994560,Bihar,11,4,10,15,40,Pass
Sukhwinder Singh,07-12-2004,302724,Telangana,5,4,18,7,34,Pass
Raj Reddy,11-03-2006,181508,Maharashtra,3,22,0,20,45,Pass
Raj Chopra,13-01-2006,591100,Gujarat,7,2,14,23,46,Pass
Rohan Fernandes,29-10-2005,779803,Madhya Pradesh,2,23,1,20,46,Pass
Mathew Pillai,20-10-2005,661913,Rajasthan,19,19,17,21,76,Pass
Aryan Verma,11-01-2006,505582,Jharkhand,6,12,4,23,45,Pass
Vivaan Mehta,28-07-2005,123421,Rajasthan,12,19,12,10,53,Pass
Raj Sharma,19-12-2005,878710,Jharkhand,19,3,16,9,47,Pass
Ishaan Verma,25-04-2005,948169,Bihar,1,6,22,2,31,Pass
Kunal Sharma,12-03-2006,493935,Uttar Pradesh,21,5,23,19,68,Pass
Rohan Khan,24-04-2006,372908,Rajasthan,8,17,19,1,45,Pass
Mathew Pillai,14-03-2006,942783,Uttar Pradesh,16,5,21,9,51,Pass
Ishaan Reddy,20-05-2005,186780,Kerala,19,16,17,2,54,Pass
Rohan Pillai,01-11-2005,124686,Goa,5,18,13,4,40,Pass
Raj Verma,19-02-2005,369018,Gujarat,15,6,0,15,36,Pass
Aditya Reddy,29-11-2004,645122,Karnataka,0,9,16,4,29,Pass
Krishna Fernandes,20-02-2005,598813,Andhra Pradesh,24,14,15,6,59,Pass
Ishaan Fernandes,22-04-2005,448782,Punjab,22,8,16,6,52,Pass
Vivaan Fernandes,21-03-2005,817564,Telangana,22,20,11,2,55,Pass
Balbir Sharma,05-06-2005,568271,Uttar Pradesh,20,5,7,18,50,Pass
Ishaan Sharma,27-02-2005,461419,Bihar,3,10,3,14,30,Pass
Rohan Reddy,22-02-2005,300890,Madhya Pradesh,14,8,12,9,43,Pass
Gurpreet Pillai,18-10-2005,629430,Bihar,6,3,0,18,27,Pass
Harjeet Mehta,31-01-2006,487314,Rajasthan,9,14,8,21,52,Pass
Aditya Verma,05-01-2005,659629,Karnataka,0,24,20,1,45,Pass
Sukhwinder D'Souza,15-01-2006,471217,Uttar Pradesh,1,5,16,13,35,Pass
Raj Chopra,04-11-2005,930178,Uttar Pradesh,23,5,15,0,43,Pass
Aryan Verma,29-08-2005,617704,Punjab,2,3,6,12,23,Pass
Balbir Chopra,19-04-2005,883628,Telangana,8,3,12,11,34,Pass
Yash Reddy,21-04-2005,640449,Maharashtra,16,4,18,3,41,Pass
Krishna Verma,16-11-2005,907716,Madhya Pradesh,1,24,23,12,60,Pass
Aditya Chopra,18-06-2005,835998,Odisha,3,21,18,11,53,Pass
Peter Singh,23-12-2005,164257,Jammu & Kashmir + Ladakh,11,23,20,2,56,Pass
Yash Singh,02-03-2006,153428,Uttar Pradesh,23,5,7,0,35,Pass
Krishna Pillai,07-11-2005,985750,Karnataka,20,18,20,4,62,Pass
Gurpreet Sharma,12-05-2005,763123,Assam,8,4,9,20,41,Pass
Aarav Sharma,19-06-2005,847304,Bihar,9,2,8,20,39,Pass
Kunal Chopra,01-02-2006,994965,Rajasthan,7,7,8,18,40,Pass
Rohan Fernandes,30-10-2005,519920,Madhya Pradesh,22,4,11,13,50,Pass
Krishna Reddy,17-02-2005,740211,Punjab,3,16,22,19,60,Pass
Vivaan Sharma,27-10-2005,811701,Gujarat,5,15,0,6,26,Pass
Mathew Verma,04-04-2006,288632,Andhra Pradesh,1,5,14,23,43,Pass
Kunal Fernandes,15-06-2005,519294,Andhra Pradesh,8,15,0,11,34,Pass
Rohan D'Souza,20-03-2005,447082,Uttarakhand,3,8,7,17,35,Pass
Aditya Fernandes,27-07-2005,874421,Karnataka,12,15,2,0,29,Pass
Kunal D'Souza,22-12-2005,845908,Uttar Pradesh,5,5,22,9,41,Pass
John Reddy,02-03-2006,937187,Uttar Pradesh,20,5,14,3,42,Pass
Harjeet Verma,21-06-2005,407456,Assam,0,7,18,15,40,Pass
Raj Singh,13-11-2004,440246,Karnataka,1,24,18,6,49,Pass
Aditya Verma,20-09-2005,551965,Maharashtra,3,8,13,15,39,Pass
Kunal Mehta,19-12-2004,285779,Chhattisgarh,15,1,22,2,40,Pass
Ishaan Sharma,29-03-2006,876592,Bihar,14,15,8,23,60,Pass
Harjeet Reddy,12-06-2005,762608,Haryana,7,12,17,8,44,Pass
Aryan Khan,19-02-2005,436171,Kerala,4,15,24,10,53,Pass
Rohan Khan,20-12-2004,575368,Uttar Pradesh,2,5,3,9,19,Pass
Paul Verma,27-10-2005,974202,Odisha,12,3,21,7,43,Pass
Rohan Chopra,20-07-2005,480643,Uttar Pradesh,18,5,2,17,42,Pass
Ishaan D'Souza,22-03-2005,224720,Odisha,3,0,7,5,15,Pass
Manpreet Khan,01-01-2005,948633,Bihar,22,16,12,10,60,Pass
Rohan Reddy,09-03-2005,848672,Karnataka,22,8,3,12,45,Pass
Krishna Reddy,13-05-2005,769444,Punjab,13,3,17,10,43,Pass
Farhan D'Souza,31-01-2005,941115,Kerala,9,1,2,8,20,Pass
Krishna Mehta,14-07-2005,274240,Punjab,10,3,24,21,58,Pass
Gurpreet Verma,17-08-2005,861220,Madhya Pradesh,1,3,21,24,49,Pass
Krishna Pillai,27-09-2005,368458,Telangana,14,7,15,7,43,Pass
Ishaan Pillai,25-08-2005,713632,Telangana,4,7,20,11,42,Pass
Krishna D'Souza,21-10-2005,838839,Tamil Nadu,6,4,24,23,57,Pass
Harjeet Singh,21-07-2005,738156,Haryana,7,19,8,5,39,Pass
Sukhwinder D'Souza,26-03-2006,837134,Maharashtra,6,1,6,1,14,Pass
Rehan Verma,26-02-2005,393607,Maharashtra,3,15,23,3,44,Pass
Paul Chopra,06-09-2005,106411,Odisha,24,13,3,3,43,Pass
Raj Verma,23-02-2006,408787,Kerala,7,24,17,1,49,Pass
Aarav Singh,01-03-2005,667747,West Bengal,18,11,15,8,52,Pass
Balbir Pillai,24-12-2004,543884,Bihar,12,15,20,21,68,Pass
Vivaan Pillai,06-01-2006,908390,Punjab,9,3,17,15,44,Pass
Vivaan Sharma,08-08-2005,672524,Bihar,22,13,10,12,57,Pass
Ishaan Verma,24-04-2005,324527,Andhra Pradesh,14,12,4,12,42,Pass
Balbir Sharma,28-03-2005,361086,West Bengal,3,20,21,6,50,Pass
Ishaan Verma,20-11-2004,187721,Himachal Pradesh,0,8,18,3,29,Pass
Ishaan Singh,11-02-2006,643544,Kerala,4,22,17,20,63,Pass
Aryan Chopra,14-04-2006,831079,Tamil Nadu,4,23,13,7,47,Pass
Ishaan Reddy,13-01-2006,638022,West Bengal,3,23,4,14,44,Pass
Aryan Pillai,17-01-2005,742153,Punjab,23,5,3,24,55,Pass
Aditya Reddy,21-04-2005,647201,Puducherry,24,17,5,6,52,Pass
Vivaan Verma,06-04-2006,312251,Assam,1,3,2,19,25,Pass
Aryan Mehta,20-01-2006,614606,Chhattisgarh,14,14,9,24,61,Pass
Krishna Chopra,18-03-2005,964332,Uttar Pradesh,10,5,17,6,38,Pass
Harjeet Verma,19-04-2005,776768,Bihar,12,17,9,0,38,Pass
Yash Singh,18-03-2006,186826,Uttar Pradesh,5,5,1,24,35,Pass
Balbir Sharma,19-12-2005,454480,Bihar,19,7,22,23,71,Pass
Krishna Pillai,21-08-2005,150597,Uttar Pradesh,3,5,21,19,48,Pass
Aryan Chopra,29-11-2005,544959,Tamil Nadu,1,4,5,21,31,Pass
Kunal Singh,07-11-2004,463149,Rajasthan,20,17,13,18,68,Pass
Rohan Reddy,04-06-2005,247571,Rajasthan,16,5,8,20,49,Pass
Aditya Verma,17-06-2005,906317,West Bengal,10,21,12,3,46,Pass
Vivaan Mehta,05-10-2005,344942,Uttar Pradesh,4,5,7,10,26,Pass
Yash Mehta,06-11-2005,345883,Jammu & Kashmir + Ladakh,4,18,15,14,51,Pass
Yash Mehta,10-01-2005,674556,Haryana,1,21,16,6,44,Pass
Vivaan Singh,05-10-2005,516003,Rajasthan,9,11,1,15,36,Pass
Krishna Verma,13-03-2005,171252,Tamil Nadu,9,0,17,8,34,Pass
David Reddy,10-04-2005,965170,Chhattisgarh,21,13,24,9,67,Pass
Aryan Mehta,27-12-2004,408620,Maharashtra,3,16,6,16,41,Pass
Aditya Chopra,15-12-2005,376294,Telangana,10,1,8,0,19,Pass
Aditya Reddy,28-01-2005,858768,Andaman & Nicobar,25,24,18,13,80,Fail
Kunal D'Souza,08-12-2004,567417,Bihar,0,21,18,21,60,Pass
Aditya Fernandes,03-01-2005,424690,Maharashtra,19,3,9,4,35,Pass
Aditya Chopra,30-05-2005,460559,Uttar Pradesh,3,5,18,19,45,Pass
Balbir D'Souza,13-07-2005,578019,Kerala,18,7,19,13,57,Pass
Krishna Fernandes,04-10-2005,223296,Tamil Nadu,4,7,21,17,49,Pass
Raj Khan,01-02-2005,997740,Punjab,11,13,22,3,49,Pass
Balbir Singh,15-03-2006,457397,West Bengal,3,23,15,7,48,Pass
Gurpreet Pillai,04-03-2006,348671,Maharashtra,3,20,11,20,54,Pass
Rohan Fernandes,23-02-2005,999133,Chhattisgarh,12,10,12,0,34,Pass
Harjeet Chopra,03-05-2006,241179,Karnataka,16,11,10,16,53,Pass
Kunal Verma,11-08-2005,980490,Assam,9,13,20,20,62,Pass
David Mehta,17-04-2005,132016,Rajasthan,3,18,3,3,27,Pass
Manpreet Singh,10-03-2005,840954,Odisha,2,15,13,13,43,Pass
David Pillai,30-11-2005,738153,West Bengal,8,2,14,22,46,Pass
Zaid Khan,08-02-2005,361823,Uttar Pradesh,9,5,10,0,24,Pass
Vivaan Singh,19-11-2004,201966,Uttar Pradesh,19,5,0,9,33,Pass
Mathew Singh,29-11-2004,588086,Uttar Pradesh,0,5,12,0,17,Pass
Peter Singh,18-07-2005,628173,Punjab,2,1,20,13,36,Pass
Aarav Chopra,29-12-2005,514933,Uttar Pradesh,13,5,19,12,49,Pass
Peter Mehta,12-11-2005,978591,Assam,6,20,3,8,37,Pass
Vivaan Mehta,14-07-2005,885648,Uttar Pradesh,5,5,17,7,34,Pass
Kunal Sharma,19-12-2004,125020,Gujarat,7,0,0,13,20,Pass
Peter Chopra,21-09-2005,907124,Telangana,5,13,4,2,24,Pass
Raj Fernandes,06-01-2005,701779,Uttar Pradesh,10,5,11,5,31,Pass
Yash Reddy,08-03-2005,768532,Arunachal Pradesh,0,4,0,6,10,Pass
Krishna Sharma,10-02-2006,297489,Madhya Pradesh,10,10,13,17,50,Pass
Aarav Khan,20-04-2005,163610,Rajasthan,13,7,11,6,37,Pass
Vivaan Chopra,24-09-2005,807654,Manipur,7,14,15,6,42,Pass
Ayaan Verma,28-05-2005,603584,Rajasthan,23,0,9,20,52,Pass
Aarav Fernandes,19-03-2005,164281,West Bengal,6,18,16,14,54,Pass
Kunal Khan,25-04-2005,418973,Telangana,13,5,23,1,42,Pass
Aarav Reddy,26-08-2005,273107,Punjab,15,9,3,18,45,Pass
Imran D'Souza,02-12-2005,167333,Madhya Pradesh,14,11,8,5,38,Pass
Krishna Mehta,10-09-2005,286781,Jharkhand,7,8,9,8,32,Pass
Krishna D'Souza,08-04-2005,690280,Telangana,2,16,8,7,33,Pass
Krishna D'Souza,30-04-2005,113262,Daman & Diu / D&N Haveli,5,9,18,6,38,Pass
Harjeet Singh,01-09-2005,623694,West Bengal,0,24,1,3,28,Pass
Aryan Chopra,06-09-2005,874570,Andhra Pradesh,11,24,1,8,44,Pass
Balbir Singh,04-11-2005,317882,Himachal Pradesh,22,9,4,11,46,Pass
Vivaan Singh,25-11-2004,579118,West Bengal,8,8,14,7,37,Pass
Yash Chopra,23-06-2005,708584,Telangana,21,10,22,3,56,Pass
Yash Mehta,05-09-2005,896445,Madhya Pradesh,1,23,22,24,70,Pass
Ishaan Singh,17-06-2005,484690,Andaman & Nicobar,10,7,2,7,26,Pass
John D'Souza,22-03-2006,379206,West Bengal,10,11,10,20,51,Pass
Raj D'Souza,20-06-2005,276711,Assam,2,0,14,15,31,Pass
Aarav Singh,03-05-2005,864387,Maharashtra,13,5,10,19,47,Pass
Harjeet Fernandes,04-03-2005,357080,West Bengal,3,23,14,23,63,Pass
Aarav Verma,01-06-2005,263535,Haryana,15,1,21,0,37,Pass
Gurpreet Sharma,03-02-2005,386457,Punjab,8,19,8,9,44,Pass
Rohan D'Souza,24-06-2005,375966,Haryana,6,22,9,19,56,Pass
Ishaan D'Souza,02-05-2005,205358,Assam,19,10,22,0,51,Pass
Gurpreet Mehta,06-05-2005,277139,Uttar Pradesh,3,5,20,23,51,Pass
Raj Khan,15-01-2006,102497,Uttar Pradesh,6,5,4,5,20,Pass
Krishna Verma,12-04-2006,527940,Rajasthan,5,9,7,15,36,Pass
Aditya Mehta,06-12-2004,787809,Madhya Pradesh,1,24,9,16,50,Pass
Manpreet Singh,15-12-2005,201083,Punjab,7,12,1,10,30,Pass
John Sharma,22-01-2006,432678,Rajasthan,15,12,24,13,64,Pass
Aditya Mehta,29-03-2005,144661,Rajasthan,4,21,10,21,56,Pass
Aryan Pillai,25-02-2006,769096,Rajasthan,12,2,3,16,33,Pass
Aarav Khan,20-08-2005,317074,Punjab,17,3,14,9,43,Pass
Krishna Khan,07-02-2005,401653,Rajasthan,3,8,22,8,41,Pass
Yash Verma,02-04-2005,134184,Uttar Pradesh,3,5,24,21,53,Pass
John Singh,25-01-2005,588289,Maharashtra,13,2,4,13,32,Pass
John Sharma,01-01-2006,209186,Assam,9,8,4,22,43,Pass
Krishna Fernandes,04-01-2005,209846,Andhra Pradesh,9,23,10,3,45,Pass
Ishaan Sharma,06-09-2005,466467,Madhya Pradesh,2,6,24,11,43,Pass
Aryan D'Souza,17-06-2005,882247,Uttar Pradesh,12,5,5,19,41,Pass
Paul Fernandes,18-12-2004,210573,Kerala,6,3,2,14,25,Pass
Manpreet Reddy,06-02-2005,684764,Madhya Pradesh,19,8,8,4,39,Pass
Raj Verma,14-01-2006,765179,Uttarakhand,14,5,21,2,42,Pass
Ishaan Mehta,08-02-2006,881978,Delhi,17,3,14,3,37,Fail
Aditya Pillai,16-11-2005,146796,Karnataka,16,5,13,14,48,Pass
Krishna Mehta,24-07-2005,358919,Punjab,11,15,13,16,55,Pass
Ishaan Chopra,22-12-2005,328412,Telangana,19,21,22,3,65,Pass
Yash Khan,11-01-2006,529179,Andhra Pradesh,20,7,19,11,57,Pass
Ayaan Verma,12-03-2006,124864,Puducherry,15,7,6,3,31,Pass
Mathew Mehta,04-01-2006,870564,Rajasthan,16,5,12,17,50,Pass
Aditya D'Souza,05-12-2004,739013,Jammu & Kashmir + Ladakh,15,7,19,18,59,Pass
Aarav Chopra,30-07-2005,424330,Karnataka,12,18,3,24,57,Pass
Harjeet Mehta,28-01-2005,399930,Meghalaya,1,13,12,17,43,Pass
Kunal Singh,03-05-2005,849507,Punjab,3,24,16,12,55,Pass
Kunal Reddy,06-05-2006,348103,Goa,7,13,8,6,34,Pass
Raj Verma,08-06-2005,458353,Jharkhand,5,4,16,23,48,Pass
Manpreet D'Souza,25-06-2005,947305,West Bengal,3,18,12,21,54,Pass
Vivaan Pillai,18-04-2005,538768,Rajasthan,21,4,0,20,45,Pass
Sukhwinder Chopra,17-07-2005,973146,Maharashtra,3,18,21,19,61,Pass
Aryan Singh,16-03-2006,333656,Karnataka,2,20,12,3,37,Pass
Vivaan Reddy,24-11-2005,674453,Maharashtra,8,12,18,5,43,Pass
Ishaan Pillai,14-02-2006,160313,Assam,9,5,1,22,37,Pass
Kunal D'Souza,01-08-2005,459917,Andhra Pradesh,4,8,7,2,21,Pass
Aarav Reddy,26-12-2004,545391,Punjab,5,23,8,6,42,Pass
Aarav Mehta,07-08-2005,220523,Uttar Pradesh,2,5,0,19,26,Pass
Yash Sharma,21-08-2005,526393,Gujarat,15,7,9,24,55,Pass
Mathew Fernandes,10-10-2005,249811,Haryana,17,22,17,17,73,Pass
Rohan Mehta,14-05-2005,826699,Chhattisgarh,23,17,4,22,66,Pass
Raj D'Souza,30-12-2004,476974,Uttar Pradesh,19,5,3,10,37,Pass
Vivaan Verma,16-09-2005,666653,Andhra Pradesh,19,20,17,8,64,Pass
Ishaan Mehta,16-12-2004,191647,Bihar,20,14,20,5,59,Pass
Aarav D'Souza,17-06-2005,149869,Haryana,16,14,3,9,42,Pass
Ishaan D'Souza,03-03-2005,929150,Rajasthan,19,20,3,7,49,Pass
Aarav Singh,29-03-2005,710870,Haryana,0,20,19,24,63,Pass
Aarav Khan,08-03-2005,985555,Telangana,1,3,20,6,30,Pass
Yash Fernandes,12-10-2005,774791,Madhya Pradesh,7,22,16,7,52,Pass
Aryan Sharma,15-04-2005,918528,Maharashtra,13,3,6,23,45,Pass
Farhan Khan,22-07-2005,788838,Rajasthan,4,7,20,10,41,Pass
Peter Verma,06-08-2005,919850,Rajasthan,18,15,9,19,61,Pass
Aryan Pillai,30-10-2005,289067,Rajasthan,10,7,20,10,47,Pass
Raj Sharma,23-07-2005,943638,Punjab,5,11,5,12,33,Pass
Balbir Verma,22-03-2006,710393,Uttar Pradesh,17,5,23,16,61,Pass
Krishna Chopra,30-05-2005,678345,Kerala,12,23,15,0,50,Pass
Krishna Verma,29-09-2005,542233,West Bengal,18,3,13,19,53,Pass
Harjeet Singh,20-12-2004,185285,West Bengal,3,8,18,17,46,Pass
Vivaan Pillai,14-04-2006,189120,Bihar,2,11,9,16,38,Pass
Aarav Reddy,06-06-2005,532897,Uttar Pradesh,10,5,24,0,39,Pass
Rohan Fernandes,03-04-2006,931221,Rajasthan,12,24,1,19,56,Pass
Aryan Chopra,16-01-2006,953372,Madhya Pradesh,10,17,20,7,54,Pass
Rohan Chopra,10-02-2006,467880,Chhattisgarh,7,2,1,2,12,Pass
Kunal Pillai,19-01-2006,496690,Uttar Pradesh,19,5,1,16,41,Pass
Peter Verma,31-03-2005,980098,Haryana,23,9,9,16,57,Pass
David Singh,16-02-2006,422099,Rajasthan,7,17,4,5,33,Pass
Gurpreet Sharma,26-04-2006,850694,Himachal Pradesh,11,22,20,14,67,Pass
Farhan Pillai,15-11-2004,422633,Tripura,13,1,23,10,47,Pass
Balbir D'Souza,10-12-2004,746691,Uttar Pradesh,21,5,17,13,56,Pass
Rehan Singh,31-12-2005,526936,Jharkhand,5,20,15,17,57,Pass
Manpreet Sharma,25-06-2005,940245,Uttar Pradesh,20,5,4,8,37,Pass
Aryan Mehta,01-02-2006,413984,Maharashtra,1,11,23,14,49,Pass
Aarav Sharma,19-10-2005,557188,Goa,11,16,4,7,38,Pass
Kunal Singh,02-01-2006,946021,Arunachal Pradesh,18,16,2,3,39,Pass
Aditya Verma,01-01-2005,240791,Haryana,9,17,12,7,45,Pass
Yash Mehta,22-03-2006,439770,Odisha,17,6,15,3,41,Pass
Gurpreet Mehta,15-11-2005,397769,Uttar Pradesh,17,5,6,21,49,Pass
John Khan,24-12-2004,842809,Karnataka,14,21,7,24,66,Pass
Raj Mehta,24-01-2006,699656,Punjab,16,13,1,6,36,Pass
Krishna Verma,07-02-2006,486825,Jharkhand,7,8,14,20,49,Pass
Krishna Pillai,06-04-2006,699139,Maharashtra,3,10,13,18,44,Pass
Ayaan D'Souza,01-05-2005,970450,Haryana,11,7,15,1,34,Pass
Raj Chopra,19-01-2005,116883,Meghalaya,3,6,7,22,38,Pass
Sukhwinder Khan,06-09-2005,214966,Himachal Pradesh,19,1,6,7,33,Pass
Paul Fernandes,05-09-2005,450262,Rajasthan,1,4,15,19,39,Pass
Krishna Chopra,28-06-2005,121950,Bihar,24,1,15,7,47,Pass
Raj Reddy,08-03-2005,806787,Punjab,9,7,19,15,50,Pass
Aryan Sharma,04-07-2005,728052,Bihar,4,8,7,11,30,Pass
Yash Chopra,16-12-2005,817019,Gujarat,7,9,22,18,56,Pass
Aditya Chopra,24-01-2006,816838,Bihar,4,18,18,12,52,Pass
Harjeet Mehta,04-12-2005,764974,Odisha,12,12,7,11,42,Pass
Kunal Mehta,30-04-2006,367775,Odisha,6,7,7,16,36,Pass
Aditya Reddy,21-08-2005,302670,Odisha,1,17,10,24,52,Pass
Aarav Verma,10-06-2005,313833,Andhra Pradesh,15,7,14,16,52,Pass
Aditya Verma,12-04-2006,505136,Uttar Pradesh,12,5,18,4,39,Pass
Manpreet Verma,14-06-2005,881901,Madhya Pradesh,24,21,0,4,49,Pass
Aryan Fernandes,25-02-2006,293719,Uttar Pradesh,15,5,11,7,38,Pass
Harjeet Verma,01-02-2006,429828,Rajasthan,12,13,4,2,31,Pass
Aarav D'Souza,04-09-2005,231642,Haryana,22,1,20,7,50,Pass
Aditya Chopra,27-10-2005,774394,Madhya Pradesh,22,11,1,4,38,Pass
Aditya Verma,26-05-2005,116392,Punjab,2,5,0,13,20,Pass
Rohan Singh,17-03-2005,267915,Madhya Pradesh,13,2,11,14,40,Pass
Raj Sharma,20-06-2005,846455,Bihar,10,11,9,5,35,Pass
Ishaan D'Souza,04-02-2006,845509,Jharkhand,3,21,3,23,50,Pass
Harjeet D'Souza,12-04-2006,332538,Gujarat,24,6,20,11,61,Pass
Aditya Mehta,18-03-2005,154785,Punjab,11,18,12,5,46,Pass
Yash Reddy,07-12-2005,224221,West Bengal,3,15,16,16,50,Pass
Aarav Singh,23-03-2005,325078,Tamil Nadu,15,20,9,0,44,Pass
Yash Pillai,10-03-2006,776284,Madhya Pradesh,1,9,24,20,54,Pass
Vivaan Fernandes,08-12-2004,552175,Uttar Pradesh,18,5,16,14,53,Pass
Aarav D'Souza,16-08-2005,832145,Haryana,4,11,0,9,24,Pass
Krishna Verma,12-11-2005,229658,Madhya Pradesh,4,24,5,16,49,Pass
Aryan Fernandes,22-08-2005,135851,Madhya Pradesh,1,13,2,19,35,Pass
Ishaan Singh,18-08-2005,931313,Haryana,7,23,18,18,66,Pass
Kunal Sharma,26-09-2005,727990,Rajasthan,3,17,2,13,35,Pass
Mathew Mehta,19-07-2005,895265,Uttar Pradesh,0,5,6,10,21,Pass
Vivaan Fernandes,26-07-2005,984836,Assam,9,11,8,17,45,Pass
Harjeet Mehta,14-10-2005,341836,Bihar,14,1,19,3,37,Pass
Rohan D'Souza,23-12-2004,524446,Jharkhand,9,15,12,2,38,Pass
Vivaan Mehta,11-02-2006,285239,Maharashtra,3,7,13,20,43,Pass
David Pillai,24-08-2005,365326,Bihar,3,0,16,18,37,Pass
John Khan,24-12-2004,258916,Uttarakhand,1,10,4,1,16,Pass
Ishaan Reddy,25-01-2005,306358,Madhya Pradesh,18,9,24,0,51,Pass
Aryan Pillai,19-06-2005,274008,Bihar,20,18,3,23,64,Pass
Kunal Reddy,19-12-2004,795404,Kerala,20,23,7,11,61,Pass
Paul Mehta,28-07-2005,791757,Madhya Pradesh,14,9,11,16,50,Pass
Kunal Pillai,29-12-2005,812594,Maharashtra,3,23,18,9,53,Pass
Harjeet Chopra,07-01-2005,778375,Madhya Pradesh,11,6,5,20,42,Pass
Aarav Pillai,21-01-2005,830728,Madhya Pradesh,10,9,14,10,43,Pass
Krishna D'Souza,06-10-2005,148448,Bihar,3,14,17,5,39,Pass
Ishaan Pillai,24-04-2006,920295,Rajasthan,2,0,22,0,24,Pass
Vivaan Fernandes,13-12-2005,412021,Chhattisgarh,18,14,14,15,61,Pass
Kunal Fernandes,11-12-2004,881374,Chhattisgarh,17,11,14,14,56,Pass
Gurpreet Reddy,30-01-2006,747188,Bihar,12,6,3,14,35,Pass
Raj Pillai,01-05-2006,458067,Uttar Pradesh,1,5,12,1,19,Pass
Rohan Chopra,29-01-2006,407181,West Bengal,3,0,22,22,47,Pass
Ishaan Pillai,13-08-2005,152133,Rajasthan,22,0,11,15,48,Pass
Raj Reddy,15-01-2005,240641,Andhra Pradesh,16,22,22,1,61,Pass
Paul Pillai,20-09-2005,518585,Maharashtra,4,0,2,16,22,Pass
Yash Pillai,04-08-2005,175115,Rajasthan,15,16,14,21,66,Pass
Aryan D'Souza,24-01-2006,430157,Rajasthan,23,23,9,19,74,Pass
Ayaan Khan,21-05-2005,927834,Haryana,21,4,10,24,59,Pass
Aditya D'Souza,13-08-2005,245987,Bihar,23,8,12,19,62,Pass
Vivaan Reddy,23-06-2005,470735,Tamil Nadu,9,14,20,5,48,Pass
Vivaan Verma,01-05-2006,523525,Madhya Pradesh,11,8,9,3,31,Pass
Krishna Sharma,17-08-2005,525683,Uttar Pradesh,2,5,15,20,42,Pass
Balbir Pillai,23-04-2005,981647,Tamil Nadu,7,4,17,18,46,Pass
Ishaan Khan,25-03-2006,676470,Haryana,17,12,0,19,48,Pass
Ishaan D'Souza,04-05-2006,817675,Madhya Pradesh,1,1,23,24,49,Pass
Vivaan Pillai,17-11-2004,848926,Uttar Pradesh,9,5,22,7,43,Pass
Vivaan Pillai,26-02-2006,820817,Madhya Pradesh,11,0,1,10,22,Pass
Krishna Singh,07-07-2005,314489,Jammu & Kashmir + Ladakh,4,20,11,9,44,Pass
Aryan Sharma,22-01-2006,707658,Madhya Pradesh,1,7,12,19,39,Pass
Ishaan Fernandes,01-05-2005,818620,Bihar,16,3,13,4,36,Pass
Balbir Pillai,04-03-2005,658192,Jharkhand,4,20,3,1,28,Pass
Aditya Mehta,05-08-2005,258906,Gujarat,24,17,17,15,73,Pass
Balbir Chopra,22-10-2005,880853,Haryana,24,22,3,13,62,Pass
Ishaan D'Souza,21-11-2005,785815,Gujarat,15,7,9,2,33,Pass
Paul D'Souza,01-01-2006,298061,Jammu & Kashmir + Ladakh,22,12,2,22,58,Pass
Aditya Fernandes,11-04-2006,960679,Jammu & Kashmir + Ladakh,17,12,17,11,57,Pass
Aryan D'Souza,18-09-2005,143570,Punjab,16,3,24,13,56,Pass
Aarav Khan,17-09-2005,925206,Uttar Pradesh,23,5,4,9,41,Pass
Krishna Fernandes,06-06-2005,992535,Rajasthan,6,11,24,20,61,Pass
Rohan D'Souza,26-12-2005,921912,Maharashtra,14,1,13,11,39,Pass
Aditya Fernandes,17-01-2006,711668,Tamil Nadu,2,6,0,4,12,Pass
Raj Pillai,24-07-2005,137355,Chhattisgarh,9,16,11,5,41,Pass
Krishna D'Souza,25-02-2005,383192,Maharashtra,3,22,3,3,31,Pass
Ishaan Mehta,14-05-2005,717590,Uttar Pradesh,23,5,1,14,43,Pass
Raj Sharma,11-02-2005,726934,Punjab,14,21,6,13,54,Pass
Kunal Verma,11-01-2005,578473,Tamil Nadu,18,6,1,23,48,Pass
Rohan Sharma,14-12-2004,969222,Karnataka,12,11,3,2,28,Pass
Kunal Reddy,22-11-2004,880685,Himachal Pradesh,5,5,8,11,29,Pass
Vivaan Pillai,09-11-2005,672412,Uttar Pradesh,8,5,12,0,25,Pass
Sukhwinder Reddy,11-08-2005,823487,Uttarakhand,10,7,11,2,30,Pass
Yash Chopra,17-06-2005,324126,West Bengal,0,0,19,1,20,Pass
Yash Singh,03-09-2005,891224,Sikkim,5,11,0,8,24,Pass
Ishaan Pillai,27-06-2005,863302,Chhattisgarh,22,0,14,22,58,Pass
David Sharma,11-03-2006,559490,Maharashtra,1,16,12,19,48,Pass
Imran Sharma,01-05-2006,760665,Uttar Pradesh,0,5,4,3,12,Pass
Vivaan Fernandes,27-06-2005,899284,Haryana,2,5,22,13,42,Pass
Ishaan Singh,19-10-2005,293976,Bihar,6,18,12,1,37,Pass
Aarav D'Souza,13-06-2005,362581,Uttar Pradesh,20,5,22,1,48,Pass
Kunal Chopra,19-05-2005,972580,Maharashtra,3,23,0,18,44,Pass
Aarav Mehta,12-01-2005,261703,Maharashtra,9,5,22,2,38,Pass
Yash Mehta,09-07-2005,673578,Punjab,11,23,2,23,59,Pass
Rohan Fernandes,13-09-2005,194370,Haryana,0,17,19,15,51,Pass
Aarav Chopra,16-09-2005,886901,Uttar Pradesh,3,5,21,13,42,Pass
Aryan Verma,19-03-2006,382344,Gujarat,2,14,20,6,42,Pass
Rohan Khan,13-01-2005,611528,Bihar,13,13,2,12,40,Pass
Vivaan Reddy,21-07-2005,564587,Haryana,12,20,2,3,37,Pass
Gurpreet Sharma,29-10-2005,608457,Assam,10,2,20,6,38,Pass
Raj Reddy,09-01-2006,574105,Maharashtra,3,6,24,14,47,Pass
Manpreet Pillai,15-02-2006,699992,Uttarakhand,18,1,8,11,38,Pass
Vivaan Mehta,15-12-2004,966487,West Bengal,11,4,22,1,38,Pass
John Reddy,24-09-2005,530584,Bihar,5,17,18,1,41,Pass
Kunal Reddy,24-01-2006,149895,Kerala,9,1,20,12,42,Pass
Krishna Sharma,20-07-2005,690212,Madhya Pradesh,7,14,10,10,41,Pass
Rohan Mehta,18-02-2006,840801,Jammu & Kashmir + Ladakh,23,11,15,17,66,Pass
Sukhwinder Sharma,19-09-2005,561568,Bihar,15,15,0,8,38,Pass
Ayaan Reddy,24-02-2006,533558,Delhi,14,17,17,4,52,Fail
Kunal Reddy,12-02-2006,866924,Assam,3,11,9,18,41,Pass
Rohan Verma,26-01-2005,572844,Assam,3,19,23,15,60,Pass
Kunal Reddy,21-04-2006,444793,Madhya Pradesh,18,5,1,7,31,Pass
Krishna Reddy,21-11-2004,229023,Madhya Pradesh,24,1,3,12,40,Pass
Raj Singh,08-10-2005,695233,Rajasthan,9,15,3,12,39,Pass
David Verma,10-02-2005,759539,Rajasthan,4,5,4,19,32,Pass
Vivaan Reddy,25-10-2005,953777,Tamil Nadu,5,3,24,19,51,Pass
Mathew Fernandes,08-03-2006,420445,Maharashtra,3,18,1,11,33,Pass
Ishaan D'Souza,13-01-2006,899137,Punjab,24,11,3,7,45,Pass
Balbir D'Souza,18-04-2005,379089,Rajasthan,15,14,14,7,50,Pass
Aryan Pillai,12-01-2006,862599,Karnataka,15,8,12,19,54,Pass
Rohan Khan,07-02-2005,174745,Haryana,22,6,11,2,41,Pass
Raj Chopra,03-01-2006,496900,Punjab,4,22,15,18,59,Pass
Sukhwinder Chopra,23-12-2004,555641,Andhra Pradesh,23,18,6,12,59,Pass
Vivaan Fernandes,13-11-2004,205192,Rajasthan,6,6,12,1,25,Pass
Rohan Fernandes,11-02-2005,179633,Uttar Pradesh,16,5,7,16,44,Pass
Ishaan Chopra,16-01-2006,853980,Maharashtra,3,6,17,20,46,Pass
Krishna Mehta,09-04-2005,238217,Maharashtra,3,18,15,7,43,Pass
Aarav D'Souza,15-10-2005,676223,West Bengal,0,6,4,22,32,Pass
Gurpreet Singh,20-11-2004,658932,Uttarakhand,8,16,2,12,38,Pass
Gurpreet Verma,24-12-2004,966948,Uttar Pradesh,11,5,4,16,36,Pass
Yash Mehta,18-02-2005,220251,Uttar Pradesh,18,5,10,1,34,Pass
Balbir Fernandes,03-12-2004,355668,Tamil Nadu,23,18,17,22,80,Pass
Aarav Reddy,16-09-2005,715357,Maharashtra,3,14,14,23,54,Pass
Yash Singh,18-01-2006,442446,Assam,7,7,12,7,33,Pass
Balbir Verma,27-11-2004,165852,Punjab,21,3,24,3,51,Pass
Yash Pillai,22-06-2005,956518,Chhattisgarh,0,3,24,19,46,Pass
Raj Khan,11-04-2005,766753,Bihar,10,20,24,9,63,Pass
Aryan Pillai,15-01-2005,422859,Maharashtra,9,11,2,18,40,Pass
Ishaan D'Souza,03-02-2006,603274,Punjab,6,9,24,5,44,Pass
Kunal Khan,29-03-2005,199221,Uttar Pradesh,6,5,14,9,34,Pass
Rohan Reddy,24-12-2004,136096,Uttar Pradesh,20,5,8,5,38,Pass
Balbir Pillai,24-12-2005,979078,Bihar,1,8,17,3,29,Pass
David Verma,18-02-2006,830260,Punjab,13,8,14,19,54,Pass
Aditya D'Souza,23-09-2005,193496,Tamil Nadu,18,0,3,1,22,Pass
Aarav Verma,07-07-2005,441883,Jharkhand,7,21,2,24,54,Pass
Aarav Pillai,23-06-2005,809220,Kerala,2,22,16,21,61,Pass
Harjeet Pillai,10-08-2005,498122,Uttar Pradesh,2,5,20,5,32,Pass
Imran Singh,05-11-2005,364934,Karnataka,8,0,9,2,19,Pass
Rohan Khan,09-06-2005,916696,Bihar,7,1,24,19,51,Pass
Kunal Chopra,20-04-2005,838151,Maharashtra,3,22,21,16,62,Pass
Manpreet D'Souza,13-04-2006,565589,Punjab,15,9,1,13,38,Pass
Balbir Khan,01-10-2005,781122,West Bengal,1,17,19,6,43,Pass
Farhan Fernandes,14-03-2005,312532,West Bengal,24,15,4,1,44,Pass
Rohan Mehta,04-06-2005,322059,Uttar Pradesh,19,5,18,8,50,Pass
Balbir Fernandes,22-02-2005,202834,Assam,9,14,23,2,48,Pass
Manpreet Mehta,23-11-2004,129388,Odisha,0,6,17,6,29,Pass
Yash D'Souza,03-02-2006,575059,Rajasthan,22,13,10,0,45,Pass
Ayaan Khan,14-06-2005,617596,West Bengal,8,13,4,6,31,Pass
Aarav Singh,24-12-2005,118353,Punjab,2,14,5,10,31,Pass
Yash Pillai,26-12-2004,231657,Uttar Pradesh,24,5,14,6,49,Pass
Krishna Verma,23-01-2005,642688,Haryana,18,3,13,12,46,Pass
David Sharma,30-03-2006,702160,Chhattisgarh,4,21,12,17,54,Pass
Kunal Reddy,28-11-2004,526173,Odisha,22,2,21,0,45,Pass
Sukhwinder Reddy,29-03-2006,679711,Madhya Pradesh,1,12,24,4,41,Pass
Ishaan Khan,27-04-2006,439578,Maharashtra,16,8,4,2,30,Pass
Balbir Singh,28-04-2006,777641,Bihar,4,3,20,22,49,Pass
Aarav Sharma,20-12-2005,444290,Rajasthan,20,14,19,13,66,Pass
Yash Mehta,16-01-2006,181374,Goa,9,6,6,0,21,Pass
Vivaan Verma,11-01-2006,329633,Uttar Pradesh,22,5,6,4,37,Pass
Krishna Sharma,12-12-2004,972981,Madhya Pradesh,13,8,13,8,42,Pass
Balbir Mehta,24-12-2005,480961,West Bengal,3,21,24,18,66,Pass
Kunal Mehta,27-12-2004,224420,Andhra Pradesh,16,10,24,9,59,Pass
Kunal D'Souza,25-04-2005,259644,Maharashtra,1,10,17,8,36,Pass
Farhan D'Souza,11-06-2005,905807,Tamil Nadu,19,10,7,4,40,Pass
Gurpreet Pillai,16-04-2005,663619,Bihar,20,5,24,0,49,Pass
Krishna Mehta,03-05-2005,395902,Telangana,20,0,10,7,37,Pass
Manpreet D'Souza,02-10-2005,325948,Karnataka,23,21,8,15,67,Pass
Aarav Reddy,04-02-2005,108311,Bihar,23,18,17,22,80,Pass
Aryan Chopra,30-08-2005,889611,Bihar,8,3,15,13,39,Pass
Aarav Khan,05-08-2005,699229,Bihar,4,21,8,20,53,Pass
Aditya D'Souza,29-05-2005,544444,Andhra Pradesh,18,12,5,13,48,Pass
Raj Mehta,26-11-2004,190092,Uttar Pradesh,20,5,0,5,30,Pass
Aarav Verma,15-11-2004,649043,Haryana,5,1,18,10,34,Pass
Paul Verma,21-12-2005,533390,Gujarat,11,12,14,19,56,Pass
Krishna Chopra,26-01-2005,969096,Bihar,4,9,8,22,43,Pass
Yash Sharma,30-03-2005,824724,Daman & Diu / D&N Haveli,8,9,6,8,31,Pass
Ishaan Singh,20-01-2006,826852,Tamil Nadu,23,23,16,18,80,Pass
Aryan Fernandes,21-03-2006,332000,Andhra Pradesh,23,3,6,8,40,Pass
Yash Fernandes,26-02-2005,293327,Jharkhand,7,2,19,12,40,Pass
David Khan,10-03-2005,452806,Punjab,16,18,15,10,59,Pass
Krishna Sharma,30-12-2005,826945,Rajasthan,12,24,21,7,64,Pass
Aditya Singh,14-05-2005,685404,Madhya Pradesh,19,12,15,7,53,Pass
Krishna Fernandes,25-12-2004,484491,Karnataka,12,15,7,15,49,Pass
Kunal Chopra,25-07-2005,253893,Rajasthan,8,6,11,1,26,Pass
Yash D'Souza,13-01-2005,281581,Haryana,22,1,4,14,41,Pass
Raj Chopra,17-01-2006,581815,Gujarat,20,13,14,21,68,Pass
Vivaan Singh,06-10-2005,518108,Gujarat,5,15,21,12,53,Pass
Krishna Reddy,10-06-2005,380378,West Bengal,19,10,18,4,51,Pass
Balbir Reddy,28-07-2005,518827,West Bengal,3,17,12,20,52,Pass
Balbir Verma,01-11-2005,607041,Andhra Pradesh,11,14,2,12,39,Pass
Yash Pillai,25-11-2005,954039,Himachal Pradesh,1,12,24,0,37,Pass
Ayaan Reddy,28-12-2005,410655,Jharkhand,23,24,7,4,58,Pass
Raj D'Souza,28-03-2006,249389,West Bengal,22,10,8,9,49,Pass
Aarav Pillai,08-01-2006,773158,Maharashtra,3,18,21,14,56,Pass
Sukhwinder Fernandes,15-06-2005,256096,Uttar Pradesh,5,5,20,7,37,Pass
Kunal Fernandes,02-02-2006,602352,Assam,6,19,0,9,34,Pass
Rohan Mehta,17-04-2006,667150,Andhra Pradesh,16,12,16,8,52,Pass
Peter Sharma,01-08-2005,243157,Tamil Nadu,21,10,23,23,77,Pass
Raj Sharma,13-12-2005,762427,Odisha,5,24,0,8,37,Pass
Vivaan Verma,17-10-2005,508826,Bihar,18,12,15,6,51,Pass
Zaid Chopra,21-09-2005,329773,West Bengal,3,19,20,11,53,Pass
Balbir Reddy,14-05-2005,512959,Madhya Pradesh,0,24,22,1,47,Pass
Aryan Verma,16-12-2005,133245,Jammu & Kashmir + Ladakh,16,14,8,2,40,Pass
Sukhwinder Verma,29-11-2005,316301,Kerala,2,19,0,23,44,Pass
Mathew Verma,26-06-2005,638574,Telangana,23,9,14,12,58,Pass
John Mehta,16-04-2005,809940,Maharashtra,3,17,17,0,37,Pass
Ayaan Pillai,30-03-2006,658093,Odisha,8,21,19,14,62,Pass
Gurpreet Reddy,23-01-2005,138616,Telangana,2,11,24,11,48,Pass
Kunal Pillai,20-12-2005,806746,Uttar Pradesh,3,5,4,16,28,Pass
Mathew Singh,09-11-2005,448464,Tamil Nadu,23,24,6,16,69,Pass
Ishaan D'Souza,29-12-2004,644735,Uttar Pradesh,9,5,23,22,59,Pass
Aryan Khan,20-01-2005,638465,Uttarakhand,3,13,10,24,50,Pass
Krishna Verma,16-05-2005,885564,Rajasthan,9,15,7,24,55,Pass
Ishaan Pillai,21-06-2005,765947,Andhra Pradesh,15,12,9,1,37,Pass
Sukhwinder D'Souza,25-02-2006,910768,Bihar,20,11,6,9,46,Pass
Aditya Verma,08-01-2006,435798,Tamil Nadu,5,15,12,13,45,Pass
Ishaan Khan,07-06-2005,791728,West Bengal,3,24,8,19,54,Pass
Yash Mehta,30-04-2005,954829,Uttar Pradesh,14,5,24,8,51,Pass
Mathew Verma,22-08-2005,634361,Maharashtra,13,5,0,15,33,Pass
Yash Chopra,19-04-2005,508763,Uttar Pradesh,12,5,22,3,42,Pass
Gurpreet Verma,02-12-2005,824001,Chhattisgarh,11,11,13,13,48,Pass
Ishaan Fernandes,21-03-2005,851937,Rajasthan,9,7,12,24,52,Pass
Vivaan Fernandes,01-03-2005,194043,Maharashtra,3,21,15,15,54,Pass
Ishaan Fernandes,01-09-2005,151585,Rajasthan,20,19,11,14,64,Pass
Ishaan Mehta,11-05-2005,517713,Chhattisgarh,4,3,13,22,42,Pass
Kunal Sharma,01-07-2005,744293,Uttar Pradesh,11,5,9,16,41,Pass
Yash Fernandes,10-04-2006,742482,Odisha,18,21,20,19,78,Pass
Raj Sharma,11-05-2005,124009,Bihar,20,21,15,7,63,Pass
Ishaan Reddy,31-12-2005,780598,Uttar Pradesh,11,5,22,22,60,Pass
Paul Verma,26-05-2005,194414,Haryana,6,21,12,20,59,Pass
Kunal Sharma,15-08-2005,221572,Kerala,1,16,5,23,45,Pass
Kunal D'Souza,21-05-2005,149381,Andhra Pradesh,10,2,12,5,29,Pass
Mathew Fernandes,22-03-2005,438919,Maharashtra,2,23,15,9,49,Pass
Yash Reddy,26-05-2005,560801,Rajasthan,2,21,0,2,25,Pass
Yash Khan,19-04-2005,409943,Madhya Pradesh,10,0,8,11,29,Pass
Aditya Reddy,08-07-2005,829546,Karnataka,2,23,22,17,64,Pass
Gurpreet Chopra,12-10-2005,887212,Maharashtra,3,22,9,20,54,Pass
Ishaan Khan,23-01-2005,846999,Rajasthan,18,6,7,13,44,Pass
Raj Mehta,21-09-2005,382296,Madhya Pradesh,22,17,7,4,50,Pass
Raj Reddy,10-12-2004,432063,Punjab,16,12,13,14,55,Pass
Vivaan Pillai,03-03-2006,327215,Punjab,11,0,21,18,50,Pass
Kunal D'Souza,06-04-2006,825214,Gujarat,7,4,2,15,28,Pass
Aditya Khan,29-05-2005,340134,Rajasthan,9,2,4,20,35,Pass
Aditya Verma,13-04-2005,288011,Uttar Pradesh,18,5,17,16,56,Pass
Vivaan Sharma,12-08-2005,383925,Rajasthan,19,14,6,20,59,Pass
Kunal D'Souza,19-09-2005,619573,Haryana,4,15,14,12,45,Pass
Raj Reddy,05-04-2005,303334,Daman & Diu / D&N Haveli,7,7,7,8,29,Pass
Ishaan Sharma,07-08-2005,722634,Karnataka,3,14,14,22,53,Pass
Aditya Fernandes,03-04-2005,228859,Punjab,10,16,10,21,57,Pass
Vivaan Singh,07-06-2005,267927,Odisha,5,12,19,17,53,Pass
Sukhwinder Fernandes,08-08-2005,164557,Uttar Pradesh,5,5,10,11,31,Pass
Aarav Pillai,30-11-2004,465937,Uttar Pradesh,22,5,0,7,34,Pass
Aditya Verma,15-07-2005,190591,Uttar Pradesh,3,5,15,9,32,Pass
Yash Sharma,26-03-2006,604593,West Bengal,3,24,13,17,57,Pass
Sukhwinder Singh,03-01-2006,118731,Uttarakhand,4,2,8,20,34,Pass
Mathew Mehta,08-05-2006,257451,Tamil Nadu,23,18,6,9,56,Pass
Aditya Sharma,28-08-2005,916011,Gujarat,3,10,4,6,23,Pass
Paul Khan,13-01-2005,381455,Odisha,2,3,12,0,17,Pass
Krishna Pillai,26-11-2005,494560,Haryana,0,8,13,17,38,Pass
Aryan Sharma,16-04-2005,585652,Punjab,3,4,22,6,35,Pass
Zaid Chopra,17-02-2006,790049,West Bengal,12,2,14,7,35,Pass
Rohan Sharma,14-12-2005,830377,Assam,3,8,6,0,17,Pass
Paul Pillai,18-11-2004,266504,Rajasthan,24,22,22,19,87,Pass
Vivaan Chopra,05-10-2005,174351,Rajasthan,7,11,3,13,34,Pass
Kunal Verma,23-02-2006,917327,West Bengal,3,15,15,8,41,Pass
Ishaan D'Souza,17-12-2005,237277,Punjab,24,11,18,4,57,Pass
Kunal Chopra,16-06-2005,858595,Maharashtra,3,21,23,24,71,Pass
Vivaan Singh,17-02-2005,719699,Andhra Pradesh,9,4,20,13,46,Pass
Gurpreet Pillai,28-03-2006,994648,Karnataka,12,13,17,18,60,Pass
Aditya D'Souza,14-08-2005,932038,West Bengal,9,4,11,23,47,Pass
Aditya Singh,19-09-2005,571849,Bihar,2,19,20,3,44,Pass
Yash D'Souza,01-01-2005,783523,Uttar Pradesh,6,5,20,13,44,Pass
Vivaan Khan,15-04-2006,735041,Maharashtra,3,11,8,14,36,Pass
Vivaan Khan,24-11-2005,858903,Rajasthan,21,6,21,13,61,Pass
David Fernandes,08-02-2005,313119,Rajasthan,24,7,13,0,44,Pass
Harjeet D'Souza,29-10-2005,465186,Odisha,5,19,7,6,37,Pass
Peter D'Souza,03-04-2005,269539,Bihar,12,3,12,20,47,Pass
David Reddy,29-04-2005,639439,Maharashtra,3,12,9,13,37,Pass
Kunal Pillai,06-05-2005,137585,Bihar,2,16,11,6,35,Pass
Ayaan Mehta,27-05-2005,114709,Andhra Pradesh,18,23,4,16,61,Pass
Krishna Fernandes,24-08-2005,408308,Tamil Nadu,22,4,23,10,59,Pass
Raj Sharma,11-05-2005,714470,Haryana,18,5,21,0,44,Pass
Rohan Khan,10-06-2005,354899,Punjab,15,16,3,16,50,Pass
Manpreet Reddy,25-01-2005,457684,Delhi,18,17,4,10,49,Fail
Yash Fernandes,11-12-2004,634927,Uttar Pradesh,7,5,19,9,40,Pass
Rohan Pillai,02-03-2005,254268,Madhya Pradesh,17,13,19,4,53,Pass
David Reddy,09-08-2005,572781,Karnataka,18,23,21,1,63,Pass
Aarav Reddy,06-03-2005,635515,Kerala,12,6,16,21,55,Pass
Balbir Mehta,19-11-2004,187168,Andhra Pradesh,24,3,11,15,53,Pass
Kunal Chopra,06-05-2005,570102,Madhya Pradesh,11,5,20,13,49,Pass
Farhan Singh,12-03-2006,593598,Maharashtra,8,2,17,18,45,Pass
Aryan Singh,14-01-2005,108130,West Bengal,21,14,6,10,51,Pass
Aditya Verma,08-08-2005,853055,West Bengal,5,17,17,10,49,Pass
Krishna Mehta,30-03-2005,823504,Madhya Pradesh,21,18,16,4,59,Pass
Aryan Fernandes,14-10-2005,561781,Madhya Pradesh,18,23,24,4,69,Pass
Yash D'Souza,24-07-2005,294402,Rajasthan,20,10,2,0,32,Pass
Rohan Khan,03-07-2005,400656,Haryana,11,18,15,14,58,Pass
John Chopra,09-04-2006,699388,Rajasthan,14,8,8,12,42,Pass
Kunal D'Souza,06-03-2005,185080,Haryana,15,1,2,4,22,Pass
Vivaan Singh,03-10-2005,667759,Maharashtra,17,4,3,9,33,Pass
David Verma,20-03-2005,369555,Rajasthan,11,3,20,8,42,Pass
Vivaan Mehta,01-12-2004,654800,Bihar,13,3,15,10,41,Pass
Zaid Chopra,02-03-2005,851045,Delhi,2,2,7,6,17,Fail
Kunal Reddy,08-08-2005,116426,Andhra Pradesh,15,13,3,2,33,Pass
Sukhwinder Fernandes,27-04-2005,741974,Bihar,22,9,6,14,51,Pass
Aarav Verma,02-11-2005,258123,Kerala,12,5,20,10,47,Pass
Rohan Verma,13-08-2005,482501,Punjab,17,11,14,10,52,Pass
Aarav Singh,03-11-2005,585164,Tamil Nadu,13,23,6,6,48,Pass
Manpreet Pillai,24-05-2005,237988,Punjab,21,3,14,14,52,Pass
Harjeet Pillai,03-04-2006,420364,Haryana,23,16,3,11,53,Pass
Imran Chopra,18-01-2006,321766,Bihar,12,20,23,10,65,Pass
Aditya Reddy,23-02-2005,418623,Punjab,20,1,9,21,51,Pass
Manpreet Fernandes,17-02-2006,739700,Madhya Pradesh,24,6,14,2,46,Pass
Aryan Verma,02-04-2006,674197,Bihar,9,4,15,7,35,Pass
Mathew Verma,07-12-2004,332244,Gujarat,11,11,15,10,47,Pass
Aarav Pillai,20-01-2006,983773,Andhra Pradesh,23,12,3,10,48,Pass
Yash Khan,22-11-2004,524292,Punjab,1,7,22,1,31,Pass
Aarav Verma,01-09-2005,245840,Tamil Nadu,20,20,15,2,57,Pass
Raj Singh,11-04-2005,368910,Madhya Pradesh,8,19,22,4,53,Pass
Balbir Reddy,07-02-2006,227704,Andhra Pradesh,15,0,12,23,50,Pass
Raj Reddy,14-01-2006,632410,Rajasthan,16,20,19,11,66,Pass
Aditya Sharma,13-05-2005,640974,Uttar Pradesh,9,5,12,15,41,Pass
David Verma,13-02-2005,580034,Karnataka,2,20,19,3,44,Pass
Aryan Fernandes,06-02-2006,677270,Haryana,5,10,19,17,51,Pass
Krishna Chopra,17-12-2004,623356,Uttar Pradesh,6,5,6,11,28,Pass
Kunal D'Souza,26-02-2006,940738,Tamil Nadu,12,22,10,18,62,Pass
Aarav Chopra,25-07-2005,776891,West Bengal,14,6,0,13,33,Pass
Paul Mehta,10-06-2005,800960,Delhi,8,19,11,15,53,Fail
Manpreet Pillai,26-03-2006,776885,Uttar Pradesh,1,5,17,15,38,Pass
Harjeet Mehta,05-12-2004,539624,Maharashtra,3,2,17,20,42,Pass
Yash Fernandes,27-03-2006,882645,Rajasthan,15,8,2,16,41,Pass
Vivaan D'Souza,30-05-2005,213082,Uttar Pradesh,3,5,11,22,41,Pass
Ishaan Singh,28-11-2004,237708,West Bengal,12,0,8,18,38,Pass
Vivaan Singh,04-02-2005,513525,Assam,23,17,8,15,63,Pass
Yash Chopra,08-12-2004,537371,Tamil Nadu,15,11,9,5,40,Pass
Ishaan Sharma,07-03-2006,220267,Karnataka,18,20,23,5,66,Pass
Ishaan Mehta,12-02-2005,966789,Jammu & Kashmir + Ladakh,19,3,24,20,66,Pass
Aryan Fernandes,01-05-2005,152306,Rajasthan,10,18,13,0,41,Pass
Kunal Reddy,19-08-2005,128574,Rajasthan,2,5,2,15,24,Pass
Krishna Mehta,14-08-2005,132739,Odisha,17,8,11,5,41,Pass
Yash Fernandes,16-02-2006,197003,Gujarat,24,1,1,24,50,Pass
Ishaan Pillai,07-11-2004,132606,Arunachal Pradesh,11,11,6,11,39,Pass
Aryan Sharma,17-04-2006,921231,Gujarat,21,5,4,3,33,Pass
Aarav Fernandes,09-03-2006,222367,Chhattisgarh,24,18,6,6,54,Pass
Ishaan Khan,27-03-2006,739546,Chhattisgarh,12,19,5,3,39,Pass
Yash Singh,05-03-2006,621788,Maharashtra,20,8,16,2,46,Pass
Raj D'Souza,27-07-2005,111371,Uttar Pradesh,7,5,11,11,34,Pass
Yash Sharma,30-06-2005,694390,Uttar Pradesh,20,5,6,21,52,Pass
Aryan Chopra,15-11-2004,738587,Telangana,20,3,5,3,31,Pass
Manpreet Sharma,10-01-2005,407066,Karnataka,20,19,18,5,62,Pass
Aarav Chopra,14-07-2005,875685,Uttar Pradesh,8,5,8,21,42,Pass
Kunal Chopra,28-02-2005,908775,Andhra Pradesh,15,3,22,2,42,Pass
Balbir Khan,10-03-2006,490629,Haryana,13,15,19,16,63,Pass
Aarav Sharma,04-10-2005,845848,Uttar Pradesh,22,5,17,10,54,Pass
Ishaan Reddy,05-04-2006,132054,Uttar Pradesh,24,5,2,15,46,Pass
Aarav Verma,10-01-2006,545358,Uttar Pradesh,20,5,12,3,40,Pass
Raj Pillai,10-01-2005,728665,Bihar,17,13,5,22,57,Pass
Manpreet Khan,30-01-2006,605299,Uttarakhand,5,16,4,16,41,Pass
Manpreet Chopra,23-01-2006,523519,Andhra Pradesh,23,15,9,10,57,Pass
Aditya Verma,09-03-2005,874194,Uttar Pradesh,21,5,22,0,48,Pass
Aryan Chopra,16-04-2006,148869,Haryana,4,5,2,18,29,Pass
Raj Reddy,19-04-2006,709933,Jammu & Kashmir + Ladakh,9,0,23,5,37,Pass
Yash Singh,27-09-2005,870397,Uttar Pradesh,23,5,24,1,53,Pass
Raj Chopra,27-12-2005,987989,Daman & Diu / D&N Haveli,3,8,8,8,27,Pass
Raj Khan,19-07-2005,670573,Maharashtra,12,15,2,4,33,Pass
Vivaan Mehta,13-05-2005,798023,Bihar,10,8,7,15,40,Pass
Balbir Mehta,08-11-2005,160697,Rajasthan,17,17,18,17,69,Pass
John Reddy,14-12-2005,520365,West Bengal,3,14,19,2,38,Pass
Raj Khan,04-05-2005,937986,Madhya Pradesh,19,0,6,14,39,Pass
David D'Souza,18-02-2005,209715,Uttarakhand,3,10,24,18,55,Pass
Aditya Pillai,12-11-2005,282726,Uttar Pradesh,7,5,1,7,20,Pass
Balbir Khan,12-02-2006,822395,Uttar Pradesh,9,5,2,17,33,Pass
Aarav Chopra,18-12-2004,455937,West Bengal,1,0,9,2,12,Pass
Aryan Singh,13-04-2006,269029,Haryana,7,14,13,13,47,Pass
Sukhwinder Fernandes,01-01-2006,855300,Odisha,13,3,20,18,54,Pass
Aryan D'Souza,09-04-2005,137267,Madhya Pradesh,14,0,2,14,30,Pass
Raj Sharma,14-11-2004,916813,Maharashtra,24,11,5,8,48,Pass
Rohan Verma,20-12-2005,227123,Jharkhand,19,19,6,3,47,Pass
Peter D'Souza,08-02-2006,629657,Rajasthan,17,22,20,14,73,Pass
Aryan Sharma,25-04-2005,125461,Maharashtra,8,2,2,13,25,Pass
Aryan Singh,10-02-2005,281354,Punjab,9,12,18,17,56,Pass
Vivaan Verma,02-12-2004,274937,Kerala,7,9,3,16,35,Pass
Manpreet Sharma,26-09-2005,864030,Uttar Pradesh,24,5,10,8,47,Pass
Krishna Pillai,02-01-2005,233548,Tamil Nadu,24,11,7,16,58,Pass
Manpreet Verma,13-10-2005,365358,Haryana,7,13,17,6,43,Pass
Krishna D'Souza,18-05-2005,426918,Uttarakhand,18,3,10,4,35,Pass
Kunal Reddy,07-05-2005,485309,Maharashtra,3,23,16,22,64,Pass
Vivaan D'Souza,17-11-2005,511929,West Bengal,6,3,8,22,39,Pass
John Chopra,20-03-2006,743097,Maharashtra,20,5,8,3,36,Pass
Gurpreet D'Souza,22-02-2006,751253,Himachal Pradesh,1,0,8,8,17,Pass
Sukhwinder Singh,26-06-2005,562076,West Bengal,5,3,7,6,21,Pass
Ishaan Sharma,17-02-2005,696729,Bihar,15,15,16,20,66,Pass
Sukhwinder D'Souza,10-02-2006,620459,Rajasthan,24,2,10,24,60,Pass
Krishna Khan,22-12-2004,977398,Gujarat,19,9,23,5,56,Pass
Rohan Chopra,25-01-2005,118358,Tamil Nadu,2,17,11,16,46,Pass
Vivaan Pillai,29-12-2004,754959,Telangana,13,23,2,3,41,Pass
Harjeet Mehta,23-01-2005,718392,Andhra Pradesh,18,5,2,17,42,Pass
Aditya Sharma,21-03-2005,282056,Delhi,18,20,4,18,60,Fail
Ishaan Pillai,09-04-2006,430813,Madhya Pradesh,16,23,0,4,43,Pass
Balbir Reddy,06-09-2005,481946,Rajasthan,9,12,12,1,34,Pass
Raj Sharma,03-10-2005,275793,Chhattisgarh,21,6,14,0,41,Pass
Gurpreet Sharma,08-12-2004,878094,Telangana,9,16,4,10,39,Pass
Kunal Verma,27-05-2005,964353,Himachal Pradesh,10,15,23,14,62,Pass
Rohan Pillai,04-12-2004,201150,Karnataka,9,11,5,3,28,Pass
Aryan Pillai,02-06-2005,807994,Kerala,15,7,17,15,54,Pass
Aryan Reddy,19-01-2005,639075,Maharashtra,0,18,21,3,42,Pass
Sukhwinder D'Souza,19-08-2005,334760,Tamil Nadu,23,10,5,21,59,Pass
John Chopra,06-08-2005,909055,West Bengal,16,20,4,8,48,Pass
David Mehta,16-04-2006,828209,Uttar Pradesh,9,5,16,8,38,Pass
Ishaan Khan,25-03-2005,710726,Rajasthan,13,11,0,19,43,Pass
Peter Verma,05-02-2005,613373,Himachal Pradesh,4,9,5,3,21,Pass
Krishna Khan,17-03-2005,633846,Gujarat,0,0,14,22,36,Pass
Mathew D'Souza,22-11-2005,450414,Himachal Pradesh,18,4,6,13,41,Pass
Rohan Singh,15-01-2005,713230,Gujarat,22,20,17,12,71,Pass
Harjeet Verma,14-03-2005,649410,Uttar Pradesh,3,5,24,11,43,Pass
David Mehta,06-10-2005,635216,Madhya Pradesh,15,22,7,5,49,Pass
Krishna Pillai,22-04-2006,384211,Manipur,4,15,24,21,64,Pass
Sukhwinder D'Souza,04-01-2006,369060,Telangana,7,15,8,1,31,Pass
Gurpreet Sharma,08-12-2005,633857,Rajasthan,9,8,3,23,43,Pass
Kunal Fernandes,19-02-2006,844121,Uttar Pradesh,12,5,18,10,45,Pass
Raj Mehta,09-02-2005,699904,Meghalaya,13,12,10,12,47,Pass
Manpreet Fernandes,01-02-2005,463915,Bihar,21,18,12,12,63,Pass
Farhan Mehta,25-12-2004,658689,Uttarakhand,9,13,5,13,40,Pass
Vivaan Reddy,07-04-2005,383158,Maharashtra,1,21,10,0,32,Pass
Sukhwinder D'Souza,02-08-2005,723110,Meghalaya,11,11,5,18,45,Pass
Ishaan Reddy,26-03-2006,777370,Rajasthan,16,14,16,21,67,Pass
Paul Mehta,11-02-2006,845724,Kerala,10,6,4,0,20,Pass
Aditya Mehta,21-10-2005,795936,Maharashtra,3,21,19,14,57,Pass
Kunal Mehta,05-07-2005,691209,Jammu & Kashmir + Ladakh,10,14,23,8,55,Pass
Rohan Singh,31-07-2005,915855,Chhattisgarh,24,8,7,20,59,Pass
Aryan Singh,07-05-2006,201616,Maharashtra,7,18,6,5,36,Pass
Ishaan Reddy,29-12-2005,651190,Bihar,8,17,8,6,39,Pass
Peter Singh,22-09-2005,555782,Karnataka,16,11,2,3,32,Pass
Zaid Fernandes,15-06-2005,257561,Odisha,22,24,12,8,66,Pass
Aryan Reddy,07-05-2005,523681,Bihar,14,23,0,0,37,Pass
Aarav D'Souza,24-10-2005,613306,Uttar Pradesh,6,5,4,17,32,Pass
Aryan Khan,15-05-2005,937007,Andhra Pradesh,13,9,12,20,54,Pass
Kunal Pillai,13-02-2006,259552,Rajasthan,11,14,15,22,62,Pass
Aditya Reddy,09-12-2005,528162,Maharashtra,9,9,12,8,38,Pass
Gurpreet Chopra,01-01-2006,577314,Bihar,22,20,16,12,70,Pass
Rohan Singh,31-03-2006,262461,Gujarat,21,16,21,14,72,Pass
Manpreet Fernandes,06-01-2006,794011,Andhra Pradesh,13,10,16,12,51,Pass
Kunal Pillai,02-02-2006,839474,Kerala,10,0,23,7,40,Pass
Raj Sharma,03-04-2006,847497,Andhra Pradesh,3,13,2,19,37,Pass
Ishaan Reddy,21-09-2005,150497,Madhya Pradesh,24,0,11,0,35,Pass
Vivaan Fernandes,15-12-2005,694110,Rajasthan,9,24,22,0,55,Pass
Gurpreet Sharma,09-03-2006,988909,Tamil Nadu,2,13,19,11,45,Pass
Aarav Verma,18-07-2005,511753,Tamil Nadu,9,5,17,22,53,Pass
Rohan Khan,18-07-2005,715256,Madhya Pradesh,9,3,13,20,45,Pass
Sukhwinder D'Souza,15-05-2005,131898,Rajasthan,18,20,0,15,53,Pass
Harjeet Khan,20-11-2005,179152,Maharashtra,3,15,16,12,46,Pass
Kunal Sharma,25-04-2006,755110,Haryana,3,3,12,0,18,Pass
Kunal Singh,25-04-2005,612262,Uttar Pradesh,3,5,0,23,31,Pass
Ishaan Singh,17-09-2005,509486,Maharashtra,4,22,22,0,48,Pass
Kunal Singh,24-12-2005,543400,Gujarat,15,17,13,11,56,Pass
Aarav Reddy,23-10-2005,365125,Madhya Pradesh,18,16,18,4,56,Pass
Rohan Chopra,08-01-2006,201520,Uttar Pradesh,0,5,15,7,27,Pass
Kunal Chopra,28-01-2006,903014,Madhya Pradesh,10,12,22,4,48,Pass
Aryan Reddy,05-10-2005,727479,Uttar Pradesh,19,5,4,12,40,Pass
Farhan D'Souza,29-01-2005,771263,Andhra Pradesh,0,18,15,2,35,Pass
Aryan Singh,13-08-2005,525822,Andhra Pradesh,15,3,16,19,53,Pass
Harjeet Pillai,08-02-2006,353731,Bihar,14,0,6,20,40,Pass
Aryan Fernandes,07-03-2005,561665,Uttar Pradesh,3,5,24,21,53,Pass
Aditya Reddy,01-02-2006,730762,Maharashtra,5,11,0,2,18,Pass
Ayaan Fernandes,01-01-2005,393905,West Bengal,1,18,10,22,51,Pass
Ishaan Verma,04-04-2006,965775,Andhra Pradesh,3,17,7,14,41,Pass
Raj Singh,11-01-2005,152693,Punjab,3,23,2,22,50,Pass
Krishna Sharma,25-09-2005,288235,Uttar Pradesh,2,5,8,10,25,Pass
Yash Mehta,09-04-2006,779564,Gujarat,24,14,0,0,38,Pass
Ishaan D'Souza,16-09-2005,989230,Telangana,7,14,0,24,45,Pass
Aryan Verma,22-08-2005,695580,Chhattisgarh,2,23,10,9,44,Pass
Raj Singh,02-12-2005,563020,Uttarakhand,23,0,24,0,47,Pass
Aarav Verma,24-04-2006,406624,Karnataka,11,10,1,19,41,Pass
Peter Verma,13-01-2005,475905,Haryana,9,4,23,18,54,Pass
Aarav Singh,15-02-2006,544560,Tamil Nadu,1,9,20,3,33,Pass
Vivaan Verma,15-04-2005,795158,Chhattisgarh,14,3,21,3,41,Pass
Imran Mehta,12-08-2005,612987,West Bengal,2,24,22,5,53,Pass
Peter Verma,30-04-2006,557893,Chhattisgarh,7,17,5,20,49,Pass
Mathew D'Souza,21-11-2005,271004,Haryana,22,11,18,4,55,Pass
Sukhwinder Pillai,04-04-2005,830872,Kerala,18,7,13,18,56,Pass
Manpreet Khan,10-08-2005,147742,Gujarat,11,22,3,2,38,Pass
Peter Verma,31-12-2005,556384,West Bengal,3,17,18,24,62,Pass
Gurpreet Reddy,06-10-2005,486058,Himachal Pradesh,14,5,21,16,56,Pass
Krishna Chopra,30-06-2005,525883,Uttar Pradesh,13,5,4,5,27,Pass
Rohan Singh,07-07-2005,874575,Bihar,0,2,20,0,22,Pass
Imran Sharma,05-05-2006,583376,Madhya Pradesh,6,6,8,15,35,Pass
Paul Mehta,04-05-2005,125381,Bihar,17,17,8,20,62,Pass
Ayaan Mehta,07-08-2005,432969,Madhya Pradesh,7,22,10,17,56,Pass
Vivaan Verma,23-11-2005,237051,Uttar Pradesh,16,5,10,6,37,Pass
Vivaan Chopra,01-04-2005,496476,Gujarat,23,21,21,19,84,Pass
David Khan,08-11-2005,944057,Haryana,16,19,13,15,63,Pass
Kunal Singh,02-01-2005,715491,Bihar,22,17,14,11,64,Pass
Ishaan Chopra,09-02-2006,404365,Tamil Nadu,5,7,6,20,38,Pass
Raj Khan,13-11-2005,393219,Rajasthan,8,22,24,1,55,Pass
Aarav Sharma,01-12-2005,299992,Odisha,6,16,12,4,38,Pass
Manpreet D'Souza,07-10-2005,324502,Punjab,12,3,19,12,46,Pass
Aryan Fernandes,25-08-2005,482162,Sikkim,1,6,19,3,29,Pass
Gurpreet Singh,02-03-2006,219696,Bihar,21,23,8,13,65,Pass
Aditya Sharma,25-09-2005,511479,Andhra Pradesh,8,6,11,0,25,Pass
Sukhwinder Reddy,13-07-2005,378368,Rajasthan,8,9,24,5,46,Pass
Yash Pillai,07-11-2005,369817,West Bengal,3,14,5,18,40,Pass
Ishaan Reddy,31-03-2006,867647,Rajasthan,13,14,14,20,61,Pass
Aarav Reddy,03-01-2006,755364,Maharashtra,13,4,20,10,47,Pass
Harjeet Pillai,14-11-2004,889793,Punjab,24,3,1,10,38,Pass
Balbir D'Souza,20-02-2005,780450,Karnataka,24,0,6,14,44,Pass
Aditya Khan,30-10-2005,494034,Tamil Nadu,8,10,20,13,51,Pass
Aarav Sharma,20-07-2005,489327,Punjab,6,11,7,10,34,Pass
Raj Verma,30-01-2005,937333,Jammu & Kashmir + Ladakh,6,11,22,11,50,Pass
Manpreet Reddy,20-11-2005,980656,Chhattisgarh,2,14,7,24,47,Pass
Krishna Khan,05-04-2006,283214,Gujarat,7,23,17,23,70,Pass
Yash Singh,26-12-2005,970861,Haryana,15,12,4,21,52,Pass
Krishna Khan,14-03-2005,306228,Andhra Pradesh,21,15,18,5,59,Pass
Raj Chopra,09-12-2005,240331,Rajasthan,9,9,15,18,51,Pass
Balbir Singh,09-08-2005,191367,Gujarat,20,12,24,3,59,Pass
Aryan Sharma,28-07-2005,799855,Bihar,22,23,6,0,51,Pass
Rohan Chopra,15-01-2005,200158,Uttar Pradesh,0,5,3,11,19,Pass
Rohan Khan,26-08-2005,378902,Punjab,21,2,3,20,46,Pass
Raj Chopra,19-12-2004,665260,Gujarat,9,17,0,11,37,Pass
Kunal Sharma,07-02-2005,576508,Bihar,11,12,3,16,42,Pass
John Sharma,03-12-2005,568026,Andhra Pradesh,23,5,16,14,58,Pass
Rohan Mehta,02-04-2005,119543,West Bengal,13,6,24,5,48,Pass
Harjeet Mehta,06-04-2006,397731,Bihar,24,24,12,20,80,Pass
Gurpreet D'Souza,18-11-2005,634881,Andhra Pradesh,22,13,7,8,50,Pass
Rohan Singh,03-10-2005,766708,Andhra Pradesh,4,16,7,2,29,Pass
Mathew Khan,25-03-2006,337634,Gujarat,10,8,9,11,38,Pass
Rohan Reddy,15-05-2005,142653,Puducherry,1,6,3,12,22,Pass
Krishna Verma,18-03-2006,423884,Rajasthan,7,0,13,18,38,Pass
Kunal Verma,11-01-2006,839850,Maharashtra,3,20,20,11,54,Pass
Raj Khan,27-09-2005,156760,Goa,6,19,17,1,43,Pass
Rehan Khan,29-12-2005,543715,Haryana,3,10,2,22,37,Pass
Ishaan Verma,22-12-2005,817630,Haryana,16,0,16,10,42,Pass
Aryan Reddy,30-01-2005,643963,Maharashtra,3,20,1,16,40,Pass
Kunal Chopra,14-11-2005,445790,Telangana,0,5,14,1,20,Pass
Kunal Verma,23-04-2005,406283,Rajasthan,13,8,17,21,59,Pass
Peter D'Souza,07-05-2006,583003,Rajasthan,7,5,3,14,29,Pass
Rohan Sharma,30-01-2005,763510,Maharashtra,3,20,18,0,41,Pass
Ishaan Pillai,09-11-2004,881370,Bihar,9,5,21,21,56,Pass
Krishna Singh,18-01-2005,792178,Maharashtra,3,21,19,11,54,Pass
Vivaan Fernandes,27-12-2005,648546,Tripura,3,8,4,22,37,Pass
Aarav Mehta,26-09-2005,578268,Uttar Pradesh,17,5,22,4,48,Pass
Yash Fernandes,28-05-2005,185847,Madhya Pradesh,12,7,4,7,30,Pass
Ishaan Verma,31-07-2005,421366,Gujarat,21,16,20,10,67,Pass
Krishna Reddy,08-01-2005,452096,West Bengal,3,20,17,18,58,Pass
Aarav Pillai,05-06-2005,224753,Odisha,17,13,1,17,48,Pass
Manpreet Khan,27-09-2005,238824,Karnataka,6,21,8,3,38,Pass
Krishna Mehta,17-05-2005,276921,Tamil Nadu,19,18,13,7,57,Pass
Aryan Pillai,21-08-2005,186001,Punjab,9,12,7,23,51,Pass
Balbir Fernandes,10-11-2004,653562,Uttar Pradesh,0,5,24,20,49,Pass
Zaid Fernandes,24-02-2006,626895,Assam,10,5,14,23,52,Pass
Vivaan D'Souza,28-10-2005,609466,Rajasthan,10,9,17,20,56,Pass
Vivaan Reddy,22-12-2004,794885,Uttar Pradesh,14,5,10,22,51,Pass
Aditya D'Souza,30-01-2005,418245,Rajasthan,10,22,13,20,65,Pass
Yash Sharma,05-01-2005,465050,Meghalaya,17,14,4,7,42,Pass
Sukhwinder Verma,05-04-2006,188815,Delhi,23,0,18,24,65,Fail
David Khan,05-07-2005,595961,Rajasthan,1,15,0,24,40,Pass
Rohan Chopra,29-11-2004,496556,Uttarakhand,6,9,5,23,43,Pass
Mathew Reddy,25-07-2005,620998,Uttar Pradesh,11,5,3,9,28,Pass
Harjeet Verma,10-11-2005,700081,Uttar Pradesh,22,5,14,6,47,Pass
Kunal Verma,17-03-2006,390367,Maharashtra,15,10,1,5,31,Pass
Ishaan Verma,18-10-2005,815885,Rajasthan,7,0,17,11,35,Pass
Vivaan Pillai,09-05-2006,577767,Chhattisgarh,7,11,12,0,30,Pass
Krishna Pillai,18-03-2006,492149,Punjab,11,13,10,10,44,Pass
David Pillai,13-11-2004,955965,Bihar,8,4,8,3,23,Pass
Raj Chopra,17-04-2006,309933,Rajasthan,12,11,20,7,50,Pass
Peter D'Souza,12-08-2005,475673,Jammu & Kashmir + Ladakh,20,4,4,4,32,Pass
Aryan Sharma,24-04-2006,921304,West Bengal,3,24,10,24,61,Pass
Aditya Khan,24-11-2005,928678,Uttarakhand,5,15,6,11,37,Pass
Aditya Chopra,13-04-2005,522935,Maharashtra,21,10,4,13,48,Pass
David Verma,01-01-2006,200081,Uttar Pradesh,13,5,0,20,38,Pass
Aryan Fernandes,03-09-2005,775641,Bihar,8,2,8,23,41,Pass
Gurpreet Chopra,20-08-2005,356789,Andhra Pradesh,23,10,16,2,51,Pass
Sukhwinder Chopra,12-06-2005,659920,Jharkhand,15,18,2,14,49,Pass
Krishna Chopra,02-11-2005,289638,Punjab,12,24,4,3,43,Pass
Aarav Khan,11-07-2005,435522,Rajasthan,0,21,24,9,54,Pass
Peter Verma,14-03-2006,714777,Maharashtra,4,7,22,14,47,Pass
Paul D'Souza,20-11-2005,816091,Uttar Pradesh,14,5,9,2,30,Pass
Manpreet Khan,18-12-2005,435778,Telangana,4,3,6,21,34,Pass
Kunal Singh,18-09-2005,805140,Uttar Pradesh,21,5,7,2,35,Pass
Aarav Reddy,21-03-2005,970683,Bihar,19,15,0,2,36,Pass
Raj Sharma,14-09-2005,561236,West Bengal,6,17,11,17,51,Pass
Kunal Khan,11-11-2004,303903,Himachal Pradesh,10,7,19,12,48,Pass
Balbir Singh,22-09-2005,756969,Rajasthan,22,17,6,22,67,Pass
Aryan Reddy,13-05-2005,931053,Gujarat,15,8,11,17,51,Pass
Aditya Verma,20-01-2005,882927,Haryana,10,11,4,5,30,Pass
Aarav D'Souza,12-02-2005,396728,Bihar,11,0,6,4,21,Pass
Yash Mehta,18-04-2006,545772,Bihar,16,0,12,7,35,Pass
Harjeet Pillai,19-07-2005,873548,West Bengal,3,19,5,17,44,Pass
Ishaan Singh,13-05-2005,242619,West Bengal,7,8,10,0,25,Pass
Vivaan Khan,31-10-2005,400589,Bihar,11,9,19,20,59,Pass
Balbir Reddy,03-04-2006,790258,Madhya Pradesh,15,6,10,18,49,Pass
Aarav Fernandes,27-03-2005,914089,Tamil Nadu,5,13,10,10,38,Pass
Aarav Pillai,16-11-2004,388708,Uttar Pradesh,17,5,23,24,69,Pass
Balbir Mehta,04-07-2005,217943,Haryana,23,11,4,24,62,Pass
Yash Singh,31-01-2005,869299,Rajasthan,13,17,17,11,58,Pass
Mathew Verma,28-11-2005,926035,Telangana,3,21,11,2,37,Pass
Raj Chopra,03-01-2006,655080,Andhra Pradesh,19,2,8,7,36,Pass
Farhan D'Souza,18-01-2006,773221,West Bengal,3,5,17,24,49,Pass
Kunal Singh,01-02-2005,816142,Himachal Pradesh,16,22,2,14,54,Pass
Farhan Verma,08-12-2005,504179,Puducherry,4,2,15,21,42,Pass
David Sharma,23-08-2005,455288,Rajasthan,16,12,22,11,61,Pass
David Mehta,23-04-2006,921141,Assam,12,13,23,16,64,Pass
Kunal Mehta,29-05-2005,147716,Uttar Pradesh,10,5,1,12,28,Pass
Rohan Chopra,19-07-2005,772141,Karnataka,11,17,15,23,66,Pass
Krishna Pillai,27-02-2006,780334,Uttar Pradesh,24,5,2,6,37,Pass
Krishna Chopra,04-03-2005,958383,Telangana,13,1,16,11,41,Pass
Vivaan Khan,11-03-2005,357304,Punjab,1,5,0,15,21,Pass
Raj Sharma,04-05-2006,195956,Andhra Pradesh,12,8,21,21,62,Pass
Aryan Sharma,11-11-2004,309306,Rajasthan,19,6,6,17,48,Pass
Aryan Khan,11-03-2006,674589,Bihar,17,18,7,5,47,Pass
Mathew Sharma,01-05-2006,980271,Andhra Pradesh,7,22,14,4,47,Pass
Vivaan Khan,29-04-2006,390469,Uttarakhand,17,16,11,2,46,Pass
Aryan D'Souza,09-02-2006,818748,West Bengal,20,6,6,7,39,Pass
Rehan D'Souza,21-11-2004,128586,Maharashtra,3,15,15,6,39,Pass
Yash Verma,20-02-2006,882835,Uttar Pradesh,17,5,12,4,38,Pass
Ishaan Verma,13-02-2005,354929,Sikkim,12,4,5,5,26,Pass
Rohan Reddy,09-01-2006,180251,Punjab,5,3,23,12,43,Pass
Manpreet Khan,28-12-2005,811323,Assam,4,9,21,7,41,Pass
Sukhwinder Mehta,24-04-2006,183108,Gujarat,7,11,8,11,37,Pass
John Sharma,07-04-2006,760301,West Bengal,3,12,21,12,48,Pass
Vivaan Reddy,28-07-2005,150478,Haryana,3,11,13,14,41,Pass
Aarav Sharma,07-11-2005,307427,Jammu & Kashmir + Ladakh,5,7,2,4,18,Pass
Raj Chopra,17-04-2006,504229,Karnataka,24,4,21,12,61,Pass
Balbir Khan,30-01-2006,475940,Rajasthan,14,22,10,5,51,Pass
Krishna Pillai,30-11-2005,127520,Uttar Pradesh,22,5,17,12,56,Pass
John D'Souza,23-09-2005,749668,Maharashtra,3,16,3,23,45,Pass
Aarav Verma,11-02-2006,170792,Maharashtra,7,7,8,0,22,Pass
Krishna Khan,21-03-2006,329743,Madhya Pradesh,16,14,0,2,32,Pass
Aryan D'Souza,22-05-2005,724182,Uttar Pradesh,2,5,17,2,26,Pass
Kunal D'Souza,08-04-2006,217897,Madhya Pradesh,12,16,3,0,31,Pass
Gurpreet Pillai,21-07-2005,470929,Gujarat,4,15,8,24,51,Pass
Rohan Reddy,13-02-2005,508091,West Bengal,17,7,13,10,47,Pass
Yash Singh,04-03-2006,593333,Uttar Pradesh,4,5,17,12,38,Pass
Rohan Verma,19-03-2005,348431,Jammu & Kashmir + Ladakh,1,7,9,17,34,Pass
Aditya Pillai,22-10-2005,241309,West Bengal,0,14,12,24,50,Pass
Rehan Khan,24-03-2006,377503,Chhattisgarh,21,7,0,15,43,Pass
Yash Chopra,17-04-2005,936750,Odisha,8,11,16,6,41,Pass
Aryan Sharma,26-02-2005,666557,Nagaland,6,6,3,11,26,Pass
Ishaan Khan,13-02-2006,505597,Maharashtra,17,7,2,19,45,Pass
Rohan D'Souza,04-02-2005,496794,Uttar Pradesh,15,5,6,10,36,Pass
Vivaan Singh,01-03-2005,174195,Bihar,8,2,7,1,18,Pass
Ayaan Chopra,08-12-2005,633637,Uttar Pradesh,21,5,12,15,53,Pass
Imran Chopra,01-01-2006,603084,Bihar,23,21,3,21,68,Pass
Rohan Pillai,26-11-2005,113347,Haryana,12,10,8,17,47,Pass
Raj D'Souza,16-02-2006,712243,Chhattisgarh,4,4,4,21,33,Pass
Yash D'Souza,02-08-2005,511928,Andhra Pradesh,22,5,10,11,48,Pass
Raj D'Souza,25-06-2005,313060,Tamil Nadu,1,5,7,22,35,Pass
Raj Fernandes,19-10-2005,102307,Tamil Nadu,5,13,5,5,28,Pass
Aditya Singh,19-01-2005,152775,West Bengal,13,4,4,20,41,Pass
Rohan Pillai,27-03-2006,595091,Uttar Pradesh,14,5,24,11,54,Pass
Vivaan Fernandes,04-04-2005,687186,Bihar,8,14,1,22,45,Pass
Raj Sharma,10-08-2005,709735,Tamil Nadu,24,24,15,17,80,Pass
Rehan Pillai,06-10-2005,938767,Odisha,18,24,1,10,53,Pass
Mathew Verma,03-12-2004,858548,Bihar,11,4,11,24,50,Pass
Krishna Verma,16-04-2006,472411,Rajasthan,0,6,18,22,46,Pass
Aryan Reddy,17-09-2005,779378,West Bengal,13,13,7,17,50,Pass
Rohan Singh,12-06-2005,662057,Uttar Pradesh,22,5,24,7,58,Pass
Raj Chopra,06-09-2005,752316,Bihar,21,9,16,5,51,Pass
Ishaan Singh,28-02-2005,694576,Uttar Pradesh,14,5,5,18,42,Pass
Aarav Singh,29-04-2006,709487,Rajasthan,20,19,23,7,69,Pass
Manpreet Verma,28-04-2006,317798,Madhya Pradesh,5,24,2,17,48,Pass
Krishna Reddy,13-04-2005,983608,Uttarakhand,3,22,15,18,58,Pass
Sukhwinder Khan,02-07-2005,604531,Kerala,15,5,16,14,50,Pass
Mathew D'Souza,15-11-2005,122954,Telangana,15,2,18,0,35,Pass
Aditya Singh,25-11-2004,253165,Kerala,3,24,14,15,56,Pass
Yash Mehta,23-04-2006,745098,Karnataka,1,21,16,14,52,Pass
Krishna Reddy,21-03-2006,600257,Tamil Nadu,7,15,10,16,48,Pass
Kunal Chopra,01-04-2006,694312,Bihar,8,17,14,17,56,Pass
Rohan Reddy,10-02-2006,781577,Karnataka,14,23,7,9,53,Pass
Paul Fernandes,06-08-2005,735140,Gujarat,5,16,1,12,34,Pass
Manpreet Pillai,19-05-2005,754886,Mizoram,9,8,13,14,44,Pass
Ishaan Khan,14-01-2005,295510,Rajasthan,23,4,5,5,37,Pass
Ishaan Singh,14-08-2005,124594,Assam,24,16,1,19,60,Pass
Ishaan Verma,25-11-2005,154296,Gujarat,9,2,20,1,32,Pass
Rehan Mehta,29-12-2005,891272,Bihar,23,10,19,5,57,Pass
Ayaan Pillai,12-06-2005,522689,Tamil Nadu,7,20,2,4,33,Pass
Rohan Singh,28-02-2005,805308,Goa,7,15,9,6,37,Pass
John Fernandes,06-08-2005,814037,Bihar,5,9,3,6,23,Pass
Aryan Khan,06-11-2005,137944,Rajasthan,16,20,11,22,69,Pass
Rohan Mehta,31-12-2004,905949,Karnataka,14,9,19,24,66,Pass
Raj Khan,10-01-2005,674093,Jammu & Kashmir + Ladakh,19,0,9,17,45,Pass
Krishna Reddy,04-12-2004,329206,Uttar Pradesh,13,5,15,17,50,Pass
Kunal Sharma,15-05-2005,712055,Tamil Nadu,7,12,4,3,26,Pass
Rohan Reddy,17-05-2005,797638,Telangana,18,12,8,2,40,Pass
Gurpreet Reddy,10-11-2004,833715,Tamil Nadu,20,4,16,4,44,Pass
Raj Mehta,30-01-2006,903972,Maharashtra,3,11,3,21,38,Pass
Ishaan Reddy,01-01-2005,379057,Uttar Pradesh,21,5,16,10,52,Pass
Aryan Sharma,16-09-2005,910122,Odisha,15,21,0,17,53,Pass
Aryan Mehta,29-11-2004,845695,Telangana,0,17,3,19,39,Pass
Raj Fernandes,23-03-2006,302444,Bihar,11,17,18,19,65,Pass
Vivaan Sharma,14-11-2005,687330,Punjab,2,19,23,2,46,Pass
Yash Fernandes,19-03-2006,717752,Maharashtra,12,4,5,11,32,Pass
Krishna Fernandes,02-07-2005,269396,Jammu & Kashmir + Ladakh,21,14,1,1,37,Pass
Rohan Chopra,24-07-2005,602377,Bihar,15,16,16,0,47,Pass
Vivaan Pillai,02-10-2005,119608,Madhya Pradesh,22,5,2,9,38,Pass
Vivaan Chopra,17-11-2005,873850,Tamil Nadu,23,7,7,9,46,Pass
Yash Reddy,20-02-2006,207989,Maharashtra,23,3,0,21,47,Pass
Vivaan Sharma,15-03-2005,357548,Chhattisgarh,22,24,10,5,61,Pass
Sukhwinder D'Souza,27-03-2005,156287,Madhya Pradesh,18,1,7,9,35,Pass
Aryan Khan,02-12-2004,860069,Himachal Pradesh,19,23,20,4,66,Pass
Kunal Singh,16-10-2005,204735,Rajasthan,15,8,18,21,62,Pass
John Singh,20-04-2005,517223,Uttar Pradesh,11,5,10,20,46,Pass
Kunal D'Souza,16-05-2005,979103,Punjab,12,7,11,16,46,Pass
Aarav Fernandes,07-12-2005,754555,Odisha,12,6,20,17,55,Pass
Aarav Pillai,30-01-2005,656481,Uttar Pradesh,13,5,12,6,36,Pass
Aditya Sharma,15-05-2005,175396,Maharashtra,3,11,18,23,55,Pass
Aarav Mehta,26-12-2005,554642,Rajasthan,9,0,2,8,19,Pass
Aryan Sharma,22-01-2006,704518,Rajasthan,5,0,6,0,11,Pass
Peter Singh,10-11-2004,239270,Madhya Pradesh,18,9,7,2,36,Pass
David D'Souza,16-11-2005,947016,Bihar,5,19,12,9,45,Pass
Gurpreet Reddy,01-05-2006,819743,Uttar Pradesh,0,5,15,14,34,Pass
Krishna Pillai,29-11-2004,454631,Bihar,14,24,3,18,59,Pass
Aryan Sharma,04-04-2005,222206,Rajasthan,23,24,7,12,66,Pass
Paul Mehta,21-02-2005,800822,Madhya Pradesh,10,14,15,4,43,Pass
Ishaan Reddy,16-02-2005,433398,Andhra Pradesh,5,18,17,3,43,Pass
Mathew Chopra,31-01-2005,313512,Mizoram,3,16,11,11,41,Pass
Ishaan Fernandes,25-11-2005,593143,Manipur,4,24,15,5,48,Pass
Aryan Reddy,28-12-2004,142081,Telangana,16,21,0,0,37,Pass
Ayaan Reddy,19-01-2006,392864,Uttar Pradesh,0,5,21,2,28,Pass
Kunal Verma,01-03-2005,144755,Andhra Pradesh,2,12,21,14,49,Pass
Rohan Verma,29-08-2005,994196,Madhya Pradesh,21,11,11,7,50,Pass
David Fernandes,05-02-2006,589018,Maharashtra,15,11,0,12,38,Pass
Aryan Singh,25-02-2005,563868,Rajasthan,24,22,13,11,70,Pass
Peter Mehta,08-11-2005,178570,Telangana,3,13,3,6,25,Pass
Aarav Sharma,26-09-2005,122611,Andhra Pradesh,14,16,13,19,62,Pass
John Verma,29-03-2005,969313,Punjab,14,3,8,8,33,Pass
Manpreet Khan,19-06-2005,588775,Uttar Pradesh,15,5,10,7,37,Pass
Krishna Reddy,23-09-2005,488656,Andhra Pradesh,18,8,2,19,47,Pass
Aryan Khan,04-05-2006,971672,Telangana,23,4,3,24,54,Pass
Yash Singh,23-10-2005,701193,Maharashtra,3,4,14,19,40,Pass
Gurpreet Mehta,27-12-2005,554039,Manipur,5,6,7,2,20,Pass
Yash Singh,28-11-2005,434176,Bihar,22,0,5,1,28,Pass
Rohan Sharma,03-05-2005,214580,Rajasthan,6,20,19,16,61,Pass
Yash Verma,02-10-2005,676098,Delhi,14,19,0,18,51,Fail
Krishna Khan,18-10-2005,356189,Rajasthan,3,23,19,6,51,Pass
Balbir Verma,21-06-2005,104359,Kerala,0,18,5,7,30,Pass
David Reddy,19-02-2006,768851,Bihar,8,12,19,12,51,Pass
Ishaan Khan,03-01-2005,264462,Kerala,15,8,5,14,42,Pass
Aditya Reddy,09-04-2005,223312,Andhra Pradesh,9,19,11,22,61,Pass
Aditya Verma,15-02-2006,709897,West Bengal,20,2,1,17,40,Pass
Ishaan Verma,02-03-2005,255695,Uttar Pradesh,7,5,17,22,51,Pass
Yash Chopra,03-02-2005,143339,Haryana,9,21,12,4,46,Pass
Raj Mehta,22-07-2005,462680,Karnataka,9,1,1,8,19,Pass
Balbir Pillai,04-11-2005,662968,Karnataka,21,16,6,23,66,Pass
Ishaan Fernandes,14-03-2006,256038,Rajasthan,16,8,6,23,53,Pass
Krishna Singh,19-01-2006,806053,Telangana,3,10,7,10,30,Pass
Yash Verma,20-06-2005,210675,Uttarakhand,5,13,11,18,47,Pass
Krishna Reddy,21-09-2005,945428,Telangana,7,9,7,4,27,Pass
Kunal Khan,14-11-2004,634930,Uttar Pradesh,22,5,0,9,36,Pass
Aditya Verma,25-11-2005,837432,Uttar Pradesh,23,5,5,18,51,Pass
Aarav Singh,08-01-2006,653711,Madhya Pradesh,5,7,6,21,39,Pass
Harjeet Chopra,23-04-2005,509829,Arunachal Pradesh,11,8,16,16,51,Pass
Sukhwinder D'Souza,17-11-2004,581005,Haryana,0,12,13,16,41,Pass
Rehan Mehta,24-02-2005,204749,Maharashtra,14,7,3,1,25,Pass
Aryan Verma,07-04-2006,945305,Haryana,4,21,7,7,39,Pass
Paul Khan,02-09-2005,211874,Tamil Nadu,18,14,5,1,38,Pass
Manpreet Reddy,19-09-2005,344878,Tamil Nadu,18,19,13,24,74,Pass
Kunal Chopra,27-05-2005,148375,Gujarat,17,19,9,9,54,Pass
Ayaan D'Souza,12-01-2005,183402,Andhra Pradesh,12,4,18,18,52,Pass
David Chopra,24-01-2006,853715,Rajasthan,19,15,0,5,39,Pass
Gurpreet Verma,18-07-2005,273171,Rajasthan,15,0,10,19,44,Pass
Vivaan D'Souza,16-04-2005,879752,Karnataka,19,23,3,3,48,Pass
Vivaan Singh,29-11-2005,244435,Andhra Pradesh,14,21,20,19,74,Pass
Yash Verma,10-11-2004,483848,Maharashtra,7,2,17,7,33,Pass
Aryan Fernandes,10-03-2005,725934,Karnataka,21,10,4,21,56,Pass
Balbir Reddy,30-07-2005,390113,Tamil Nadu,1,13,4,6,24,Pass
Balbir Sharma,13-11-2005,650205,Rajasthan,6,7,24,15,52,Pass
Aditya Fernandes,06-03-2006,339324,Uttar Pradesh,24,5,13,13,55,Pass
Aarav Chopra,24-11-2005,911622,Daman & Diu / D&N Haveli,6,6,9,9,30,Pass
John Sharma,15-12-2005,206645,Tamil Nadu,13,13,24,6,56,Pass
Raj Khan,18-12-2005,120254,Haryana,5,6,3,1,15,Pass
Aryan Khan,06-11-2005,588584,Kerala,19,8,19,10,56,Pass
Sukhwinder Khan,20-03-2005,225121,Odisha,0,8,5,4,17,Pass
Ishaan Mehta,03-06-2005,173632,Punjab,11,11,3,15,40,Pass
Krishna Sharma,14-08-2005,480579,Maharashtra,3,13,18,16,50,Pass
Raj Mehta,10-01-2005,161056,Maharashtra,12,3,7,12,34,Pass
Kunal Pillai,28-06-2005,920178,Assam,0,1,1,14,16,Pass
Yash Chopra,13-08-2005,951212,Rajasthan,2,16,10,18,46,Pass
Aditya Chopra,11-12-2005,792403,Madhya Pradesh,0,14,22,3,39,Pass
Gurpreet Fernandes,15-09-2005,719220,Chhattisgarh,11,0,17,23,51,Pass
Raj Singh,04-04-2006,996238,Uttar Pradesh,9,5,14,2,30,Pass
Aditya Khan,25-11-2005,603325,Madhya Pradesh,16,9,13,12,50,Pass
Imran Fernandes,07-02-2005,246203,Kerala,4,2,0,21,27,Pass
Manpreet Mehta,29-08-2005,723568,Uttarakhand,14,19,1,13,47,Pass
Aarav Fernandes,07-09-2005,775003,Himachal Pradesh,13,11,19,14,57,Pass
Aarav Fernandes,29-05-2005,908684,Rajasthan,1,16,7,23,47,Pass
Krishna Singh,12-08-2005,916082,Rajasthan,16,8,8,11,43,Pass
John Pillai,08-02-2005,131644,Punjab,15,17,23,21,76,Pass
Ayaan Khan,30-08-2005,976193,Uttar Pradesh,9,5,18,16,48,Pass
Ishaan Mehta,02-05-2005,174418,Bihar,6,21,23,19,69,Pass
Vivaan Khan,12-11-2004,357717,Uttar Pradesh,19,5,16,12,52,Pass
Aditya Verma,26-12-2004,248772,Uttar Pradesh,1,5,11,5,22,Pass
Vivaan Sharma,11-02-2005,546755,Uttar Pradesh,14,5,24,12,55,Pass
Imran Chopra,22-08-2005,903634,Tamil Nadu,7,1,10,5,23,Pass
Ayaan Mehta,06-12-2005,500593,Tamil Nadu,18,10,12,0,40,Pass
Rohan Verma,13-02-2005,429299,Rajasthan,0,18,23,12,53,Pass
Gurpreet D'Souza,15-11-2004,721107,Telangana,4,4,9,0,17,Pass
Gurpreet Sharma,09-05-2005,620688,Madhya Pradesh,0,4,12,13,29,Pass
Manpreet Pillai,20-05-2005,573136,Kerala,11,10,13,4,38,Pass
Kunal Verma,07-01-2006,576943,Karnataka,3,22,11,1,37,Pass
Yash Verma,14-01-2006,158194,Bihar,22,16,13,19,70,Pass
Ishaan Pillai,06-03-2006,427448,Punjab,22,19,3,14,58,Pass
Rohan Khan,23-10-2005,679524,Punjab,22,3,23,9,57,Pass
David Chopra,09-12-2004,624141,Madhya Pradesh,12,10,16,2,40,Pass
Aarav Reddy,08-10-2005,128375,Manipur,0,4,15,7,26,Pass
Vivaan D'Souza,17-12-2004,720147,Bihar,17,20,17,6,60,Pass
Gurpreet Chopra,17-12-2005,614561,Assam,11,8,16,12,47,Pass
Mathew D'Souza,31-07-2005,781169,Uttar Pradesh,0,5,22,1,28,Pass
Rohan Sharma,02-12-2004,237605,Kerala,2,5,24,1,32,Pass
Kunal Khan,31-03-2006,546994,Tamil Nadu,22,14,0,3,39,Pass
Manpreet Singh,26-12-2005,474129,Karnataka,6,19,3,5,33,Pass
Farhan Mehta,04-02-2006,116522,Rajasthan,14,22,3,6,45,Pass
Rohan Khan,22-04-2005,466123,West Bengal,22,0,14,13,49,Pass
Aditya Reddy,31-05-2005,925448,West Bengal,2,12,22,5,41,Pass
Rohan Sharma,03-03-2006,404306,Madhya Pradesh,7,19,21,2,49,Pass
Yash D'Souza,02-09-2005,220257,Kerala,2,12,19,15,48,Pass
Yash D'Souza,15-02-2006,976199,Tamil Nadu,13,20,9,15,57,Pass
Ishaan Sharma,12-01-2005,179268,Bihar,6,14,0,22,42,Pass
Aditya Sharma,26-07-2005,560978,Rajasthan,5,5,7,6,23,Pass
Aditya Verma,13-10-2005,514918,Bihar,4,10,14,11,39,Pass
Krishna Sharma,16-11-2005,272116,Karnataka,6,1,0,2,9,Pass
Raj Fernandes,02-06-2005,816325,Karnataka,0,5,2,6,13,Pass
David Pillai,15-12-2004,414405,West Bengal,9,4,21,2,36,Pass
Yash Khan,02-12-2005,673318,Bihar,6,2,15,1,24,Pass
Krishna Pillai,02-10-2005,208204,Rajasthan,10,2,5,23,40,Pass
Aditya Fernandes,28-10-2005,273952,Assam,8,8,8,20,44,Pass
Aditya Fernandes,04-01-2005,904710,Karnataka,4,19,7,21,51,Pass
David D'Souza,18-04-2005,594877,Jharkhand,24,7,3,0,34,Pass
Aryan Verma,17-05-2005,924224,Odisha,6,15,18,17,56,Pass
Ishaan D'Souza,09-03-2005,829332,Tamil Nadu,9,5,7,20,41,Pass
Manpreet Singh,04-12-2005,923610,Gujarat,3,23,17,4,47,Pass
Rohan Khan,09-01-2005,680924,Punjab,7,2,6,8,23,Pass
Ishaan Singh,16-03-2005,924377,Rajasthan,7,6,12,8,33,Pass
Manpreet Khan,20-09-2005,508347,Tamil Nadu,22,18,23,14,77,Pass
David D'Souza,04-06-2005,890644,Andhra Pradesh,14,4,5,23,46,Pass
Ayaan Mehta,28-10-2005,384941,Maharashtra,2,8,12,11,33,Pass
Aditya Sharma,17-03-2005,853467,Tamil Nadu,5,7,11,11,34,Pass
David D'Souza,14-03-2006,306105,Andhra Pradesh,14,19,12,10,55,Pass
Manpreet Chopra,31-01-2006,190121,Andhra Pradesh,18,14,5,2,39,Pass
Yash Mehta,10-02-2005,580935,West Bengal,6,3,5,15,29,Pass
Krishna D'Souza,23-04-2006,830406,Tamil Nadu,22,16,3,13,54,Pass
Paul Chopra,21-04-2006,460686,Chhattisgarh,2,2,17,11,32,Pass
Aditya Singh,25-10-2005,347317,Uttar Pradesh,22,5,23,7,57,Pass
Manpreet Verma,24-01-2005,707606,Chhattisgarh,21,14,10,6,51,Pass
Raj Reddy,23-02-2005,380391,Uttar Pradesh,4,5,17,18,44,Pass
Yash D'Souza,22-11-2005,796877,West Bengal,18,1,3,0,22,Pass
Yash Singh,16-05-2005,689468,Jammu & Kashmir + Ladakh,15,2,24,24,65,Pass
Ayaan Fernandes,29-06-2005,374788,Uttarakhand,3,9,23,8,43,Pass
Raj Reddy,07-06-2005,699150,West Bengal,21,1,3,0,25,Pass
Vivaan Mehta,27-03-2005,204868,Uttar Pradesh,3,5,18,1,27,Pass
Vivaan Reddy,11-02-2005,192400,Telangana,19,21,21,2,63,Pass
Rohan Singh,10-12-2005,942547,Uttar Pradesh,3,5,20,21,49,Pass
Vivaan D'Souza,29-12-2005,573147,Maharashtra,5,3,18,23,49,Pass
Paul Reddy,06-08-2005,527543,Bihar,2,21,19,15,57,Pass
Yash Mehta,20-10-2005,569663,Tamil Nadu,21,13,23,7,64,Pass
Raj Khan,27-04-2005,125587,West Bengal,15,3,13,11,42,Pass
Rohan Sharma,11-08-2005,143137,Tamil Nadu,23,21,13,7,64,Pass
Rehan Fernandes,11-01-2006,906497,Andhra Pradesh,1,19,6,0,26,Pass
Ishaan Reddy,02-05-2006,211126,Madhya Pradesh,0,17,4,19,40,Pass
Aarav Sharma,03-11-2005,142514,Odisha,3,21,13,9,46,Pass
Peter Reddy,12-01-2005,858778,Bihar,2,13,8,13,36,Pass
Peter Fernandes,23-02-2005,545161,Chhattisgarh,16,18,16,13,63,Pass
Yash Singh,28-12-2004,319781,Uttar Pradesh,9,5,21,20,55,Pass
Mathew Sharma,19-06-2005,164704,Rajasthan,0,5,17,24,46,Pass
Aryan Fernandes,06-03-2005,498826,West Bengal,4,1,14,14,33,Pass
Yash Verma,21-10-2005,599198,Kerala,0,21,0,0,21,Pass
Paul Pillai,28-04-2006,802677,Bihar,17,15,9,22,63,Pass
Paul Chopra,04-08-2005,310739,Rajasthan,8,12,13,13,46,Pass
Kunal Fernandes,12-04-2006,897017,Punjab,10,3,14,24,51,Pass
John Sharma,09-04-2005,668971,Tamil Nadu,10,1,21,21,53,Pass
Aditya Chopra,25-02-2006,737491,Bihar,4,12,1,7,24,Pass
Balbir Singh,25-01-2006,239615,Maharashtra,3,23,24,12,62,Pass
Balbir Khan,06-04-2005,702900,West Bengal,22,2,0,15,39,Pass
John Verma,09-04-2005,943665,Telangana,15,17,18,6,56,Pass
David Chopra,30-11-2005,679163,Rajasthan,11,12,7,0,30,Pass
Krishna Reddy,22-09-2005,561422,Rajasthan,23,24,1,20,68,Pass
Aryan Sharma,15-09-2005,658714,Bihar,16,3,8,19,46,Pass
Yash Khan,28-03-2006,392717,West Bengal,3,8,23,19,53,Pass
Aryan Sharma,26-10-2005,857953,Rajasthan,24,0,15,3,42,Pass
Aditya Pillai,25-12-2004,971020,Jharkhand,23,0,15,15,53,Pass
Mathew Verma,19-04-2005,641381,Karnataka,1,8,24,1,34,Pass
Vivaan Mehta,14-11-2005,629245,West Bengal,2,2,2,8,14,Pass
David Verma,27-05-2005,256806,Madhya Pradesh,17,8,16,5,46,Pass
Krishna Sharma,11-08-2005,817548,Uttar Pradesh,13,5,0,8,26,Pass
Raj Mehta,12-01-2006,744790,Uttar Pradesh,23,5,4,15,47,Pass
Farhan Fernandes,25-04-2006,158422,Madhya Pradesh,12,23,20,4,59,Pass
Raj Pillai,02-12-2005,405008,Telangana,7,23,18,7,55,Pass
Kunal Verma,10-09-2005,808363,Gujarat,2,18,15,6,41,Pass
Vivaan Pillai,25-01-2005,959307,Maharashtra,3,20,19,24,66,Pass
John Fernandes,14-04-2005,737668,Uttar Pradesh,11,5,17,10,43,Pass
Farhan Khan,03-12-2005,359547,Haryana,11,13,17,4,45,Pass
Peter D'Souza,20-03-2005,656461,Tamil Nadu,7,13,22,21,63,Pass
Rehan Mehta,19-03-2006,357367,Tamil Nadu,16,9,4,21,50,Pass
Aditya Verma,28-01-2006,216395,Rajasthan,8,8,16,14,46,Pass
Aditya D'Souza,09-09-2005,922295,Gujarat,21,7,21,18,67,Pass
Kunal Pillai,25-09-2005,748413,Rajasthan,13,20,16,21,70,Pass
Krishna Khan,08-12-2004,887999,Andhra Pradesh,16,20,5,24,65,Pass
David Reddy,07-05-2005,178786,Meghalaya,7,9,9,5,30,Pass
Aditya Fernandes,21-09-2005,775852,West Bengal,14,7,18,1,40,Pass
Rehan Chopra,22-04-2005,295958,Mizoram,15,1,3,10,29,Pass
Mathew Reddy,21-06-2005,361507,Kerala,13,0,16,24,53,Pass
Kunal Singh,12-03-2006,390196,West Bengal,14,20,7,3,44,Pass
Yash Singh,16-07-2005,513361,Maharashtra,3,19,17,22,61,Pass
Yash Verma,14-11-2004,522955,Uttar Pradesh,7,5,12,20,44,Pass
Raj Fernandes,28-02-2006,259162,Punjab,10,13,0,2,25,Pass
Ishaan Pillai,22-09-2005,325249,Jharkhand,9,10,10,23,52,Pass
Krishna Pillai,27-05-2005,354921,Punjab,6,6,15,17,44,Pass
Kunal Reddy,19-09-2005,272779,Nagaland,4,9,13,7,33,Pass
Aditya Verma,23-11-2004,391585,Jharkhand,22,0,21,7,50,Pass
Krishna Verma,11-04-2005,814455,Uttarakhand,18,11,6,0,35,Pass
Aditya Chopra,30-03-2005,904523,Gujarat,1,2,2,4,9,Pass
Paul Sharma,02-12-2004,460152,Uttar Pradesh,7,5,22,13,47,Pass
Yash Singh,15-02-2006,673706,Karnataka,17,18,11,6,52,Pass
Kunal D'Souza,07-12-2005,610676,Karnataka,8,7,11,12,38,Pass
Ishaan D'Souza,20-01-2006,547872,Uttar Pradesh,3,5,6,23,37,Pass
Aarav Chopra,08-11-2004,484765,Haryana,15,15,1,20,51,Pass
Balbir Khan,20-09-2005,410413,Tamil Nadu,5,22,7,1,35,Pass
Aarav Pillai,17-04-2005,203319,Haryana,8,1,13,5,27,Pass
Raj D'Souza,04-01-2006,743574,Rajasthan,6,13,3,10,32,Pass
David Fernandes,09-01-2006,462526,Himachal Pradesh,5,6,8,6,25,Pass
Ishaan Khan,31-01-2006,592032,Telangana,18,16,2,10,46,Pass
Aarav Singh,26-07-2005,472179,Maharashtra,3,10,13,6,32,Pass
Aditya Reddy,07-05-2005,337765,Uttar Pradesh,14,5,12,6,37,Pass
Raj Sharma,19-04-2006,136898,Karnataka,9,18,21,11,59,Pass
Aditya Verma,02-01-2005,994269,Uttar Pradesh,1,5,14,22,42,Pass
Ishaan Khan,14-04-2005,456515,Rajasthan,7,16,6,20,49,Pass
Kunal Fernandes,17-03-2005,767455,Chhattisgarh,4,5,17,14,40,Pass
Aarav D'Souza,31-07-2005,877460,Kerala,8,9,20,1,38,Pass
Rohan Verma,29-11-2005,615208,Uttar Pradesh,21,5,12,15,53,Pass
Paul Verma,15-11-2005,805634,Haryana,16,20,6,4,46,Pass
Aryan Pillai,24-11-2005,442094,Odisha,18,8,3,1,30,Pass
Ishaan Khan,06-10-2005,186614,Karnataka,14,5,14,16,49,Pass
Gurpreet Verma,05-09-2005,878628,Haryana,18,20,4,13,55,Pass
Aarav Verma,15-09-2005,458265,Tamil Nadu,9,4,15,0,28,Pass
Ishaan Khan,29-10-2005,870321,Haryana,15,18,16,5,54,Pass
Rohan Mehta,10-02-2005,286113,Odisha,4,3,2,17,26,Pass
Kunal D'Souza,24-12-2004,643281,Madhya Pradesh,6,22,6,1,35,Pass
Aryan Chopra,06-09-2005,392616,Madhya Pradesh,9,15,10,8,42,Pass
Balbir D'Souza,09-01-2005,129582,Uttar Pradesh,8,5,18,3,34,Pass
Yash Khan,24-11-2004,209984,Tamil Nadu,3,17,22,9,51,Pass
Krishna Sharma,26-09-2005,940737,Maharashtra,3,24,10,10,47,Pass
Ishaan Reddy,17-10-2005,514946,Uttar Pradesh,13,5,9,1,28,Pass
Vivaan Singh,27-04-2006,400588,Bihar,4,2,7,22,35,Pass
John Fernandes,22-12-2005,983760,Goa,0,21,1,11,33,Pass
Kunal Sharma,11-12-2004,823786,Bihar,22,21,1,11,55,Pass
Kunal Mehta,23-11-2004,804383,Madhya Pradesh,15,6,9,12,42,Pass
Aryan Verma,26-02-2006,957564,Haryana,3,22,5,16,46,Pass
Manpreet Khan,10-04-2006,812650,Maharashtra,14,11,3,0,28,Pass
Zaid Chopra,08-09-2005,214077,Telangana,18,5,22,4,49,Pass
Krishna Mehta,11-02-2005,640309,Chhattisgarh,24,24,3,5,56,Pass
Aryan Khan,27-10-2005,304688,Chhattisgarh,21,14,24,15,74,Pass
Rohan Khan,23-01-2006,307964,Andhra Pradesh,16,22,7,2,47,Pass
Krishna Pillai,31-01-2006,924253,Bihar,18,6,19,20,63,Pass
Rohan Khan,15-11-2004,926476,Bihar,20,17,7,19,63,Pass
John Khan,22-03-2005,282310,Rajasthan,15,12,17,2,46,Pass
Farhan Reddy,16-09-2005,372890,Madhya Pradesh,2,24,5,17,48,Pass
Rohan Fernandes,17-03-2005,453038,Uttarakhand,3,19,17,23,62,Pass
Yash Sharma,18-07-2005,405718,Uttar Pradesh,4,5,17,7,33,Pass
Aditya Verma,16-01-2006,601049,Himachal Pradesh,3,13,3,4,23,Pass
Vivaan Singh,29-12-2005,708498,Odisha,17,24,7,17,65,Pass
Ayaan Reddy,30-09-2005,558790,Andhra Pradesh,1,6,15,19,41,Pass
Krishna Pillai,19-07-2005,815098,Punjab,6,5,20,7,38,Pass
Harjeet Singh,14-03-2005,630195,Meghalaya,13,4,10,4,31,Pass
David Reddy,05-07-2005,498361,Haryana,6,20,0,24,50,Pass
Raj Mehta,27-11-2004,563327,Tamil Nadu,13,8,16,14,51,Pass
Manpreet Fernandes,31-07-2005,265323,Bihar,17,21,15,0,53,Pass
Aarav Mehta,13-12-2005,563727,Kerala,21,20,15,0,56,Pass
Aryan Mehta,10-11-2005,906735,Gujarat,16,12,21,8,57,Pass
Yash Khan,31-12-2005,521159,Maharashtra,6,21,19,0,46,Pass
Vivaan D'Souza,04-06-2005,770214,Tamil Nadu,14,24,7,8,53,Pass
Yash Pillai,20-06-2005,265443,Assam,7,8,4,3,22,Pass
Aditya Mehta,01-11-2005,120997,Karnataka,14,0,9,6,29,Pass
Gurpreet Chopra,19-12-2005,529947,Andhra Pradesh,21,1,15,6,43,Pass
Vivaan Verma,18-12-2005,130440,Gujarat,15,1,23,11,50,Pass
Manpreet Mehta,24-12-2004,803634,Jharkhand,24,4,8,14,50,Pass
Aditya D'Souza,17-03-2006,764948,Tamil Nadu,12,0,14,10,36,Pass
Sukhwinder Reddy,03-11-2005,402616,Madhya Pradesh,3,6,6,7,22,Pass
Farhan Verma,07-08-2005,293606,Telangana,3,13,23,0,39,Pass
Imran Chopra,25-12-2005,899132,Rajasthan,21,21,17,11,70,Pass
Gurpreet D'Souza,21-07-2005,120661,Jammu & Kashmir + Ladakh,24,5,15,3,47,Pass
David Fernandes,01-12-2004,978970,Telangana,17,0,11,11,39,Pass
Ishaan Pillai,27-11-2004,852574,Rajasthan,7,1,0,1,9,Pass
Krishna Pillai,05-03-2006,913203,Chhattisgarh,24,13,12,9,58,Pass
Ayaan Verma,12-11-2004,585747,Uttar Pradesh,1,5,0,6,12,Pass
Vivaan Mehta,07-06-2005,436178,Tamil Nadu,5,15,9,8,37,Pass
Rohan Singh,09-03-2006,238519,Uttarakhand,20,11,6,4,41,Pass
Harjeet Khan,20-01-2006,421893,Maharashtra,19,12,5,3,39,Pass
Rohan Fernandes,18-04-2006,543654,Uttarakhand,1,19,1,24,45,Pass
Imran Mehta,19-05-2005,171371,Himachal Pradesh,14,7,18,15,54,Pass
John D'Souza,25-04-2006,537139,Maharashtra,13,8,8,1,30,Pass
Peter Singh,23-10-2005,899207,Tripura,10,0,16,1,27,Pass
Yash Pillai,04-06-2005,549981,Punjab,2,12,20,23,57,Pass
Rehan Fernandes,16-03-2005,300966,Punjab,11,20,23,1,55,Pass
Kunal Sharma,02-11-2005,485448,West Bengal,1,0,12,12,25,Pass
Ishaan Khan,22-04-2005,507635,Jammu & Kashmir + Ladakh,2,18,20,10,50,Pass
Aditya Verma,29-06-2005,467104,Haryana,0,4,3,20,27,Pass
Raj Reddy,29-03-2005,650220,Uttar Pradesh,22,5,4,4,35,Pass
Zaid Mehta,29-10-2005,823959,Delhi,9,15,6,15,45,Fail
Raj Sharma,18-01-2006,419244,Rajasthan,17,6,15,4,42,Pass
Farhan Singh,11-01-2005,474463,Uttar Pradesh,9,5,16,15,45,Pass
Rohan D'Souza,03-12-2004,302655,Mizoram,5,10,1,18,34,Pass
Zaid Sharma,02-06-2005,654582,Punjab,13,15,11,17,56,Pass
Aryan D'Souza,31-03-2006,561912,Jharkhand,22,0,3,4,29,Pass
Peter Verma,30-09-2005,899440,Assam,0,8,8,17,33,Pass
Harjeet Khan,04-05-2005,754486,Uttar Pradesh,18,5,13,15,51,Pass
Yash Khan,29-07-2005,945996,West Bengal,2,3,12,8,25,Pass
Krishna Khan,29-03-2005,690591,Uttar Pradesh,18,5,24,5,52,Pass
Raj D'Souza,19-08-2005,610909,Uttar Pradesh,16,5,2,24,47,Pass
Vivaan Fernandes,14-02-2006,371789,Uttar Pradesh,3,5,11,24,43,Pass
Rohan Sharma,08-03-2006,222356,Bihar,13,23,23,4,63,Pass
Aditya Chopra,01-01-2005,459700,Bihar,6,23,22,4,55,Pass
Sukhwinder Khan,02-12-2004,862982,Madhya Pradesh,7,21,8,8,44,Pass
Krishna Sharma,04-09-2005,765095,Tamil Nadu,5,8,19,7,39,Pass
Ishaan Verma,21-01-2006,571670,Rajasthan,6,1,11,11,29,Pass
Kunal Verma,10-02-2006,640046,Uttarakhand,8,1,13,8,30,Pass
Aryan Reddy,21-03-2005,695075,Haryana,20,11,22,15,68,Pass
Sukhwinder Pillai,12-08-2005,324783,Punjab,3,19,20,11,53,Pass
Raj Chopra,09-07-2005,353171,Tamil Nadu,20,14,9,11,54,Pass
Sukhwinder D'Souza,25-09-2005,938838,Tamil Nadu,21,9,5,13,48,Pass
Ishaan Mehta,20-12-2005,832976,Rajasthan,13,11,20,16,60,Pass
Kunal Pillai,27-09-2005,944712,Uttar Pradesh,8,5,14,3,30,Pass
Sukhwinder Khan,17-02-2006,978161,Gujarat,22,22,17,22,83,Pass
Gurpreet Khan,15-08-2005,135909,Tamil Nadu,0,23,17,15,55,Pass
Mathew Singh,06-12-2004,185053,Kerala,5,7,6,24,42,Pass
Ishaan Verma,10-06-2005,232172,Andhra Pradesh,2,18,6,13,39,Pass
Aarav Pillai,21-11-2004,568650,Meghalaya,22,2,19,13,56,Pass
Ishaan Verma,21-08-2005,154903,Tamil Nadu,4,16,24,1,45,Pass
Imran Mehta,14-12-2004,713348,Punjab,22,6,22,9,59,Pass
Peter Reddy,23-08-2005,573241,Odisha,15,16,1,19,51,Pass
Aditya Reddy,27-09-2005,598898,Bihar,6,2,4,10,22,Pass
Raj Reddy,20-09-2005,753643,Tamil Nadu,3,15,2,7,27,Pass
Peter Singh,27-10-2005,869200,Bihar,19,22,10,6,57,Pass
Kunal D'Souza,16-01-2006,122255,Delhi,17,2,3,15,37,Fail
Ishaan Reddy,09-03-2006,459724,Maharashtra,3,3,23,16,45,Pass
Yash Chopra,17-03-2005,351591,Andhra Pradesh,20,5,1,20,46,Pass
Aditya Pillai,17-04-2005,872862,Maharashtra,3,15,18,24,60,Pass
Aryan Chopra,25-12-2004,660886,Madhya Pradesh,6,13,17,16,52,Pass
Raj D'Souza,27-03-2006,937595,Andhra Pradesh,3,7,3,3,16,Pass
Kunal Chopra,17-02-2006,300470,Punjab,0,2,22,14,38,Pass
Kunal Sharma,30-12-2005,856231,Andhra Pradesh,13,3,5,15,36,Pass
Kunal Sharma,15-04-2006,102107,Haryana,5,6,16,24,51,Pass
Rohan Mehta,23-12-2004,147826,Uttar Pradesh,23,5,17,13,58,Pass
Aarav Pillai,23-08-2005,125270,Kerala,5,7,7,13,32,Pass
Balbir Fernandes,17-10-2005,226964,Maharashtra,15,0,4,3,22,Pass
Sukhwinder Khan,12-08-2005,448955,Odisha,3,3,19,2,27,Pass
David Pillai,21-03-2006,449175,Maharashtra,9,0,10,16,35,Pass
Rohan Chopra,04-03-2005,816753,Sikkim,20,5,22,8,55,Pass
Aryan Mehta,01-05-2006,375307,Rajasthan,12,10,2,14,38,Pass
Paul Reddy,02-02-2006,943848,Jharkhand,10,12,12,12,46,Pass
Yash D'Souza,23-01-2006,146821,Assam,0,22,5,2,29,Pass
Ayaan Verma,12-01-2006,950319,Assam,5,10,12,3,30,Pass
Aditya Chopra,01-07-2005,812418,Telangana,22,11,2,3,38,Pass
Peter Verma,24-04-2006,542485,Maharashtra,12,18,8,6,44,Pass
Mathew Pillai,12-01-2005,965484,Punjab,4,19,4,9,36,Pass
Gurpreet Fernandes,12-04-2006,196750,Assam,10,12,11,13,46,Pass
Harjeet Fernandes,18-03-2006,994595,Bihar,3,12,16,7,38,Pass
Aryan Singh,22-01-2006,372756,Rajasthan,3,24,11,11,49,Pass
Yash Mehta,02-09-2005,547112,Assam,2,21,14,4,41,Pass
Aarav Mehta,29-12-2005,734556,Uttar Pradesh,19,5,3,24,51,Pass
Paul Singh,05-01-2006,547076,Uttar Pradesh,23,5,2,24,54,Pass
Yash Pillai,19-02-2005,508302,Uttar Pradesh,13,5,3,22,43,Pass
Aryan D'Souza,25-07-2005,151391,Madhya Pradesh,22,15,7,4,48,Pass
Rohan Singh,11-09-2005,397207,Tamil Nadu,12,13,2,19,46,Pass
Manpreet Khan,18-04-2006,254013,Madhya Pradesh,17,17,13,5,52,Pass
Yash Fernandes,08-10-2005,162742,Gujarat,23,3,12,4,42,Pass
Rehan Pillai,21-04-2005,193068,Rajasthan,3,5,1,6,15,Pass
Aditya Sharma,25-10-2005,249723,Uttar Pradesh,17,5,13,14,49,Pass
Rohan Verma,24-12-2004,859505,Uttar Pradesh,11,5,2,10,28,Pass
Vivaan D'Souza,12-01-2005,301605,Gujarat,12,17,13,14,56,Pass
Rohan Chopra,03-08-2005,979502,Maharashtra,0,11,24,13,48,Pass
Sukhwinder Sharma,28-07-2005,141281,Tamil Nadu,17,18,6,24,65,Pass
Harjeet Verma,15-05-2005,544031,West Bengal,20,4,16,7,47,Pass
Ayaan Fernandes,14-12-2005,642145,Gujarat,15,13,1,7,36,Pass
Ishaan Verma,21-04-2006,662562,Uttar Pradesh,0,5,9,21,35,Pass
Ishaan Fernandes,07-07-2005,399898,Telangana,16,3,0,17,36,Pass
Rehan Reddy,14-01-2006,619637,Madhya Pradesh,16,1,23,4,44,Pass
Aditya Pillai,14-05-2005,373286,Uttar Pradesh,14,5,23,8,50,Pass
Aditya Chopra,05-05-2006,281166,Bihar,23,13,22,0,58,Pass
Kunal Khan,18-11-2005,763509,Kerala,9,7,0,11,27,Pass
Rohan Khan,01-04-2005,439769,Daman & Diu / D&N Haveli,6,6,9,9,30,Pass
Yash Fernandes,06-05-2005,339341,Maharashtra,3,23,22,23,71,Pass
Kunal Singh,09-12-2004,304517,Uttar Pradesh,5,5,1,19,30,Pass
Harjeet D'Souza,22-03-2006,122870,Arunachal Pradesh,13,7,16,16,52,Pass
Aryan Khan,03-01-2006,548252,Rajasthan,9,2,20,12,43,Pass
Yash Fernandes,26-12-2005,158212,Bihar,2,9,9,8,28,Pass
Kunal D'Souza,19-03-2006,792462,Odisha,17,16,4,20,57,Pass
Ishaan Sharma,26-09-2005,458946,Odisha,8,15,12,0,35,Pass
Yash D'Souza,11-08-2005,982983,Bihar,24,18,6,0,48,Pass
Rohan Mehta,31-03-2005,201153,Bihar,2,17,20,0,39,Pass
Manpreet D'Souza,23-03-2006,773737,Bihar,17,5,9,23,54,Pass
Aditya Khan,28-12-2004,296234,Sikkim,3,5,17,6,31,Pass
Vivaan Khan,20-12-2005,610008,West Bengal,22,8,8,4,42,Pass
Rohan Pillai,04-05-2005,127184,Andhra Pradesh,17,22,5,22,66,Pass
Paul Reddy,07-04-2005,799575,Telangana,3,3,23,20,49,Pass
Kunal Khan,25-03-2005,542467,Haryana,5,12,19,24,60,Pass
Ishaan Reddy,08-11-2005,360473,Madhya Pradesh,10,23,14,4,51,Pass
Kunal Khan,09-06-2005,491416,Jharkhand,20,7,22,1,50,Pass
Yash Singh,06-10-2005,493811,Uttar Pradesh,9,5,8,4,26,Pass
Aryan Chopra,28-08-2005,685970,Bihar,12,13,2,5,32,Pass
Ishaan Reddy,08-09-2005,559352,Uttar Pradesh,10,5,17,10,42,Pass
Imran Pillai,06-03-2005,110136,Chhattisgarh,6,12,23,9,50,Pass
Vivaan Chopra,28-10-2005,287841,Kerala,8,9,22,15,54,Pass
John Fernandes,23-10-2005,185408,Bihar,18,22,20,1,61,Pass
Manpreet D'Souza,19-02-2005,769291,Punjab,11,19,8,11,49,Pass
Vivaan Chopra,22-03-2005,738119,Assam,3,3,16,7,29,Pass
Balbir Sharma,21-06-2005,892906,Telangana,3,8,23,13,47,Pass
Yash Fernandes,12-11-2005,219127,Tamil Nadu,24,5,16,4,49,Pass
Ishaan Sharma,27-08-2005,414510,Tamil Nadu,22,3,23,20,68,Pass
Yash Sharma,23-01-2005,115495,Punjab,2,4,13,22,41,Pass
Raj Fernandes,28-01-2006,929219,Uttar Pradesh,14,5,5,3,27,Pass
Aryan Sharma,01-04-2006,756097,Rajasthan,4,9,6,12,31,Pass
Rohan D'Souza,10-10-2005,526041,Tamil Nadu,19,5,6,3,33,Pass
Kunal Pillai,25-12-2005,160529,Maharashtra,3,8,2,19,32,Pass
Krishna Chopra,11-08-2005,754240,Punjab,21,3,17,7,48,Pass
Harjeet Reddy,20-09-2005,463914,Uttar Pradesh,9,5,11,22,47,Pass
Imran Khan,12-06-2005,742039,Madhya Pradesh,21,2,2,13,38,Pass
Ishaan D'Souza,23-11-2004,257386,Madhya Pradesh,11,15,6,22,54,Pass
Zaid Pillai,24-02-2005,695571,Uttar Pradesh,17,5,18,4,44,Pass
Ayaan Verma,12-04-2005,955548,Haryana,16,2,11,20,49,Pass
Ishaan Singh,04-01-2006,668651,Punjab,3,16,21,0,40,Pass
Vivaan Singh,18-04-2005,399198,Kerala,5,2,0,5,12,Pass
Ishaan Singh,20-11-2004,733780,Uttar Pradesh,7,5,6,24,42,Pass
Aarav Pillai,16-02-2005,350960,Haryana,9,9,14,5,37,Pass
Aditya Mehta,24-12-2004,155158,Haryana,14,21,1,23,59,Pass
Sukhwinder Mehta,23-02-2006,369669,Bihar,22,0,24,8,54,Pass
Peter Pillai,25-04-2005,708749,Delhi,19,17,12,7,55,Fail
Aditya D'Souza,04-02-2006,900391,Telangana,9,0,17,0,26,Pass
Sukhwinder Khan,06-02-2006,185714,Tamil Nadu,5,7,23,20,55,Pass
Rohan Khan,06-09-2005,174630,Haryana,12,4,22,3,41,Pass
Mathew Chopra,18-09-2005,732155,Karnataka,0,5,7,0,12,Pass
Rohan Pillai,06-01-2005,369651,Rajasthan,6,2,7,22,37,Pass
Yash Chopra,14-04-2005,839159,Tamil Nadu,8,4,22,10,44,Pass
Paul Chopra,26-01-2006,475284,Jammu & Kashmir + Ladakh,1,17,18,6,42,Pass
Aarav Mehta,22-04-2005,846144,Bihar,23,11,12,12,58,Pass
Aryan Pillai,28-06-2005,884032,Tamil Nadu,8,1,12,20,41,Pass
Sukhwinder Reddy,30-07-2005,612315,Tamil Nadu,8,17,8,11,44,Pass
Aditya Reddy,19-03-2006,632159,Bihar,7,7,21,17,52,Pass
Farhan Singh,06-08-2005,637915,Haryana,5,0,17,17,39,Pass
Vivaan Sharma,25-08-2005,661367,Maharashtra,17,1,2,24,44,Pass
Paul Reddy,25-03-2005,225484,Himachal Pradesh,23,1,2,24,50,Pass
Yash Sharma,25-07-2005,668791,Uttar Pradesh,16,5,5,8,34,Pass
Yash D'Souza,11-05-2005,508080,Jharkhand,11,1,4,6,22,Pass
Peter Singh,04-10-2005,796759,Maharashtra,3,16,24,21,64,Pass
Aarav Sharma,09-02-2006,313236,Rajasthan,12,18,22,21,73,Pass
Sukhwinder Verma,06-06-2005,894275,Chhattisgarh,4,7,6,9,26,Pass
Imran Khan,27-12-2005,571600,Odisha,15,2,6,1,24,Pass
Aarav Chopra,28-01-2005,239849,Andhra Pradesh,8,8,3,17,36,Pass
Harjeet D'Souza,08-03-2005,623710,Bihar,13,18,23,10,64,Pass
Rehan Sharma,18-03-2006,574597,Uttar Pradesh,6,5,9,3,23,Pass
Raj Singh,23-10-2005,925920,Haryana,24,6,0,10,40,Pass
Aarav Chopra,16-01-2005,181909,Delhi,9,13,5,17,44,Fail
Aditya Mehta,25-03-2005,922728,Bihar,23,22,23,9,77,Pass
Harjeet Pillai,31-03-2006,514313,Andhra Pradesh,13,22,4,5,44,Pass
Harjeet Singh,21-11-2005,307914,Tamil Nadu,23,5,1,11,40,Pass
Aarav Singh,01-06-2005,302963,Maharashtra,3,18,12,21,54,Pass
Harjeet Chopra,17-07-2005,918852,Madhya Pradesh,0,10,19,5,34,Pass
Gurpreet Pillai,07-04-2006,950592,Uttar Pradesh,15,5,1,21,42,Pass
Yash Pillai,23-03-2005,886848,Arunachal Pradesh,3,1,12,6,22,Pass
Kunal Chopra,27-01-2005,554339,Himachal Pradesh,12,8,4,7,31,Pass
Aditya Pillai,06-02-2006,312054,Rajasthan,14,2,21,6,43,Pass
Manpreet Pillai,13-11-2005,873589,Punjab,16,6,7,13,42,Pass
Aditya Verma,13-11-2005,300635,Rajasthan,16,4,8,4,32,Pass
John Pillai,26-09-2005,397080,Uttar Pradesh,22,5,11,9,47,Pass
Sukhwinder Mehta,20-11-2004,960595,Tamil Nadu,13,18,3,19,53,Pass
Kunal Verma,28-10-2005,838441,Uttar Pradesh,13,5,7,21,46,Pass
Aditya Sharma,17-02-2005,765761,Nagaland,9,5,13,10,37,Pass
Aarav Sharma,23-03-2005,380252,Maharashtra,3,16,17,7,43,Pass
Aarav Verma,17-12-2005,911308,Tamil Nadu,3,3,0,23,29,Pass
Gurpreet Verma,12-01-2005,751324,Mizoram,2,4,5,5,16,Pass
Balbir Khan,23-03-2006,474091,Bihar,11,3,14,20,48,Pass
Kunal Fernandes,10-03-2006,141737,Bihar,9,11,1,14,35,Pass
Raj Fernandes,29-03-2006,852961,Telangana,0,12,8,1,21,Pass
Krishna Mehta,13-04-2006,262960,Assam,5,9,6,14,34,Pass
John Verma,31-08-2005,901048,Assam,8,22,8,6,44,Pass
Yash Khan,25-04-2006,945347,Madhya Pradesh,4,6,7,12,29,Pass
Krishna Khan,17-10-2005,164769,Maharashtra,18,21,6,1,46,Pass
Sukhwinder Khan,05-08-2005,947820,West Bengal,3,15,20,20,58,Pass
Rohan Sharma,08-12-2005,593190,Rajasthan,19,13,10,17,59,Pass
Aryan Khan,31-10-2005,784667,Manipur,14,0,5,17,36,Pass
Aarav Reddy,08-07-2005,769349,Madhya Pradesh,4,2,11,6,23,Pass
Ayaan Singh,29-04-2005,959346,Karnataka,2,3,16,13,34,Pass
Krishna D'Souza,22-01-2006,668795,Jammu & Kashmir + Ladakh,1,13,9,14,37,Pass
Rohan Chopra,27-03-2006,404487,Maharashtra,14,3,3,10,30,Pass
Aryan Chopra,03-04-2006,882666,Chhattisgarh,16,11,22,9,58,Pass
Gurpreet Mehta,14-02-2005,854055,West Bengal,13,15,1,9,38,Pass
Imran Verma,24-03-2006,301784,Uttarakhand,3,13,6,14,36,Pass
Raj Reddy,07-10-2005,783198,Uttar Pradesh,18,5,14,12,49,Pass
Krishna Fernandes,17-11-2005,195583,Maharashtra,3,6,7,14,30,Pass
Raj Sharma,21-04-2005,911306,Rajasthan,2,24,16,2,44,Pass
Ishaan Khan,27-09-2005,310498,Uttar Pradesh,3,5,4,8,20,Pass
Raj Sharma,25-12-2004,396191,Rajasthan,15,23,6,13,57,Pass
Vivaan Chopra,10-08-2005,689106,Jammu & Kashmir + Ladakh,4,15,12,23,54,Pass
Aarav Verma,08-05-2006,501856,Bihar,17,12,12,12,53,Pass
Paul Reddy,16-08-2005,627039,Uttar Pradesh,12,5,12,21,50,Pass
Kunal Reddy,10-12-2004,653633,Madhya Pradesh,4,2,13,9,28,Pass
Manpreet Verma,14-06-2005,350752,Andhra Pradesh,10,18,14,14,56,Pass
Vivaan Mehta,09-02-2006,685383,Uttar Pradesh,3,5,16,24,48,Pass
Aditya Singh,23-06-2005,355656,Bihar,14,0,20,24,58,Pass
Ishaan Verma,08-08-2005,884156,Madhya Pradesh,4,11,16,10,41,Pass
Rohan Fernandes,04-04-2006,738147,Andhra Pradesh,5,10,16,11,42,Pass
Yash D'Souza,07-10-2005,662812,Maharashtra,1,6,21,15,43,Pass
Mathew Singh,19-08-2005,651704,Rajasthan,0,23,2,8,33,Pass
Rohan Pillai,14-01-2005,793407,Maharashtra,3,17,21,11,52,Pass
Aarav Sharma,16-01-2005,704056,Rajasthan,23,2,0,17,42,Pass
Manpreet Chopra,12-07-2005,934668,Rajasthan,14,3,10,9,36,Pass
Rohan Khan,28-12-2005,776132,Rajasthan,0,10,18,3,31,Pass
Manpreet Verma,04-09-2005,132964,Rajasthan,8,22,21,6,57,Pass
Aryan Sharma,26-02-2006,746504,Delhi,18,17,12,19,66,Fail
Rohan Fernandes,23-01-2006,796718,Bihar,23,17,4,7,51,Pass
Aditya Pillai,27-12-2004,426733,Jharkhand,20,11,12,11,54,Pass
Balbir D'Souza,20-02-2006,381809,West Bengal,12,0,19,11,42,Pass
Aditya Mehta,14-09-2005,841677,Andhra Pradesh,13,16,17,11,57,Pass
Manpreet Khan,08-07-2005,651586,Punjab,13,23,3,21,60,Pass
Ayaan Verma,04-03-2005,553179,Maharashtra,3,24,7,10,44,Pass
Aarav Mehta,31-12-2004,759177,Bihar,15,8,14,1,38,Pass
Rohan Chopra,17-02-2006,912980,Andaman & Nicobar,18,18,12,4,52,Fail
Mathew Verma,13-03-2006,330133,Telangana,16,6,19,19,60,Pass
Raj Chopra,23-10-2005,364015,West Bengal,18,8,18,2,46,Pass
Rohan Khan,08-07-2005,771959,Assam,1,8,24,21,54,Pass
Mathew Mehta,23-11-2005,738304,Andhra Pradesh,6,24,15,11,56,Pass
Aarav Mehta,12-04-2005,720039,Bihar,6,22,19,5,52,Pass
Balbir Mehta,17-08-2005,781176,Telangana,19,4,3,15,41,Pass
Ishaan Khan,08-02-2006,110771,Madhya Pradesh,18,10,24,4,56,Pass
Mathew Singh,14-11-2005,203881,Gujarat,0,7,19,2,28,Pass
Vivaan Fernandes,13-08-2005,360661,West Bengal,1,18,12,21,52,Pass
Aarav Sharma,17-04-2006,747523,Kerala,17,2,16,6,41,Pass
Krishna Mehta,22-11-2004,650894,Rajasthan,19,2,17,22,60,Pass
Aditya Mehta,08-12-2004,816886,Bihar,18,2,20,9,49,Pass
Paul Sharma,10-11-2004,877685,Telangana,10,20,19,13,62,Pass
Harjeet D'Souza,05-11-2005,459153,Karnataka,7,14,6,15,42,Pass
Aryan Verma,20-02-2006,804218,Bihar,4,13,9,0,26,Pass
Ishaan Verma,17-03-2005,505627,Rajasthan,3,4,19,12,38,Pass
Balbir Verma,27-06-2005,340852,West Bengal,3,24,9,12,48,Pass
Krishna Singh,07-01-2006,715737,West Bengal,3,13,18,24,58,Pass
Kunal Sharma,03-04-2006,928769,Odisha,20,17,6,10,53,Pass
Harjeet Reddy,26-01-2005,269701,West Bengal,12,10,9,11,42,Pass
Krishna D'Souza,16-08-2005,348276,Uttar Pradesh,1,5,17,13,36,Pass
Aditya Sharma,10-10-2005,856885,Chhattisgarh,20,17,21,8,66,Pass
David Pillai,18-10-2005,224904,Odisha,1,15,2,18,36,Pass
Harjeet Chopra,27-04-2006,379367,Rajasthan,7,0,22,3,32,Pass
Sukhwinder Singh,25-03-2005,982359,Punjab,13,1,12,3,29,Pass
Aarav Pillai,03-12-2004,253618,West Bengal,3,10,24,15,52,Pass
Sukhwinder Fernandes,09-10-2005,192324,Madhya Pradesh,11,9,0,12,32,Pass
Zaid D'Souza,10-07-2005,896636,Karnataka,1,2,13,5,21,Pass
Paul Sharma,07-04-2006,768828,West Bengal,3,8,24,4,39,Pass
Aarav Mehta,09-05-2006,627475,Bihar,9,5,5,3,22,Pass
Vivaan Singh,30-01-2006,841858,Rajasthan,9,12,15,18,54,Pass
Kunal Khan,08-12-2005,997877,Punjab,0,18,24,3,45,Pass
Sukhwinder Singh,23-06-2005,750990,Bihar,22,1,15,5,43,Pass
Rohan Mehta,14-03-2005,585321,Karnataka,18,7,11,0,36,Pass
Aditya Verma,17-10-2005,993561,Andhra Pradesh,4,19,10,23,56,Pass
Peter Verma,30-09-2005,144831,Kerala,19,3,16,15,53,Pass
Ishaan Mehta,24-06-2005,638462,Karnataka,12,2,2,20,36,Pass
Vivaan Mehta,25-01-2005,161219,Delhi,15,17,17,13,62,Fail
Krishna Mehta,17-03-2006,844595,Karnataka,10,7,5,10,32,Pass
Ishaan Singh,20-01-2005,771919,Punjab,23,18,18,3,62,Pass
Kunal Reddy,10-02-2006,634718,Telangana,5,11,12,5,33,Pass
Ishaan D'Souza,29-10-2005,519494,West Bengal,4,14,2,14,34,Pass
Ishaan Verma,14-04-2005,405213,Karnataka,17,0,21,7,45,Pass
Sukhwinder Reddy,05-01-2006,669271,Uttar Pradesh,9,5,23,24,61,Pass
Ishaan Khan,30-10-2005,472081,Uttarakhand,3,10,23,18,54,Pass
Aarav Chopra,06-01-2005,216322,Karnataka,19,19,0,24,62,Pass
Ishaan Khan,03-02-2005,112794,Jammu & Kashmir + Ladakh,22,13,11,7,53,Pass
Ishaan Pillai,06-02-2006,235287,West Bengal,3,24,16,8,51,Pass
Kunal Sharma,22-07-2005,502532,Tamil Nadu,17,19,16,3,55,Pass
David Verma,07-06-2005,887705,Odisha,16,14,17,20,67,Pass
Krishna D'Souza,12-02-2005,877660,Bihar,9,21,2,21,53,Pass
Krishna Fernandes,17-11-2004,129849,Haryana,22,3,21,19,65,Pass
Peter Fernandes,17-07-2005,445358,Punjab,1,16,8,19,44,Pass
Yash Pillai,28-02-2005,956194,Tamil Nadu,3,21,9,18,51,Pass
Yash D'Souza,21-07-2005,742356,Telangana,23,7,3,3,36,Pass
Aditya Fernandes,13-04-2005,643993,West Bengal,11,10,10,5,36,Pass
Vivaan Singh,11-02-2006,933897,Maharashtra,12,4,16,7,39,Pass
Harjeet Mehta,25-02-2006,571061,Jharkhand,8,5,5,8,26,Pass
Raj Fernandes,22-04-2006,986683,Maharashtra,0,5,9,1,15,Pass
Aditya Chopra,14-12-2004,997884,Gujarat,18,10,22,12,62,Pass
Vivaan Pillai,14-06-2005,182527,Bihar,13,7,6,18,44,Pass
Aryan Fernandes,15-01-2005,147741,Madhya Pradesh,22,11,15,4,52,Pass
Gurpreet Sharma,08-11-2005,364233,Odisha,17,0,16,15,48,Pass
Aditya Khan,06-08-2005,855442,Maharashtra,3,15,12,14,44,Pass
Aditya Verma,17-02-2006,703982,Bihar,23,17,18,15,73,Pass
Aryan Khan,29-03-2005,139391,Gujarat,17,4,5,19,45,Pass
Yash Pillai,04-07-2005,359412,Bihar,0,5,6,14,25,Pass
Rohan Khan,02-09-2005,982444,Rajasthan,19,11,1,19,50,Pass
Mathew Sharma,15-08-2005,420516,Uttar Pradesh,8,5,5,2,20,Pass
Yash Singh,19-11-2004,541444,West Bengal,15,15,8,15,53,Pass
Kunal Sharma,14-12-2004,756057,Haryana,11,3,19,18,51,Pass
Manpreet Chopra,23-10-2005,999633,Uttar Pradesh,3,5,19,21,48,Pass
Raj Fernandes,04-05-2006,333676,Assam,2,11,4,16,33,Pass
Peter Fernandes,02-05-2005,737215,Jharkhand,2,7,2,0,11,Pass
Rohan Sharma,16-03-2006,532215,Jharkhand,2,16,18,15,51,Pass
Peter Singh,10-01-2005,444914,Jharkhand,22,20,0,17,59,Pass
Kunal Sharma,23-12-2005,256618,Maharashtra,10,3,6,7,26,Pass
Aryan Chopra,16-03-2005,913098,Jharkhand,11,22,6,6,45,Pass
John Pillai,14-06-2005,349056,Chhattisgarh,2,24,24,8,58,Pass
Sukhwinder Khan,08-01-2006,751428,Odisha,14,4,14,5,37,Pass
Yash Chopra,27-12-2005,699390,Madhya Pradesh,11,9,19,14,53,Pass
Ishaan Mehta,16-05-2005,222610,Telangana,21,3,4,24,52,Pass
Kunal Verma,07-04-2006,642343,West Bengal,16,14,12,1,43,Pass
Raj Fernandes,07-06-2005,126554,Haryana,4,2,8,8,22,Pass
Krishna Sharma,06-02-2006,896927,Maharashtra,3,11,11,24,49,Pass
Aarav Verma,26-06-2005,190223,Madhya Pradesh,22,5,0,4,31,Pass
John Reddy,11-02-2006,538247,Haryana,22,1,21,13,57,Pass
Aarav Chopra,05-05-2006,439992,Karnataka,11,24,3,9,47,Pass
Kunal Chopra,15-03-2005,248932,Andhra Pradesh,22,7,12,17,58,Pass
Aarav D'Souza,23-01-2005,278438,Telangana,3,1,7,0,11,Pass
Raj Verma,16-09-2005,378874,Tamil Nadu,15,21,1,5,42,Pass
Yash Fernandes,23-06-2005,957618,Rajasthan,21,19,17,8,65,Pass
Aryan Fernandes,12-03-2005,808514,Maharashtra,16,12,8,0,36,Pass
Paul D'Souza,05-02-2005,193668,Himachal Pradesh,9,10,20,8,47,Pass
Kunal Sharma,16-02-2006,415461,Uttar Pradesh,9,5,24,4,42,Pass
Ayaan Mehta,05-11-2005,333163,Punjab,11,17,7,12,47,Pass
Raj Sharma,04-01-2005,712111,Madhya Pradesh,6,9,16,1,32,Pass
Harjeet Chopra,26-02-2005,281768,Maharashtra,3,6,11,5,25,Pass
Manpreet Verma,29-10-2005,875668,Tamil Nadu,3,6,15,23,47,Pass
Rohan Pillai,10-03-2006,770217,Uttar Pradesh,7,5,11,7,30,Pass
Aditya D'Souza,16-07-2005,649876,Rajasthan,14,7,13,16,50,Pass
Aryan Fernandes,09-03-2005,881947,Rajasthan,15,21,4,18,58,Pass
Aarav Sharma,16-09-2005,870450,Bihar,4,2,21,21,48,Pass
Aryan Verma,12-06-2005,100568,Uttar Pradesh,23,5,18,13,59,Pass
Vivaan Mehta,26-12-2005,543432,Andhra Pradesh,16,3,22,19,60,Pass
Mathew Pillai,26-06-2005,938181,Kerala,20,10,11,2,43,Pass
Krishna Verma,27-04-2006,994826,Haryana,5,18,0,2,25,Pass
Aditya Fernandes,12-04-2006,403146,Tamil Nadu,8,2,12,11,33,Pass
Ishaan D'Souza,28-08-2005,226961,Madhya Pradesh,0,11,24,8,43,Pass
Aditya Reddy,17-08-2005,107093,Andhra Pradesh,18,6,24,23,71,Pass
Vivaan Chopra,02-07-2005,400169,Punjab,15,17,21,2,55,Pass
Aarav Chopra,05-03-2005,229190,Telangana,24,14,4,23,65,Pass
Aryan Sharma,15-11-2005,822703,Maharashtra,7,11,10,0,28,Pass
Mathew D'Souza,16-08-2005,634557,Odisha,21,4,13,16,54,Pass
Ishaan Verma,14-04-2006,174685,Rajasthan,3,21,10,2,36,Pass
Aditya D'Souza,18-04-2005,744055,West Bengal,4,10,9,16,39,Pass
Balbir Reddy,09-05-2005,751552,Uttarakhand,3,21,23,9,56,Pass
Paul D'Souza,01-03-2006,953061,Bihar,8,12,21,12,53,Pass
Gurpreet Chopra,25-04-2005,315993,Chhattisgarh,20,12,10,1,43,Pass
Paul Pillai,06-01-2006,751720,Telangana,13,4,17,2,36,Pass
Manpreet Khan,26-10-2005,179188,Gujarat,24,8,7,20,59,Pass
Aarav Sharma,16-01-2006,844283,Uttar Pradesh,3,5,16,23,47,Pass
Aarav Sharma,06-03-2006,548698,Karnataka,15,17,5,14,51,Pass
Rohan Mehta,18-07-2005,343601,Haryana,15,8,13,12,48,Pass
Ishaan D'Souza,25-11-2004,850026,Gujarat,2,0,16,19,37,Pass
Krishna Sharma,24-12-2005,203977,Maharashtra,11,11,5,10,37,Pass
Raj Sharma,04-07-2005,646744,Delhi,22,20,10,9,61,Fail
Aditya D'Souza,20-06-2005,317873,Madhya Pradesh,7,1,18,20,46,Pass
Manpreet Chopra,03-08-2005,716763,Gujarat,16,11,4,19,50,Pass
Raj Fernandes,16-04-2005,278230,Bihar,21,6,20,7,54,Pass
Farhan Verma,16-06-2005,487486,Uttar Pradesh,2,5,1,7,15,Pass
Aryan Singh,28-03-2005,188417,Tamil Nadu,7,7,21,14,49,Pass
Yash Singh,14-06-2005,546206,Uttar Pradesh,3,5,15,3,26,Pass
Vivaan Pillai,27-10-2005,144509,West Bengal,3,19,9,17,48,Pass
Harjeet Verma,16-03-2005,360634,Andhra Pradesh,24,8,1,15,48,Pass
Krishna Reddy,28-02-2006,369343,Bihar,14,11,5,11,41,Pass
Rohan Pillai,16-03-2005,513731,Haryana,16,20,1,8,45,Pass
Rohan Khan,15-12-2005,870484,Punjab,4,2,7,13,26,Pass
Sukhwinder D'Souza,20-08-2005,213001,Uttar Pradesh,16,5,2,0,23,Pass
Aditya Chopra,01-06-2005,216813,Uttar Pradesh,13,5,18,20,56,Pass
Vivaan Reddy,25-05-2005,724253,Uttar Pradesh,1,5,6,5,17,Pass
Aryan Sharma,27-07-2005,155395,Haryana,11,12,16,8,47,Pass
Rohan Singh,19-01-2006,256616,Uttar Pradesh,11,5,16,18,50,Pass
Kunal Sharma,23-04-2005,678519,Andhra Pradesh,2,22,7,14,45,Pass
Sukhwinder D'Souza,09-09-2005,937790,Maharashtra,15,1,12,16,44,Pass
Aditya Chopra,01-01-2005,285760,Tripura,18,9,21,6,54,Pass
Ishaan Khan,16-08-2005,473334,Telangana,0,11,12,7,30,Pass
Vivaan Singh,17-07-2005,457206,Telangana,15,1,8,6,30,Pass
Balbir Sharma,29-12-2005,915392,Tamil Nadu,15,8,2,23,48,Pass
Aditya Pillai,12-03-2006,361348,Telangana,4,16,18,16,54,Pass
Kunal Sharma,14-02-2006,771327,Jharkhand,7,10,6,10,33,Pass
Raj Sharma,15-08-2005,621982,Rajasthan,4,19,4,4,31,Pass
Ishaan Pillai,16-06-2005,121011,Chhattisgarh,7,20,14,1,42,Pass
Aarav Singh,18-03-2005,740914,Uttar Pradesh,6,5,20,2,33,Pass
Manpreet D'Souza,06-05-2006,943771,Uttar Pradesh,9,5,6,0,20,Pass
Balbir D'Souza,21-09-2005,802959,Haryana,2,10,10,0,22,Pass
Kunal Reddy,01-12-2005,772805,Bihar,13,20,1,11,45,Pass
Kunal Verma,16-02-2006,603417,Bihar,8,5,9,21,43,Pass
Imran Fernandes,09-05-2006,379560,Delhi,8,13,20,16,57,Fail
Rehan Singh,23-03-2006,700267,Bihar,14,3,16,0,33,Pass
Aditya Pillai,09-02-2006,969280,West Bengal,0,14,14,1,29,Pass
Balbir Pillai,01-04-2005,274097,Uttar Pradesh,3,5,23,17,48,Pass
Imran Sharma,22-03-2005,820098,Uttar Pradesh,23,5,13,12,53,Pass
Aarav Verma,23-11-2004,548243,Maharashtra,6,2,6,5,19,Pass
Yash Pillai,08-04-2005,826909,Uttar Pradesh,9,5,10,9,33,Pass
Yash Fernandes,01-12-2005,676478,Tamil Nadu,15,2,9,8,34,Pass
Raj Sharma,03-10-2005,367897,Gujarat,4,10,23,6,43,Pass
Aryan Reddy,16-04-2006,297971,Punjab,19,11,6,21,57,Pass
Kunal Fernandes,02-04-2006,558967,Uttarakhand,3,19,8,11,41,Pass
Vivaan D'Souza,07-04-2006,486458,Rajasthan,3,17,5,4,29,Pass
Aditya Reddy,21-03-2005,308917,Andhra Pradesh,10,12,5,7,34,Pass
Ishaan Khan,23-12-2004,849453,Bihar,12,23,9,0,44,Pass
Manpreet D'Souza,17-06-2005,691733,Madhya Pradesh,17,12,15,4,48,Pass
Yash Chopra,07-08-2005,562942,Tamil Nadu,24,2,6,23,55,Pass
Manpreet Khan,13-12-2004,268837,West Bengal,13,16,3,9,41,Pass
Sukhwinder Fernandes,10-05-2005,787385,Maharashtra,3,3,24,21,51,Pass
Vivaan Sharma,19-12-2004,625574,Maharashtra,3,3,17,8,31,Pass
Gurpreet Fernandes,21-11-2005,565198,Chhattisgarh,11,23,9,12,55,Pass
Raj Chopra,08-04-2006,684488,Tamil Nadu,8,3,20,18,49,Pass
Aarav Pillai,14-01-2006,948595,Uttar Pradesh,10,5,15,5,35,Pass
Aditya Singh,14-02-2006,307868,Kerala,19,11,17,7,54,Pass
Kunal Singh,07-11-2005,589619,Rajasthan,23,16,0,17,56,Pass
Manpreet D'Souza,26-12-2004,458211,Haryana,24,23,10,8,65,Pass
Vivaan Fernandes,02-01-2005,374999,Maharashtra,7,9,11,21,48,Pass
Aarav Singh,16-10-2005,552981,Madhya Pradesh,18,7,15,6,46,Pass
David Verma,25-12-2004,750639,Punjab,22,4,0,2,28,Pass
Ishaan Pillai,21-11-2005,569733,Uttar Pradesh,16,5,6,17,44,Pass
Krishna Fernandes,24-05-2005,947885,Jharkhand,6,17,16,4,43,Pass
Rohan Fernandes,04-01-2006,663598,Maharashtra,0,8,3,14,25,Pass
Imran Chopra,13-03-2006,505443,Himachal Pradesh,7,18,2,1,28,Pass
Vivaan Pillai,09-11-2004,897674,Haryana,17,13,4,18,52,Pass
Yash D'Souza,28-07-2005,478772,Tamil Nadu,13,10,10,6,39,Pass
Rohan Mehta,19-04-2006,775262,Maharashtra,13,24,0,1,38,Pass
Aditya Chopra,12-11-2004,843737,Andaman & Nicobar,19,6,6,15,46,Pass
Rohan Khan,22-01-2006,751950,Uttar Pradesh,12,5,12,17,46,Pass
Harjeet Mehta,29-03-2005,842569,Maharashtra,3,24,11,14,52,Pass
Aarav D'Souza,06-01-2006,670525,Uttarakhand,15,3,13,13,44,Pass
Vivaan D'Souza,15-12-2004,574264,Karnataka,22,9,10,7,48,Pass
Aryan Fernandes,25-04-2006,956840,Jammu & Kashmir + Ladakh,15,5,0,1,21,Pass
Vivaan Fernandes,20-05-2005,636342,Maharashtra,4,12,0,3,19,Pass
Aarav D'Souza,16-04-2005,345996,Karnataka,3,14,23,14,54,Pass
David Pillai,04-05-2005,996605,Madhya Pradesh,1,19,19,12,51,Pass
Peter Verma,08-12-2004,985969,Delhi,11,11,12,19,53,Fail
Aarav Khan,05-04-2006,112957,Punjab,24,13,15,5,57,Pass
Zaid Pillai,02-06-2005,730231,Rajasthan,9,23,12,22,66,Pass
Balbir Sharma,29-01-2005,363097,Rajasthan,20,19,14,23,76,Pass
John D'Souza,03-12-2005,318219,Uttar Pradesh,1,5,1,22,29,Pass
Krishna Chopra,20-09-2005,226018,Assam,24,11,19,4,58,Pass
Yash Fernandes,18-06-2005,176835,Delhi,0,12,5,10,27,Fail
Kunal Reddy,17-05-2005,390690,Andhra Pradesh,7,20,12,24,63,Pass
Rohan Mehta,07-06-2005,914684,Karnataka,4,20,11,2,37,Pass
Aditya Sharma,03-05-2006,417835,Haryana,6,7,1,14,28,Pass
Mathew Khan,18-06-2005,450252,Odisha,0,12,0,14,26,Pass
Aditya Reddy,19-09-2005,434292,Haryana,19,13,7,13,52,Pass
Paul Reddy,20-01-2005,937372,Rajasthan,2,8,4,2,16,Pass
Ishaan Sharma,10-10-2005,755215,Bihar,23,18,6,8,55,Pass
Yash Verma,21-12-2005,809684,Rajasthan,5,7,3,9,24,Pass
Vivaan Reddy,08-08-2005,751641,Maharashtra,11,7,13,16,47,Pass
Aryan Sharma,22-08-2005,279169,Uttar Pradesh,17,5,20,15,57,Pass
Krishna Pillai,26-11-2005,628865,Tamil Nadu,14,6,22,20,62,Pass
Krishna Reddy,28-11-2005,650634,Bihar,9,14,5,15,43,Pass
John Reddy,04-03-2005,681237,West Bengal,3,21,20,23,67,Pass
Mathew Chopra,06-12-2005,986503,Madhya Pradesh,1,10,16,14,41,Pass
Manpreet Fernandes,05-06-2005,351849,Tamil Nadu,4,23,0,4,31,Pass
Kunal Sharma,07-08-2005,564987,Uttar Pradesh,0,5,23,1,29,Pass
Aditya Fernandes,25-03-2005,747211,Telangana,4,23,9,6,42,Pass
Aryan Khan,14-12-2005,960556,Gujarat,15,21,17,2,55,Pass
Ishaan Mehta,07-07-2005,759494,West Bengal,5,11,22,4,42,Pass
Rohan Khan,13-02-2006,170202,Maharashtra,0,19,14,0,33,Pass
Vivaan Mehta,26-04-2005,575157,West Bengal,7,8,8,2,25,Pass
Balbir Verma,10-10-2005,411677,Madhya Pradesh,2,8,5,22,37,Pass
Ishaan Khan,20-11-2005,874742,Punjab,1,1,22,13,37,Pass
Yash Singh,18-04-2005,184561,Uttar Pradesh,13,5,3,24,45,Pass
Aryan Reddy,15-04-2005,104704,Kerala,16,5,12,11,44,Pass
Rohan Fernandes,18-04-2006,947571,Uttar Pradesh,14,5,24,4,47,Pass
Ayaan Reddy,14-11-2004,732313,Rajasthan,4,13,1,4,22,Pass
Rohan Chopra,21-07-2005,477707,Uttar Pradesh,20,5,2,19,46,Pass
Yash Chopra,13-08-2005,955660,Himachal Pradesh,0,2,22,1,25,Pass
Balbir Chopra,21-11-2004,646418,Assam,11,5,19,22,57,Pass
Balbir Sharma,11-12-2004,169247,Kerala,2,20,2,17,41,Pass
Raj Sharma,22-02-2005,106149,Uttar Pradesh,6,5,11,0,22,Pass
Ishaan Reddy,06-09-2005,373162,Uttar Pradesh,3,5,23,21,52,Pass
Balbir Mehta,27-03-2006,279066,Uttar Pradesh,1,5,11,9,26,Pass
Vivaan Verma,09-02-2005,518503,Uttar Pradesh,22,5,11,21,59,Pass
Gurpreet Singh,07-12-2004,537138,Odisha,4,4,4,4,16,Pass
Paul Khan,05-04-2006,193800,Himachal Pradesh,17,17,17,14,65,Pass
Vivaan Reddy,25-02-2005,479250,Punjab,0,6,17,4,27,Pass
Krishna Sharma,10-09-2005,763765,Kerala,22,11,2,20,55,Pass
Krishna Chopra,03-04-2006,198014,Rajasthan,2,3,15,7,27,Pass
Krishna Fernandes,31-08-2005,304667,Telangana,23,20,22,4,69,Pass
Raj Pillai,31-03-2006,174575,Madhya Pradesh,8,11,17,5,41,Pass
Yash Pillai,08-03-2005,188059,Uttar Pradesh,20,5,21,20,66,Pass
Sukhwinder Singh,18-01-2005,423038,Andhra Pradesh,18,21,21,18,78,Pass
Yash Reddy,03-03-2005,267390,Madhya Pradesh,2,16,19,5,42,Pass
Ishaan Verma,20-02-2006,866984,Bihar,10,7,19,0,36,Pass
Ishaan Khan,15-12-2004,757902,Bihar,18,9,18,2,47,Pass
Sukhwinder Chopra,21-04-2005,914854,Gujarat,4,6,16,17,43,Pass
Raj Chopra,04-05-2005,945105,Jammu & Kashmir + Ladakh,24,11,13,7,55,Pass
John Sharma,23-07-2005,750548,Bihar,8,6,7,23,44,Pass
Rohan Mehta,13-09-2005,452309,Bihar,11,8,9,3,31,Pass
Krishna Mehta,24-02-2005,886828,Uttar Pradesh,8,5,6,16,35,Pass
Peter Pillai,19-12-2004,236393,Uttar Pradesh,17,5,19,8,49,Pass
Gurpreet Khan,31-10-2005,930058,Chhattisgarh,11,21,16,21,69,Pass
Kunal Chopra,26-11-2005,624353,Manipur,4,23,9,18,54,Pass
Aarav Khan,13-11-2004,895419,Rajasthan,8,10,13,24,55,Pass
Aryan Sharma,15-03-2005,795718,Karnataka,0,13,18,15,46,Pass
Kunal Khan,04-03-2005,468750,Odisha,24,6,5,3,38,Pass
Aditya Sharma,18-07-2005,835985,Maharashtra,3,11,23,12,49,Pass
John Sharma,22-11-2004,118513,Rajasthan,6,6,20,18,50,Pass
Rehan Reddy,29-11-2004,343485,Andhra Pradesh,22,12,19,22,75,Pass
John Sharma,03-04-2006,709795,Uttar Pradesh,5,5,8,19,37,Pass
Aryan Mehta,20-02-2005,498035,Karnataka,22,9,21,4,56,Pass
Aarav Reddy,31-03-2006,717728,West Bengal,12,5,7,15,39,Pass
Rohan Sharma,23-11-2004,727824,Delhi,21,1,3,23,48,Fail
Raj Singh,15-12-2005,364129,Tripura,20,10,4,14,48,Pass
Kunal Reddy,27-07-2005,396480,Tamil Nadu,7,7,11,13,38,Pass
Ayaan Pillai,14-05-2005,847895,Madhya Pradesh,9,15,2,21,47,Pass
Yash Singh,03-05-2005,488418,Madhya Pradesh,21,24,0,4,49,Pass
Krishna Mehta,27-07-2005,968006,Uttar Pradesh,22,5,5,16,48,Pass
Sukhwinder Singh,15-11-2005,916410,Bihar,8,22,10,24,64,Pass
Aditya Chopra,10-06-2005,678569,Tamil Nadu,24,20,15,18,77,Pass
Krishna D'Souza,30-04-2006,906256,Andhra Pradesh,13,16,0,18,47,Pass
Aryan Singh,25-12-2005,464571,Punjab,17,3,20,4,44,Pass
Sukhwinder Mehta,23-01-2005,868102,Haryana,21,1,0,20,42,Pass
Kunal D'Souza,09-04-2005,929249,Odisha,7,5,5,5,22,Pass
Ishaan Sharma,04-01-2006,507155,Himachal Pradesh,21,18,21,24,84,Pass
Raj Chopra,09-09-2005,494274,Bihar,11,24,21,12,68,Pass
Raj Khan,04-05-2005,762263,Himachal Pradesh,11,4,9,23,47,Pass
Sukhwinder Singh,02-02-2006,891415,Gujarat,22,10,19,0,51,Pass
Aditya Khan,03-04-2005,689893,Chhattisgarh,23,6,9,19,57,Pass
Rohan Mehta,22-09-2005,173945,Tamil Nadu,14,3,7,11,35,Pass
Rohan Sharma,23-10-2005,367398,Meghalaya,15,8,9,4,36,Pass
Kunal Pillai,13-07-2005,972589,Odisha,19,2,19,0,40,Pass
Aditya D'Souza,14-02-2006,580746,Jharkhand,5,11,5,24,45,Pass
Yash Chopra,16-03-2006,322068,Bihar,12,4,13,1,30,Pass
Gurpreet Verma,07-11-2004,677707,Bihar,3,19,7,9,38,Pass
Yash Fernandes,23-09-2005,399579,Haryana,14,6,23,20,63,Pass
Imran Fernandes,16-07-2005,375337,Madhya Pradesh,18,14,0,19,51,Pass
Aditya Reddy,15-12-2005,134743,Maharashtra,3,17,20,0,40,Pass
Yash Verma,26-09-2005,972497,Odisha,24,5,1,10,40,Pass
Aryan Reddy,10-01-2006,120048,Madhya Pradesh,12,6,10,6,34,Pass
Yash Singh,22-11-2005,232333,Gujarat,8,2,11,14,35,Pass
Aarav Verma,22-11-2004,845851,Bihar,21,13,14,12,60,Pass
Vivaan Verma,10-04-2005,686189,Jammu & Kashmir + Ladakh,3,1,13,8,25,Pass
Vivaan Mehta,04-05-2005,882507,Bihar,7,17,8,11,43,Pass
Raj Verma,23-03-2005,405293,Bihar,8,3,7,23,41,Pass
Vivaan Pillai,25-01-2005,996359,Himachal Pradesh,4,10,13,19,46,Pass
Aarav Fernandes,29-10-2005,731248,Punjab,6,17,11,14,48,Pass
Raj Singh,05-03-2006,727629,Madhya Pradesh,5,13,24,5,47,Pass
Balbir Singh,03-03-2006,683443,Maharashtra,3,20,21,14,58,Pass
Rohan Sharma,08-08-2005,873015,Uttarakhand,10,6,7,13,36,Pass
Aditya Chopra,22-02-2005,283901,Madhya Pradesh,5,16,8,11,40,Pass
Aditya Khan,26-03-2005,527673,Assam,6,12,15,17,50,Pass
Ishaan Singh,03-11-2005,246790,Rajasthan,16,7,3,19,45,Pass
Aryan D'Souza,11-03-2006,625233,Maharashtra,3,11,20,13,47,Pass
Aryan Sharma,05-10-2005,899469,Gujarat,2,6,21,24,53,Pass
Rohan Verma,02-04-2006,150562,Bihar,1,21,16,11,49,Pass
Aditya Sharma,27-03-2005,533884,West Bengal,3,9,17,21,50,Pass
John Chopra,21-04-2005,797488,Tripura,11,0,0,0,11,Pass
Harjeet Mehta,27-10-2005,312303,Rajasthan,5,18,3,10,36,Pass
Balbir Mehta,17-03-2005,764296,Uttarakhand,6,3,24,3,36,Pass
Paul Reddy,23-12-2004,614574,Kerala,16,14,10,0,40,Pass
Peter Mehta,18-11-2004,936223,West Bengal,5,20,2,0,27,Pass
Kunal Khan,22-11-2005,572684,Rajasthan,11,10,18,2,41,Pass
Aditya D'Souza,26-05-2005,195500,Chhattisgarh,7,16,4,3,30,Pass
Rohan Singh,20-12-2005,584472,Gujarat,19,18,9,10,56,Pass
Manpreet Chopra,28-01-2005,963625,Tamil Nadu,18,5,0,1,24,Pass
Raj Sharma,11-05-2005,445827,Madhya Pradesh,6,18,8,15,47,Pass
Gurpreet Mehta,23-04-2005,722410,Himachal Pradesh,2,13,11,12,38,Pass
Rohan Fernandes,03-05-2006,556888,Madhya Pradesh,4,1,2,5,12,Pass
Ishaan Khan,12-01-2006,102675,Madhya Pradesh,10,2,18,7,37,Pass
Paul Chopra,14-04-2005,498801,Uttar Pradesh,20,5,23,13,61,Pass
Aditya Mehta,30-11-2004,391883,Bihar,0,3,3,12,18,Pass
Aditya Mehta,20-05-2005,940056,Rajasthan,5,18,12,0,35,Pass
Raj Chopra,09-01-2006,148093,Punjab,3,2,18,24,47,Pass
Gurpreet Verma,17-07-2005,512653,Assam,10,11,19,15,55,Pass
Manpreet Singh,30-12-2005,624106,Rajasthan,8,2,3,19,32,Pass
Mathew Pillai,15-11-2005,860474,Telangana,13,16,17,10,56,Pass
Raj Sharma,01-02-2005,149021,Gujarat,3,4,9,1,17,Pass
Kunal Khan,20-04-2006,429440,Jharkhand,14,10,12,11,47,Pass
David D'Souza,11-08-2005,843654,Tamil Nadu,4,5,8,16,33,Pass
Raj D'Souza,12-03-2006,668569,West Bengal,13,12,6,3,34,Pass
Vivaan Singh,05-02-2005,411435,Maharashtra,19,0,10,4,33,Pass
John Khan,13-01-2005,226427,Rajasthan,10,15,13,10,48,Pass
Paul D'Souza,24-01-2006,380681,Haryana,16,5,23,6,50,Pass
David D'Souza,06-09-2005,206752,Maharashtra,16,12,3,11,42,Pass
Aditya Pillai,28-12-2005,869134,Punjab,0,24,0,9,33,Pass
Kunal Fernandes,15-09-2005,773917,Jammu & Kashmir + Ladakh,4,9,3,18,34,Pass
Sukhwinder Sharma,16-10-2005,672010,Uttar Pradesh,24,5,1,23,53,Pass
Rohan Sharma,17-11-2005,189171,Uttarakhand,4,0,11,6,21,Pass
Kunal D'Souza,18-04-2005,591797,Gujarat,5,11,23,16,55,Pass
Gurpreet Fernandes,26-01-2006,984450,Jharkhand,9,8,14,10,41,Pass
John Sharma,11-09-2005,596158,West Bengal,3,19,21,16,59,Pass
Aarav D'Souza,14-07-2005,553894,Rajasthan,11,17,4,4,36,Pass
Manpreet Fernandes,01-05-2005,910169,Uttar Pradesh,13,5,8,5,31,Pass
Kunal D'Souza,28-04-2006,917931,Haryana,5,18,1,23,47,Pass
Aditya Sharma,24-05-2005,369745,Bihar,18,5,13,1,37,Pass
Krishna D'Souza,16-11-2005,209106,Madhya Pradesh,14,2,24,16,56,Pass
Yash Pillai,10-12-2004,175266,Tamil Nadu,5,23,14,5,47,Pass
Sukhwinder Verma,04-02-2005,489239,Telangana,6,17,12,2,37,Pass
Aditya Reddy,17-06-2005,136994,Assam,8,13,14,11,46,Pass
Balbir Reddy,22-02-2006,236696,Bihar,8,18,23,18,67,Pass
Kunal Singh,11-04-2005,511993,Odisha,2,24,17,4,47,Pass
Aditya Singh,02-12-2005,847607,Bihar,15,6,19,10,50,Pass
Vivaan Mehta,01-03-2006,733229,Bihar,14,2,18,8,42,Pass
Gurpreet Chopra,27-01-2006,665672,Jharkhand,19,17,8,16,60,Pass
Peter Singh,23-03-2005,311325,West Bengal,16,8,0,19,43,Pass
Balbir Singh,03-02-2006,716568,Delhi,13,10,7,6,36,Fail
Yash Chopra,22-12-2005,727823,Telangana,23,15,4,3,45,Pass
Rohan Pillai,16-11-2005,150898,Haryana,10,16,23,18,67,Pass
Rohan Khan,10-08-2005,151175,Chhattisgarh,16,11,20,20,67,Pass
Aditya Chopra,25-08-2005,503525,West Bengal,7,16,17,7,47,Pass
Kunal Fernandes,08-07-2005,657434,Punjab,16,13,3,23,55,Pass
Aditya Chopra,01-03-2006,196379,West Bengal,16,7,15,16,54,Pass
David Singh,04-11-2005,465449,Himachal Pradesh,12,21,13,3,49,Pass
Aryan Khan,03-12-2004,709643,Gujarat,11,2,16,0,29,Pass
Kunal Verma,06-05-2006,606272,West Bengal,3,23,4,19,49,Pass
Kunal Pillai,12-12-2004,540549,Kerala,16,6,17,15,54,Pass
Kunal Pillai,30-04-2006,997909,Punjab,14,18,2,13,47,Pass
Raj D'Souza,31-03-2006,811618,Bihar,18,11,18,9,56,Pass
Rohan Mehta,01-10-2005,574122,Haryana,1,3,23,12,39,Pass
Raj Chopra,25-03-2005,949389,Madhya Pradesh,6,18,5,7,36,Pass
Rohan Sharma,03-05-2005,745268,Odisha,10,13,14,3,40,Pass
Yash Khan,08-01-2006,837370,Punjab,21,14,1,0,36,Pass
Kunal Khan,18-12-2004,657938,Madhya Pradesh,9,24,6,4,43,Pass
Paul Fernandes,28-01-2005,786939,Bihar,19,10,3,24,56,Pass
Kunal Khan,21-10-2005,544842,Bihar,24,11,4,12,51,Pass
Ishaan Chopra,02-01-2005,801508,Punjab,3,19,17,18,57,Pass
Yash Reddy,16-04-2006,388827,Punjab,20,18,0,0,38,Pass
Kunal Fernandes,10-09-2005,547698,Madhya Pradesh,3,21,23,1,48,Pass
Yash Chopra,20-06-2005,454275,Gujarat,22,24,14,16,76,Pass
Aarav Pillai,13-12-2005,743001,Andaman & Nicobar,9,14,7,16,46,Pass
Peter Sharma,21-07-2005,575759,Tamil Nadu,14,9,19,9,51,Pass
Balbir Verma,06-02-2006,827726,West Bengal,5,7,4,0,16,Pass
Yash Fernandes,06-09-2005,948636,Uttar Pradesh,10,5,19,6,40,Pass
Aryan Verma,08-03-2006,146191,Telangana,12,8,21,17,58,Pass
Harjeet Mehta,28-07-2005,248157,Andhra Pradesh,23,18,20,20,81,Pass
Aarav Mehta,17-04-2005,655100,Kerala,16,6,24,14,60,Pass
Ishaan Khan,31-03-2005,861142,Haryana,10,22,17,24,73,Pass
Balbir Verma,21-02-2006,483218,Gujarat,22,20,22,22,86,Pass
Aarav Singh,29-03-2006,272810,Uttar Pradesh,24,5,13,1,43,Pass
Aryan Singh,13-11-2004,790240,Tripura,11,20,23,2,56,Pass
Raj Pillai,22-02-2006,564057,Assam,23,7,24,7,61,Pass
Peter Verma,01-02-2005,741002,Bihar,3,22,0,0,25,Pass
Rohan Mehta,09-05-2005,344365,Haryana,23,9,11,5,48,Pass
Aryan D'Souza,21-03-2005,492936,Assam,17,18,13,16,64,Pass
Aditya Mehta,04-01-2005,595807,Delhi,4,21,18,7,50,Fail
Sukhwinder D'Souza,24-10-2005,409243,Gujarat,1,5,12,18,36,Pass
Balbir Khan,05-01-2005,224976,Punjab,12,3,21,12,48,Pass
Kunal Khan,07-03-2006,291130,Madhya Pradesh,5,10,12,7,34,Pass
Aarav Chopra,08-06-2005,292532,Uttar Pradesh,14,5,21,3,43,Pass
Vivaan Verma,29-11-2004,573262,Gujarat,16,23,23,2,64,Pass
Manpreet Singh,20-02-2006,780221,Telangana,8,13,0,19,40,Pass
Vivaan Mehta,14-12-2005,520541,Tamil Nadu,6,1,21,5,33,Pass
Aarav Pillai,23-05-2005,564603,Bihar,11,19,12,1,43,Pass
Gurpreet Verma,26-11-2005,992967,Karnataka,9,16,18,24,67,Pass
Sukhwinder Chopra,14-04-2006,470619,Rajasthan,2,7,10,13,32,Pass
Vivaan Fernandes,20-09-2005,635378,Assam,9,17,6,18,50,Pass
Balbir Sharma,08-02-2005,796926,Madhya Pradesh,19,0,2,16,37,Pass
David Reddy,18-12-2005,943433,Telangana,5,16,1,9,31,Pass
Balbir Mehta,17-02-2005,199408,Maharashtra,3,22,3,23,51,Pass
Aditya Reddy,14-12-2005,244764,Uttar Pradesh,14,5,13,23,55,Pass
Vivaan D'Souza,08-02-2006,502980,Uttar Pradesh,19,5,1,13,38,Pass
Paul Khan,16-09-2005,427793,Punjab,3,19,22,0,44,Pass
Vivaan Mehta,16-10-2005,345650,Odisha,16,6,9,2,33,Pass
Sukhwinder Singh,25-11-2004,761355,Punjab,3,5,1,18,27,Pass
Aryan Reddy,05-01-2005,752798,Punjab,3,15,15,23,56,Pass
Gurpreet Khan,14-11-2004,732005,Punjab,7,22,23,6,58,Pass
Yash Verma,09-11-2004,813265,Madhya Pradesh,20,20,0,4,44,Pass
Kunal Reddy,15-12-2005,889197,Maharashtra,0,8,1,20,29,Pass
Vivaan Khan,06-03-2006,301208,Bihar,8,3,11,23,45,Pass
Aryan Sharma,28-06-2005,830940,Bihar,21,1,11,15,48,Pass
Krishna Chopra,26-10-2005,585079,Karnataka,5,8,11,24,48,Pass
Krishna Mehta,22-01-2006,157588,Andhra Pradesh,18,18,8,16,60,Pass
Raj Verma,30-01-2005,423452,Bihar,15,24,9,19,67,Pass
Gurpreet Khan,03-01-2005,954675,West Bengal,0,10,2,7,19,Pass
Rohan Pillai,22-09-2005,979181,Punjab,17,20,19,18,74,Pass
Krishna D'Souza,11-10-2005,906987,Karnataka,3,21,21,18,63,Pass
Mathew Verma,26-07-2005,725640,Rajasthan,20,2,4,11,37,Pass
Sukhwinder Reddy,17-10-2005,719127,Chhattisgarh,14,0,18,17,49,Pass
Aryan Chopra,12-11-2004,111488,West Bengal,6,1,2,9,18,Pass
Vivaan Fernandes,17-04-2006,710779,West Bengal,3,22,6,3,34,Pass
Gurpreet D'Souza,08-02-2006,521390,Maharashtra,6,23,14,4,47,Pass
Vivaan Sharma,01-03-2005,906344,Tamil Nadu,23,7,9,1,40,Pass
Manpreet Sharma,22-09-2005,993040,Rajasthan,10,6,10,7,33,Pass
Rohan D'Souza,12-02-2006,474685,Uttarakhand,3,22,1,17,43,Pass
Aditya Sharma,28-09-2005,483291,Kerala,11,23,12,20,66,Pass
Rohan Reddy,22-08-2005,845716,Bihar,9,18,14,22,63,Pass
Raj Mehta,08-12-2004,903622,Telangana,19,3,24,12,58,Pass
Gurpreet Singh,19-02-2005,744150,Manipur,4,14,12,24,54,Pass
Aarav Verma,01-04-2005,483003,Kerala,21,0,3,23,47,Pass
Balbir Verma,14-02-2006,420802,Haryana,20,5,11,4,40,Pass
Vivaan D'Souza,05-03-2006,926100,Andhra Pradesh,8,9,1,7,25,Pass
Sukhwinder Sharma,01-03-2006,180366,Rajasthan,21,13,22,11,67,Pass
Mathew Chopra,08-02-2005,275230,Maharashtra,3,7,7,23,40,Pass
Aarav Mehta,12-01-2006,332020,Haryana,17,7,9,15,48,Pass
Ayaan Chopra,30-01-2006,317515,Rajasthan,4,5,15,13,37,Pass
Kunal Verma,14-11-2004,496146,Tamil Nadu,17,1,14,13,45,Pass
Aditya Chopra,21-02-2005,522583,Bihar,20,17,8,17,62,Pass
Aryan Mehta,24-02-2006,721395,Delhi,19,21,23,0,63,Fail
Paul D'Souza,22-12-2005,474419,Jharkhand,3,11,11,13,38,Pass
Aditya Chopra,06-11-2005,984706,Gujarat,23,3,9,23,58,Pass
Raj Verma,17-03-2005,157045,Punjab,20,0,19,0,39,Pass
Krishna Singh,11-07-2005,417728,Bihar,19,19,2,17,57,Pass
Imran Khan,09-04-2006,106223,Uttar Pradesh,10,5,20,1,36,Pass
Manpreet Sharma,21-10-2005,999467,Odisha,1,17,12,19,49,Pass
Manpreet Pillai,24-11-2004,527071,Tamil Nadu,7,17,24,20,68,Pass
Aditya Fernandes,27-01-2006,355866,Jharkhand,15,14,5,5,39,Pass
Aarav Khan,27-08-2005,709852,Odisha,14,20,11,9,54,Pass
Aarav Chopra,10-08-2005,746705,Gujarat,14,2,9,6,31,Pass
Yash Sharma,10-11-2004,626164,West Bengal,3,18,10,11,42,Pass
Harjeet D'Souza,10-06-2005,814294,Uttar Pradesh,21,5,5,23,54,Pass
Sukhwinder Fernandes,09-10-2005,246526,Gujarat,4,24,15,22,65,Pass
David Chopra,31-12-2005,219847,Uttarakhand,3,21,6,24,54,Pass
Balbir Fernandes,22-10-2005,416338,Puducherry,5,19,6,5,35,Pass
Raj D'Souza,24-12-2005,891172,Karnataka,3,17,15,19,54,Pass
Harjeet Pillai,06-12-2005,411684,Rajasthan,20,4,0,11,35,Pass
Krishna D'Souza,28-07-2005,488730,Telangana,5,14,1,17,37,Pass
Aditya Khan,10-09-2005,541917,Jharkhand,10,22,19,16,67,Pass
Harjeet Reddy,08-06-2005,694666,Maharashtra,3,20,4,11,38,Pass
Yash Verma,08-12-2005,979696,Andhra Pradesh,7,24,20,8,59,Pass
Mathew D'Souza,23-01-2005,419924,Karnataka,10,5,20,3,38,Pass
Aditya Pillai,22-11-2005,562413,Uttar Pradesh,13,5,9,5,32,Pass
Aryan Reddy,20-03-2005,359935,Bihar,8,13,16,24,61,Pass
Yash Fernandes,13-02-2006,954849,Haryana,12,0,6,0,18,Pass
Paul Pillai,26-11-2004,132062,Tamil Nadu,21,17,7,17,62,Pass
Aryan Khan,28-11-2005,823696,Telangana,13,3,15,4,35,Pass
Imran Singh,09-02-2006,162577,Madhya Pradesh,24,11,24,4,63,Pass
Ishaan Verma,21-07-2005,466258,Rajasthan,1,6,15,10,32,Pass
Kunal Fernandes,11-11-2004,986244,Bihar,8,8,21,24,61,Pass
John Sharma,18-11-2004,321172,Uttarakhand,3,15,8,22,48,Pass
Raj Pillai,18-04-2005,448117,Rajasthan,24,4,0,13,41,Pass
Yash Khan,15-03-2006,852730,Haryana,12,2,20,23,57,Pass
Krishna Pillai,16-02-2005,811063,Jharkhand,12,9,6,8,35,Pass
Aarav D'Souza,23-11-2005,263834,Rajasthan,4,4,3,9,20,Pass
Sukhwinder Reddy,23-08-2005,237730,Maharashtra,23,10,3,0,36,Pass
Krishna Sharma,05-11-2005,860447,Punjab,15,13,4,16,48,Pass
Yash Sharma,15-07-2005,459191,Delhi,23,24,19,17,83,Fail
Gurpreet Chopra,09-05-2006,720187,Uttar Pradesh,7,5,5,9,26,Pass
Kunal Fernandes,04-11-2005,762590,Uttar Pradesh,18,5,22,2,47,Pass
Balbir Verma,23-07-2005,203991,Tamil Nadu,22,4,23,17,66,Pass
Gurpreet D'Souza,24-01-2006,682860,Karnataka,3,21,14,10,48,Pass
Yash Fernandes,22-02-2005,485261,Tripura,17,18,9,3,47,Pass
Gurpreet Pillai,19-05-2005,876720,West Bengal,1,8,23,3,35,Pass
Raj D'Souza,30-05-2005,937053,Madhya Pradesh,7,2,15,11,35,Pass
Peter Reddy,18-02-2006,756724,Uttar Pradesh,23,5,8,0,36,Pass
Raj Reddy,10-10-2005,147478,Bihar,1,20,19,16,56,Pass
Zaid Fernandes,10-02-2006,832261,Punjab,2,18,15,13,48,Pass
Ishaan Reddy,06-02-2005,302883,Gujarat,23,17,17,20,77,Pass
Rohan Fernandes,12-02-2006,951857,Rajasthan,2,18,9,11,40,Pass
Raj Sharma,05-01-2006,836474,Maharashtra,3,23,17,13,56,Pass
Balbir Reddy,13-02-2005,962160,Uttar Pradesh,8,5,13,22,48,Pass
Rohan Chopra,06-02-2005,167819,Bihar,14,18,0,11,43,Pass
Yash Pillai,17-07-2005,178448,Uttar Pradesh,18,5,2,23,48,Pass
Aarav D'Souza,24-02-2006,726961,Andhra Pradesh,2,16,13,21,52,Pass
Krishna Khan,02-04-2005,124257,Meghalaya,7,19,12,7,45,Pass
Krishna D'Souza,10-04-2005,951152,Meghalaya,6,14,5,10,35,Pass
Ishaan Fernandes,10-10-2005,742010,Rajasthan,6,16,3,1,26,Pass
Krishna Sharma,10-02-2005,512354,Tamil Nadu,15,1,12,24,52,Pass
Balbir Pillai,07-05-2005,475642,Bihar,3,10,10,24,47,Pass
Harjeet Chopra,29-04-2005,836112,West Bengal,15,2,21,8,46,Pass
Krishna Sharma,25-11-2005,715353,Tripura,13,3,7,10,33,Pass
Mathew Singh,19-07-2005,570505,Chhattisgarh,10,19,15,22,66,Pass
Balbir Chopra,24-04-2006,921351,Punjab,1,4,4,22,31,Pass
David D'Souza,18-12-2004,532064,Madhya Pradesh,9,12,10,13,44,Pass
Aarav Chopra,24-01-2005,351175,Karnataka,6,18,14,17,55,Pass
Raj D'Souza,15-01-2006,536251,Uttar Pradesh,15,5,19,0,39,Pass
Mathew Fernandes,20-11-2005,798642,Madhya Pradesh,13,7,0,0,20,Pass
Aditya Fernandes,05-05-2006,510515,Telangana,23,2,6,21,52,Pass
David Khan,17-11-2004,551030,Karnataka,1,12,24,0,37,Pass
Krishna Chopra,28-12-2004,884297,Madhya Pradesh,9,11,4,14,38,Pass
Rohan Khan,31-01-2006,911410,Maharashtra,24,10,10,0,44,Pass
Harjeet Pillai,13-04-2006,240824,Uttarakhand,3,6,22,10,41,Pass
Aarav Verma,07-02-2005,216976,Andhra Pradesh,18,14,24,8,64,Pass
Krishna Singh,09-07-2005,831239,Punjab,7,10,19,13,49,Pass
Yash Mehta,14-04-2005,867061,Madhya Pradesh,4,14,24,2,44,Pass
Harjeet Pillai,28-04-2006,722217,Rajasthan,1,3,14,5,23,Pass
Krishna Sharma,18-08-2005,395411,Uttar Pradesh,22,5,12,10,49,Pass
Aarav Singh,25-12-2005,544827,Uttar Pradesh,1,5,1,18,25,Pass
Yash Verma,08-04-2006,929965,Andhra Pradesh,1,9,9,1,20,Pass
Peter Khan,21-08-2005,245960,Rajasthan,18,15,21,15,69,Pass
Krishna Fernandes,08-09-2005,447390,Tamil Nadu,13,21,10,6,50,Pass
Harjeet Chopra,30-11-2004,523394,Madhya Pradesh,0,17,6,0,23,Pass
Mathew Mehta,12-12-2005,356846,Andhra Pradesh,23,2,1,6,32,Pass
Aryan Singh,14-04-2005,707713,Punjab,9,3,10,23,45,Pass
Ishaan Verma,27-04-2006,353339,Madhya Pradesh,11,14,4,14,43,Pass
Aarav Reddy,04-12-2005,666129,Haryana,24,16,5,11,56,Pass
David Khan,05-03-2006,736844,Tamil Nadu,6,18,23,17,64,Pass
Aditya Singh,19-09-2005,949968,Tamil Nadu,4,0,21,0,25,Pass
Aditya Khan,13-02-2006,632013,Bihar,10,6,6,3,25,Pass
Mathew Mehta,03-04-2006,805676,Maharashtra,3,3,5,1,12,Pass
Krishna D'Souza,05-08-2005,502976,Tamil Nadu,17,22,1,2,42,Pass
Aryan Sharma,27-04-2005,743473,Punjab,4,21,3,12,40,Pass
Aryan Singh,26-02-2005,663726,Uttar Pradesh,0,5,8,14,27,Pass
Raj D'Souza,05-08-2005,389185,Haryana,24,15,13,17,69,Pass
Aryan Reddy,01-12-2005,872946,Rajasthan,7,4,22,20,53,Pass
Aarav Pillai,12-07-2005,681067,Telangana,22,13,6,3,44,Pass
Raj Sharma,02-02-2005,134280,Uttarakhand,3,10,21,11,45,Pass
Harjeet Verma,18-11-2005,870194,Haryana,17,10,23,19,69,Pass
David Chopra,17-02-2006,499846,Uttar Pradesh,20,5,7,3,35,Pass
Aditya Mehta,20-07-2005,729098,Andhra Pradesh,1,19,10,14,44,Pass
Ayaan Reddy,04-01-2005,728223,Maharashtra,3,22,17,23,65,Pass
Rohan Mehta,29-08-2005,895739,Rajasthan,14,8,4,5,31,Pass
John Fernandes,26-11-2005,851605,Rajasthan,6,5,18,24,53,Pass
John D'Souza,05-03-2005,845732,Tamil Nadu,3,14,3,15,35,Pass
Rohan Khan,12-09-2005,720337,Maharashtra,12,16,3,6,37,Pass
Rohan Sharma,18-09-2005,323850,Rajasthan,23,16,15,16,70,Pass
Raj Mehta,25-04-2005,440529,Rajasthan,15,19,16,10,60,Pass
Kunal Verma,29-04-2005,836503,Tamil Nadu,2,5,9,22,38,Pass
Harjeet Khan,23-02-2006,887362,Haryana,16,16,1,0,33,Pass
Raj Khan,28-01-2005,772434,Uttar Pradesh,5,5,19,22,51,Pass
Mathew D'Souza,07-08-2005,969544,Andhra Pradesh,8,3,11,4,26,Pass
Aditya Reddy,19-01-2005,888538,Punjab,6,20,6,10,42,Pass
Vivaan Fernandes,10-08-2005,124414,Chhattisgarh,24,17,4,0,45,Pass
Gurpreet Verma,05-02-2005,718228,Rajasthan,23,21,17,23,84,Pass
Manpreet Khan,09-10-2005,535004,Delhi,20,18,22,7,67,Fail
Ishaan Khan,11-08-2005,991408,Haryana,18,11,4,7,40,Pass
Aryan Mehta,28-06-2005,205071,Andhra Pradesh,11,4,1,3,19,Pass
David D'Souza,28-12-2004,392532,Andhra Pradesh,0,12,20,2,34,Pass
Kunal Pillai,10-01-2005,276791,Odisha,5,11,15,3,34,Pass
Ayaan D'Souza,17-11-2004,338812,Bihar,9,3,8,23,43,Pass
Raj D'Souza,21-09-2005,419789,Telangana,0,16,17,1,34,Pass
Harjeet Verma,20-07-2005,100619,Karnataka,3,21,11,23,58,Pass
Aryan D'Souza,22-02-2006,438969,Bihar,22,22,5,11,60,Pass
John D'Souza,07-06-2005,151961,Bihar,19,5,18,16,58,Pass
Yash Chopra,18-07-2005,158397,Gujarat,6,21,0,2,29,Pass
Aarav Mehta,13-04-2005,290751,Karnataka,24,13,19,1,57,Pass
Kunal Khan,10-02-2005,374546,Bihar,4,19,22,24,69,Pass
Ishaan Verma,03-08-2005,411149,Haryana,14,16,13,17,60,Pass
Aarav Chopra,27-03-2005,669740,Maharashtra,8,10,10,17,45,Pass
Aarav Pillai,01-05-2005,787115,Maharashtra,13,1,1,18,33,Pass
Raj Reddy,21-01-2006,902644,Rajasthan,21,9,17,1,48,Pass
Yash D'Souza,19-09-2005,541849,Bihar,1,16,5,6,28,Pass
Vivaan Mehta,15-03-2006,981306,Rajasthan,15,10,20,24,69,Pass
Rohan Pillai,16-01-2006,192081,Andhra Pradesh,7,21,23,14,65,Pass
Ishaan Mehta,11-11-2005,501921,Jammu & Kashmir + Ladakh,10,9,7,6,32,Pass
David Fernandes,04-09-2005,425086,Gujarat,2,21,7,9,39,Pass
Balbir Reddy,16-11-2004,304176,Bihar,14,23,8,1,46,Pass
Aditya Fernandes,13-03-2005,875591,Mizoram,4,0,2,5,11,Pass
Aarav Chopra,25-08-2005,947389,Bihar,7,9,19,13,48,Pass
Ishaan Verma,18-02-2006,760683,Uttar Pradesh,7,5,15,11,38,Pass
Vivaan Mehta,07-03-2005,162643,Karnataka,1,21,7,5,34,Pass
Yash Fernandes,30-09-2005,701688,Uttar Pradesh,6,5,19,12,42,Pass
Ishaan Reddy,24-12-2005,919173,West Bengal,0,4,11,7,22,Pass
Raj Pillai,12-11-2005,993130,Punjab,14,17,4,7,42,Pass
Kunal Chopra,29-05-2005,410477,Punjab,0,4,7,9,20,Pass
Aarav Sharma,23-04-2005,316181,Chhattisgarh,12,22,11,4,49,Pass
Farhan Chopra,17-03-2005,228625,Uttar Pradesh,18,5,17,3,43,Pass
Aditya Chopra,13-09-2005,605339,Haryana,11,0,5,15,31,Pass
Peter Fernandes,27-12-2004,851436,Maharashtra,3,22,23,23,71,Pass
Rohan Sharma,08-05-2006,545452,Rajasthan,14,24,2,18,58,Pass
Aryan Chopra,15-02-2005,175548,Puducherry,17,6,5,6,34,Pass
Krishna Singh,10-02-2005,700810,Uttar Pradesh,6,5,0,10,21,Pass
Krishna Sharma,16-06-2005,709874,Rajasthan,10,2,0,17,29,Pass
Manpreet Pillai,25-11-2004,594340,Punjab,1,20,12,21,54,Pass
Kunal Sharma,23-09-2005,451378,Jharkhand,12,9,22,23,66,Pass
Ishaan D'Souza,24-01-2006,943827,Madhya Pradesh,12,4,20,13,49,Pass
Raj Sharma,06-03-2006,875467,Bihar,14,15,19,7,55,Pass
Aarav Khan,18-12-2004,805887,Chhattisgarh,4,4,18,16,42,Pass
Aryan Verma,06-12-2005,830963,Gujarat,10,16,9,13,48,Pass
Yash Chopra,23-12-2004,254814,Delhi,2,19,19,6,46,Fail
Peter Reddy,27-08-2005,763671,Haryana,21,1,0,16,38,Pass
Kunal Chopra,21-10-2005,236303,Rajasthan,18,7,8,0,33,Pass
Vivaan Pillai,30-08-2005,716702,West Bengal,3,20,11,13,47,Pass
Farhan Khan,17-08-2005,449865,Bihar,7,24,20,17,68,Pass
Kunal Pillai,24-12-2004,952914,Delhi,14,20,4,19,57,Fail
Yash Singh,08-05-2005,704862,Bihar,8,12,19,16,55,Pass
Gurpreet D'Souza,03-06-2005,511207,Punjab,21,7,21,2,51,Pass
Rehan D'Souza,11-07-2005,419196,Rajasthan,13,17,11,13,54,Pass
Aryan Chopra,01-01-2006,715964,Bihar,16,6,12,1,35,Pass
Kunal Singh,25-12-2004,174931,Uttarakhand,3,18,15,8,44,Pass
Imran Khan,24-01-2005,611184,Maharashtra,11,9,20,7,47,Pass
Yash Sharma,08-08-2005,937940,Punjab,12,8,10,23,53,Pass
Peter Chopra,30-12-2005,283857,Telangana,10,15,6,14,45,Pass
Aryan Mehta,30-01-2006,946731,Bihar,9,16,8,0,33,Pass
Raj Pillai,30-09-2005,533101,Andhra Pradesh,8,11,12,13,44,Pass
Yash D'Souza,06-05-2006,787881,Uttar Pradesh,16,5,8,20,49,Pass
Aditya Fernandes,07-09-2005,425148,Odisha,17,4,6,4,31,Pass
Kunal Fernandes,25-01-2006,121806,Karnataka,11,24,11,6,52,Pass
Kunal Fernandes,26-08-2005,991293,Jammu & Kashmir + Ladakh,4,12,14,21,51,Pass
Aarav Singh,17-04-2006,557823,Madhya Pradesh,19,13,10,2,44,Pass
Gurpreet Reddy,09-01-2005,847931,Haryana,19,19,21,18,77,Pass
Rohan Khan,19-06-2005,825367,Rajasthan,10,4,0,13,27,Pass
Mathew Verma,04-04-2006,784385,Rajasthan,13,1,24,15,53,Pass
Krishna Pillai,21-01-2005,373193,Maharashtra,10,16,7,0,33,Pass
Raj Sharma,20-10-2005,314087,Maharashtra,19,4,6,2,31,Pass
Vivaan Fernandes,27-08-2005,404096,Uttar Pradesh,22,5,6,9,42,Pass
Yash Mehta,05-01-2006,742674,Punjab,8,20,8,16,52,Pass
Rohan Singh,02-05-2006,762117,Uttar Pradesh,21,5,20,6,52,Pass
Raj Khan,19-02-2005,658530,Bihar,10,20,23,2,55,Pass
Sukhwinder Verma,06-01-2006,542817,Punjab,5,21,10,17,53,Pass
Raj Fernandes,24-04-2005,385512,Madhya Pradesh,20,1,23,4,48,Pass
Gurpreet Fernandes,25-03-2006,770421,Bihar,15,18,6,23,62,Pass
Kunal Fernandes,06-05-2005,447691,Uttar Pradesh,6,5,22,24,57,Pass
Harjeet Fernandes,05-12-2005,597928,Punjab,23,13,4,3,43,Pass
Ishaan Fernandes,01-03-2005,218004,Uttar Pradesh,2,5,4,11,22,Pass
Gurpreet Sharma,07-12-2004,337220,Andhra Pradesh,18,19,23,19,79,Pass
Aarav Mehta,02-11-2005,631203,West Bengal,3,23,24,6,56,Pass
Krishna Pillai,09-11-2004,788586,Maharashtra,8,8,14,4,34,Pass
Yash Reddy,05-04-2006,781902,Punjab,24,19,0,13,56,Pass
Raj Singh,27-09-2005,749371,Haryana,6,12,12,14,44,Pass
Rohan Singh,12-06-2005,849174,Uttar Pradesh,1,5,13,20,39,Pass
Harjeet Khan,03-02-2005,300382,Delhi,9,0,19,8,36,Fail
Aryan Khan,28-06-2005,166614,Tripura,3,20,18,17,58,Pass
Gurpreet Singh,25-12-2004,799344,Punjab,2,0,14,23,39,Pass
Krishna Reddy,30-04-2005,842372,Delhi,14,17,11,22,64,Fail
Sukhwinder Reddy,07-12-2005,653390,Karnataka,3,23,11,23,60,Pass
Aarav Khan,25-11-2004,204312,Haryana,9,7,19,2,37,Pass
Raj Mehta,01-04-2005,643164,Bihar,15,7,9,21,52,Pass
Gurpreet Singh,01-09-2005,511562,Bihar,15,20,19,19,73,Pass
Yash Fernandes,24-03-2005,612452,Uttar Pradesh,3,5,17,15,40,Pass
Ishaan Sharma,10-03-2006,752951,Haryana,20,0,5,12,37,Pass
Rohan Pillai,29-11-2004,946398,Delhi,6,23,20,17,66,Fail
Kunal Singh,09-02-2006,568309,Kerala,2,13,6,23,44,Pass
Aarav Singh,11-03-2006,529908,Uttar Pradesh,1,5,4,0,10,Pass
Aarav Chopra,24-04-2006,475124,Chhattisgarh,0,19,2,12,33,Pass
Ishaan Mehta,18-04-2005,929896,Haryana,22,2,1,24,49,Pass
Rohan Reddy,21-10-2005,825883,Uttar Pradesh,6,5,21,8,40,Pass
Aarav Fernandes,17-08-2005,314733,Haryana,23,14,21,0,58,Pass
Raj Verma,13-04-2006,675702,Telangana,9,14,13,11,47,Pass
Paul Chopra,12-12-2005,686670,Rajasthan,20,19,13,9,61,Pass
Aarav Khan,22-03-2005,415916,Bihar,12,10,14,11,47,Pass
Kunal Khan,12-02-2005,797853,Karnataka,18,8,9,13,48,Pass
Aryan Verma,04-06-2005,443940,Uttar Pradesh,23,5,21,1,50,Pass
John Sharma,03-11-2005,184381,Tamil Nadu,18,3,9,0,30,Pass
Yash Sharma,01-02-2006,480024,Kerala,24,2,2,8,36,Pass
Ishaan Singh,18-05-2005,809081,Uttar Pradesh,4,5,10,4,23,Pass
Aarav Singh,14-05-2005,745150,Haryana,3,4,0,1,8,Pass
Farhan D'Souza,13-02-2005,812281,Madhya Pradesh,17,11,6,10,44,Pass
Krishna Pillai,16-08-2005,739674,Madhya Pradesh,12,7,11,21,51,Pass
Yash Singh,03-06-2005,435916,Chhattisgarh,18,12,10,5,45,Pass
Rohan Singh,21-03-2005,779048,Maharashtra,0,11,3,9,23,Pass
Mathew Mehta,19-12-2005,902589,Andhra Pradesh,4,15,10,15,44,Pass
Aryan D'Souza,30-10-2005,373711,Uttar Pradesh,21,5,0,7,33,Pass
Kunal Fernandes,25-02-2006,699787,Uttar Pradesh,4,5,2,23,34,Pass
Mathew Mehta,06-12-2005,105862,Jharkhand,19,6,6,3,34,Pass
Yash D'Souza,30-09-2005,373791,Delhi,4,19,21,14,58,Fail
Raj Sharma,20-04-2005,782679,Chhattisgarh,17,23,24,9,73,Pass
Krishna Pillai,13-12-2004,951028,Delhi,6,12,19,2,39,Fail
Manpreet D'Souza,30-08-2005,484241,Uttar Pradesh,18,5,20,9,52,Pass
Raj Verma,27-03-2006,543979,Madhya Pradesh,10,13,3,11,37,Pass
Raj Reddy,21-12-2005,957913,Meghalaya,11,4,2,12,29,Pass
Aryan Pillai,21-01-2005,142627,West Bengal,10,14,0,23,47,Pass
Aryan Pillai,13-03-2005,808699,Bihar,22,4,18,8,52,Pass
Aditya Singh,16-11-2004,245837,Odisha,4,3,5,20,32,Pass
Raj Singh,11-04-2005,293554,Andhra Pradesh,15,10,21,1,47,Pass
Manpreet Reddy,05-12-2004,349165,Andhra Pradesh,23,6,17,10,56,Pass
Aditya Chopra,08-02-2006,801962,Bihar,2,5,6,8,21,Pass
Krishna Sharma,16-01-2006,710155,Uttar Pradesh,4,5,14,22,45,Pass
Harjeet Pillai,07-01-2005,463016,Bihar,7,12,20,10,49,Pass
Ishaan Fernandes,25-03-2006,603320,Bihar,18,12,11,23,64,Pass
Peter D'Souza,19-03-2006,767574,West Bengal,2,5,14,16,37,Pass
Aryan Sharma,17-11-2005,235508,Madhya Pradesh,12,22,8,6,48,Pass
Aarav Singh,11-02-2005,979470,Haryana,9,19,2,14,44,Pass
Aarav Reddy,21-01-2005,721054,Punjab,24,15,3,18,60,Pass
Ishaan Fernandes,19-07-2005,333258,Tamil Nadu,23,19,1,14,57,Pass
Vivaan Sharma,22-05-2005,247415,Rajasthan,4,15,6,0,25,Pass
Aarav Khan,26-11-2005,209350,Bihar,17,3,5,8,33,Pass
Ishaan D'Souza,08-06-2005,772066,Haryana,7,6,10,2,25,Pass
Krishna Chopra,07-01-2006,510001,Uttar Pradesh,11,5,19,14,49,Pass
Kunal Reddy,12-11-2005,738776,Himachal Pradesh,1,20,20,17,58,Pass
Krishna Singh,23-02-2006,704290,Delhi,10,19,24,18,71,Fail
Kunal Fernandes,07-06-2005,164778,Andhra Pradesh,2,14,8,8,32,Pass
Paul Verma,07-02-2006,715317,West Bengal,3,7,15,22,47,Pass
Balbir Singh,23-12-2004,476380,West Bengal,3,11,19,14,47,Pass
Aditya Fernandes,31-03-2005,430190,Bihar,24,15,20,24,83,Pass
Aarav Chopra,14-07-2005,580252,Uttar Pradesh,3,5,12,18,38,Pass
Aryan Mehta,28-04-2006,202862,Odisha,3,22,4,1,30,Pass
Rohan D'Souza,31-12-2005,115110,Rajasthan,5,13,5,12,35,Pass
Peter Verma,08-04-2005,770560,Bihar,7,9,0,23,39,Pass
Farhan Chopra,22-11-2004,310524,Uttar Pradesh,18,5,16,3,42,Pass
Yash Sharma,20-02-2006,211067,West Bengal,16,5,24,3,48,Pass
Aditya Singh,27-03-2006,929362,Andhra Pradesh,12,21,4,10,47,Pass
Harjeet Reddy,07-04-2005,679362,Andhra Pradesh,21,17,22,17,77,Pass
Kunal Chopra,11-04-2005,530660,Bihar,3,21,18,20,62,Pass
Aditya Singh,24-11-2005,964014,Tamil Nadu,3,18,22,24,67,Pass
Kunal Fernandes,12-04-2005,743852,Uttar Pradesh,23,5,12,23,63,Pass
Balbir Khan,15-01-2005,384463,Haryana,12,15,20,3,50,Pass
Manpreet Chopra,27-11-2004,422858,Maharashtra,3,23,18,14,58,Pass
Kunal Reddy,20-04-2005,539524,Odisha,0,22,6,9,37,Pass
Ishaan Mehta,14-06-2005,616577,Delhi,5,18,18,14,55,Fail
Vivaan Sharma,30-10-2005,752306,Maharashtra,11,0,10,10,31,Pass
Krishna D'Souza,20-09-2005,907993,Karnataka,3,23,24,16,66,Pass
Krishna Fernandes,02-02-2005,100395,Rajasthan,18,9,0,5,32,Pass
Ishaan Fernandes,31-05-2005,245241,West Bengal,17,7,15,13,52,Pass
Kunal Khan,06-06-2005,342375,Chhattisgarh,8,5,3,1,17,Pass
Harjeet Chopra,28-09-2005,440657,Assam,18,5,8,17,48,Pass
Aryan Verma,01-04-2005,754640,Haryana,22,23,7,13,65,Pass
Vivaan D'Souza,16-11-2005,583362,Madhya Pradesh,21,2,3,5,31,Pass
Manpreet Verma,30-08-2005,917605,Maharashtra,3,22,8,9,42,Pass
Rohan Sharma,19-11-2005,876777,Madhya Pradesh,12,10,3,17,42,Pass
Peter Verma,02-07-2005,503416,Odisha,3,6,7,6,22,Pass
Yash Fernandes,24-02-2005,353788,Gujarat,18,20,20,10,68,Pass
Vivaan Sharma,17-04-2006,341319,Madhya Pradesh,2,10,3,17,32,Pass
Vivaan Reddy,01-01-2005,166753,Assam,7,15,5,24,51,Pass
Ishaan Khan,10-07-2005,174169,Gujarat,0,6,2,19,27,Pass
Vivaan Sharma,23-01-2005,947643,Uttar Pradesh,12,5,13,10,40,Pass
Aarav Sharma,06-06-2005,249973,Bihar,0,13,23,5,41,Pass
Raj Chopra,27-01-2005,516469,Chhattisgarh,9,21,17,0,47,Pass
Gurpreet Khan,04-10-2005,128460,West Bengal,4,17,1,15,37,Pass
Aryan Fernandes,08-01-2005,137203,Tamil Nadu,17,19,14,13,63,Pass
Krishna Fernandes,20-12-2005,241781,Rajasthan,3,1,3,21,28,Pass
Sukhwinder Sharma,05-09-2005,398638,Karnataka,12,21,1,23,57,Pass
Ayaan Singh,18-04-2006,213562,Uttar Pradesh,12,5,19,12,48,Pass
Aarav Sharma,20-12-2004,446205,Bihar,3,0,19,21,43,Pass
Mathew Khan,08-10-2005,698674,West Bengal,23,2,24,2,51,Pass
Raj Sharma,21-12-2004,854084,Andhra Pradesh,15,7,11,15,48,Pass
Aditya Sharma,16-12-2005,505887,West Bengal,9,13,11,11,44,Pass
Aditya Khan,09-09-2005,698097,Maharashtra,17,1,17,1,36,Pass
Rohan Sharma,25-08-2005,171290,Punjab,1,23,9,21,54,Pass
Ishaan Chopra,14-04-2006,432324,Bihar,2,0,13,19,34,Pass
Rohan Khan,13-07-2005,359235,West Bengal,18,4,5,5,32,Pass
Manpreet Singh,17-03-2006,486072,Karnataka,23,20,1,19,63,Pass
Rohan Khan,27-06-2005,777134,Madhya Pradesh,17,15,9,7,48,Pass
Aryan Chopra,09-02-2005,378867,Andhra Pradesh,0,4,16,9,29,Pass
Sukhwinder Fernandes,15-08-2005,872166,Jammu & Kashmir + Ladakh,1,22,4,8,35,Pass
Vivaan Verma,07-10-2005,611709,Maharashtra,5,6,0,17,28,Pass
Aryan Singh,30-11-2005,434581,Jharkhand,5,20,13,15,53,Pass
Aryan Khan,11-12-2005,109631,Tamil Nadu,3,8,23,17,51,Pass
Kunal Singh,19-09-2005,271942,Assam,8,11,15,4,38,Pass
Rohan Singh,22-11-2004,712787,West Bengal,6,20,8,15,49,Pass
Kunal Reddy,30-11-2005,114358,West Bengal,18,4,21,6,49,Pass
Aarav Singh,26-12-2005,895776,Bihar,17,17,8,23,65,Pass
Kunal Sharma,25-02-2005,136933,Maharashtra,4,9,3,16,32,Pass
Ishaan Chopra,14-03-2005,478641,Rajasthan,12,10,13,23,58,Pass
Yash Pillai,09-11-2004,984784,Kerala,13,5,13,0,31,Pass
Rehan Reddy,23-11-2005,990587,Punjab,1,13,9,14,37,Pass
Ishaan Verma,17-02-2005,473272,Tamil Nadu,23,6,17,23,69,Pass
Mathew D'Souza,04-12-2005,554849,Uttarakhand,2,8,7,2,19,Pass
Kunal Pillai,21-02-2005,758972,Assam,6,5,4,21,36,Pass
Rehan Reddy,14-03-2005,302845,Tamil Nadu,5,16,4,10,35,Pass
Rohan Chopra,31-03-2005,283452,Bihar,12,11,1,16,40,Pass
Kunal Verma,28-09-2005,711426,Uttar Pradesh,2,5,19,16,42,Pass
Kunal Khan,07-03-2006,224897,Uttar Pradesh,17,5,17,23,62,Pass
Kunal Chopra,27-12-2004,762540,Bihar,7,18,4,8,37,Pass
Balbir Mehta,15-01-2005,413705,West Bengal,0,15,2,15,32,Pass
Kunal Reddy,12-06-2005,168385,Bihar,6,15,24,24,69,Pass
Vivaan Singh,04-02-2006,379864,Rajasthan,11,3,1,18,33,Pass
Ishaan Reddy,27-01-2006,294443,Maharashtra,17,16,4,4,41,Pass
Aarav Mehta,09-09-2005,395634,Madhya Pradesh,15,7,19,5,46,Pass
Aryan Verma,11-11-2005,450618,Jammu & Kashmir + Ladakh,20,12,11,10,53,Pass
Kunal Pillai,12-09-2005,263197,West Bengal,16,12,0,22,50,Pass
Raj Khan,13-04-2005,834674,Tamil Nadu,14,20,14,1,49,Pass
Aditya D'Souza,13-11-2005,172556,Madhya Pradesh,18,19,5,9,51,Pass
Aarav Reddy,21-02-2006,864459,Gujarat,16,20,22,21,79,Pass
Krishna Fernandes,10-03-2006,530092,Punjab,21,3,0,24,48,Pass
Aarav D'Souza,17-10-2005,100194,Tamil Nadu,8,8,9,24,49,Pass
Aarav Pillai,19-01-2006,606574,Tamil Nadu,22,13,5,23,63,Pass
Vivaan D'Souza,18-12-2005,277457,West Bengal,7,8,13,1,29,Pass
Vivaan Pillai,26-07-2005,173071,Uttar Pradesh,11,5,6,3,25,Pass
Rohan D'Souza,16-01-2005,674712,Assam,3,23,15,7,48,Pass
Raj Sharma,14-12-2005,794477,Uttar Pradesh,23,5,21,2,51,Pass
Aryan Reddy,06-03-2006,599436,Rajasthan,23,7,15,21,66,Pass
Mathew Pillai,17-01-2006,160188,Bihar,13,0,17,13,43,Pass
Harjeet Pillai,01-07-2005,515995,Maharashtra,3,15,6,17,41,Pass
Aryan Singh,03-02-2006,715398,Tamil Nadu,14,22,6,8,50,Pass
Raj Singh,29-06-2005,732484,Andhra Pradesh,24,0,17,21,62,Pass
Yash Verma,30-10-2005,683449,Bihar,5,22,24,5,56,Pass
Sukhwinder Mehta,06-02-2005,871311,Karnataka,5,23,12,1,41,Pass
Sukhwinder D'Souza,18-04-2005,721033,Madhya Pradesh,16,16,24,4,60,Pass
Gurpreet Reddy,20-02-2005,841933,Uttar Pradesh,5,5,15,1,26,Pass
Krishna Singh,25-10-2005,303053,Uttar Pradesh,12,5,16,19,52,Pass
David Sharma,28-10-2005,656857,Assam,9,18,14,12,53,Pass
Vivaan D'Souza,18-01-2005,561914,Assam,20,14,8,0,42,Pass
Aditya Mehta,11-04-2005,365468,Uttar Pradesh,10,5,12,9,36,Pass
John Singh,22-10-2005,606586,Bihar,7,7,1,19,34,Pass
Rohan Fernandes,18-02-2005,639965,Punjab,3,3,12,14,32,Pass
Rohan Singh,23-05-2005,470509,Haryana,21,5,6,21,53,Pass
Vivaan Singh,25-09-2005,264537,Uttar Pradesh,8,5,19,16,48,Pass
Aarav Verma,20-02-2006,824187,Bihar,4,2,8,10,24,Pass
Raj Fernandes,19-01-2006,827235,West Bengal,3,18,16,20,57,Pass
Aditya Fernandes,07-07-2005,301769,Madhya Pradesh,12,21,14,4,51,Pass
Kunal Khan,17-04-2005,435624,Punjab,24,22,13,0,59,Pass
Aarav Sharma,16-12-2005,841463,Maharashtra,3,15,19,0,37,Pass
David Fernandes,15-02-2005,316332,Karnataka,18,20,19,1,58,Pass
Aditya Fernandes,15-02-2006,207598,Madhya Pradesh,11,9,12,12,44,Pass
Aarav Sharma,06-03-2005,581142,Maharashtra,3,23,20,18,64,Pass
Rohan Sharma,16-06-2005,816675,Assam,5,0,13,5,23,Pass
Krishna D'Souza,31-08-2005,420576,Bihar,13,3,0,0,16,Pass
Rohan Fernandes,07-04-2006,545451,Rajasthan,19,5,22,19,65,Pass
Aarav Pillai,25-03-2006,906500,Nagaland,24,24,4,24,76,Pass
Aditya Khan,22-09-2005,471220,Himachal Pradesh,12,23,6,11,52,Pass
Vivaan Reddy,22-09-2005,211389,Karnataka,14,0,6,15,35,Pass
Zaid Pillai,11-01-2005,228336,Odisha,7,22,5,18,52,Pass
Paul Fernandes,14-03-2006,896327,Jharkhand,5,19,5,8,37,Pass
Peter Reddy,29-06-2005,950867,Telangana,17,16,11,14,58,Pass
Aarav Mehta,18-05-2005,341873,Andhra Pradesh,1,20,10,14,45,Pass
Rehan Singh,26-12-2005,147659,West Bengal,2,13,24,9,48,Pass
Raj Pillai,26-03-2006,948053,Tamil Nadu,5,11,7,24,47,Pass
Raj Khan,22-10-2005,648066,West Bengal,15,6,17,11,49,Pass
Yash Reddy,18-05-2005,481949,Andhra Pradesh,24,14,4,20,62,Pass
Krishna Verma,27-09-2005,726861,Jharkhand,7,0,15,8,30,Pass
Aryan Mehta,20-12-2004,945127,Karnataka,16,18,6,24,64,Pass
Rohan Mehta,28-04-2006,351390,Karnataka,4,6,10,7,27,Pass
Sukhwinder Verma,20-06-2005,303885,Chhattisgarh,21,8,20,23,72,Pass
Vivaan Verma,06-09-2005,580934,Madhya Pradesh,19,14,20,4,57,Pass
Ayaan D'Souza,06-09-2005,758778,Uttar Pradesh,12,5,5,5,27,Pass
Kunal Khan,04-12-2004,845343,Punjab,4,11,21,20,56,Pass
Aryan Singh,31-05-2005,971573,Madhya Pradesh,11,24,2,11,48,Pass
Yash Chopra,17-12-2004,269316,Uttar Pradesh,4,5,23,0,32,Pass
Sukhwinder Chopra,11-12-2005,645608,Punjab,13,17,3,2,35,Pass
Aditya Verma,27-10-2005,482744,Delhi,8,10,15,7,40,Fail
Yash Sharma,04-12-2004,682411,Bihar,2,21,7,22,52,Pass
Rohan D'Souza,27-06-2005,101650,Bihar,4,10,8,6,28,Pass
Yash Pillai,31-03-2005,747077,Maharashtra,3,22,3,15,43,Pass
Raj Verma,13-02-2005,365770,Rajasthan,7,3,14,16,40,Pass
Kunal Reddy,03-01-2006,432700,Uttar Pradesh,12,5,3,13,33,Pass
Rohan Chopra,03-04-2006,900333,Andhra Pradesh,6,16,17,0,39,Pass
Aryan Singh,19-07-2005,986362,Tamil Nadu,14,20,12,13,59,Pass
Paul Singh,26-04-2006,160695,Andhra Pradesh,10,7,13,2,32,Pass
Aarav Fernandes,24-03-2006,947922,Bihar,8,5,2,12,27,Pass
Kunal D'Souza,21-02-2005,123291,Uttarakhand,3,2,18,24,47,Pass
Aarav Reddy,17-12-2004,401130,Uttar Pradesh,18,5,19,7,49,Pass
Rehan Verma,11-02-2006,930825,West Bengal,4,21,9,13,47,Pass
Ishaan Sharma,26-05-2005,602946,Andhra Pradesh,22,20,6,14,62,Pass
Gurpreet Fernandes,14-01-2005,227370,Rajasthan,2,24,17,15,58,Pass
Aryan Khan,03-04-2005,740050,Madhya Pradesh,1,17,11,18,47,Pass
Yash Mehta,17-03-2005,595278,Himachal Pradesh,6,17,20,21,64,Pass
Peter Sharma,24-09-2005,284157,Uttar Pradesh,20,5,5,11,41,Pass
Aditya D'Souza,08-02-2006,104496,Assam,9,4,8,18,39,Pass
Kunal Singh,01-12-2005,128210,Uttar Pradesh,10,5,9,1,25,Pass
Aditya Pillai,14-11-2005,611332,Karnataka,24,21,7,8,60,Pass
Aryan Verma,10-08-2005,557768,Karnataka,15,10,24,6,55,Pass
Ishaan Fernandes,21-05-2005,319303,Bihar,12,18,11,16,57,Pass
Rohan Reddy,05-01-2005,759792,Delhi,12,14,24,20,70,Fail
Sukhwinder Chopra,07-07-2005,688994,Bihar,13,4,10,10,37,Pass
Vivaan Sharma,03-07-2005,877419,Bihar,0,23,0,21,44,Pass
Ishaan Sharma,27-06-2005,271061,Odisha,1,0,2,4,7,Pass
David Singh,04-11-2005,714784,Assam,8,14,11,15,48,Pass
Aditya D'Souza,06-09-2005,986044,Uttar Pradesh,2,5,10,3,20,Pass
Krishna Fernandes,28-02-2005,442328,Karnataka,16,0,18,6,40,Pass
Raj Chopra,04-02-2005,739079,Chhattisgarh,19,6,8,22,55,Pass
Ishaan D'Souza,20-01-2006,595369,Odisha,1,10,7,5,23,Pass
Yash Verma,04-11-2005,950410,Uttarakhand,5,19,0,24,48,Pass
Raj Verma,16-08-2005,952047,Madhya Pradesh,16,5,0,9,30,Pass
Krishna Singh,13-04-2005,211673,Uttarakhand,2,8,23,6,39,Pass
Ishaan Fernandes,15-02-2005,927635,Andhra Pradesh,13,17,23,9,62,Pass
Kunal Reddy,28-02-2006,546436,Karnataka,5,9,4,22,40,Pass
Rohan Pillai,05-10-2005,560949,Himachal Pradesh,8,16,9,4,37,Pass
Kunal Reddy,10-11-2004,663436,Maharashtra,3,4,7,3,17,Pass
Yash Verma,06-08-2005,243155,Odisha,1,9,20,2,32,Pass
Yash Fernandes,03-05-2006,292898,Haryana,23,23,1,13,60,Pass
Ayaan D'Souza,08-02-2006,165388,Karnataka,10,7,10,13,40,Pass
Yash Khan,08-11-2005,839637,Andhra Pradesh,8,20,5,4,37,Pass
Aryan Chopra,04-02-2005,103304,Uttar Pradesh,7,5,14,7,33,Pass
Krishna Fernandes,15-07-2005,784209,Andhra Pradesh,5,8,23,7,43,Pass
Balbir Mehta,27-04-2006,672930,Rajasthan,7,22,22,20,71,Pass
Sukhwinder Reddy,04-05-2005,715067,Gujarat,4,13,18,17,52,Pass
Gurpreet Reddy,26-10-2005,292932,Tamil Nadu,21,20,19,9,69,Pass
Vivaan Pillai,27-08-2005,338147,Andhra Pradesh,21,8,6,2,37,Pass
Aditya Khan,04-05-2005,501346,Jammu & Kashmir + Ladakh,7,5,11,7,30,Pass
Raj D'Souza,10-04-2006,781375,Andhra Pradesh,12,16,10,9,47,Pass
Krishna Singh,28-01-2006,577806,Bihar,18,12,20,23,73,Pass
David Pillai,20-02-2006,805248,Rajasthan,16,11,1,19,47,Pass
Rohan Sharma,31-05-2005,957107,West Bengal,3,19,5,13,40,Pass
Aryan D'Souza,01-02-2006,451956,Karnataka,24,20,20,3,67,Pass
Aarav Fernandes,07-01-2006,302507,Punjab,2,13,8,7,30,Pass
Aryan Sharma,31-08-2005,659155,Madhya Pradesh,17,20,23,4,64,Pass
Aditya Verma,28-02-2005,139564,West Bengal,3,23,20,9,55,Pass
Krishna Verma,09-05-2005,571107,Maharashtra,3,9,22,22,56,Pass
Ishaan Chopra,20-01-2006,957853,Madhya Pradesh,11,18,17,4,50,Pass
Balbir D'Souza,16-04-2005,950649,Madhya Pradesh,1,11,20,2,34,Pass
Krishna D'Souza,04-08-2005,442663,Kerala,10,4,17,18,49,Pass
Rohan Chopra,19-10-2005,234357,Tamil Nadu,23,11,6,23,63,Pass
Balbir Fernandes,18-01-2005,170553,Maharashtra,3,13,10,22,48,Pass
Peter Pillai,24-04-2006,476112,Rajasthan,12,11,2,9,34,Pass
Raj Reddy,17-09-2005,689092,Odisha,5,6,7,8,26,Pass
Aryan D'Souza,12-06-2005,849510,West Bengal,4,19,11,11,45,Pass
Zaid D'Souza,23-12-2004,172647,Kerala,1,13,1,10,25,Pass
Peter Sharma,09-05-2006,974497,Bihar,18,13,4,7,42,Pass
Aditya Chopra,05-04-2006,629429,Uttar Pradesh,3,5,22,12,42,Pass
Aryan Verma,21-01-2005,934271,Gujarat,18,23,16,6,63,Pass
Raj D'Souza,17-01-2006,448360,Tamil Nadu,23,1,9,4,37,Pass
Aditya D'Souza,17-03-2005,746063,Karnataka,15,14,1,4,34,Pass
Aarav Verma,04-03-2006,539326,Bihar,13,10,18,3,44,Pass
Ishaan Khan,07-02-2006,795362,Uttar Pradesh,18,5,10,4,37,Pass
David Pillai,03-02-2006,742648,Rajasthan,4,12,12,11,39,Pass
Kunal Khan,15-01-2005,318883,Jharkhand,0,4,17,16,37,Pass
Rohan Khan,30-12-2005,845423,Madhya Pradesh,0,8,1,3,12,Pass
Aditya Sharma,12-03-2005,408481,Assam,7,7,24,6,44,Pass
Gurpreet D'Souza,26-09-2005,109114,Madhya Pradesh,16,20,7,7,50,Pass
Vivaan Verma,25-10-2005,422380,Jammu & Kashmir + Ladakh,14,20,15,1,50,Pass
Balbir Chopra,04-08-2005,513950,Karnataka,14,8,14,6,42,Pass
Aarav Verma,28-11-2005,918110,Rajasthan,13,4,9,11,37,Pass
John Khan,25-01-2005,392662,Kerala,13,8,8,16,45,Pass
Kunal D'Souza,20-04-2006,583579,Rajasthan,4,20,9,12,45,Pass
Aditya Reddy,12-02-2006,644976,Madhya Pradesh,11,15,19,4,49,Pass
Peter Singh,08-12-2004,498102,Karnataka,4,22,19,14,59,Pass
Raj Reddy,30-03-2006,798675,Maharashtra,3,18,12,18,51,Pass
Harjeet Chopra,05-12-2005,726842,Daman & Diu / D&N Haveli,9,5,6,7,27,Pass
Raj Verma,25-11-2004,964189,West Bengal,12,12,3,3,30,Pass
Balbir Khan,20-03-2005,311240,Kerala,8,16,8,8,40,Pass
Rohan Reddy,19-10-2005,293495,Telangana,16,7,0,12,35,Pass
Ayaan Sharma,27-09-2005,941627,Bihar,23,15,15,14,67,Pass
Rehan Sharma,18-11-2005,939290,Punjab,2,20,17,5,44,Pass
Aryan D'Souza,20-02-2006,488781,Odisha,3,19,19,12,53,Pass
Paul Reddy,23-12-2004,483602,Karnataka,18,13,10,10,51,Pass
Kunal Verma,23-12-2004,193084,Rajasthan,15,6,20,10,51,Pass
Mathew Fernandes,22-11-2005,383135,Andhra Pradesh,19,4,16,21,60,Pass
Vivaan Verma,21-04-2006,904955,Andhra Pradesh,13,15,15,3,46,Pass
Zaid Mehta,02-04-2006,415988,Rajasthan,15,10,20,11,56,Pass
Aarav Khan,01-01-2005,328304,Tamil Nadu,5,12,24,10,51,Pass
Rohan Chopra,06-08-2005,777025,Madhya Pradesh,15,18,10,8,51,Pass
Vivaan D'Souza,18-12-2004,563361,Madhya Pradesh,3,5,20,13,41,Pass
Raj Sharma,19-02-2006,221739,Himachal Pradesh,16,24,22,2,64,Pass
Peter D'Souza,17-02-2005,685488,Rajasthan,2,21,9,10,42,Pass
Rohan D'Souza,09-10-2005,442144,Maharashtra,21,13,6,2,42,Pass
Yash Pillai,15-12-2005,585076,West Bengal,3,11,23,11,48,Pass
Aarav Verma,10-12-2004,703022,Bihar,1,22,7,0,30,Pass
Rohan Singh,13-02-2005,323786,Rajasthan,20,13,0,3,36,Pass
Ishaan Sharma,20-12-2004,882976,Maharashtra,19,1,16,3,39,Pass
Paul Fernandes,18-10-2005,294187,Meghalaya,12,23,15,1,51,Pass
Vivaan Mehta,07-05-2006,181053,Sikkim,3,11,8,5,27,Pass
Kunal Pillai,19-01-2006,810756,Rajasthan,1,12,16,16,45,Pass
Krishna Sharma,04-06-2005,976220,Gujarat,21,10,13,16,60,Pass
Krishna Mehta,09-09-2005,274905,Bihar,1,5,20,3,29,Pass
Gurpreet Sharma,20-10-2005,337982,Uttarakhand,0,9,9,8,26,Pass
Manpreet D'Souza,24-04-2006,174628,Madhya Pradesh,19,21,20,4,64,Pass
Mathew Pillai,28-01-2006,868113,Delhi,4,5,9,6,24,Fail
Aarav D'Souza,05-08-2005,974774,Goa,0,5,21,4,30,Pass
Manpreet Singh,21-01-2006,435668,Jammu & Kashmir + Ladakh,5,22,17,10,54,Pass
Farhan Chopra,07-07-2005,204857,West Bengal,13,0,4,0,17,Pass
Raj D'Souza,05-09-2005,758701,Gujarat,12,15,15,0,42,Pass
Raj Khan,29-11-2005,319517,Rajasthan,15,3,24,23,65,Pass
Manpreet Mehta,13-08-2005,228017,Uttar Pradesh,0,5,2,14,21,Pass
Yash Sharma,03-07-2005,454100,Delhi,24,0,11,14,49,Fail
Aarav Reddy,21-03-2005,783964,Rajasthan,0,0,10,21,31,Pass
Kunal Fernandes,06-09-2005,826168,Bihar,13,14,6,13,46,Pass
Sukhwinder Reddy,06-05-2006,783227,West Bengal,3,12,10,18,43,Pass
Krishna Singh,12-06-2005,164481,Rajasthan,21,4,12,2,39,Pass
Harjeet Khan,15-04-2005,460940,Bihar,21,19,12,12,64,Pass
Ishaan Khan,01-03-2005,922563,West Bengal,3,23,22,16,64,Pass
Ishaan Sharma,04-06-2005,493904,Haryana,18,14,18,21,71,Pass
Aarav Chopra,16-05-2005,735767,Gujarat,4,6,18,11,39,Pass
Aarav Verma,13-02-2005,120875,Andhra Pradesh,8,13,6,23,50,Pass
Ishaan D'Souza,29-01-2006,253921,Rajasthan,13,21,15,20,69,Pass
Balbir Fernandes,19-04-2006,657234,West Bengal,3,22,10,17,52,Pass
Sukhwinder Reddy,12-12-2004,205580,Madhya Pradesh,2,17,5,11,35,Pass
Aditya Khan,14-06-2005,856831,Chhattisgarh,4,7,20,13,44,Pass
Aryan Verma,24-04-2006,197578,West Bengal,3,19,19,13,54,Pass
Zaid Pillai,13-12-2005,692330,Uttar Pradesh,1,5,2,4,12,Pass
Krishna Reddy,22-03-2005,322075,Uttar Pradesh,1,5,17,4,27,Pass
Paul Sharma,04-03-2005,204692,Uttar Pradesh,18,5,1,2,26,Pass
Balbir Mehta,10-03-2006,797281,Bihar,21,4,14,7,46,Pass
Kunal Fernandes,05-03-2005,794457,Rajasthan,3,23,16,17,59,Pass
Vivaan Fernandes,13-11-2005,526441,Odisha,20,17,24,3,64,Pass
Balbir Chopra,15-05-2005,144931,Rajasthan,7,4,16,0,27,Pass
Peter Khan,23-01-2005,906157,Uttar Pradesh,3,5,23,12,43,Pass
Harjeet Verma,10-02-2006,475489,Gujarat,18,1,8,18,45,Pass
Raj D'Souza,28-03-2006,413978,Kerala,18,21,5,8,52,Pass
Gurpreet Fernandes,16-12-2005,420650,Bihar,2,0,6,0,8,Pass
Harjeet Reddy,30-05-2005,640074,Uttar Pradesh,7,5,20,10,42,Pass
Rohan Khan,04-09-2005,530119,Punjab,2,24,17,10,53,Pass
Aditya Singh,13-09-2005,881676,Maharashtra,3,24,19,12,58,Pass
Kunal Fernandes,22-01-2005,837515,Odisha,20,7,22,8,57,Pass
Aditya Chopra,08-04-2006,905891,Madhya Pradesh,15,20,1,16,52,Pass
Rohan Fernandes,25-01-2005,400516,Haryana,14,14,11,7,46,Pass
Aryan Fernandes,02-10-2005,740402,Rajasthan,5,11,7,15,38,Pass
David Sharma,15-08-2005,241740,Chhattisgarh,23,4,2,11,40,Pass
Aditya Sharma,10-06-2005,142764,Rajasthan,4,19,23,15,61,Pass
Ishaan Verma,06-04-2006,106207,Tamil Nadu,5,21,14,5,45,Pass
Aarav Sharma,04-05-2005,332431,Madhya Pradesh,17,16,11,7,51,Pass
Zaid D'Souza,23-04-2005,365187,Andhra Pradesh,1,21,11,10,43,Pass
John Pillai,18-01-2005,819879,Andhra Pradesh,24,20,1,21,66,Pass
Aditya Mehta,09-02-2006,513260,Uttar Pradesh,0,5,16,0,21,Pass
Vivaan Sharma,31-01-2005,698780,Uttar Pradesh,14,5,15,10,44,Pass
Rohan Fernandes,07-03-2005,639775,Uttar Pradesh,11,5,22,4,42,Pass
Rohan D'Souza,24-12-2004,983001,Bihar,7,14,3,15,39,Pass
Harjeet Fernandes,18-04-2006,797265,Uttar Pradesh,7,5,20,9,41,Pass
Yash Chopra,12-01-2005,535533,Punjab,12,15,17,2,46,Pass
Kunal Khan,14-02-2006,321170,Delhi,22,21,11,9,63,Fail
Yash Verma,11-02-2005,682613,Maharashtra,3,18,9,9,39,Pass
Gurpreet Verma,30-04-2006,388847,Maharashtra,3,4,14,20,41,Pass
Yash Mehta,18-02-2005,250054,Gujarat,1,1,13,3,18,Pass
Manpreet Khan,13-11-2005,104476,Rajasthan,19,23,10,3,55,Pass
Vivaan Pillai,03-05-2006,683122,Rajasthan,18,18,5,2,43,Pass
Krishna Verma,01-05-2006,454800,Haryana,10,0,5,3,18,Pass
Aditya Chopra,05-03-2005,609881,West Bengal,3,14,12,13,42,Pass
Paul Pillai,08-11-2005,752724,Uttar Pradesh,18,5,18,12,53,Pass
Aryan Chopra,07-03-2005,394086,Uttar Pradesh,3,5,19,16,43,Pass
Krishna Pillai,04-12-2004,173644,Uttar Pradesh,18,5,11,17,51,Pass
John Pillai,20-10-2005,796421,Tamil Nadu,5,17,15,7,44,Pass
Raj Reddy,15-01-2005,287065,Uttar Pradesh,3,5,15,14,37,Pass
Rohan Chopra,22-06-2005,632946,West Bengal,7,8,21,1,37,Pass
Vivaan Fernandes,23-04-2005,352660,Gujarat,1,8,0,14,23,Pass
Rohan Verma,05-03-2005,318419,Tamil Nadu,9,9,3,21,42,Pass
Aditya D'Souza,05-05-2006,895917,Chhattisgarh,6,9,22,12,49,Pass
Aarav Singh,13-03-2005,331362,Himachal Pradesh,17,9,23,10,59,Pass
Sukhwinder D'Souza,04-11-2005,558921,Andhra Pradesh,18,3,12,6,39,Pass
Balbir Pillai,04-07-2005,584817,West Bengal,3,18,12,24,57,Pass
Ishaan Pillai,31-12-2004,423156,Telangana,15,14,2,19,50,Pass
Krishna Mehta,23-01-2005,414403,Uttar Pradesh,1,5,1,2,9,Pass
Vivaan Verma,07-03-2005,868612,Telangana,4,17,6,15,42,Pass
John Singh,07-02-2006,339704,Uttar Pradesh,23,5,7,7,42,Pass
Aryan Khan,10-11-2004,704186,Gujarat,21,8,15,22,66,Pass
Vivaan Verma,19-10-2005,263305,Odisha,2,7,4,21,34,Pass
Aditya Verma,08-10-2005,429754,Uttarakhand,5,1,19,18,43,Pass
Aarav Sharma,23-01-2006,720758,Rajasthan,3,22,13,5,43,Pass
Rohan Fernandes,10-04-2006,628785,Andhra Pradesh,19,6,4,8,37,Pass
Imran D'Souza,23-08-2005,816280,Chhattisgarh,0,1,8,7,16,Pass
Aarav Khan,24-01-2006,118933,Rajasthan,5,13,10,17,45,Pass
Harjeet D'Souza,11-05-2005,746514,Rajasthan,11,0,16,17,44,Pass
Raj Singh,22-09-2005,115709,Daman & Diu / D&N Haveli,3,8,1,7,19,Pass
Aditya Singh,28-07-2005,938773,Andhra Pradesh,22,8,22,10,62,Pass
Raj Fernandes,19-04-2006,272527,Rajasthan,17,8,4,2,31,Pass
Raj Singh,05-01-2006,431104,Rajasthan,17,13,6,13,49,Pass
Raj Singh,30-03-2006,541996,Uttar Pradesh,3,5,24,15,47,Pass
David Pillai,23-10-2005,668624,Maharashtra,6,1,19,20,46,Pass
Manpreet Singh,13-08-2005,400799,Bihar,22,9,12,6,49,Pass
Balbir Sharma,02-12-2004,934262,Nagaland,11,0,9,11,31,Pass
Balbir Fernandes,29-03-2006,117563,Uttar Pradesh,24,5,12,23,64,Pass
Aarav Singh,14-06-2005,360403,Uttarakhand,3,4,19,12,38,Pass
Aryan Mehta,25-03-2005,897579,Rajasthan,18,5,13,11,47,Pass
Gurpreet Mehta,09-08-2005,208474,Tamil Nadu,11,15,2,7,35,Pass
Aditya Mehta,27-03-2006,137136,Manipur,4,23,24,3,54,Pass
Peter Singh,13-05-2005,161380,Andhra Pradesh,4,4,19,2,29,Pass
Rohan Khan,05-03-2005,735389,Andhra Pradesh,18,16,13,10,57,Pass
Aarav Sharma,09-09-2005,777161,Andhra Pradesh,4,4,6,8,22,Pass
Yash Pillai,20-11-2004,614796,Andhra Pradesh,24,7,9,10,50,Pass
Aryan Sharma,28-08-2005,659780,Haryana,16,16,4,9,45,Pass
Ishaan Mehta,05-06-2005,786763,Madhya Pradesh,15,4,2,7,28,Pass
Raj Verma,09-03-2005,953320,Uttar Pradesh,3,5,11,18,37,Pass
Sukhwinder Sharma,19-12-2005,607382,Rajasthan,7,17,22,5,51,Pass
Kunal Fernandes,16-09-2005,405507,Bihar,23,7,7,17,54,Pass
Aditya Fernandes,06-10-2005,893588,Telangana,5,20,4,17,46,Pass
Paul Fernandes,12-12-2005,818848,Tamil Nadu,23,9,6,21,59,Pass
Balbir Chopra,05-09-2005,905305,Jharkhand,18,13,5,11,47,Pass
Paul Fernandes,27-06-2005,583647,West Bengal,7,14,21,2,44,Pass
Paul D'Souza,11-03-2005,665081,Odisha,23,23,12,16,74,Pass
Aryan Reddy,17-01-2005,237953,Maharashtra,7,4,4,20,35,Pass
Ishaan Chopra,19-04-2005,854756,Uttar Pradesh,7,5,19,6,37,Pass
Raj Chopra,18-11-2004,394722,Uttar Pradesh,21,5,16,11,53,Pass
Rohan Pillai,21-09-2005,554075,Assam,7,1,12,5,25,Pass
Kunal Singh,13-11-2005,713905,Punjab,3,10,13,1,27,Pass
Krishna Chopra,14-09-2005,993000,Rajasthan,2,7,21,18,48,Pass
Vivaan Singh,17-01-2006,168874,Tamil Nadu,24,13,7,5,49,Pass
Aryan Fernandes,15-11-2004,649352,Chhattisgarh,12,6,0,5,23,Pass
Rohan Singh,08-04-2005,425209,Punjab,19,1,23,4,47,Pass
Aryan Khan,06-10-2005,803338,Tamil Nadu,10,5,19,16,50,Pass
David Singh,30-04-2006,777893,Uttar Pradesh,11,5,9,0,25,Pass
Zaid Singh,05-01-2005,372167,Uttar Pradesh,19,5,20,10,54,Pass
Raj Fernandes,03-08-2005,145399,West Bengal,7,7,18,8,40,Pass
Aarav Verma,19-08-2005,858652,Bihar,21,17,15,10,63,Pass
Aditya Reddy,22-04-2006,250007,Tamil Nadu,21,14,22,15,72,Pass
Sukhwinder Khan,14-03-2005,525702,Delhi,4,3,11,3,21,Fail
Aryan Sharma,10-03-2006,423339,Telangana,8,13,14,20,55,Pass
Gurpreet Sharma,16-05-2005,796233,Bihar,9,23,14,18,64,Pass
Zaid D'Souza,19-10-2005,499612,Rajasthan,8,20,21,7,56,Pass
Vivaan Reddy,22-09-2005,670276,Chhattisgarh,18,24,10,12,64,Pass
Balbir Mehta,08-08-2005,762663,Bihar,20,15,15,8,58,Pass
Aarav Khan,16-03-2006,845933,Uttar Pradesh,11,5,14,0,30,Pass
Aditya Khan,28-08-2005,724209,Madhya Pradesh,5,7,6,19,37,Pass
Aryan Chopra,18-08-2005,401395,Rajasthan,15,23,22,12,72,Pass
Gurpreet Pillai,11-12-2004,952240,Bihar,5,17,21,24,67,Pass
Ishaan Pillai,13-08-2005,836794,Kerala,20,9,0,3,32,Pass
Krishna Singh,15-04-2005,480225,Maharashtra,20,9,11,6,46,Pass
Mathew Khan,29-08-2005,285960,Jammu & Kashmir + Ladakh,11,17,8,17,53,Pass
Kunal Sharma,27-01-2005,509715,Gujarat,7,12,3,7,29,Pass
Ishaan Sharma,02-09-2005,722001,Tamil Nadu,21,18,7,19,65,Pass
Krishna Pillai,15-05-2005,357795,Telangana,15,11,4,3,33,Pass
Kunal Singh,14-12-2004,258597,Assam,9,4,24,10,47,Pass
Balbir Verma,22-09-2005,284457,Chhattisgarh,15,22,3,22,62,Pass
Balbir Fernandes,01-03-2005,192510,Odisha,15,0,0,3,18,Pass
Raj Reddy,19-07-2005,167022,Rajasthan,16,13,5,15,49,Pass
Yash Singh,25-07-2005,288555,Uttar Pradesh,8,5,13,0,26,Pass
Ishaan Mehta,05-07-2005,966791,Uttar Pradesh,7,5,23,7,42,Pass
Raj Verma,08-11-2005,803283,Uttar Pradesh,8,5,18,4,35,Pass
Aditya Khan,28-01-2005,664032,Jharkhand,13,6,11,4,34,Pass
Paul D'Souza,02-11-2005,849670,Maharashtra,9,12,0,20,41,Pass
Krishna Sharma,16-04-2006,108980,Bihar,0,18,23,1,42,Pass
Farhan Reddy,14-06-2005,126687,Maharashtra,14,11,7,1,33,Pass
Paul D'Souza,13-05-2005,366394,Manipur,6,9,10,3,28,Pass
Raj Khan,09-10-2005,673262,Tamil Nadu,7,3,20,24,54,Pass
Aarav Pillai,25-08-2005,606550,Himachal Pradesh,11,22,14,10,57,Pass
Kunal Singh,21-03-2006,664693,Andhra Pradesh,0,4,19,1,24,Pass
Peter Khan,18-10-2005,790680,Uttar Pradesh,6,5,13,12,36,Pass
Yash Chopra,13-12-2005,865377,Punjab,12,17,7,15,51,Pass
Rohan Pillai,15-04-2005,200852,Uttar Pradesh,7,5,17,18,47,Pass
Aryan Khan,04-10-2005,522736,Maharashtra,23,1,15,10,49,Pass
Kunal Reddy,30-07-2005,923554,Haryana,13,20,18,19,70,Pass
Aditya Sharma,17-02-2005,160329,Madhya Pradesh,23,18,19,4,64,Pass
Farhan Pillai,14-12-2004,270764,Uttar Pradesh,3,5,12,24,44,Pass
Kunal Chopra,05-04-2005,194662,Bihar,4,10,2,4,20,Pass
Mathew Khan,14-04-2006,573370,West Bengal,11,23,13,4,51,Pass
Paul Sharma,27-07-2005,960408,Tamil Nadu,9,17,11,15,52,Pass
Kunal Verma,09-01-2006,815865,Karnataka,14,9,21,0,44,Pass
Rohan Chopra,25-08-2005,584474,Punjab,3,12,8,0,23,Pass
Raj Chopra,25-04-2005,759372,Maharashtra,3,13,8,22,46,Pass
Sukhwinder Verma,14-04-2005,642924,Bihar,7,7,19,11,44,Pass
Aryan Reddy,22-04-2006,260324,Delhi,9,10,19,12,50,Fail
Aryan D'Souza,04-01-2005,652210,Maharashtra,9,11,2,23,45,Pass
Aarav Sharma,09-04-2006,607543,Rajasthan,3,17,12,22,54,Pass
Ishaan Pillai,18-02-2005,205589,Punjab,10,23,8,3,44,Pass
Krishna Chopra,15-08-2005,921167,Assam,8,20,11,6,45,Pass
Krishna Reddy,06-09-2005,625772,Punjab,20,13,5,13,51,Pass
Aditya Chopra,12-08-2005,813297,Bihar,2,5,22,18,47,Pass
Kunal Pillai,25-03-2005,546527,Tamil Nadu,12,8,20,8,48,Pass
Raj D'Souza,26-12-2005,140592,Maharashtra,3,19,13,22,57,Pass
Manpreet Khan,18-02-2006,933294,Bihar,17,12,1,13,43,Pass
Raj Khan,17-10-2005,448829,West Bengal,3,7,17,16,43,Pass
Mathew Mehta,21-01-2005,761741,Uttar Pradesh,21,5,6,6,38,Pass
Kunal Sharma,22-05-2005,720441,Karnataka,7,2,4,22,35,Pass
Kunal Verma,12-02-2005,926822,Maharashtra,3,11,22,23,59,Pass
John Pillai,05-12-2004,614874,Delhi,5,0,22,21,48,Fail
Imran Pillai,12-11-2004,306577,Uttar Pradesh,6,5,24,18,53,Pass
Ayaan Singh,05-03-2006,291407,Tamil Nadu,19,3,14,21,57,Pass
Ishaan D'Souza,24-02-2006,128279,Assam,6,0,2,2,10,Pass
Raj Sharma,02-05-2006,643774,Punjab,14,7,3,23,47,Pass
Rohan Reddy,09-07-2005,776040,West Bengal,3,3,17,5,28,Pass
Aditya Fernandes,16-04-2005,299907,Chhattisgarh,0,19,7,4,30,Pass
Manpreet Pillai,03-06-2005,198157,Madhya Pradesh,21,8,20,4,53,Pass
Yash Fernandes,22-02-2006,543805,Jharkhand,11,16,23,12,62,Pass
Balbir Chopra,04-11-2005,136857,Maharashtra,3,15,22,7,47,Pass
Imran Chopra,04-07-2005,937968,Uttarakhand,3,16,15,17,51,Pass
Rehan Reddy,20-11-2004,269384,Chhattisgarh,3,20,8,15,46,Pass
Kunal Mehta,24-03-2006,423123,Bihar,2,23,0,21,46,Pass
Ishaan Mehta,17-05-2005,725523,Rajasthan,1,18,4,10,33,Pass
Aarav Khan,24-12-2004,287713,Andhra Pradesh,14,24,18,3,59,Pass
Ayaan Chopra,11-09-2005,911419,Bihar,9,12,19,3,43,Pass
Rohan Khan,31-03-2006,483011,Maharashtra,24,7,10,8,49,Pass
John Singh,05-10-2005,556810,Bihar,22,21,1,20,64,Pass
Zaid Khan,21-11-2005,193240,Tamil Nadu,9,10,2,18,39,Pass
Ishaan Sharma,25-07-2005,528535,Daman & Diu / D&N Haveli,9,7,3,8,27,Pass
Rohan Mehta,14-01-2006,645022,Karnataka,6,23,11,8,48,Pass
Aarav Reddy,23-04-2005,138940,Haryana,1,20,11,19,51,Pass
Krishna Fernandes,23-05-2005,659257,West Bengal,3,17,15,20,55,Pass
John Fernandes,03-02-2005,204971,Gujarat,11,7,18,17,53,Pass
Raj Mehta,01-02-2005,784652,Madhya Pradesh,8,3,8,23,42,Pass
Krishna Verma,06-04-2005,275659,Maharashtra,3,1,24,16,44,Pass
Raj Reddy,07-03-2005,146668,Tripura,23,10,2,9,44,Pass
Kunal Khan,03-08-2005,282919,Nagaland,7,15,5,4,31,Pass
Raj Pillai,09-12-2004,518167,Jammu & Kashmir + Ladakh,2,20,16,23,61,Pass
Sukhwinder Fernandes,24-04-2006,774971,Madhya Pradesh,2,16,3,1,22,Pass
Aryan Chopra,24-01-2005,231878,Andhra Pradesh,6,15,1,18,40,Pass
Ishaan Mehta,04-07-2005,843606,Maharashtra,20,3,1,11,35,Pass
John D'Souza,13-02-2006,462800,Himachal Pradesh,15,7,15,20,57,Pass
Raj Pillai,28-11-2005,540613,Gujarat,6,12,15,16,49,Pass
Raj Khan,04-01-2006,683175,Telangana,5,24,16,14,59,Pass
Aryan Singh,14-12-2005,846974,Chhattisgarh,1,13,17,3,34,Pass
Raj Chopra,29-03-2006,184537,Bihar,19,2,20,19,60,Pass
Ishaan Verma,09-04-2005,390705,Madhya Pradesh,19,6,17,1,43,Pass
Aryan D'Souza,31-07-2005,281482,Uttar Pradesh,14,5,23,16,58,Pass
Paul Khan,20-01-2006,509284,Uttar Pradesh,24,5,9,10,48,Pass
Krishna Chopra,27-12-2005,912314,Rajasthan,18,4,19,23,64,Pass
Raj Fernandes,05-03-2005,597553,Punjab,14,15,24,3,56,Pass
Aarav D'Souza,28-05-2005,998003,Karnataka,24,24,1,0,49,Pass
Aditya Fernandes,11-04-2006,761960,West Bengal,3,22,11,16,52,Pass
Rohan Reddy,07-01-2006,277522,West Bengal,8,3,15,11,37,Pass
Ishaan D'Souza,11-06-2005,239934,Madhya Pradesh,7,19,9,12,47,Pass
Aarav Fernandes,16-12-2004,231850,Tamil Nadu,14,17,24,23,78,Pass
Kunal Verma,27-03-2006,535909,Telangana,21,8,4,14,47,Pass
Rohan Fernandes,16-06-2005,117399,Bihar,9,8,7,21,45,Pass
Sukhwinder Mehta,11-11-2005,232237,Rajasthan,22,1,8,21,52,Pass
Mathew Singh,02-02-2006,700889,Karnataka,5,7,7,7,26,Pass
Balbir Singh,04-11-2005,943390,Kerala,20,8,7,0,35,Pass
Yash Sharma,10-11-2004,727945,Nagaland,8,3,10,19,40,Pass
Manpreet Mehta,11-02-2006,661386,Rajasthan,20,15,21,14,70,Pass
Krishna Reddy,14-04-2005,324778,Tamil Nadu,7,19,18,16,60,Pass
Balbir Verma,17-02-2006,307088,Gujarat,7,11,12,0,30,Pass
Aditya Mehta,10-05-2005,349931,Gujarat,11,20,3,0,34,Pass
Aarav Singh,01-12-2005,477505,Maharashtra,6,19,1,5,31,Pass
Sukhwinder D'Souza,17-07-2005,382211,Maharashtra,7,14,2,8,31,Pass
Aarav Pillai,19-11-2005,946753,Andhra Pradesh,4,11,5,0,20,Pass
Kunal Sharma,15-12-2005,213833,Telangana,24,16,11,14,65,Pass
Aryan Singh,09-03-2006,671997,Andhra Pradesh,18,0,9,20,47,Pass
Vivaan D'Souza,29-11-2004,396656,Madhya Pradesh,15,8,18,4,45,Pass
Kunal Khan,30-05-2005,891008,West Bengal,3,24,13,1,41,Pass
David Mehta,15-10-2005,507418,Uttar Pradesh,9,5,6,23,43,Pass
Aditya Sharma,09-09-2005,988898,Punjab,24,8,3,19,54,Pass
David Pillai,18-01-2005,154133,Gujarat,4,19,9,10,42,Pass
Rohan Chopra,12-12-2005,394301,Punjab,8,24,5,7,44,Pass
Aarav Chopra,17-10-2005,841819,Haryana,24,14,15,6,59,Pass
Aryan Verma,05-04-2006,932458,Uttar Pradesh,15,5,11,9,40,Pass
Rohan Fernandes,11-05-2005,146480,Punjab,23,3,7,21,54,Pass
Vivaan Khan,23-04-2005,136300,Madhya Pradesh,11,21,23,4,59,Pass
Aryan Mehta,04-06-2005,852604,Delhi,24,21,2,23,70,Fail
Krishna Mehta,10-01-2005,565774,Maharashtra,3,5,17,0,25,Pass
Yash Verma,02-04-2005,136535,Madhya Pradesh,15,1,12,8,36,Pass
Aarav Mehta,03-08-2005,842221,Rajasthan,12,17,9,4,42,Pass
Kunal D'Souza,27-09-2005,433188,Karnataka,3,10,20,23,56,Pass
Kunal Chopra,24-03-2006,786966,Telangana,15,0,17,2,34,Pass
Harjeet Reddy,29-09-2005,175337,Rajasthan,0,23,21,5,49,Pass
Yash Chopra,08-03-2005,282822,Jharkhand,2,10,10,4,26,Pass
Sukhwinder Sharma,18-12-2004,482473,Madhya Pradesh,10,22,12,4,48,Pass
Krishna Fernandes,31-10-2005,231293,Haryana,0,8,12,16,36,Pass
Balbir Singh,27-06-2005,486289,Rajasthan,5,23,9,21,58,Pass
Yash Mehta,21-11-2005,472682,Rajasthan,17,21,9,14,61,Pass
Rehan D'Souza,20-04-2005,250867,Haryana,16,19,9,4,48,Pass
John Singh,12-03-2006,890344,Andhra Pradesh,9,13,7,18,47,Pass
Manpreet Khan,19-12-2005,766505,Gujarat,12,1,14,10,37,Pass
Balbir Singh,13-05-2005,101116,Bihar,18,9,22,0,49,Pass
Aditya D'Souza,08-12-2004,712898,Haryana,11,6,12,15,44,Pass
Zaid Reddy,11-12-2004,377283,West Bengal,3,16,18,11,48,Pass
Vivaan Reddy,22-03-2006,892360,Telangana,20,12,11,5,48,Pass
Raj Reddy,30-12-2005,501487,Bihar,0,6,4,23,33,Pass
Peter Verma,19-02-2006,887497,Tamil Nadu,1,23,23,17,64,Pass
Balbir Pillai,01-12-2005,945333,Punjab,7,8,18,0,33,Pass
Vivaan D'Souza,17-03-2005,883181,Bihar,19,15,9,11,54,Pass
Gurpreet Mehta,01-03-2005,810940,Delhi,6,1,10,15,32,Fail
Yash Verma,10-03-2006,943204,Odisha,15,7,4,17,43,Pass
Harjeet Reddy,27-03-2005,531376,Uttarakhand,3,5,17,16,41,Pass
Aarav Pillai,08-11-2004,441967,Himachal Pradesh,18,8,2,6,34,Pass
Aryan D'Souza,28-06-2005,745845,Tamil Nadu,20,2,2,2,26,Pass
Manpreet Khan,26-08-2005,588325,Tamil Nadu,15,4,23,5,47,Pass
Aarav Verma,22-12-2005,808746,Meghalaya,2,12,9,13,36,Pass
Raj Pillai,16-06-2005,960736,Telangana,3,5,12,1,21,Pass
Paul Chopra,26-02-2006,349772,Bihar,6,2,22,10,40,Pass
Yash Pillai,18-10-2005,554589,Maharashtra,5,1,21,12,39,Pass
Ishaan D'Souza,14-03-2006,732505,Maharashtra,9,0,8,1,18,Pass
Yash Sharma,25-11-2004,276109,Kerala,11,9,10,9,39,Pass
Aryan Verma,31-12-2005,187766,Punjab,3,13,6,20,42,Pass
David Khan,07-06-2005,633160,Gujarat,10,15,3,19,47,Pass
Aditya Chopra,06-04-2005,285063,Karnataka,19,9,6,0,34,Pass
Krishna Fernandes,11-09-2005,767515,Uttar Pradesh,0,5,10,12,27,Pass
Zaid Khan,09-03-2006,712664,Madhya Pradesh,18,6,7,23,54,Pass
Aryan Singh,11-01-2005,429524,Jammu & Kashmir + Ladakh,0,11,8,8,27,Pass
Krishna D'Souza,08-04-2005,372090,Andhra Pradesh,2,0,19,3,24,Pass
Yash Pillai,18-02-2006,577337,Jharkhand,6,7,6,6,25,Pass
Rohan Sharma,06-09-2005,803325,Bihar,15,24,4,9,52,Pass
Aditya Sharma,05-06-2005,324319,Punjab,10,3,9,20,42,Pass
Aarav Pillai,04-06-2005,844963,Daman & Diu / D&N Haveli,3,13,1,1,18,Pass
Kunal Mehta,04-04-2006,479634,Tamil Nadu,9,0,12,13,34,Pass
Vivaan Verma,22-11-2005,569838,Uttarakhand,4,1,18,24,47,Pass
Aarav Pillai,01-09-2005,500053,West Bengal,9,11,1,7,28,Pass
Aryan Chopra,05-05-2006,209128,Haryana,10,22,3,9,44,Pass
Krishna Khan,18-11-2004,198168,Madhya Pradesh,8,1,7,9,25,Pass
Manpreet Mehta,14-01-2006,731116,Andhra Pradesh,12,14,3,14,43,Pass
Raj Khan,31-08-2005,382495,Bihar,5,14,6,24,49,Pass
Aryan Sharma,11-07-2005,399691,Madhya Pradesh,4,11,16,10,41,Pass
Kunal Verma,07-02-2005,675292,Jharkhand,12,16,16,13,57,Pass
Kunal Reddy,18-02-2006,638595,Karnataka,0,15,6,4,25,Pass
Paul Chopra,20-03-2005,745540,Chhattisgarh,9,8,7,10,34,Pass
Aditya Mehta,26-04-2005,450308,Uttar Pradesh,20,5,3,23,51,Pass
Raj D'Souza,20-06-2005,981263,Assam,6,5,21,8,40,Pass
Raj Khan,20-12-2005,140056,Tamil Nadu,13,16,11,2,42,Pass
Aarav Fernandes,05-01-2005,291287,Haryana,8,0,3,8,19,Pass
Aarav Verma,04-01-2006,865089,Bihar,7,16,20,20,63,Pass
Aditya Singh,31-07-2005,229443,Telangana,14,13,15,11,53,Pass
Balbir Pillai,14-09-2005,393866,Rajasthan,19,5,1,17,42,Pass
Ishaan Verma,31-01-2006,131170,Maharashtra,3,21,10,13,47,Pass
Aditya Sharma,18-11-2005,826579,Madhya Pradesh,17,13,11,4,45,Pass
Aryan Verma,28-09-2005,355937,Delhi,3,23,0,3,29,Fail
Harjeet Mehta,01-10-2005,439369,Madhya Pradesh,3,13,10,11,37,Pass
Paul Verma,02-02-2005,931957,Telangana,3,12,4,0,19,Pass
Kunal Khan,20-02-2005,301860,Andhra Pradesh,10,17,16,10,53,Pass
Sukhwinder Singh,28-02-2005,889801,Madhya Pradesh,20,24,18,4,66,Pass
Aryan Singh,16-10-2005,614652,Rajasthan,1,10,0,8,19,Pass
Kunal Pillai,18-10-2005,179443,Rajasthan,15,16,9,23,63,Pass
Yash Sharma,07-11-2004,352859,Bihar,15,10,1,4,30,Pass
Rehan Chopra,16-03-2006,560246,Delhi,22,14,16,17,69,Fail
Gurpreet Mehta,23-11-2004,150036,Maharashtra,12,0,9,24,45,Pass
Manpreet Singh,22-02-2005,372836,Telangana,10,3,8,15,36,Pass
Kunal Mehta,28-11-2004,854305,West Bengal,3,21,21,19,64,Pass
Kunal Mehta,01-12-2004,758051,Chhattisgarh,18,4,5,1,28,Pass
David Fernandes,15-04-2006,780537,Bihar,6,22,20,24,72,Pass
Raj Singh,08-02-2006,425756,Bihar,1,7,5,19,32,Pass
Sukhwinder Fernandes,19-05-2005,293571,Odisha,13,9,22,10,54,Pass
John Sharma,05-06-2005,246613,Rajasthan,19,20,18,23,80,Pass
Farhan D'Souza,01-12-2004,840125,Maharashtra,18,16,7,1,42,Pass
Raj Chopra,07-08-2005,630344,Odisha,15,13,16,11,55,Pass
Krishna Reddy,07-05-2006,665655,Jharkhand,7,4,4,19,34,Pass
John Khan,31-03-2005,797700,Gujarat,4,1,5,1,11,Pass
Aditya Singh,09-11-2005,729105,Uttar Pradesh,18,5,3,23,49,Pass
Vivaan Mehta,27-11-2004,570386,Jammu & Kashmir + Ladakh,4,19,17,4,44,Pass
Sukhwinder Fernandes,13-08-2005,462902,Rajasthan,24,14,16,6,60,Pass
Aryan Mehta,05-01-2006,284534,Gujarat,4,22,24,3,53,Pass
Yash Verma,17-02-2005,688011,Uttar Pradesh,2,5,10,23,40,Pass
Kunal D'Souza,21-08-2005,310344,Madhya Pradesh,16,12,5,13,46,Pass
Vivaan D'Souza,12-12-2005,871128,Odisha,23,1,24,12,60,Pass
Aditya Sharma,18-04-2005,354038,West Bengal,3,14,24,19,60,Pass
Balbir Pillai,06-02-2006,953931,Madhya Pradesh,16,18,14,8,56,Pass
Raj D'Souza,17-06-2005,402131,Andhra Pradesh,9,17,10,21,57,Pass
Paul Chopra,21-02-2005,208400,West Bengal,10,18,20,0,48,Pass
Rohan Verma,02-09-2005,991407,Tamil Nadu,19,12,10,18,59,Pass
Paul Pillai,06-06-2005,570677,Uttar Pradesh,23,5,2,15,45,Pass
Aditya D'Souza,07-04-2006,736549,Andhra Pradesh,3,15,23,11,52,Pass
Kunal Chopra,29-09-2005,157704,Maharashtra,5,0,14,23,42,Pass
Aditya D'Souza,17-01-2006,129507,Punjab,8,15,3,22,48,Pass
Sukhwinder Singh,13-11-2004,406832,Maharashtra,3,14,12,12,41,Pass
Ayaan Verma,16-11-2004,325278,Maharashtra,3,21,15,19,58,Pass
Vivaan Mehta,08-07-2005,943413,Uttar Pradesh,13,5,8,8,34,Pass
Rohan Mehta,03-04-2006,318156,Jammu & Kashmir + Ladakh,4,4,5,6,19,Pass
Aarav Sharma,30-08-2005,932688,Maharashtra,9,6,3,8,26,Pass
Gurpreet Verma,04-07-2005,244220,Haryana,23,4,21,20,68,Pass
Yash Mehta,17-01-2006,723289,Bihar,5,13,13,7,38,Pass
Yash Verma,17-12-2004,884637,Maharashtra,3,15,23,12,53,Pass
Manpreet Reddy,01-02-2006,996429,Uttar Pradesh,17,5,12,1,35,Pass
Yash Singh,06-08-2005,374455,Haryana,11,21,7,11,50,Pass
Aryan Verma,13-03-2005,586687,West Bengal,6,0,5,10,21,Pass
Farhan Singh,12-07-2005,205284,Karnataka,15,19,9,22,65,Pass
Peter Fernandes,30-10-2005,297355,Maharashtra,24,2,10,6,42,Pass
Aarav Fernandes,16-04-2005,973078,Chhattisgarh,3,1,7,11,22,Pass
Zaid D'Souza,28-02-2005,696434,Rajasthan,24,19,24,18,85,Pass
Paul Chopra,14-10-2005,315659,Uttar Pradesh,20,5,4,6,35,Pass
Vivaan Mehta,13-09-2005,362934,Tamil Nadu,1,21,1,3,26,Pass
Aarav Verma,19-11-2005,947905,Delhi,23,1,4,3,31,Fail
Aditya Singh,22-01-2005,214714,Jammu & Kashmir + Ladakh,3,19,17,17,56,Pass
Aditya Fernandes,06-07-2005,569494,Maharashtra,3,15,14,22,54,Pass
Kunal Khan,10-08-2005,892606,Chhattisgarh,1,2,1,22,26,Pass
Rohan Pillai,05-11-2005,428971,Uttar Pradesh,0,5,7,17,29,Pass
Aarav Chopra,12-04-2006,935243,Punjab,0,3,17,1,21,Pass
Kunal Fernandes,12-12-2005,926824,Telangana,15,10,21,15,61,Pass
Vivaan Mehta,13-08-2005,405503,Gujarat,2,12,17,4,35,Pass
Rohan Mehta,06-01-2006,854376,Haryana,10,5,18,24,57,Pass
Paul Reddy,18-09-2005,881137,Karnataka,2,20,6,15,43,Pass
Sukhwinder Pillai,13-05-2005,616321,Bihar,21,3,18,18,60,Pass
Ishaan Pillai,27-01-2006,685958,Rajasthan,23,7,10,5,45,Pass
Rohan Pillai,15-05-2005,870031,Rajasthan,12,12,19,18,61,Pass
Balbir Verma,19-03-2006,486537,Punjab,3,6,2,24,35,Pass
Kunal Sharma,10-03-2006,198930,Assam,15,24,1,11,51,Pass
Ishaan Pillai,23-01-2005,722087,Punjab,3,7,4,10,24,Pass
Peter Fernandes,04-11-2005,186766,Maharashtra,2,4,18,15,39,Pass
Kunal Singh,03-04-2005,179914,Chhattisgarh,11,19,11,21,62,Pass
Krishna Verma,13-07-2005,773706,Kerala,21,5,1,8,35,Pass
Raj Fernandes,10-01-2005,836248,Bihar,15,20,0,24,59,Pass
Vivaan Singh,31-03-2006,624864,Maharashtra,3,21,11,19,54,Pass
Yash Mehta,28-10-2005,531733,Rajasthan,2,12,5,14,33,Pass
Ishaan Reddy,18-10-2005,964909,Punjab,19,4,1,17,41,Pass
Aditya Reddy,29-10-2005,675013,Gujarat,21,17,8,6,52,Pass
Vivaan Reddy,19-02-2005,987336,Rajasthan,20,16,12,3,51,Pass
Yash Verma,11-05-2005,648527,Uttar Pradesh,14,5,23,0,42,Pass
Harjeet Reddy,29-10-2005,542007,Maharashtra,17,11,5,10,43,Pass
Krishna D'Souza,30-05-2005,516210,Delhi,23,17,2,14,56,Fail
Krishna Mehta,10-02-2006,229296,Rajasthan,15,23,19,3,60,Pass
Yash Khan,28-11-2005,205111,Madhya Pradesh,5,7,1,9,22,Pass
Krishna Reddy,28-07-2005,179891,Haryana,16,16,10,8,50,Pass
Manpreet Singh,29-10-2005,822575,Rajasthan,4,5,12,1,22,Pass
Aarav Chopra,17-03-2006,843911,Meghalaya,13,10,2,11,36,Pass
Yash Reddy,14-10-2005,910878,West Bengal,3,24,23,7,57,Pass
Aarav Pillai,07-11-2005,108818,Tamil Nadu,9,9,24,18,60,Pass
Raj Khan,22-10-2005,434347,Uttar Pradesh,13,5,1,7,26,Pass
Aryan Chopra,04-05-2005,128888,Uttar Pradesh,22,5,23,15,65,Pass
Krishna Pillai,02-09-2005,980160,West Bengal,3,12,23,21,59,Pass
Aarav Mehta,17-03-2006,649510,Rajasthan,23,14,11,7,55,Pass
Raj Chopra,20-11-2005,842345,Karnataka,4,6,24,6,40,Pass
Aryan Singh,17-02-2005,705165,Assam,17,20,21,20,78,Pass
Aryan Reddy,14-04-2006,520733,Maharashtra,3,17,18,3,41,Pass
Balbir Chopra,16-12-2004,714810,Bihar,9,10,13,21,53,Pass
Aryan Mehta,02-01-2006,846552,West Bengal,3,19,16,17,55,Pass
Ishaan Khan,08-12-2004,632967,West Bengal,3,23,14,22,62,Pass
Kunal Reddy,13-03-2006,827736,Bihar,18,21,20,13,72,Pass
Raj Chopra,28-11-2004,187084,Gujarat,8,0,3,21,32,Pass
Sukhwinder Chopra,23-12-2005,253382,Andhra Pradesh,0,9,1,8,18,Pass
Rohan Reddy,17-08-2005,318335,Maharashtra,9,9,0,16,34,Pass
Aditya Khan,21-09-2005,876376,Gujarat,17,0,24,4,45,Pass
Aditya Verma,28-05-2005,179365,Bihar,5,21,8,17,51,Pass
Vivaan Mehta,13-06-2005,138657,Manipur,7,1,5,21,34,Pass
Aarav Singh,03-12-2004,233266,Odisha,24,18,4,16,62,Pass
Ishaan Singh,31-03-2005,514886,Kerala,3,11,17,9,40,Pass
Gurpreet Mehta,13-04-2005,899033,Bihar,20,22,10,8,60,Pass
Imran Fernandes,11-02-2006,818514,Maharashtra,3,14,17,17,51,Pass
Vivaan Pillai,06-09-2005,742202,Gujarat,8,11,18,17,54,Pass
Rohan D'Souza,03-12-2004,171619,Haryana,24,3,16,7,50,Pass
Sukhwinder Mehta,23-01-2006,165178,Himachal Pradesh,13,12,5,11,41,Pass
Raj Mehta,01-05-2006,496601,Punjab,4,14,9,2,29,Pass
Harjeet Reddy,13-06-2005,937498,Punjab,19,13,3,23,58,Pass
Yash Reddy,09-01-2006,483428,Bihar,4,12,20,13,49,Pass
Aditya Khan,21-04-2005,765928,Chhattisgarh,13,3,19,4,39,Pass
Sukhwinder Chopra,19-02-2005,993101,Karnataka,21,14,19,0,54,Pass
Aarav Mehta,06-01-2006,646430,Uttarakhand,5,22,1,9,37,Pass
Aditya Reddy,29-08-2005,565975,Haryana,13,9,24,2,48,Pass
Paul Chopra,25-03-2006,670540,Punjab,4,4,0,8,16,Pass
Paul Reddy,29-01-2006,346114,Bihar,12,15,19,6,52,Pass
Yash Verma,07-04-2005,861680,Assam,6,22,4,3,35,Pass
Aarav Mehta,12-10-2005,209142,Telangana,18,6,12,19,55,Pass
Raj Khan,06-03-2006,826997,Karnataka,23,17,2,14,56,Pass
Sukhwinder Verma,25-02-2005,597645,Telangana,7,20,10,1,38,Pass
Yash D'Souza,05-03-2006,460197,Andaman & Nicobar,21,23,0,4,48,Pass
Krishna Singh,11-04-2006,525591,Kerala,22,6,5,18,51,Pass
Harjeet D'Souza,09-09-2005,324181,Uttar Pradesh,24,5,2,24,55,Pass
Rehan Mehta,05-02-2006,561057,West Bengal,11,15,19,8,53,Pass
Aarav Khan,21-01-2006,123184,Karnataka,15,18,18,3,54,Pass
Rohan Fernandes,15-04-2006,375160,Uttar Pradesh,3,5,17,14,39,Pass
Ishaan Singh,06-05-2006,147354,Assam,7,18,5,8,38,Pass
Aarav Chopra,24-10-2005,506734,Tamil Nadu,4,12,6,13,35,Pass
Rohan Singh,13-01-2006,607697,Odisha,12,0,6,4,22,Pass
Yash Khan,22-06-2005,101938,Goa,1,22,12,9,44,Pass
Raj Reddy,04-08-2005,554386,Madhya Pradesh,18,23,6,7,54,Pass
Manpreet Singh,14-02-2006,949919,Rajasthan,23,10,16,14,63,Pass
Raj Singh,16-01-2006,347134,Punjab,6,7,4,7,24,Pass
Rehan Sharma,16-01-2006,790475,West Bengal,20,12,2,12,46,Pass
Kunal Singh,01-08-2005,842415,Maharashtra,3,23,17,17,60,Pass
Peter D'Souza,17-02-2006,887420,Rajasthan,0,1,24,6,31,Pass
Krishna Sharma,09-03-2006,538296,West Bengal,3,17,14,21,55,Pass
Aditya D'Souza,29-12-2005,181806,Maharashtra,0,15,23,2,40,Pass
Rohan Pillai,18-01-2005,817533,Telangana,12,17,5,0,34,Pass
Aarav Reddy,19-01-2005,524555,Chhattisgarh,13,23,3,9,48,Pass
Manpreet Verma,19-02-2006,801983,Uttarakhand,16,8,13,12,49,Pass
Peter Pillai,07-03-2005,856618,Gujarat,12,11,20,17,60,Pass
Aditya Fernandes,20-04-2005,238789,Uttar Pradesh,14,5,11,2,32,Pass
Vivaan Fernandes,06-06-2005,238879,Madhya Pradesh,3,13,12,6,34,Pass
David Pillai,05-03-2006,963306,Bihar,4,6,11,14,35,Pass
Ishaan Pillai,08-01-2005,253899,Tamil Nadu,16,7,3,9,35,Pass
Paul Singh,19-10-2005,100831,Tamil Nadu,12,23,6,19,60,Pass
Kunal D'Souza,26-06-2005,339131,Jharkhand,17,4,4,23,48,Pass
Balbir Reddy,12-12-2004,585443,Maharashtra,3,13,17,5,38,Pass
Aarav Fernandes,05-04-2006,300154,Tamil Nadu,1,10,4,9,24,Pass
Rohan Sharma,26-01-2005,488320,Maharashtra,6,7,7,9,29,Pass
Aditya Singh,06-11-2005,813650,Uttar Pradesh,0,5,10,19,34,Pass
Rohan Reddy,22-02-2005,939302,Jharkhand,16,20,2,3,41,Pass
Gurpreet Reddy,28-02-2006,220226,Karnataka,3,9,17,12,41,Pass
Manpreet Reddy,02-01-2005,425319,Punjab,3,3,8,0,14,Pass
Rohan Singh,07-01-2005,658454,Maharashtra,3,23,13,12,51,Pass
Krishna Pillai,06-05-2006,478144,Maharashtra,19,6,12,5,42,Pass
John Mehta,14-08-2005,401861,Chhattisgarh,14,4,20,24,62,Pass
Manpreet Sharma,18-03-2006,198430,Tamil Nadu,0,20,21,15,56,Pass
Sukhwinder Pillai,03-01-2005,114738,Rajasthan,10,14,18,22,64,Pass
Aditya Fernandes,07-08-2005,248536,Tamil Nadu,17,22,19,21,79,Pass
Kunal Khan,03-01-2005,225340,Gujarat,4,11,22,18,55,Pass
Kunal D'Souza,30-06-2005,343742,Uttarakhand,11,0,13,13,37,Pass
Sukhwinder Reddy,21-05-2005,140136,Uttar Pradesh,0,5,8,19,32,Pass
Aarav Sharma,27-04-2006,259225,Uttar Pradesh,5,5,1,7,18,Pass
Aarav Verma,07-06-2005,134702,Bihar,21,17,0,0,38,Pass
Gurpreet Khan,04-02-2005,361173,Bihar,19,23,2,10,54,Pass
Raj Mehta,16-04-2006,921689,Bihar,13,11,24,5,53,Pass
Rohan D'Souza,09-02-2005,594223,Rajasthan,15,16,5,18,54,Pass
Krishna Sharma,29-03-2005,787346,West Bengal,5,9,20,13,47,Pass
Yash D'Souza,25-08-2005,435528,Rajasthan,18,12,5,5,40,Pass
Raj Reddy,14-03-2006,139931,Andhra Pradesh,5,13,22,12,52,Pass
Yash Pillai,04-05-2005,155436,Chhattisgarh,23,18,4,11,56,Pass
Raj Mehta,26-04-2006,392390,Haryana,11,20,13,14,58,Pass
John Reddy,25-03-2005,598775,Tamil Nadu,18,22,3,2,45,Pass
Aarav Verma,03-09-2005,926076,Jharkhand,16,18,8,3,45,Pass
Raj Fernandes,02-06-2005,799624,West Bengal,6,3,0,7,16,Pass
Yash Singh,18-01-2005,470927,Bihar,9,9,10,2,30,Pass
Krishna Verma,16-12-2005,714974,Bihar,1,1,4,16,22,Pass
Ishaan Pillai,17-05-2005,501032,Kerala,23,16,4,21,64,Pass
Aditya Pillai,02-08-2005,619397,Assam,8,0,24,21,53,Pass
Krishna Sharma,04-12-2004,238679,Tripura,5,1,9,14,29,Pass
Mathew Chopra,24-01-2005,922643,Kerala,4,19,14,21,58,Pass
Yash Fernandes,21-12-2004,518151,Telangana,18,21,20,7,66,Pass
Sukhwinder Chopra,23-07-2005,958432,Chhattisgarh,9,14,24,12,59,Pass
Harjeet Sharma,29-11-2004,463609,Gujarat,2,9,13,23,47,Pass
Rohan Mehta,03-02-2006,298242,Maharashtra,3,6,20,20,49,Pass
Yash D'Souza,07-03-2005,212433,Karnataka,21,11,16,6,54,Pass
Aryan D'Souza,07-12-2005,843490,West Bengal,5,22,10,17,54,Pass
Vivaan Chopra,11-10-2005,878032,Maharashtra,7,1,6,11,25,Pass
John Pillai,17-02-2005,570411,Maharashtra,4,6,11,4,25,Pass
Rohan Pillai,21-11-2004,756384,Jammu & Kashmir + Ladakh,19,16,15,16,66,Pass
Gurpreet Singh,23-02-2006,169785,Haryana,11,9,18,15,53,Pass
Aryan Reddy,30-05-2005,137217,Delhi,22,8,8,3,41,Fail
Raj Reddy,14-07-2005,128772,Rajasthan,1,17,21,11,50,Pass
Harjeet Khan,11-04-2006,492663,Punjab,18,11,21,0,50,Pass
Vivaan Reddy,17-03-2006,911899,Chhattisgarh,17,0,24,19,60,Pass
Vivaan Pillai,15-11-2005,997082,Assam,5,13,9,12,39,Pass
Yash Mehta,06-05-2005,553825,Rajasthan,16,6,13,18,53,Pass
Raj Mehta,11-01-2005,967843,Maharashtra,3,21,0,22,46,Pass
Farhan Pillai,10-08-2005,594968,Uttarakhand,3,18,6,10,37,Pass
Harjeet Sharma,24-09-2005,149004,Chhattisgarh,2,13,2,16,33,Pass
Aditya Khan,04-08-2005,904420,Rajasthan,23,11,20,19,73,Pass
Yash Reddy,09-05-2006,540884,Madhya Pradesh,19,5,22,1,47,Pass
Krishna Verma,07-09-2005,191561,Bihar,2,15,18,10,45,Pass
Aarav Fernandes,29-03-2006,585634,Andhra Pradesh,5,6,10,21,42,Pass
Raj D'Souza,21-01-2006,105926,Uttar Pradesh,20,5,15,3,43,Pass
Krishna Reddy,03-05-2006,746851,Rajasthan,18,8,19,22,67,Pass
Aditya Pillai,24-01-2006,741756,Uttarakhand,9,5,19,17,50,Pass
Paul Mehta,03-09-2005,320427,Madhya Pradesh,10,14,18,13,55,Pass
Kunal Verma,03-03-2006,516428,Punjab,6,7,16,3,32,Pass
Ishaan Fernandes,28-09-2005,178875,Uttar Pradesh,8,5,15,0,28,Pass
Aryan Verma,11-03-2006,443827,Rajasthan,8,4,18,11,41,Pass
Raj Khan,25-03-2006,314933,Odisha,14,7,8,18,47,Pass
Rohan Reddy,23-12-2004,587423,Madhya Pradesh,2,2,13,11,28,Pass
Manpreet Chopra,10-05-2005,496535,Karnataka,16,23,19,7,65,Pass
John Singh,05-01-2006,475876,Uttar Pradesh,24,5,3,2,34,Pass
Ishaan Khan,18-05-2005,609359,Chhattisgarh,5,14,0,24,43,Pass
Aarav D'Souza,03-03-2005,400466,West Bengal,15,2,6,9,32,Pass
Gurpreet D'Souza,11-11-2005,932804,Karnataka,8,10,8,17,43,Pass
Ishaan Singh,20-05-2005,406672,Jharkhand,4,4,12,1,21,Pass
Vivaan Singh,05-10-2005,284376,Punjab,7,14,8,10,39,Pass
Aarav Sharma,15-01-2006,769524,Maharashtra,19,18,1,11,49,Pass
Raj D'Souza,14-06-2005,156000,Haryana,6,5,0,13,24,Pass
Krishna Chopra,18-11-2004,909598,Rajasthan,0,0,8,11,19,Pass
Krishna Pillai,14-12-2004,470138,Uttar Pradesh,6,5,14,15,40,Pass
Sukhwinder D'Souza,18-10-2005,568614,Bihar,4,13,22,21,60,Pass
Balbir Pillai,03-02-2005,828129,Haryana,8,10,2,0,20,Pass
Aarav Sharma,14-04-2005,206329,Himachal Pradesh,3,2,24,9,38,Pass
Yash Singh,20-03-2005,808557,Andhra Pradesh,18,21,3,5,47,Pass
Peter D'Souza,22-10-2005,912136,Uttar Pradesh,19,5,16,7,47,Pass
David Singh,08-01-2005,979407,Uttar Pradesh,4,5,10,5,24,Pass
Krishna Khan,07-06-2005,153195,Andhra Pradesh,5,0,20,17,42,Pass
Balbir Mehta,04-03-2005,103862,Tamil Nadu,10,23,17,15,65,Pass
Rohan Reddy,08-11-2004,478636,Rajasthan,10,22,18,22,72,Pass
Aryan Mehta,22-03-2005,899958,Bihar,12,17,1,1,31,Pass
Balbir Fernandes,16-07-2005,150176,Kerala,10,10,14,0,34,Pass
Gurpreet Verma,04-01-2006,764446,Tamil Nadu,4,5,10,0,19,Pass
Ishaan Sharma,03-05-2005,977719,Bihar,12,18,8,24,62,Pass
Sukhwinder Pillai,03-01-2006,990052,Madhya Pradesh,16,21,10,3,50,Pass
Krishna Pillai,29-04-2005,387596,Gujarat,3,2,2,13,20,Pass
David Fernandes,04-08-2005,796857,Bihar,22,0,17,12,51,Pass
Yash Verma,28-12-2005,762153,Odisha,8,22,0,7,37,Pass
Raj Khan,20-03-2005,783241,West Bengal,11,11,24,8,54,Pass
Aarav Singh,14-01-2006,225846,Maharashtra,3,14,20,24,61,Pass
Vivaan Sharma,16-07-2005,643545,Nagaland,5,0,11,10,26,Pass
Krishna Pillai,07-08-2005,848380,Uttarakhand,11,11,2,12,36,Pass
Krishna D'Souza,27-09-2005,316316,Bihar,17,4,12,2,35,Pass
Manpreet Pillai,26-04-2006,519483,Kerala,11,7,22,3,43,Pass
Aryan D'Souza,02-02-2005,367449,Uttar Pradesh,22,5,6,15,48,Pass
Raj Fernandes,22-05-2005,261899,West Bengal,0,3,0,20,23,Pass
Vivaan Fernandes,27-12-2004,934159,Madhya Pradesh,24,18,2,5,49,Pass
Aryan Sharma,09-03-2005,965262,Haryana,14,9,0,20,43,Pass
Paul D'Souza,05-04-2006,773427,Telangana,5,23,10,8,46,Pass
Raj Reddy,14-06-2005,610038,Karnataka,19,19,15,6,59,Pass
Imran Reddy,04-03-2005,937878,Rajasthan,11,18,22,21,72,Pass
Yash Chopra,29-10-2005,679263,Rajasthan,12,17,23,23,75,Pass
Rohan Singh,20-09-2005,118333,Punjab,18,11,22,3,54,Pass
Rohan Sharma,22-11-2005,675078,Gujarat,7,17,10,10,44,Pass
Krishna Singh,24-09-2005,111042,Odisha,24,18,8,0,50,Pass
Sukhwinder Fernandes,06-03-2005,874586,Uttar Pradesh,2,5,18,17,42,Pass
Manpreet Sharma,14-03-2005,274450,West Bengal,3,18,7,21,49,Pass
Imran Sharma,29-05-2005,747297,Uttar Pradesh,15,5,13,2,35,Pass
Raj Pillai,20-01-2005,404903,Bihar,13,17,17,14,61,Pass
John Verma,16-04-2005,172939,Madhya Pradesh,22,16,23,4,65,Pass
Yash Pillai,05-03-2005,654107,West Bengal,13,18,5,10,46,Pass
Balbir Pillai,30-10-2005,919207,Himachal Pradesh,11,23,11,4,49,Pass
Zaid Pillai,09-01-2006,894633,Punjab,21,1,0,22,44,Pass
Manpreet Chopra,25-12-2004,737007,Delhi,17,16,8,21,62,Fail
Raj Mehta,24-06-2005,911006,Gujarat,18,21,7,13,59,Pass
Raj Chopra,20-07-2005,220098,Tamil Nadu,7,6,8,6,27,Pass
Aarav Mehta,18-08-2005,698206,Maharashtra,3,14,24,24,65,Pass
Aarav Chopra,29-11-2004,707206,Gujarat,15,12,12,12,51,Pass
Krishna D'Souza,19-09-2005,700600,Haryana,16,3,9,0,28,Pass
Kunal D'Souza,28-12-2004,279185,Uttar Pradesh,23,5,11,1,40,Pass
Kunal Chopra,30-11-2005,185110,Maharashtra,6,6,22,8,42,Pass
Yash Verma,02-12-2004,979127,Punjab,12,11,3,14,40,Pass
Aryan Reddy,18-12-2004,334398,Punjab,13,24,3,5,45,Pass
Sukhwinder Sharma,26-02-2006,232854,Madhya Pradesh,14,17,10,4,45,Pass
Rohan Verma,01-01-2006,204118,Maharashtra,3,22,15,5,45,Pass
Manpreet Sharma,08-03-2005,955759,Odisha,0,3,7,15,25,Pass
Yash Verma,09-05-2005,916655,West Bengal,3,10,18,23,54,Pass
Aarav Pillai,02-09-2005,236689,Delhi,21,9,5,15,50,Fail
Krishna Verma,02-06-2005,238254,Maharashtra,3,12,23,21,59,Pass
Rohan Fernandes,04-01-2005,444741,Uttar Pradesh,5,5,23,9,42,Pass
Kunal Verma,18-02-2005,717725,Assam,8,17,19,1,45,Pass
Aditya D'Souza,07-02-2006,232729,Haryana,8,19,4,22,53,Pass
Yash Verma,12-04-2005,870981,Odisha,1,17,1,15,34,Pass
Aryan Verma,15-01-2006,619837,Bihar,0,6,2,1,9,Pass
Harjeet Reddy,26-01-2005,973699,Bihar,3,21,17,2,43,Pass
Rohan Chopra,24-09-2005,910685,Odisha,6,12,8,22,48,Pass
Ayaan D'Souza,12-11-2005,279598,Delhi,13,12,16,14,55,Fail
Aditya Reddy,24-11-2004,365489,Andhra Pradesh,8,7,5,13,33,Pass
Harjeet D'Souza,30-11-2004,587413,Haryana,2,2,13,0,17,Pass
Vivaan Pillai,31-10-2005,269927,Haryana,5,18,4,3,30,Pass
Aarav Khan,13-03-2005,691056,West Bengal,3,10,24,24,61,Pass
Imran Singh,06-08-2005,297894,West Bengal,19,20,1,11,51,Pass
Aryan Khan,27-01-2005,651261,Punjab,15,24,12,0,51,Pass
Raj Singh,25-09-2005,927950,Gujarat,8,0,12,2,22,Pass
Balbir Reddy,16-01-2005,989442,Andhra Pradesh,2,1,8,19,30,Pass
Krishna Pillai,27-04-2005,806103,Rajasthan,2,6,8,0,16,Pass
Aarav Fernandes,27-05-2005,154643,Uttar Pradesh,23,5,9,11,48,Pass
Krishna Fernandes,25-06-2005,922308,Uttar Pradesh,23,5,5,3,36,Pass
Krishna Sharma,30-04-2006,769438,Rajasthan,13,17,1,8,39,Pass
Krishna Chopra,18-02-2005,321423,Bihar,11,13,24,14,62,Pass
Ayaan Khan,23-03-2006,480283,Gujarat,19,19,5,3,46,Pass
Aarav Pillai,11-03-2005,862517,Himachal Pradesh,7,15,3,19,44,Pass
Yash Khan,14-10-2005,359906,Bihar,20,9,2,8,39,Pass
Vivaan Fernandes,03-03-2005,110312,Kerala,1,5,5,18,29,Pass
Raj Verma,19-11-2004,854221,Uttar Pradesh,16,5,1,6,28,Pass
Aryan Chopra,09-09-2005,214210,Rajasthan,11,0,24,4,39,Pass
Kunal Verma,07-04-2006,830384,Bihar,23,17,3,16,59,Pass
Harjeet Khan,26-04-2005,884894,Delhi,10,13,21,20,64,Fail
Ayaan Khan,18-02-2006,165966,Uttar Pradesh,14,5,2,20,41,Pass
Aditya Chopra,30-01-2005,678457,Rajasthan,24,14,1,13,52,Pass
Raj Fernandes,03-03-2006,430650,Assam,1,18,22,13,54,Pass
Yash Verma,01-05-2006,240676,Madhya Pradesh,8,12,6,15,41,Pass
Vivaan Reddy,12-08-2005,670337,West Bengal,1,19,5,1,26,Pass
Aryan Sharma,13-08-2005,330171,Maharashtra,1,18,15,0,34,Pass
Gurpreet Sharma,30-01-2006,371020,Madhya Pradesh,18,21,6,10,55,Pass
Raj Singh,22-11-2005,660103,Chhattisgarh,19,20,12,11,62,Pass
Raj D'Souza,02-12-2005,559856,Andhra Pradesh,15,24,12,10,61,Pass
Yash Mehta,17-01-2005,995697,West Bengal,3,24,6,24,57,Pass
Aarav Singh,12-03-2005,208664,Uttar Pradesh,24,5,8,15,52,Pass
Vivaan Pillai,31-12-2004,171106,Maharashtra,3,16,11,20,50,Pass
Sukhwinder Fernandes,17-12-2005,778553,Haryana,8,6,7,21,42,Pass
Manpreet Fernandes,18-02-2005,858608,Rajasthan,23,8,13,8,52,Pass
Raj Pillai,06-05-2006,998382,Maharashtra,3,18,11,5,37,Pass
Farhan Reddy,21-08-2005,301145,Gujarat,11,17,8,3,39,Pass
John Mehta,26-07-2005,285495,Maharashtra,3,9,16,18,46,Pass
Gurpreet Mehta,11-06-2005,311232,Uttar Pradesh,6,5,12,24,47,Pass
John Fernandes,27-04-2005,389697,Jammu & Kashmir + Ladakh,11,5,14,10,40,Pass
Harjeet Fernandes,09-03-2005,986293,Rajasthan,22,24,0,18,64,Pass
Vivaan Sharma,11-07-2005,310801,Telangana,20,11,1,12,44,Pass
Rohan Mehta,09-05-2005,965245,Jharkhand,4,8,19,10,41,Pass
Aryan Singh,31-01-2006,277307,Maharashtra,8,15,8,17,48,Pass
Vivaan Khan,03-03-2005,783959,Himachal Pradesh,23,2,23,17,65,Pass
Manpreet Verma,13-11-2004,434701,Rajasthan,2,4,24,17,47,Pass
Harjeet Reddy,07-09-2005,430688,Jharkhand,22,8,17,18,65,Pass
Vivaan Khan,21-09-2005,921068,Maharashtra,6,4,21,21,52,Pass
Manpreet Mehta,25-05-2005,292126,Uttar Pradesh,7,5,15,8,35,Pass
Vivaan Khan,27-01-2005,213850,Chhattisgarh,24,6,23,23,76,Pass
Rohan Mehta,21-11-2005,599000,Arunachal Pradesh,5,5,19,12,41,Pass
Vivaan Singh,17-11-2004,692351,Haryana,14,8,22,9,53,Pass
Sukhwinder Reddy,22-09-2005,956477,Tamil Nadu,1,19,19,20,59,Pass
Rohan D'Souza,21-08-2005,697419,Uttar Pradesh,9,5,22,16,52,Pass
Aarav D'Souza,01-01-2005,103943,Jharkhand,5,6,11,11,33,Pass
Krishna Singh,27-01-2006,134763,Delhi,20,1,16,7,44,Fail
Aarav Pillai,26-11-2004,698339,West Bengal,3,9,11,21,44,Pass
Zaid Sharma,10-05-2005,982173,Jharkhand,0,13,0,6,19,Pass
Aditya Mehta,02-02-2006,332359,Uttar Pradesh,10,5,16,17,48,Pass
Kunal Singh,23-07-2005,774921,Telangana,22,4,19,4,49,Pass
Ishaan Singh,20-09-2005,518746,Uttar Pradesh,4,5,0,22,31,Pass
Kunal Khan,05-04-2005,243702,Rajasthan,9,17,2,22,50,Pass
Mathew Verma,29-03-2006,917910,Kerala,3,1,18,11,33,Pass
Rehan Singh,01-02-2006,504431,Punjab,18,13,15,9,55,Pass
Vivaan Pillai,10-04-2005,571051,Bihar,23,5,6,16,50,Pass
Krishna Reddy,12-09-2005,983720,Punjab,7,5,14,0,26,Pass
Vivaan Reddy,08-03-2005,925851,Assam,7,21,16,16,60,Pass
Ishaan Sharma,30-04-2005,490566,Rajasthan,9,0,11,22,42,Pass
Sukhwinder Khan,11-05-2005,158840,Meghalaya,2,5,20,16,43,Pass
Yash Pillai,18-12-2005,994211,Uttar Pradesh,5,5,5,14,29,Pass
Rohan Khan,04-03-2005,439996,Tamil Nadu,3,2,14,17,36,Pass
Aarav D'Souza,30-11-2005,842296,Telangana,2,13,16,24,55,Pass
Vivaan D'Souza,10-09-2005,852845,Bihar,0,24,13,23,60,Pass
David Singh,04-11-2005,894792,Jammu & Kashmir + Ladakh,18,7,3,14,42,Pass
Raj Reddy,06-02-2005,251556,Gujarat,22,4,23,5,54,Pass
Aryan Singh,01-05-2005,874480,Chhattisgarh,20,1,7,20,48,Pass
Imran Fernandes,26-12-2004,187840,Telangana,20,4,22,20,66,Pass
Kunal Chopra,08-03-2005,320584,Telangana,3,19,19,1,42,Pass
Kunal Mehta,23-04-2006,503203,Delhi,24,6,20,12,62,Fail
Aditya Verma,03-01-2005,974787,Uttar Pradesh,11,5,2,12,30,Pass
Peter Verma,10-09-2005,697480,Assam,5,8,16,12,41,Pass
Ishaan Singh,11-04-2006,237995,Tamil Nadu,8,0,8,0,16,Pass
Kunal Verma,25-03-2006,563452,Assam,8,9,9,0,26,Pass
Aryan Chopra,24-09-2005,947172,Maharashtra,22,4,22,22,70,Pass
Aryan Pillai,06-05-2006,938953,Rajasthan,4,3,7,1,15,Pass
Peter Mehta,08-03-2006,845370,Jammu & Kashmir + Ladakh,8,7,7,15,37,Pass
Ishaan Sharma,03-07-2005,811242,Odisha,12,9,19,12,52,Pass
Vivaan Pillai,26-03-2006,621585,Kerala,20,17,9,15,61,Pass
Paul Pillai,14-09-2005,654191,Rajasthan,8,4,10,11,33,Pass
John Fernandes,19-01-2006,379610,Rajasthan,5,10,16,17,48,Pass
David Mehta,19-02-2005,398436,Gujarat,19,15,1,22,57,Pass
Aditya D'Souza,18-11-2004,825362,Telangana,8,12,7,6,33,Pass
Raj Fernandes,23-12-2005,351595,Rajasthan,0,18,15,9,42,Pass
Raj Verma,20-12-2004,643609,Haryana,4,9,14,0,27,Pass
Gurpreet Verma,07-05-2005,517064,Madhya Pradesh,7,19,10,4,40,Pass
Rohan Verma,01-11-2005,654344,Bihar,0,10,24,16,50,Pass
Rehan Sharma,29-06-2005,861256,Rajasthan,16,4,14,0,34,Pass
Ishaan D'Souza,21-10-2005,370524,Bihar,9,22,22,21,74,Pass
Vivaan Fernandes,18-04-2006,530210,Goa,5,5,6,7,23,Pass
Aditya Reddy,19-10-2005,385053,West Bengal,21,6,6,0,33,Pass
Ishaan Khan,03-10-2005,922514,Bihar,14,1,8,17,40,Pass
Ishaan Verma,27-07-2005,342961,Uttar Pradesh,11,5,16,15,47,Pass
Aarav Khan,26-06-2005,695576,Kerala,19,19,9,6,53,Pass
Raj Reddy,03-05-2006,289624,Maharashtra,6,4,7,23,40,Pass
Balbir Sharma,23-04-2006,176225,West Bengal,11,6,16,19,52,Pass
Rohan Mehta,04-04-2006,717713,Maharashtra,19,4,21,6,50,Pass
Kunal Pillai,21-10-2005,946253,Maharashtra,7,15,22,0,44,Pass
Gurpreet Mehta,25-06-2005,974711,Gujarat,14,9,4,4,31,Pass
Vivaan Mehta,23-02-2006,735720,Bihar,13,0,18,5,36,Pass
Krishna Reddy,06-11-2005,972628,Andhra Pradesh,14,20,23,24,81,Pass
Balbir Mehta,13-02-2006,373602,Karnataka,14,2,11,0,27,Pass
Yash D'Souza,08-02-2005,945967,Telangana,1,16,2,14,33,Pass
Peter Sharma,16-09-2005,501428,Tamil Nadu,15,1,6,23,45,Pass
Aarav Khan,14-10-2005,957925,Andhra Pradesh,19,1,4,18,42,Pass
Harjeet Mehta,02-04-2006,308380,Tamil Nadu,13,10,13,3,39,Pass
Aarav Mehta,16-12-2005,552211,Haryana,11,9,15,24,59,Pass
Aarav Chopra,08-03-2005,471991,Bihar,20,15,2,4,41,Pass
Peter Mehta,17-03-2006,552157,Odisha,1,5,0,12,18,Pass
Aryan Fernandes,24-10-2005,605759,Rajasthan,24,9,8,5,46,Pass
Ayaan Fernandes,21-11-2005,985073,Chhattisgarh,18,10,19,11,58,Pass
Harjeet Reddy,28-11-2005,534356,Assam,9,18,14,18,59,Pass
Yash D'Souza,09-05-2005,534019,Tamil Nadu,20,8,18,1,47,Pass
Gurpreet Pillai,01-12-2005,227299,Tamil Nadu,14,21,9,24,68,Pass
Harjeet Fernandes,05-10-2005,486822,Maharashtra,7,4,4,19,34,Pass
Kunal Singh,14-02-2006,730029,Uttar Pradesh,2,5,10,8,25,Pass
Manpreet Chopra,24-03-2005,968613,Madhya Pradesh,4,14,4,23,45,Pass
Peter Fernandes,02-03-2006,418545,Tamil Nadu,23,20,7,15,65,Pass
Krishna Mehta,09-08-2005,389775,Tamil Nadu,18,18,12,1,49,Pass
Kunal Sharma,09-02-2005,128507,Bihar,14,6,4,18,42,Pass
Aarav Singh,07-12-2005,113794,Kerala,3,7,3,19,32,Pass
Raj Sharma,07-04-2006,486723,Rajasthan,16,2,21,15,54,Pass
Vivaan Mehta,23-03-2006,282859,Maharashtra,0,4,23,18,45,Pass
Aarav Khan,10-08-2005,670799,Assam,6,11,8,12,37,Pass
Rohan Verma,29-03-2006,983845,Jammu & Kashmir + Ladakh,14,20,17,1,52,Pass
Ayaan Pillai,30-06-2005,849343,West Bengal,3,1,16,15,35,Pass
Rohan Pillai,08-12-2005,473669,Bihar,24,17,24,13,78,Pass
Aditya Pillai,15-04-2006,433087,Uttar Pradesh,6,5,0,12,23,Pass
Farhan Chopra,16-11-2005,628463,Maharashtra,20,2,3,7,32,Pass
Krishna Pillai,11-10-2005,389784,Bihar,15,3,1,3,22,Pass
Aditya Pillai,20-09-2005,632313,Uttar Pradesh,9,5,6,20,40,Pass
Vivaan Chopra,08-11-2005,636856,Punjab,10,12,2,10,34,Pass
Aditya Sharma,10-04-2006,223472,Uttar Pradesh,1,5,8,11,25,Pass
Vivaan Pillai,09-05-2005,882020,Tamil Nadu,22,23,6,6,57,Pass
Yash Pillai,12-04-2006,777665,Rajasthan,6,12,23,4,45,Pass
Aarav Mehta,15-01-2005,592377,Haryana,14,13,18,12,57,Pass
Raj Chopra,03-05-2005,252659,Madhya Pradesh,15,14,24,4,57,Pass
Aarav Verma,30-01-2005,557752,Punjab,13,3,19,16,51,Pass
Harjeet Singh,23-09-2005,127580,Uttar Pradesh,2,5,23,5,35,Pass
Aditya Pillai,08-04-2006,628464,Uttar Pradesh,10,5,10,15,40,Pass
Harjeet Reddy,01-12-2004,507505,West Bengal,3,19,22,17,61,Pass
Mathew Reddy,09-03-2005,729023,Jharkhand,0,10,20,15,45,Pass
Krishna Sharma,03-03-2006,332773,Delhi,14,13,2,2,31,Fail
Aditya Verma,26-06-2005,358728,Madhya Pradesh,15,19,24,4,62,Pass
Sukhwinder Reddy,14-02-2006,369485,Madhya Pradesh,3,11,5,3,22,Pass
Paul Reddy,11-04-2006,398424,Uttar Pradesh,21,5,9,16,51,Pass
David D'Souza,27-12-2005,626811,West Bengal,12,7,20,15,54,Pass
Aarav Sharma,14-01-2006,159995,Maharashtra,16,6,11,6,39,Pass
Yash Chopra,06-11-2005,381739,Maharashtra,14,8,10,14,46,Pass
Aarav Pillai,25-08-2005,744430,Rajasthan,23,4,13,6,46,Pass
Aditya Khan,26-02-2005,688459,Haryana,13,14,7,18,52,Pass
Raj Reddy,21-04-2006,341106,Gujarat,0,13,5,22,40,Pass
Gurpreet Singh,29-06-2005,521519,Uttar Pradesh,5,5,12,3,25,Pass
Yash Singh,11-10-2005,825566,Bihar,0,19,3,12,34,Pass
Kunal Khan,04-02-2005,873940,Uttar Pradesh,15,5,18,5,43,Pass
Aryan Mehta,23-11-2004,961750,Maharashtra,23,4,1,22,50,Pass
Aditya D'Souza,24-10-2005,374617,Andhra Pradesh,10,20,23,12,65,Pass
Aarav Verma,02-04-2005,407995,Tamil Nadu,3,21,9,11,44,Pass
Sukhwinder Singh,22-02-2005,939881,Haryana,12,4,22,1,39,Pass
Raj Fernandes,19-06-2005,484502,West Bengal,18,9,4,14,45,Pass
Paul Mehta,04-11-2005,622490,Punjab,7,13,6,20,46,Pass
Kunal Verma,09-11-2004,504419,West Bengal,14,5,3,1,23,Pass
Raj Mehta,03-03-2006,946120,Rajasthan,9,2,4,19,34,Pass
Ayaan Mehta,03-08-2005,937017,Uttar Pradesh,3,5,12,21,41,Pass
Yash Chopra,10-04-2005,570173,Odisha,12,13,11,9,45,Pass
Yash Reddy,17-12-2005,974274,West Bengal,3,20,15,23,61,Pass
Balbir Mehta,27-03-2005,624490,Maharashtra,12,4,23,8,47,Pass
Aarav Reddy,19-11-2004,796956,Uttar Pradesh,13,5,7,19,44,Pass
Aryan Fernandes,04-02-2005,358748,Uttar Pradesh,16,5,11,9,41,Pass
Aarav Singh,08-06-2005,816159,Sikkim,5,3,7,6,21,Pass
Kunal Sharma,04-01-2005,390526,Andhra Pradesh,15,15,18,6,54,Pass
Vivaan Verma,16-03-2006,545972,Chhattisgarh,15,18,22,23,78,Pass
Aarav Mehta,02-05-2005,731516,Assam,7,10,20,17,54,Pass
Aditya Fernandes,02-08-2005,808818,Maharashtra,13,14,7,11,45,Pass
Harjeet Chopra,24-12-2005,384167,West Bengal,3,11,17,19,50,Pass
Ishaan Mehta,05-07-2005,624410,Rajasthan,14,15,16,8,53,Pass
Yash Khan,25-03-2006,691027,Karnataka,14,6,23,18,61,Pass
Aarav Mehta,09-05-2005,827813,Bihar,3,13,16,1,33,Pass
Rohan Verma,22-02-2005,598920,Haryana,3,6,19,11,39,Pass
Rohan Chopra,22-03-2006,509649,Karnataka,6,24,8,12,50,Pass
Imran Pillai,27-04-2005,594797,Chhattisgarh,2,4,1,8,15,Pass
Krishna Sharma,13-04-2005,957560,Jammu & Kashmir + Ladakh,1,0,18,18,37,Pass
Vivaan Pillai,12-05-2005,310836,Maharashtra,24,4,11,13,52,Pass
Rohan Pillai,03-02-2005,713420,Maharashtra,17,4,14,15,50,Pass
Aditya Reddy,03-01-2005,674214,Puducherry,5,3,8,2,18,Pass
David Sharma,03-05-2006,805491,Bihar,20,21,8,14,63,Pass
Yash Khan,14-11-2005,380485,Madhya Pradesh,7,4,6,1,18,Pass
Manpreet Verma,22-12-2005,315179,Odisha,20,11,1,5,37,Pass
Paul Sharma,22-01-2005,290152,Madhya Pradesh,22,13,23,4,62,Pass
Aarav Reddy,12-01-2006,481855,Haryana,12,12,21,20,65,Pass
Rohan Sharma,21-01-2005,946812,Uttar Pradesh,16,5,1,3,25,Pass
Ishaan Reddy,01-03-2006,430414,Uttar Pradesh,18,5,16,8,47,Pass
Raj D'Souza,18-09-2005,390018,Chhattisgarh,11,12,1,3,27,Pass
Aarav Khan,14-05-2005,530874,Tamil Nadu,13,7,14,11,45,Pass
Rohan D'Souza,23-04-2006,848365,Andhra Pradesh,12,23,2,17,54,Pass
Vivaan Khan,12-09-2005,211554,Rajasthan,21,1,6,6,34,Pass
Krishna Fernandes,26-01-2005,325210,Uttar Pradesh,12,5,15,4,36,Pass
Aarav Reddy,06-11-2005,782978,Bihar,4,17,11,6,38,Pass
Zaid D'Souza,15-03-2005,333558,Odisha,23,23,10,0,56,Pass
Rohan Khan,18-06-2005,608342,Haryana,5,20,15,3,43,Pass
Manpreet Mehta,08-08-2005,287114,Uttar Pradesh,2,5,16,6,29,Pass
Sukhwinder Pillai,24-05-2005,727972,Karnataka,18,0,14,14,46,Pass
Kunal Fernandes,26-12-2004,881671,Meghalaya,6,4,9,3,22,Pass
Peter D'Souza,23-12-2005,512318,Bihar,24,24,24,19,91,Pass
Kunal Pillai,29-01-2006,429259,Bihar,2,5,0,11,18,Pass
Aarav Reddy,16-09-2005,947161,West Bengal,3,16,10,9,38,Pass
Rohan Fernandes,19-02-2005,616077,West Bengal,2,7,5,16,30,Pass
Zaid D'Souza,03-01-2006,460660,Bihar,6,0,13,7,26,Pass
Harjeet Khan,10-01-2006,634491,Himachal Pradesh,20,6,10,4,40,Pass
Raj Fernandes,28-01-2006,670857,Madhya Pradesh,22,14,24,4,64,Pass
Rohan Pillai,13-11-2005,611993,Rajasthan,4,14,7,12,37,Pass
John D'Souza,21-06-2005,639783,Rajasthan,9,19,3,18,49,Pass
Kunal Sharma,10-12-2005,971898,Punjab,11,13,7,24,55,Pass
Raj Khan,12-11-2005,273539,Uttar Pradesh,20,5,7,9,41,Pass
David Singh,30-11-2004,240939,West Bengal,19,11,7,4,41,Pass
Ishaan Chopra,19-06-2005,990071,Karnataka,21,9,16,2,48,Pass
Rohan Chopra,20-01-2005,208256,Punjab,17,24,2,4,47,Pass
Aarav D'Souza,14-04-2006,296986,Jammu & Kashmir + Ladakh,3,18,21,10,52,Pass
Kunal Pillai,23-11-2005,518064,Chhattisgarh,21,22,21,3,67,Pass
Mathew D'Souza,14-02-2006,852252,Tamil Nadu,20,22,22,5,69,Pass
Krishna Sharma,16-06-2005,924823,Uttar Pradesh,12,5,24,9,50,Pass
Krishna Singh,21-02-2006,611145,Jammu & Kashmir + Ladakh,10,4,12,4,30,Pass
Ishaan Pillai,14-01-2005,322466,Rajasthan,13,5,24,17,59,Pass
Yash Chopra,14-02-2005,549125,Andhra Pradesh,22,19,0,18,59,Pass
Yash Khan,29-04-2006,188069,Uttar Pradesh,8,5,8,14,35,Pass
Mathew Mehta,18-04-2006,846092,Chhattisgarh,11,12,6,19,48,Pass
Aryan Mehta,18-01-2006,434689,Maharashtra,19,4,21,16,60,Pass
Yash D'Souza,08-11-2005,405384,Tamil Nadu,4,14,12,21,51,Pass
Vivaan Sharma,02-07-2005,625635,Odisha,1,6,3,19,29,Pass
Kunal D'Souza,22-07-2005,527100,Karnataka,4,22,22,17,65,Pass
Kunal Chopra,03-03-2006,462116,Maharashtra,12,19,4,10,45,Pass
Vivaan Chopra,03-08-2005,896549,Manipur,4,20,4,11,39,Pass
Rohan Singh,17-04-2005,961375,Uttar Pradesh,11,5,2,20,38,Pass
Sukhwinder Mehta,20-12-2005,949672,Assam,10,4,0,10,24,Pass
Yash Khan,27-12-2004,749058,Chhattisgarh,13,6,0,0,19,Pass
Yash Reddy,19-07-2005,908207,Himachal Pradesh,16,10,5,21,52,Pass
Aarav Khan,07-02-2005,907662,Andhra Pradesh,4,7,20,0,31,Pass
Vivaan Sharma,19-02-2006,596472,Mizoram,3,13,6,5,27,Pass
Aarav Fernandes,31-07-2005,699986,Rajasthan,3,2,10,21,36,Pass
Kunal Singh,25-12-2005,775036,Kerala,24,3,13,23,63,Pass
Manpreet Pillai,13-03-2006,629436,Jharkhand,24,24,9,9,66,Pass
John Khan,07-01-2006,510329,Jharkhand,11,6,11,11,39,Pass
Vivaan Pillai,12-12-2004,486882,Rajasthan,19,12,12,3,46,Pass
Aditya Mehta,25-08-2005,181873,Odisha,12,19,0,3,34,Pass
Aarav Reddy,03-05-2006,341528,Uttar Pradesh,21,5,7,11,44,Pass
Vivaan Chopra,29-06-2005,620956,Odisha,8,4,9,12,33,Pass
Aditya Verma,09-12-2004,850707,Madhya Pradesh,0,11,0,0,11,Pass
Aditya Mehta,30-09-2005,247170,Karnataka,6,8,8,9,31,Pass
Aarav Fernandes,09-10-2005,599898,Tripura,21,1,11,3,36,Pass
Raj Fernandes,25-11-2005,652411,Karnataka,1,8,15,16,40,Pass
Yash Mehta,26-06-2005,439459,Gujarat,18,11,14,19,62,Pass
Paul Khan,29-01-2006,937105,Uttar Pradesh,24,5,19,4,52,Pass
Vivaan Reddy,02-01-2005,457253,Andhra Pradesh,4,12,8,4,28,Pass
Harjeet Chopra,27-08-2005,832938,Jharkhand,9,7,19,18,53,Pass
Krishna Fernandes,20-07-2005,712591,Maharashtra,14,16,3,8,41,Pass
Krishna Sharma,26-11-2005,628264,West Bengal,3,6,21,24,54,Pass
Paul D'Souza,05-12-2005,855997,Punjab,3,10,12,21,46,Pass
Kunal Singh,07-03-2006,122247,Madhya Pradesh,8,9,11,9,37,Pass
Imran Chopra,14-12-2005,698615,Bihar,4,8,6,15,33,Pass
Yash Chopra,18-01-2005,682820,Telangana,13,21,1,21,56,Pass
Ishaan Reddy,04-03-2006,583483,Punjab,12,12,2,14,40,Pass
Manpreet Sharma,06-07-2005,816184,Rajasthan,10,12,6,22,50,Pass
Krishna Pillai,30-01-2005,113097,Rajasthan,15,6,5,22,48,Pass
Farhan Khan,05-01-2006,878469,Haryana,18,13,11,12,54,Pass
John Pillai,16-03-2005,634135,Haryana,12,10,12,11,45,Pass
Ishaan Khan,20-11-2004,631996,Jharkhand,23,7,9,15,54,Pass
Ayaan Pillai,26-03-2005,699059,West Bengal,4,10,11,16,41,Pass
Manpreet Singh,11-01-2006,895847,Andhra Pradesh,18,9,23,16,66,Pass
Rehan Mehta,23-10-2005,124026,Uttar Pradesh,0,5,15,14,34,Pass
Rehan D'Souza,26-09-2005,200144,Jammu & Kashmir + Ladakh,12,19,5,13,49,Pass
Yash Singh,30-03-2006,205784,Rajasthan,5,7,18,6,36,Pass
Vivaan Mehta,09-02-2006,948933,Bihar,3,6,20,22,51,Pass
Aditya Verma,02-05-2006,962177,West Bengal,1,0,2,12,15,Pass
Aarav Mehta,19-12-2004,722550,Madhya Pradesh,24,20,2,4,50,Pass
Vivaan Chopra,20-04-2006,855153,Jammu & Kashmir + Ladakh,12,14,20,18,64,Pass
Vivaan Pillai,17-03-2005,401389,Punjab,7,15,10,20,52,Pass
Yash Sharma,14-03-2006,651988,Chhattisgarh,11,9,13,13,46,Pass
Sukhwinder Sharma,05-01-2006,632137,Maharashtra,0,24,0,15,39,Pass
Krishna Khan,13-04-2005,546526,Uttar Pradesh,24,5,7,5,41,Pass
Yash Mehta,06-05-2006,453658,Uttar Pradesh,3,5,18,4,30,Pass
Yash Fernandes,03-09-2005,702876,Jharkhand,2,9,17,2,30,Pass
Aarav Fernandes,04-10-2005,974950,Tamil Nadu,19,15,13,5,52,Pass
Krishna Khan,07-03-2005,564091,Rajasthan,10,2,24,20,56,Pass
Aryan Pillai,05-12-2005,117883,Andhra Pradesh,0,17,23,4,44,Pass
Aarav Sharma,17-07-2005,847599,Rajasthan,18,6,9,15,48,Pass
Aditya Verma,10-04-2006,310397,Madhya Pradesh,4,22,12,9,47,Pass
Aryan Chopra,05-04-2005,217331,Andhra Pradesh,17,2,7,14,40,Pass
Raj Fernandes,20-10-2005,323694,Telangana,15,5,16,6,42,Pass
Kunal Fernandes,21-11-2005,988684,Punjab,24,7,3,24,58,Pass
Aarav Verma,16-09-2005,822869,Tamil Nadu,0,2,19,1,22,Pass
Harjeet Pillai,19-03-2006,109024,West Bengal,3,21,11,17,52,Pass
Vivaan Pillai,17-10-2005,920489,Jharkhand,8,3,15,11,37,Pass
Aarav Fernandes,17-12-2004,685243,Bihar,18,17,13,15,63,Pass
Aditya Mehta,05-06-2005,405596,Delhi,16,14,23,8,61,Fail
Manpreet Mehta,25-11-2004,252116,Madhya Pradesh,17,2,10,17,46,Pass
Aryan Khan,06-03-2006,463999,Tamil Nadu,16,1,13,2,32,Pass
Yash Singh,23-11-2005,156787,Assam,14,5,19,16,54,Pass
Paul Verma,26-11-2004,987150,Bihar,24,0,22,16,62,Pass
Krishna Chopra,05-06-2005,780654,Himachal Pradesh,7,16,17,9,49,Pass
Yash Khan,20-10-2005,471136,Karnataka,7,19,21,19,66,Pass
Gurpreet Verma,31-05-2005,399922,Telangana,11,3,19,8,41,Pass
Zaid Reddy,05-04-2005,836410,Himachal Pradesh,10,17,18,7,52,Pass
Aarav Reddy,03-05-2005,732800,Madhya Pradesh,21,16,6,4,47,Pass
Krishna Chopra,10-12-2005,492167,Madhya Pradesh,12,24,20,4,60,Pass
Aarav Pillai,17-04-2005,260234,West Bengal,3,12,9,18,42,Pass
Aditya Sharma,10-09-2005,475772,Karnataka,22,20,5,1,48,Pass
Vivaan Reddy,05-04-2006,709877,Uttar Pradesh,21,5,23,1,50,Pass
Balbir Pillai,13-01-2005,706516,West Bengal,4,22,19,6,51,Pass
Vivaan Mehta,10-07-2005,143575,Uttarakhand,6,2,14,2,24,Pass
Aditya Pillai,04-06-2005,910661,Karnataka,24,24,2,17,67,Pass
Ishaan D'Souza,06-08-2005,407073,Chhattisgarh,5,18,14,12,49,Pass
Ishaan Singh,01-09-2005,591718,Karnataka,18,0,17,21,56,Pass
Aryan Reddy,04-08-2005,278024,Uttar Pradesh,13,5,10,1,29,Pass
Krishna D'Souza,10-08-2005,809388,Rajasthan,21,23,10,12,66,Pass
Mathew Fernandes,10-11-2004,400084,Odisha,4,20,2,11,37,Pass
Aarav D'Souza,05-03-2005,831436,Jharkhand,24,12,24,4,64,Pass
Ishaan Pillai,16-09-2005,889209,Madhya Pradesh,1,23,19,4,47,Pass
Kunal Mehta,31-10-2005,196964,Karnataka,13,1,6,7,27,Pass
Aarav Reddy,10-01-2006,202436,Madhya Pradesh,15,13,13,4,45,Pass
Krishna Chopra,29-03-2005,151538,Bihar,19,7,17,0,43,Pass
Aryan D'Souza,24-12-2004,825098,Gujarat,21,13,0,9,43,Pass
Raj Reddy,24-01-2005,796425,Maharashtra,5,4,14,16,39,Pass
Aarav Fernandes,20-12-2004,732591,Karnataka,6,6,22,5,39,Pass
Mathew Reddy,11-11-2005,922001,Uttar Pradesh,2,5,4,24,35,Pass
John Reddy,08-01-2005,203025,Madhya Pradesh,17,20,13,6,56,Pass
Kunal Reddy,12-03-2006,294466,Himachal Pradesh,4,19,7,10,40,Pass
David Singh,11-04-2006,471720,Assam,8,4,22,22,56,Pass
Aryan Pillai,14-01-2006,938966,Jharkhand,13,16,8,12,49,Pass
John Sharma,30-11-2004,734105,Jammu & Kashmir + Ladakh,18,11,18,9,56,Pass
Yash Fernandes,09-08-2005,573381,Uttar Pradesh,9,5,15,22,51,Pass
Aditya Singh,13-04-2006,925255,Kerala,1,23,13,20,57,Pass
Aditya Singh,05-03-2006,407919,Telangana,24,6,8,6,44,Pass
Aryan Fernandes,16-01-2006,993717,Madhya Pradesh,9,1,15,14,39,Pass
Krishna Verma,22-02-2005,611795,Assam,9,16,23,21,69,Pass
Raj Chopra,26-02-2006,365588,Bihar,10,0,16,16,42,Pass
Paul Chopra,25-06-2005,461541,Madhya Pradesh,0,7,6,1,14,Pass
Ishaan Mehta,15-12-2004,334122,Uttar Pradesh,16,5,16,15,52,Pass
Paul D'Souza,30-01-2006,393971,Maharashtra,15,4,3,11,33,Pass
David D'Souza,30-10-2005,329957,Bihar,5,6,1,17,29,Pass
Raj Pillai,14-01-2005,671713,Punjab,6,23,2,12,43,Pass
Aditya Singh,28-10-2005,577134,Rajasthan,22,13,10,1,46,Pass
Vivaan Chopra,22-07-2005,625690,Karnataka,1,11,3,21,36,Pass
Balbir Verma,08-12-2005,364370,Himachal Pradesh,4,11,17,11,43,Pass
Raj Reddy,07-04-2005,261750,Bihar,5,14,2,18,39,Pass
Aarav Reddy,14-10-2005,863477,Jharkhand,2,9,21,21,53,Pass
Yash Mehta,16-09-2005,327621,Andhra Pradesh,3,13,11,18,45,Pass
Gurpreet Verma,05-10-2005,960354,Rajasthan,2,23,17,0,42,Pass
Ishaan Singh,19-07-2005,931368,Maharashtra,21,1,12,9,43,Pass
Rohan Mehta,03-01-2006,511701,Madhya Pradesh,6,12,18,4,40,Pass
Balbir Pillai,06-04-2005,916048,Rajasthan,9,14,8,15,46,Pass
Rohan Chopra,16-12-2004,882661,Uttar Pradesh,3,5,20,17,45,Pass
Rohan Chopra,26-01-2005,550543,Bihar,14,16,7,6,43,Pass
Harjeet Mehta,03-11-2005,862856,Maharashtra,2,17,8,19,46,Pass
Aditya Verma,27-03-2006,446042,Andhra Pradesh,7,14,6,8,35,Pass
Aryan Chopra,19-01-2005,218201,Bihar,14,13,23,19,69,Pass
Ishaan Singh,17-03-2006,701367,Bihar,23,3,4,3,33,Pass
Sukhwinder Verma,21-02-2006,296754,Bihar,15,23,21,17,76,Pass
Gurpreet Fernandes,30-12-2004,439196,Kerala,3,11,14,21,49,Pass
Mathew Sharma,06-05-2005,675646,Telangana,4,8,13,3,28,Pass
Yash Pillai,02-10-2005,785858,Punjab,3,18,23,3,47,Pass
Harjeet Reddy,06-12-2005,492346,Bihar,6,12,8,10,36,Pass
Gurpreet Sharma,07-08-2005,406019,Odisha,9,2,1,2,14,Pass
Ayaan Fernandes,14-12-2004,232768,Punjab,20,3,17,8,48,Pass
Krishna Verma,03-02-2005,931275,Maharashtra,12,0,16,3,31,Pass
Manpreet Chopra,20-01-2005,668080,Haryana,17,7,11,19,54,Pass
Rohan Verma,10-02-2005,561452,Rajasthan,4,10,0,20,34,Pass
Aarav Fernandes,12-04-2005,600344,Madhya Pradesh,14,24,22,4,64,Pass
Krishna Singh,16-11-2005,647829,Bihar,5,5,3,10,23,Pass
Vivaan Khan,12-05-2005,345202,Uttar Pradesh,16,5,16,2,39,Pass
Krishna Verma,08-09-2005,783481,Kerala,3,21,22,22,68,Pass
Aarav Sharma,26-11-2005,917826,Rajasthan,22,5,18,0,45,Pass
Rohan Singh,12-11-2004,748695,Odisha,6,0,0,16,22,Pass
Aarav Pillai,12-11-2004,210187,Uttarakhand,3,12,10,23,48,Pass
Mathew Reddy,03-12-2004,576821,Assam,8,15,21,11,55,Pass
Vivaan Khan,15-04-2006,322963,Gujarat,5,19,20,18,62,Pass
Balbir Singh,17-04-2005,231376,Bihar,13,24,8,3,48,Pass
Ishaan Sharma,08-12-2004,331626,Uttar Pradesh,0,5,6,4,15,Pass
Ishaan Singh,03-12-2004,417417,Bihar,4,3,16,18,41,Pass
David Verma,03-12-2005,323690,Andhra Pradesh,15,21,5,19,60,Pass
Raj Reddy,19-09-2005,855203,Bihar,16,20,6,6,48,Pass
Aditya Mehta,01-01-2006,415447,Uttarakhand,10,0,5,24,39,Pass
Yash Khan,09-10-2005,331817,Bihar,24,22,17,8,71,Pass
Ayaan Khan,20-12-2005,730520,Uttar Pradesh,13,5,23,23,64,Pass
Ishaan Verma,20-07-2005,624046,Uttar Pradesh,5,5,8,2,20,Pass
Aarav Fernandes,18-01-2005,459671,Uttarakhand,5,7,3,5,20,Pass
Yash Pillai,01-11-2005,608895,Karnataka,8,5,15,9,37,Pass
David Fernandes,09-11-2005,141621,Punjab,17,17,18,24,76,Pass
Rohan Mehta,04-02-2005,356746,Uttar Pradesh,12,5,3,13,33,Pass
Ishaan Singh,11-01-2005,785318,Meghalaya,9,24,7,3,43,Pass
Ishaan Verma,04-08-2005,327005,Jammu & Kashmir + Ladakh,18,6,22,9,55,Pass
Aditya Fernandes,15-02-2005,773781,West Bengal,0,10,5,16,31,Pass
Rohan Mehta,28-09-2005,531948,Jammu & Kashmir + Ladakh,13,8,15,6,42,Pass
John Sharma,18-04-2005,750638,Bihar,12,3,16,14,45,Pass
Ishaan Reddy,29-06-2005,646592,Maharashtra,17,1,3,17,38,Pass
Yash Chopra,30-03-2005,485741,Chhattisgarh,12,0,8,19,39,Pass
Aditya Verma,06-05-2006,964613,Haryana,21,8,11,18,58,Pass
Ishaan Mehta,29-11-2004,633465,Daman & Diu / D&N Haveli,7,11,9,1,28,Pass
David D'Souza,03-04-2006,817460,Maharashtra,20,4,18,18,60,Pass
Aarav D'Souza,27-08-2005,778766,Uttar Pradesh,10,5,7,14,36,Pass
Mathew Reddy,25-01-2006,587631,Madhya Pradesh,22,20,12,4,58,Pass
Kunal Reddy,23-12-2004,713640,Telangana,16,12,17,11,56,Pass
Harjeet Chopra,21-01-2005,643971,Chhattisgarh,6,24,22,0,52,Pass
Manpreet Sharma,09-11-2004,828095,Haryana,1,15,20,12,48,Pass
Sukhwinder Pillai,24-02-2005,150976,Andhra Pradesh,5,19,5,11,40,Pass
Aarav Mehta,26-03-2005,936153,Madhya Pradesh,18,17,20,4,59,Pass
Ishaan D'Souza,03-12-2005,312185,Meghalaya,0,19,7,17,43,Pass
Vivaan Reddy,01-04-2006,897204,Tamil Nadu,1,1,20,2,24,Pass
Ayaan Sharma,20-06-2005,692820,Gujarat,12,18,23,1,54,Pass
Rohan Fernandes,02-04-2005,997413,West Bengal,2,1,2,19,24,Pass
Aryan D'Souza,06-12-2005,500591,Uttar Pradesh,12,5,21,24,62,Pass
Aditya Chopra,08-06-2005,280354,Andhra Pradesh,1,21,20,6,48,Pass
Raj Reddy,21-01-2005,513956,Maharashtra,14,11,9,6,40,Pass
Vivaan D'Souza,25-05-2005,593003,Bihar,16,2,16,0,34,Pass
Imran Verma,23-04-2006,281935,West Bengal,18,19,6,10,53,Pass
Paul D'Souza,30-08-2005,675589,West Bengal,3,23,17,12,55,Pass
Ishaan D'Souza,25-03-2005,400177,Rajasthan,23,20,0,8,51,Pass
John Verma,02-12-2005,939468,Tripura,19,3,19,11,52,Pass
Yash Verma,24-04-2006,158229,Rajasthan,11,20,21,22,74,Pass
Raj Chopra,24-01-2006,389793,Haryana,20,17,10,4,51,Pass
Aditya Mehta,02-12-2005,131037,Tamil Nadu,19,13,13,18,63,Pass
Yash D'Souza,18-12-2004,238691,Madhya Pradesh,19,0,22,0,41,Pass
Raj Khan,02-10-2005,924158,Jammu & Kashmir + Ladakh,8,15,5,12,40,Pass
Peter Verma,21-02-2006,435112,Bihar,0,6,16,17,39,Pass
Aditya Fernandes,05-06-2005,175828,Jharkhand,19,18,7,15,59,Pass
Aditya Fernandes,20-03-2005,949750,Chhattisgarh,10,15,19,9,53,Pass
Rohan Sharma,05-03-2006,739001,Tamil Nadu,13,18,1,18,50,Pass
Raj Verma,14-11-2004,395778,Uttar Pradesh,3,5,24,22,54,Pass
Krishna Pillai,23-02-2006,990323,Kerala,5,14,21,15,55,Pass
Balbir Khan,31-12-2004,624614,Telangana,0,21,4,14,39,Pass
Raj Khan,15-12-2004,113949,Madhya Pradesh,0,21,10,4,35,Pass
Harjeet D'Souza,03-03-2006,172812,Punjab,17,10,4,10,41,Pass
Mathew Singh,16-12-2005,118699,Haryana,20,10,8,5,43,Pass
David Sharma,04-01-2005,252198,Uttarakhand,3,19,16,23,61,Pass
Vivaan Mehta,22-04-2006,184394,Punjab,2,13,1,10,26,Pass
Aryan Chopra,24-08-2005,417029,Karnataka,1,0,7,16,24,Pass
Aditya Fernandes,10-09-2005,796766,Haryana,22,11,12,20,65,Pass
David Fernandes,05-03-2006,416467,Uttar Pradesh,4,5,12,23,44,Pass
Raj Sharma,24-08-2005,713570,Telangana,8,13,4,0,25,Pass
Balbir Reddy,17-12-2004,425276,Uttarakhand,3,7,19,12,41,Pass
Raj Singh,05-11-2005,399568,Kerala,19,2,18,13,52,Pass
Kunal Reddy,13-07-2005,212004,Assam,4,18,17,7,46,Pass
Yash Singh,11-09-2005,791503,Jammu & Kashmir + Ladakh,5,19,12,3,39,Pass
Mathew Singh,17-02-2005,537829,Rajasthan,21,20,20,2,63,Pass
Aarav Pillai,14-03-2006,253777,Jharkhand,24,21,4,13,62,Pass
Aarav Mehta,17-08-2005,499890,Tamil Nadu,6,20,22,12,60,Pass
Gurpreet Pillai,22-04-2005,237244,Madhya Pradesh,23,2,6,18,49,Pass
Harjeet Pillai,11-01-2005,499284,Madhya Pradesh,15,24,20,4,63,Pass
Gurpreet Singh,14-04-2006,683785,Maharashtra,7,4,18,19,48,Pass
Kunal Fernandes,12-12-2004,402591,Maharashtra,14,4,15,11,44,Pass
Harjeet Sharma,03-09-2005,731339,Chhattisgarh,9,18,0,14,41,Pass
Peter Reddy,09-11-2005,403466,Uttar Pradesh,13,5,13,20,51,Pass
Aarav Singh,05-09-2005,728728,Mizoram,7,2,5,10,24,Pass
Ishaan Mehta,13-06-2005,928941,Haryana,16,19,8,13,56,Pass
Balbir Pillai,05-11-2005,531514,Andhra Pradesh,8,12,4,22,46,Pass
Aditya Fernandes,08-07-2005,501800,Nagaland,3,22,1,8,34,Pass
Yash Reddy,27-03-2005,982980,Jharkhand,2,12,11,22,47,Pass
Aarav Fernandes,11-01-2005,538941,Punjab,17,13,4,16,50,Pass
Farhan Reddy,05-12-2004,885967,Bihar,8,4,18,0,30,Pass
Mathew Mehta,25-02-2006,771803,West Bengal,2,9,17,19,47,Pass
Balbir Khan,02-01-2005,348149,Maharashtra,2,12,13,0,27,Pass
Aditya Reddy,31-03-2006,890903,Maharashtra,22,7,2,13,44,Pass
Rohan Fernandes,02-06-2005,669850,Bihar,18,14,12,1,45,Pass
Aryan Mehta,01-04-2006,323400,Telangana,7,12,3,0,22,Pass
Raj Mehta,11-11-2004,239768,Maharashtra,23,4,17,9,53,Pass
Kunal Pillai,25-03-2006,664429,Haryana,17,7,8,8,40,Pass
Aarav Mehta,01-08-2005,818293,Jharkhand,19,4,5,1,29,Pass
Paul Fernandes,05-05-2006,513889,Uttar Pradesh,17,5,21,21,64,Pass
Aditya D'Souza,22-10-2005,147753,Telangana,13,18,24,14,69,Pass
Vivaan Khan,10-11-2004,101117,Bihar,5,0,14,20,39,Pass
Peter Verma,03-09-2005,591066,Bihar,6,19,3,1,29,Pass
Yash Fernandes,26-01-2006,203069,Assam,0,11,24,15,50,Pass
Raj Mehta,29-03-2006,577319,Delhi,5,15,18,8,46,Fail
Mathew Mehta,02-12-2004,185074,Chhattisgarh,3,3,2,4,12,Pass
Sukhwinder Fernandes,07-07-2005,514914,Madhya Pradesh,5,19,19,8,51,Pass
Peter D'Souza,11-04-2006,184693,Chhattisgarh,21,18,16,13,68,Pass
Sukhwinder Fernandes,14-04-2005,282329,West Bengal,3,11,14,24,52,Pass
Rohan Fernandes,13-01-2006,648172,West Bengal,3,2,16,21,42,Pass
Rohan Verma,16-10-2005,581660,Bihar,18,24,7,2,51,Pass
Raj Verma,28-10-2005,718185,Meghalaya,6,8,8,8,30,Pass
Kunal Chopra,21-01-2006,864565,Punjab,24,3,23,13,63,Pass
Gurpreet Verma,30-12-2005,503705,Rajasthan,7,2,13,10,32,Pass
Raj Khan,14-10-2005,384023,Karnataka,5,7,6,7,25,Pass
Ishaan Chopra,26-02-2005,788876,Uttar Pradesh,22,5,15,14,56,Pass
Krishna Singh,07-05-2005,798740,Punjab,3,4,11,14,32,Pass
Aarav Sharma,02-03-2005,856418,Madhya Pradesh,10,16,23,2,51,Pass
Manpreet Chopra,11-08-2005,571658,Telangana,11,7,3,1,22,Pass
Aryan Pillai,26-12-2004,425828,Himachal Pradesh,10,6,23,16,55,Pass
Rohan Pillai,20-11-2004,980072,Tamil Nadu,14,20,22,2,58,Pass
Yash Sharma,27-01-2006,900379,Madhya Pradesh,14,1,13,23,51,Pass
Aarav Fernandes,21-02-2006,111094,Jammu & Kashmir + Ladakh,16,9,5,6,36,Pass
Kunal Pillai,19-09-2005,976750,Goa,9,7,6,6,28,Pass
Balbir D'Souza,26-06-2005,836502,Uttar Pradesh,6,5,2,23,36,Pass
Gurpreet Pillai,14-09-2005,362633,Tamil Nadu,15,16,7,16,54,Pass
Krishna Singh,24-02-2005,448608,Uttar Pradesh,24,5,4,22,55,Pass
Mathew Chopra,05-12-2005,327392,Telangana,7,5,5,2,19,Pass
Zaid Singh,10-03-2005,683771,Telangana,24,11,14,5,54,Pass
Sukhwinder Singh,04-03-2006,815798,Uttar Pradesh,2,5,4,6,17,Pass
Aarav Fernandes,03-04-2006,604189,Telangana,24,12,3,14,53,Pass
Manpreet Mehta,16-05-2005,508497,Tripura,3,16,0,10,29,Pass
Yash Pillai,28-02-2006,549844,Haryana,21,4,19,19,63,Pass
Peter Singh,05-07-2005,695821,Madhya Pradesh,1,4,12,9,26,Pass
Vivaan Mehta,03-05-2005,607232,Assam,1,13,13,11,38,Pass
Aditya Pillai,23-09-2005,443796,Andhra Pradesh,7,18,12,16,53,Pass
Aarav D'Souza,03-05-2006,501153,West Bengal,12,0,0,23,35,Pass
Mathew Mehta,03-05-2006,703461,Chhattisgarh,11,11,16,24,62,Pass
Balbir Singh,06-12-2005,158094,Bihar,6,14,10,1,31,Pass
Aditya Pillai,22-04-2006,459139,Bihar,14,0,9,10,33,Pass
Harjeet Khan,25-02-2006,450677,Punjab,14,0,1,8,23,Pass
Vivaan Khan,08-04-2005,427460,West Bengal,3,17,24,15,59,Pass
Ishaan Pillai,17-09-2005,604659,Jharkhand,15,4,11,12,42,Pass
Kunal Pillai,12-10-2005,663492,Madhya Pradesh,9,10,11,2,32,Pass
Kunal Mehta,06-02-2006,553248,Bihar,17,20,15,4,56,Pass
Aarav Reddy,05-01-2006,882048,Assam,5,23,7,16,51,Pass
Krishna Khan,26-10-2005,700964,Rajasthan,14,24,11,10,59,Pass
Aarav Sharma,26-09-2005,368869,Odisha,8,13,22,11,54,Pass
Aarav Sharma,30-06-2005,177979,Tamil Nadu,23,21,12,19,75,Pass
Raj Khan,24-11-2005,632571,Uttar Pradesh,7,5,1,5,18,Pass
Ishaan D'Souza,02-02-2005,475690,West Bengal,3,15,19,22,59,Pass
Aarav Verma,05-02-2006,531727,Uttar Pradesh,9,5,10,19,43,Pass
Gurpreet Singh,29-03-2006,189995,Odisha,21,1,9,11,42,Pass
David D'Souza,07-02-2005,455332,Telangana,13,7,5,10,35,Pass
Kunal Chopra,05-07-2005,783967,Maharashtra,13,4,22,18,57,Pass
Aryan Fernandes,03-12-2005,359083,Haryana,20,24,16,3,63,Pass
Yash Verma,08-07-2005,972749,Jharkhand,22,9,0,0,31,Pass
Mathew Chopra,12-06-2005,158704,West Bengal,19,15,3,4,41,Pass
Aditya Mehta,14-07-2005,588315,Meghalaya,24,1,21,5,51,Pass
Aarav Pillai,14-12-2005,200113,Assam,4,17,3,9,33,Pass
Aarav Singh,15-01-2006,655149,Jammu & Kashmir + Ladakh,1,19,2,21,43,Pass
Krishna Chopra,10-04-2005,469928,Andhra Pradesh,4,1,6,5,16,Pass
Aarav Chopra,31-12-2004,220556,Madhya Pradesh,20,20,20,4,64,Pass
Krishna Reddy,11-10-2005,204794,Bihar,17,2,8,19,46,Pass
Manpreet Fernandes,13-11-2004,169378,Maharashtra,5,15,16,5,41,Pass
Krishna Chopra,18-12-2005,362286,Telangana,18,3,14,16,51,Pass
Krishna Fernandes,23-01-2005,494164,Uttar Pradesh,8,5,10,22,45,Pass
Aditya Singh,02-12-2005,759317,Tamil Nadu,3,18,10,13,44,Pass
Vivaan Sharma,25-11-2005,309577,Bihar,7,16,20,16,59,Pass
Krishna Mehta,30-08-2005,922132,Andhra Pradesh,3,6,13,11,33,Pass
Vivaan Singh,25-04-2005,252415,Haryana,10,21,2,2,35,Pass
Aarav Singh,08-11-2005,688664,Uttar Pradesh,2,5,9,23,39,Pass
Ishaan Mehta,08-11-2005,496791,Uttar Pradesh,11,5,3,22,41,Pass
Manpreet Sharma,20-01-2005,609818,Tamil Nadu,11,19,5,7,42,Pass
Paul Pillai,02-05-2005,281384,West Bengal,6,12,11,2,31,Pass
Yash Fernandes,02-03-2006,963349,Punjab,18,9,19,5,51,Pass
Farhan Chopra,20-04-2006,290336,Karnataka,4,0,23,16,43,Pass
Peter Singh,21-08-2005,471123,Gujarat,0,4,1,0,5,Pass
Vivaan Chopra,07-07-2005,671788,Rajasthan,21,20,10,17,68,Pass
Raj Verma,12-12-2005,390788,Maharashtra,9,5,16,18,48,Pass
Balbir Chopra,01-04-2005,932938,Uttar Pradesh,13,5,17,5,40,Pass
Ishaan Khan,18-04-2006,485856,Mizoram,4,9,8,9,30,Pass
Sukhwinder Singh,01-02-2005,683537,Madhya Pradesh,11,14,10,6,41,Pass
Aarav Fernandes,18-12-2005,186602,West Bengal,3,19,15,15,52,Pass
Paul Fernandes,02-01-2006,931139,Haryana,5,17,12,19,53,Pass
Ishaan Fernandes,11-07-2005,501514,Manipur,21,3,24,2,50,Pass
Aarav Chopra,25-06-2005,486891,Rajasthan,22,16,2,9,49,Pass
Ayaan D'Souza,21-10-2005,250346,Punjab,20,15,3,15,53,Pass
Vivaan Pillai,26-09-2005,181525,Punjab,17,17,17,2,53,Pass
Balbir Singh,25-10-2005,547678,Maharashtra,14,4,18,24,60,Pass
Gurpreet Fernandes,22-12-2004,120861,Maharashtra,8,4,4,18,34,Pass
Aryan Khan,09-07-2005,738405,Gujarat,6,20,22,3,51,Pass
Mathew Pillai,04-04-2006,645253,Bihar,22,9,6,7,44,Pass
Rohan Sharma,10-12-2005,921451,Gujarat,3,12,20,3,38,Pass
Rohan Khan,20-01-2005,241530,Uttar Pradesh,7,5,12,1,25,Pass
Krishna Khan,16-01-2006,553338,Uttar Pradesh,13,5,3,1,22,Pass
Manpreet Verma,16-08-2005,734118,Nagaland,5,4,3,18,30,Pass
Aarav Sharma,16-01-2006,273655,Rajasthan,23,1,14,12,50,Pass
Kunal Verma,11-04-2006,526523,Karnataka,4,19,19,12,54,Pass
Vivaan Mehta,11-05-2005,485433,Uttar Pradesh,19,5,17,13,54,Pass
Raj Verma,07-01-2005,791617,Haryana,18,15,23,7,63,Pass
Aryan Mehta,12-02-2005,163444,Punjab,17,13,3,20,53,Pass
Vivaan Singh,16-02-2005,507835,Maharashtra,1,12,0,0,13,Pass
Ayaan Pillai,02-12-2004,175118,Uttar Pradesh,11,5,4,21,41,Pass
Krishna Fernandes,12-07-2005,376127,Karnataka,17,14,12,4,47,Pass
Harjeet Chopra,13-04-2005,477218,Haryana,12,7,24,6,49,Pass
Zaid Singh,29-03-2006,960897,Rajasthan,15,9,20,23,67,Pass
Peter Mehta,06-05-2005,393355,Rajasthan,16,23,22,15,76,Pass
Aarav Khan,15-01-2006,124472,Uttar Pradesh,3,5,16,18,42,Pass
Farhan Reddy,17-01-2006,450738,Maharashtra,8,17,8,9,42,Pass
Rehan Fernandes,09-11-2004,961348,West Bengal,3,21,11,16,51,Pass
Raj Sharma,23-07-2005,959520,Uttar Pradesh,3,5,20,14,42,Pass
Manpreet Reddy,12-11-2004,425694,Assam,7,15,4,2,28,Pass
Kunal D'Souza,01-12-2005,494765,Kerala,13,10,5,21,49,Pass
Aditya Verma,05-04-2005,369931,Madhya Pradesh,9,8,20,10,47,Pass
Aditya Sharma,17-01-2006,505952,Bihar,3,20,5,21,49,Pass
Krishna Fernandes,27-10-2005,658135,Maharashtra,10,7,3,13,33,Pass
Sukhwinder Verma,25-11-2005,689136,Bihar,17,0,5,23,45,Pass
Raj Mehta,15-10-2005,909382,Telangana,17,3,21,21,62,Pass
Aarav Singh,25-08-2005,572466,Bihar,4,11,20,4,39,Pass
Aditya Pillai,01-01-2006,626876,Bihar,20,20,10,8,58,Pass
Kunal Khan,23-02-2006,709355,Rajasthan,22,6,19,9,56,Pass
Yash Verma,04-02-2006,478594,Rajasthan,15,10,24,24,73,Pass
Aryan Singh,08-02-2005,686917,Uttarakhand,2,2,5,5,14,Pass
Ishaan Chopra,29-04-2006,141227,Andhra Pradesh,1,22,6,1,30,Pass
Balbir Reddy,27-05-2005,547695,Delhi,3,9,16,24,52,Fail
Peter Verma,17-04-2006,274425,Karnataka,4,5,6,6,21,Pass
Aryan Khan,16-03-2006,104939,Gujarat,22,1,10,19,52,Pass
Gurpreet Pillai,28-12-2005,665231,Andhra Pradesh,2,22,3,19,46,Pass
Ishaan Pillai,03-04-2005,730981,Bihar,1,20,7,1,29,Pass
Vivaan Singh,23-06-2005,451247,Bihar,5,12,13,5,35,Pass
Aryan Mehta,22-06-2005,334249,Maharashtra,14,13,10,4,41,Pass
Ishaan Singh,26-12-2005,107317,Rajasthan,9,14,17,24,64,Pass
Sukhwinder Singh,10-01-2006,943183,Uttar Pradesh,7,5,5,18,35,Pass
Ishaan D'Souza,03-02-2005,438890,West Bengal,18,0,2,23,43,Pass
Balbir Mehta,09-07-2005,886178,Bihar,11,6,16,5,38,Pass
Kunal Fernandes,11-01-2005,787494,Gujarat,6,7,12,6,31,Pass
Paul Mehta,11-06-2005,589730,Delhi,22,0,19,9,50,Fail
Aarav Fernandes,12-11-2004,474565,Gujarat,16,3,22,7,48,Pass
Aryan Reddy,08-01-2006,277642,West Bengal,3,18,20,11,52,Pass
Gurpreet D'Souza,09-11-2004,667050,Rajasthan,8,14,13,22,57,Pass
Vivaan Mehta,10-12-2005,887758,Rajasthan,22,21,1,5,49,Pass
Rohan Chopra,27-07-2005,994352,Andhra Pradesh,15,13,15,11,54,Pass
Peter Mehta,07-05-2006,170102,Punjab,21,11,23,3,58,Pass
Harjeet D'Souza,23-11-2005,228091,Rajasthan,16,8,10,22,56,Pass
Vivaan Fernandes,02-02-2005,412345,Uttar Pradesh,18,5,12,18,53,Pass
Krishna Fernandes,22-12-2005,511494,Bihar,10,4,12,11,37,Pass
Raj Singh,20-01-2006,124176,Haryana,17,14,16,11,58,Pass
Kunal Verma,09-12-2004,440516,Bihar,15,23,21,0,59,Pass
Yash Pillai,26-04-2005,803158,Madhya Pradesh,18,18,5,15,56,Pass
Paul Sharma,25-04-2006,395659,Uttar Pradesh,5,5,11,0,21,Pass
Raj Fernandes,14-02-2005,810656,Punjab,3,3,16,21,43,Pass
Kunal Pillai,04-12-2005,371880,Karnataka,21,17,17,0,55,Pass
Krishna Singh,24-09-2005,375698,Tamil Nadu,6,0,7,15,28,Pass
Ishaan Verma,02-04-2005,852866,West Bengal,3,20,8,21,52,Pass
Aarav Singh,18-11-2004,263946,Bihar,11,2,21,7,41,Pass
Yash Singh,25-10-2005,349968,Rajasthan,22,21,9,20,72,Pass
Imran Khan,06-12-2004,882802,Jharkhand,12,22,7,4,45,Pass
Yash D'Souza,08-12-2005,649852,Uttar Pradesh,5,5,18,5,33,Pass
David Singh,27-10-2005,817673,Chhattisgarh,6,8,21,23,58,Pass
Yash Singh,06-02-2005,493339,Bihar,7,5,7,1,20,Pass
Krishna Singh,01-08-2005,560059,Uttar Pradesh,12,5,8,21,46,Pass
Krishna Fernandes,15-01-2006,853767,Gujarat,2,17,18,9,46,Pass
Peter Chopra,07-06-2005,142110,Haryana,13,17,22,17,69,Pass
Ishaan Verma,26-06-2005,243896,Bihar,16,7,11,22,56,Pass
Vivaan Sharma,14-08-2005,241139,Kerala,6,8,9,9,32,Pass
Aarav Fernandes,13-03-2006,383147,Delhi,13,0,21,10,44,Fail
Balbir Singh,03-07-2005,618145,Rajasthan,24,15,8,14,61,Pass
Vivaan Mehta,24-08-2005,600647,Delhi,7,13,16,5,41,Fail
Ishaan Chopra,05-02-2005,430523,Rajasthan,12,17,8,4,41,Pass
Krishna Chopra,18-03-2005,973552,Haryana,6,20,19,16,61,Pass
Krishna Verma,01-01-2005,469133,Punjab,10,20,4,7,41,Pass
Raj Verma,23-09-2005,631066,Maharashtra,11,4,20,22,57,Pass
Aryan Verma,09-03-2005,483829,Odisha,6,6,24,10,46,Pass
Aditya D'Souza,29-12-2004,553333,Gujarat,14,20,22,22,78,Pass
Peter Fernandes,03-05-2005,521284,Bihar,17,4,11,5,37,Pass
Yash Chopra,20-08-2005,601045,Uttar Pradesh,4,5,18,5,32,Pass
Raj Fernandes,23-09-2005,237616,Tamil Nadu,11,5,19,2,37,Pass
Aryan Sharma,25-03-2006,267346,Gujarat,21,8,17,14,60,Pass
Rohan Chopra,08-12-2005,502596,Bihar,3,24,3,10,40,Pass
Aryan Reddy,10-01-2005,155930,Tamil Nadu,1,6,10,7,24,Pass
Yash Reddy,18-12-2005,161591,Rajasthan,24,22,23,16,85,Pass
Aarav Pillai,27-10-2005,375352,Rajasthan,15,15,7,2,39,Pass
Aarav Pillai,14-04-2006,911926,Haryana,20,20,0,6,46,Pass
Harjeet Chopra,13-01-2006,308511,Uttar Pradesh,13,5,0,10,28,Pass
Ishaan Fernandes,10-10-2005,723020,West Bengal,3,1,24,13,41,Pass
Ishaan Fernandes,17-11-2005,534214,Kerala,21,14,5,10,50,Pass
Aryan Singh,16-02-2006,447010,Punjab,16,20,3,18,57,Pass
Aarav Khan,11-07-2005,788583,Bihar,16,19,21,11,67,Pass
Vivaan Sharma,12-11-2005,320369,Rajasthan,18,6,15,17,56,Pass
John Chopra,16-01-2005,329636,Bihar,16,24,20,3,63,Pass
Aarav D'Souza,03-01-2006,268876,Jharkhand,13,24,4,11,52,Pass
Manpreet Singh,10-07-2005,291885,Karnataka,6,5,8,9,28,Pass
Gurpreet Singh,22-06-2005,984495,Rajasthan,20,11,24,24,79,Pass
Kunal Khan,07-10-2005,873517,Assam,7,6,1,20,34,Pass
Yash Singh,16-04-2005,181684,Tamil Nadu,9,11,24,10,54,Pass
Vivaan Sharma,18-10-2005,400539,Kerala,12,19,3,18,52,Pass
Aarav Pillai,25-04-2006,461239,Uttar Pradesh,1,5,23,2,31,Pass
Ishaan Singh,22-12-2004,952632,Meghalaya,11,11,4,7,33,Pass
Kunal Pillai,15-01-2005,501563,Jammu & Kashmir + Ladakh,11,5,8,11,35,Pass
Balbir Fernandes,29-07-2005,141392,West Bengal,5,0,10,21,36,Pass
Raj Mehta,17-11-2005,304587,Uttarakhand,13,17,3,3,36,Pass
Harjeet Khan,22-04-2005,250081,Uttar Pradesh,13,5,20,2,40,Pass
Aryan Sharma,27-04-2006,901005,Kerala,12,19,14,1,46,Pass
Raj Reddy,05-02-2005,564141,Bihar,18,24,9,2,53,Pass
Aditya D'Souza,16-10-2005,137114,Madhya Pradesh,0,3,24,10,37,Pass
Aditya Mehta,01-12-2005,432847,Andhra Pradesh,20,6,8,14,48,Pass
Aditya Khan,23-12-2005,247232,Kerala,5,10,11,12,38,Pass
Vivaan Verma,29-10-2005,961471,Bihar,12,11,14,19,56,Pass
Vivaan Singh,05-05-2006,425716,Telangana,12,15,11,10,48,Pass
Sukhwinder Mehta,12-08-2005,618501,Tamil Nadu,12,5,3,0,20,Pass
Aarav Reddy,08-01-2006,253479,Tamil Nadu,14,15,23,22,74,Pass
Harjeet Verma,10-10-2005,339213,Telangana,16,16,2,18,52,Pass
Aryan D'Souza,12-04-2005,653153,Rajasthan,19,7,24,6,56,Pass
Rohan Pillai,24-07-2005,296850,Nagaland,18,8,3,8,37,Pass
Aditya Fernandes,11-09-2005,349732,Haryana,0,6,20,0,26,Pass
Aryan Verma,22-06-2005,970831,Madhya Pradesh,6,7,17,11,41,Pass
Yash Chopra,04-05-2005,221429,Bihar,0,19,0,13,32,Pass
Peter Fernandes,26-03-2006,691378,Uttar Pradesh,1,5,23,3,32,Pass
Harjeet Mehta,29-04-2006,625422,Telangana,18,14,2,19,53,Pass
Gurpreet Mehta,25-12-2005,228217,Bihar,10,24,10,12,56,Pass
Sukhwinder Pillai,26-06-2005,346666,Rajasthan,11,19,11,15,56,Pass
Aarav Reddy,25-12-2004,167505,Karnataka,4,22,3,4,33,Pass
Paul Mehta,14-09-2005,328230,West Bengal,4,18,1,13,36,Pass
Aarav Mehta,18-03-2005,764298,Chhattisgarh,17,13,1,5,36,Pass
Gurpreet Sharma,23-05-2005,255424,Meghalaya,13,6,6,7,32,Pass
Kunal Mehta,25-01-2005,288515,Chhattisgarh,15,22,17,0,54,Pass
Mathew Singh,15-02-2006,324650,Gujarat,12,10,8,22,52,Pass
Ishaan Pillai,11-03-2006,518060,Jharkhand,8,19,14,3,44,Pass
Vivaan Verma,11-01-2006,790321,Gujarat,3,6,22,24,55,Pass
Manpreet Mehta,27-01-2005,134255,Bihar,23,8,14,22,67,Pass
Balbir Reddy,17-04-2006,866131,Maharashtra,18,4,24,20,66,Pass
Kunal Chopra,29-01-2005,911612,Rajasthan,4,1,13,10,28,Pass
Yash Verma,02-11-2005,446646,West Bengal,1,23,13,14,51,Pass
Aarav Chopra,31-12-2005,879823,Punjab,0,20,4,18,42,Pass
Aryan D'Souza,23-07-2005,746771,Uttar Pradesh,9,5,0,5,19,Pass
Vivaan Pillai,14-03-2006,989102,Rajasthan,4,22,14,24,64,Pass
Krishna Reddy,03-05-2005,598270,Uttar Pradesh,11,5,2,23,41,Pass
Rohan Fernandes,18-12-2004,350012,Rajasthan,0,11,16,12,39,Pass
Manpreet Singh,03-07-2005,342770,West Bengal,12,12,19,4,47,Pass
Yash Khan,30-11-2005,835288,Odisha,1,17,10,5,33,Pass
Gurpreet Singh,16-04-2005,647280,Uttarakhand,3,21,13,21,58,Pass
Yash Pillai,19-01-2006,858091,West Bengal,18,14,3,11,46,Pass
Aditya Reddy,28-01-2005,224104,Delhi,19,5,19,8,51,Fail
Yash Chopra,22-05-2005,519064,Uttar Pradesh,23,5,5,19,52,Pass
Vivaan Reddy,25-04-2005,671136,Uttar Pradesh,19,5,23,11,58,Pass
Yash D'Souza,06-03-2006,801666,Jharkhand,17,17,16,1,51,Pass
Raj Singh,20-12-2004,749611,Bihar,8,11,3,5,27,Pass
Mathew Pillai,14-02-2005,346480,Andhra Pradesh,1,3,18,4,26,Pass
Gurpreet Mehta,25-02-2005,360676,Andhra Pradesh,4,22,3,22,51,Pass
Aryan Verma,20-12-2005,100634,Rajasthan,19,7,21,24,71,Pass
Aryan Singh,05-05-2006,582683,Maharashtra,23,4,22,24,73,Pass
Kunal Verma,07-06-2005,608465,Kerala,19,23,2,18,62,Pass
Aarav Reddy,04-07-2005,729178,West Bengal,3,21,24,18,66,Pass
Sukhwinder Khan,11-03-2005,612602,Punjab,23,3,23,1,50,Pass
Ishaan Singh,23-11-2004,986236,Delhi,20,13,24,9,66,Fail
Gurpreet Reddy,06-05-2006,880968,Bihar,15,15,3,9,42,Pass
Aarav D'Souza,13-12-2005,478576,Uttar Pradesh,16,5,18,12,51,Pass
Aryan Sharma,16-01-2006,846598,Rajasthan,18,9,5,14,46,Pass
Rohan Pillai,24-01-2006,591524,Haryana,22,19,2,23,66,Pass
Mathew Sharma,28-10-2005,766689,Punjab,22,4,2,1,29,Pass
Farhan Pillai,16-07-2005,117574,Gujarat,20,14,10,8,52,Pass
Aditya D'Souza,13-11-2004,954590,Madhya Pradesh,17,11,12,4,44,Pass
Farhan Khan,26-07-2005,211251,Rajasthan,3,14,21,2,40,Pass
Ishaan Chopra,12-06-2005,664682,Karnataka,24,4,0,14,42,Pass
Aarav Fernandes,15-01-2005,228814,Delhi,11,24,21,24,80,Fail
Vivaan Fernandes,09-10-2005,360413,Gujarat,21,18,8,4,51,Pass
Ishaan Pillai,30-03-2005,856380,Punjab,2,22,11,8,43,Pass
Vivaan Mehta,19-12-2004,592449,Punjab,2,14,18,5,39,Pass
Aryan Fernandes,23-10-2005,958238,Tamil Nadu,23,18,17,1,59,Pass
Farhan Pillai,31-05-2005,126158,West Bengal,3,10,13,19,45,Pass
Aditya Reddy,03-04-2005,892270,Maharashtra,4,7,13,3,27,Pass
Aryan Chopra,28-01-2005,183095,Jharkhand,24,9,13,20,66,Pass
Sukhwinder Verma,30-05-2005,437728,Punjab,22,5,4,16,47,Pass
Yash Pillai,28-02-2006,938128,Rajasthan,15,17,15,24,71,Pass
Ishaan D'Souza,10-12-2004,870271,Maharashtra,0,4,23,23,50,Pass
Aryan Chopra,26-12-2004,727845,Meghalaya,9,6,8,7,30,Pass
Aditya Khan,04-05-2006,975840,Uttar Pradesh,14,5,3,7,29,Pass
Aarav Verma,30-10-2005,662535,Uttar Pradesh,16,5,6,19,46,Pass
Sukhwinder Reddy,05-11-2005,639611,Maharashtra,20,4,18,18,60,Pass
Krishna Chopra,19-07-2005,498533,Bihar,7,23,18,20,68,Pass
Vivaan D'Souza,28-10-2005,588210,Andhra Pradesh,1,6,21,23,51,Pass
Rohan Chopra,14-01-2005,645577,Haryana,24,8,24,22,78,Pass
Krishna Sharma,31-03-2005,110440,Bihar,21,10,15,12,58,Pass
Aryan Fernandes,20-04-2006,780703,Uttar Pradesh,15,5,22,8,50,Pass
Peter D'Souza,21-01-2005,141361,Tamil Nadu,20,13,23,23,79,Pass
Aryan Chopra,08-01-2006,580792,Bihar,21,0,9,0,30,Pass
Vivaan D'Souza,23-02-2006,441656,Assam,7,1,19,7,34,Pass
Ayaan Reddy,19-03-2006,769943,Rajasthan,16,16,22,21,75,Pass
Kunal Singh,06-08-2005,797123,Chhattisgarh,21,4,6,22,53,Pass
Gurpreet D'Souza,07-05-2006,587522,Gujarat,22,2,20,15,59,Pass
Mathew Sharma,03-02-2005,809665,Gujarat,9,2,0,20,31,Pass
Rohan Mehta,27-06-2005,212538,Meghalaya,8,16,11,14,49,Pass
Yash Singh,09-06-2005,252433,Jharkhand,11,14,11,24,60,Pass
Rohan Khan,15-04-2005,576712,Uttar Pradesh,16,5,23,13,57,Pass
Krishna Fernandes,26-11-2004,203011,Gujarat,8,12,13,18,51,Pass
Aryan Pillai,13-12-2005,941438,Tamil Nadu,14,14,22,8,58,Pass
Ishaan Fernandes,02-04-2005,393789,Rajasthan,11,0,2,17,30,Pass
Aryan Fernandes,15-12-2004,340196,Uttar Pradesh,5,5,8,24,42,Pass
Ayaan Verma,07-07-2005,956787,Jharkhand,0,9,14,6,29,Pass
Raj Verma,08-09-2005,373374,Maharashtra,11,0,17,17,45,Pass
Ishaan D'Souza,20-12-2004,219307,Tamil Nadu,16,3,21,9,49,Pass
Kunal Singh,09-11-2005,424136,Maharashtra,17,3,1,11,32,Pass
Kunal Khan,24-09-2005,524168,Haryana,1,12,24,21,58,Pass
Balbir Mehta,26-07-2005,400917,West Bengal,8,7,14,20,49,Pass
Krishna Pillai,28-01-2006,823229,Karnataka,19,6,17,2,44,Pass
Paul D'Souza,03-02-2005,687605,Kerala,11,12,14,6,43,Pass
Yash Fernandes,21-05-2005,387022,Bihar,4,15,7,17,43,Pass
Krishna Reddy,13-02-2006,166224,Maharashtra,11,4,10,12,37,Pass
Vivaan Sharma,13-03-2006,233297,Telangana,16,5,12,2,35,Pass
Aarav Reddy,21-02-2006,876387,Bihar,21,8,17,2,48,Pass
Rohan Sharma,27-01-2005,641450,Haryana,5,5,11,17,38,Pass
Aditya Khan,20-12-2004,151307,Andhra Pradesh,9,9,18,12,48,Pass
Krishna Fernandes,14-12-2004,510421,Chhattisgarh,13,23,6,16,58,Pass
Yash Verma,28-01-2006,783362,Punjab,0,8,15,3,26,Pass
Krishna Sharma,20-08-2005,423578,Madhya Pradesh,21,1,6,20,48,Pass
Aryan Reddy,30-01-2005,106902,Uttar Pradesh,11,5,5,17,38,Pass
Vivaan D'Souza,08-10-2005,856958,Maharashtra,7,12,2,10,31,Pass
Rohan Mehta,08-11-2005,659716,Kerala,11,12,11,11,45,Pass
Vivaan Chopra,03-01-2006,133246,Jharkhand,11,24,9,7,51,Pass
Aarav Singh,26-02-2006,822284,Madhya Pradesh,1,7,20,22,50,Pass
Rohan Chopra,02-07-2005,307842,Jharkhand,6,2,10,22,40,Pass
Aryan Singh,02-11-2005,692322,Uttar Pradesh,3,5,23,20,51,Pass
John Verma,13-01-2006,953171,Rajasthan,19,9,16,21,65,Pass
Aryan Reddy,28-06-2005,911717,Uttar Pradesh,24,5,11,17,57,Pass
Kunal Singh,11-03-2006,173220,Uttar Pradesh,20,5,19,24,68,Pass
Raj Sharma,16-04-2006,588457,Punjab,10,5,17,0,32,Pass
Aryan Verma,28-08-2005,309238,Telangana,3,13,20,19,55,Pass
Rohan Khan,13-07-2005,361447,Tamil Nadu,9,20,9,15,53,Pass
Sukhwinder Reddy,16-12-2005,338019,Madhya Pradesh,24,2,8,22,56,Pass
Raj Chopra,29-09-2005,299608,Bihar,18,0,9,15,42,Pass
Vivaan Sharma,04-01-2006,478514,Kerala,12,11,12,11,46,Pass
Yash Mehta,25-12-2005,985348,Bihar,7,6,16,18,47,Pass
Krishna Pillai,09-03-2005,692718,Kerala,23,4,9,10,46,Pass
Ishaan Mehta,28-02-2006,840057,Chhattisgarh,6,14,7,24,51,Pass
Imran Reddy,11-04-2005,557641,Uttarakhand,3,0,4,14,21,Pass
Yash Singh,23-04-2006,322921,Uttar Pradesh,2,5,12,19,38,Pass
Rohan Verma,29-03-2005,286378,Chhattisgarh,12,22,8,2,44,Pass
Peter Fernandes,13-08-2005,506964,Bihar,20,1,20,21,62,Pass
Krishna Sharma,16-01-2006,355762,Bihar,3,8,9,22,42,Pass
Vivaan Pillai,03-12-2005,955474,Uttar Pradesh,3,5,14,18,40,Pass
Vivaan Pillai,03-08-2005,997507,Bihar,8,8,14,20,50,Pass
Balbir Mehta,04-03-2005,351298,Jharkhand,13,22,24,0,59,Pass
Kunal D'Souza,18-11-2005,547893,Haryana,11,11,24,7,53,Pass
John D'Souza,05-03-2005,849708,Madhya Pradesh,16,2,4,19,41,Pass
Rohan Singh,19-10-2005,418179,Bihar,6,13,24,9,52,Pass
Sukhwinder Reddy,23-11-2005,736854,Bihar,13,20,14,4,51,Pass
Sukhwinder Pillai,12-12-2004,225952,Maharashtra,9,6,8,17,40,Pass
Kunal Khan,10-12-2004,114761,Tamil Nadu,7,7,7,13,34,Pass
Raj Sharma,02-07-2005,505480,Karnataka,14,3,15,3,35,Pass
Paul Chopra,31-03-2005,351936,Haryana,11,6,20,7,44,Pass
David Pillai,16-04-2005,633360,Bihar,15,18,7,17,57,Pass
Gurpreet Reddy,30-04-2006,648236,Punjab,2,7,17,23,49,Pass
Krishna Verma,28-11-2004,309369,Maharashtra,21,18,9,0,48,Pass
Aditya Reddy,14-02-2005,115570,Telangana,4,15,2,4,25,Pass
Aarav Sharma,21-11-2004,864352,Uttar Pradesh,6,5,15,8,34,Pass
Vivaan Chopra,13-04-2006,854282,Haryana,18,21,10,24,73,Pass
John D'Souza,04-11-2005,478515,Maharashtra,4,23,13,7,47,Pass
Aarav D'Souza,29-12-2005,313211,Maharashtra,14,4,14,18,50,Pass
Harjeet Reddy,01-02-2005,144703,West Bengal,23,10,17,3,53,Pass
Rohan Singh,08-07-2005,458440,Madhya Pradesh,12,15,14,12,53,Pass
Aarav Sharma,02-01-2006,737815,Madhya Pradesh,11,12,16,4,43,Pass
David Singh,24-02-2005,320705,Uttar Pradesh,8,5,15,0,28,Pass
Aditya Sharma,04-04-2005,732610,West Bengal,2,5,1,19,27,Pass
Krishna Reddy,30-09-2005,646731,West Bengal,7,6,1,13,27,Pass
Kunal Reddy,18-06-2005,447597,Maharashtra,22,4,11,22,59,Pass
Rohan Singh,14-10-2005,202855,Madhya Pradesh,23,10,0,19,52,Pass
Aarav D'Souza,11-08-2005,549003,Tamil Nadu,15,8,0,13,36,Pass
Kunal Chopra,12-01-2006,550959,Tamil Nadu,13,19,16,13,61,Pass
Ishaan Reddy,11-01-2005,231442,Odisha,9,10,6,12,37,Pass
Krishna Sharma,17-04-2005,975538,Haryana,14,4,15,15,48,Pass
Krishna Sharma,09-05-2006,351213,Assam,9,6,23,1,39,Pass
Aarav D'Souza,03-06-2005,320111,Bihar,12,14,8,13,47,Pass
Imran Khan,28-10-2005,592808,Tamil Nadu,8,23,18,24,73,Pass
Mathew Chopra,24-04-2005,920596,Andhra Pradesh,15,4,14,5,38,Pass
John Chopra,01-06-2005,768145,Gujarat,9,12,1,9,31,Pass
Aditya Khan,10-02-2005,242582,Goa,7,7,5,7,26,Pass
Rohan Khan,20-01-2005,450894,Odisha,11,0,10,24,45,Pass
Ayaan Chopra,26-03-2006,981773,Punjab,14,12,5,12,43,Pass
Aryan Chopra,19-04-2005,180396,Telangana,14,9,9,18,50,Pass
Aarav Mehta,09-02-2005,693016,Rajasthan,9,9,16,3,37,Pass
Raj Khan,08-10-2005,787720,Bihar,11,7,0,6,24,Pass
Krishna D'Souza,26-01-2005,538710,Uttar Pradesh,17,5,10,13,45,Pass
Aarav Singh,25-01-2006,736809,Tamil Nadu,9,8,20,10,47,Pass
Aryan Singh,14-10-2005,512257,Rajasthan,4,0,4,24,32,Pass
Yash Mehta,22-06-2005,855281,Andhra Pradesh,10,10,5,24,49,Pass
Aryan Singh,06-01-2005,276393,Jharkhand,3,22,17,21,63,Pass
Imran Sharma,25-11-2005,171662,Gujarat,5,23,16,14,58,Pass
Ishaan Khan,20-04-2006,769876,Maharashtra,19,4,6,20,49,Pass
Rohan Fernandes,07-12-2004,716470,Uttarakhand,0,22,11,2,35,Pass
Sukhwinder Khan,20-04-2006,510886,Rajasthan,14,19,18,0,51,Pass
Aryan Fernandes,23-10-2005,807958,Uttar Pradesh,17,5,6,22,50,Pass
Aryan Singh,24-09-2005,526743,Uttar Pradesh,2,5,0,7,14,Pass
Aryan Reddy,03-03-2005,478666,Uttar Pradesh,21,5,5,19,50,Pass
Gurpreet Singh,06-05-2006,759741,Punjab,3,22,15,13,53,Pass
Kunal Mehta,24-04-2006,331597,Himachal Pradesh,12,20,18,5,55,Pass
Rohan Singh,08-03-2006,755868,Punjab,7,18,17,14,56,Pass
David Reddy,27-11-2004,632658,Uttar Pradesh,7,5,13,4,29,Pass
David Mehta,05-09-2005,578723,West Bengal,3,16,6,23,48,Pass
Raj Singh,08-08-2005,841579,Karnataka,4,11,14,20,49,Pass
Balbir Singh,08-06-2005,776932,Gujarat,22,11,2,23,58,Pass
Rohan D'Souza,13-07-2005,789391,Gujarat,6,16,0,23,45,Pass
Kunal Sharma,17-11-2004,723607,Uttar Pradesh,18,5,20,7,50,Pass
Raj Singh,22-11-2005,734705,Delhi,1,23,17,0,41,Fail
Aditya Chopra,09-07-2005,763613,Uttar Pradesh,16,5,14,20,55,Pass
Raj Reddy,10-08-2005,619084,Karnataka,15,6,7,21,49,Pass
Raj Sharma,14-08-2005,712621,Madhya Pradesh,3,11,10,23,47,Pass
Krishna Singh,04-03-2006,766966,Karnataka,21,22,6,3,52,Pass
Balbir Sharma,09-02-2006,656496,Delhi,5,23,14,12,54,Fail
Yash Sharma,17-04-2005,250138,Gujarat,22,21,2,15,60,Pass
Ishaan Chopra,26-11-2004,785207,Rajasthan,17,21,22,8,68,Pass
Zaid Sharma,12-10-2005,751136,Maharashtra,10,7,7,11,35,Pass
John Chopra,29-11-2005,952245,Bihar,15,4,17,11,47,Pass
Peter Singh,26-01-2006,872175,Rajasthan,1,7,0,5,13,Pass
Aarav Verma,22-09-2005,862265,Assam,3,2,5,20,30,Pass
Gurpreet D'Souza,21-12-2005,227609,West Bengal,3,10,12,19,44,Pass
Kunal Sharma,27-02-2005,976618,Madhya Pradesh,23,14,15,1,53,Pass
Manpreet Reddy,20-02-2005,768396,Bihar,8,16,3,12,39,Pass
Aryan Sharma,21-12-2005,633875,Tamil Nadu,13,10,22,10,55,Pass
Krishna Fernandes,03-02-2006,581036,Maharashtra,21,4,14,7,46,Pass
Raj Verma,14-12-2005,784116,Madhya Pradesh,18,12,18,8,56,Pass
Ishaan Pillai,24-03-2006,625972,Rajasthan,9,20,4,23,56,Pass
Ishaan Sharma,03-05-2006,328485,Jharkhand,19,0,19,4,42,Pass
Rehan Sharma,01-02-2006,313566,Jammu & Kashmir + Ladakh,14,15,16,14,59,Pass
Sukhwinder Pillai,16-09-2005,315884,Gujarat,21,6,22,13,62,Pass
Raj Pillai,01-03-2006,780192,Bihar,14,2,13,2,31,Pass
Aditya Pillai,08-02-2006,191094,Bihar,0,0,2,2,4,Pass
John Singh,28-07-2005,813322,Odisha,6,13,2,8,29,Pass
Aarav Mehta,07-01-2006,496061,Maharashtra,2,12,13,7,34,Pass
Yash Reddy,02-01-2006,768101,Uttar Pradesh,22,5,18,11,56,Pass
Aarav D'Souza,24-11-2004,455498,Uttar Pradesh,23,5,1,15,44,Pass
Yash Verma,04-01-2005,215360,Kerala,8,16,9,10,43,Pass
Sukhwinder Chopra,04-10-2005,974254,Chhattisgarh,20,6,1,24,51,Pass
Kunal Sharma,27-04-2005,637340,Telangana,4,9,23,14,50,Pass
Aryan Singh,27-05-2005,706132,Maharashtra,14,4,6,23,47,Pass
Vivaan D'Souza,15-05-2005,790360,Andaman & Nicobar,6,7,7,6,26,Pass
Raj Singh,11-12-2004,868933,Uttar Pradesh,13,5,20,18,56,Pass
Aryan Sharma,01-05-2005,264686,Goa,2,16,7,9,34,Pass
Kunal Chopra,17-03-2005,184423,Uttar Pradesh,12,5,4,3,24,Pass
Aditya Chopra,10-04-2005,757073,Bihar,24,9,2,16,51,Pass
Aarav Sharma,30-03-2006,208331,Madhya Pradesh,11,12,0,23,46,Pass
Kunal Reddy,23-10-2005,239451,Madhya Pradesh,19,16,2,1,38,Pass
Raj Fernandes,13-01-2006,488109,Rajasthan,9,12,4,19,44,Pass
Aarav D'Souza,29-01-2005,716628,Tamil Nadu,9,16,23,16,64,Pass
Krishna Chopra,05-06-2005,871164,Andhra Pradesh,4,6,20,12,42,Pass
Ayaan Mehta,27-12-2004,497282,West Bengal,3,10,17,14,44,Pass
Yash Verma,26-03-2006,991271,Chhattisgarh,18,8,24,8,58,Pass
Aarav Sharma,17-08-2005,395453,Chhattisgarh,24,19,14,9,66,Pass
Zaid Khan,18-11-2005,997086,Punjab,18,0,24,15,57,Pass
John Fernandes,04-01-2005,972902,West Bengal,3,7,24,12,46,Pass
Balbir Verma,30-10-2005,631570,Uttar Pradesh,15,5,24,14,58,Pass
Aarav Pillai,28-08-2005,613094,Uttar Pradesh,4,5,7,9,25,Pass
Rohan Fernandes,06-06-2005,205864,Karnataka,4,6,21,14,45,Pass
Yash Sharma,29-04-2006,142161,Uttar Pradesh,18,5,5,12,40,Pass
Imran Khan,10-02-2005,223383,Andhra Pradesh,10,0,24,18,52,Pass
John D'Souza,19-06-2005,621715,Maharashtra,6,1,15,17,39,Pass
Mathew Fernandes,14-01-2005,336029,Karnataka,13,13,4,13,43,Pass
Aryan Mehta,18-03-2005,434711,Assam,6,5,17,2,30,Pass
Raj Reddy,04-06-2005,763774,Jharkhand,15,9,8,15,47,Pass
Krishna D'Souza,21-10-2005,629668,Uttar Pradesh,2,5,3,14,24,Pass
Vivaan Fernandes,25-04-2005,184303,Rajasthan,14,0,18,12,44,Pass
Peter Sharma,30-04-2005,944060,Rajasthan,18,11,5,4,38,Pass
Aditya Pillai,26-04-2006,948250,Punjab,11,3,14,4,32,Pass
Aryan D'Souza,12-12-2004,284705,Punjab,1,1,14,11,27,Pass
Yash Khan,01-01-2005,946065,Uttar Pradesh,14,5,3,8,30,Pass
Aditya Khan,15-08-2005,471686,Chhattisgarh,0,20,13,23,56,Pass
Rohan Mehta,20-03-2006,389296,Jammu & Kashmir + Ladakh,3,21,15,20,59,Pass
Krishna Verma,29-01-2005,396009,Uttar Pradesh,21,5,20,9,55,Pass
Ishaan Chopra,21-02-2005,678414,Haryana,24,15,10,20,69,Pass
Krishna Verma,02-01-2005,650153,Kerala,15,19,19,11,64,Pass
Aarav Pillai,13-05-2005,557910,Madhya Pradesh,13,9,1,3,26,Pass
Gurpreet D'Souza,13-06-2005,112693,Bihar,18,19,20,9,66,Pass
Yash Chopra,13-11-2005,155901,Maharashtra,23,4,7,24,58,Pass
Rehan Sharma,07-08-2005,163134,Uttar Pradesh,8,5,23,12,48,Pass
Aditya Fernandes,11-12-2005,650774,Assam,14,0,4,18,36,Pass
David Chopra,13-09-2005,832941,West Bengal,3,4,17,23,47,Pass
Ayaan Singh,01-03-2005,355628,Chhattisgarh,0,21,3,4,28,Pass
Peter Fernandes,17-04-2005,908893,Haryana,23,21,6,0,50,Pass
Manpreet D'Souza,20-06-2005,258453,Assam,8,3,17,10,38,Pass
Kunal Reddy,30-01-2005,226373,Bihar,23,15,5,1,44,Pass
Gurpreet Sharma,14-08-2005,158858,Punjab,23,22,0,15,60,Pass
Yash Verma,16-02-2005,539018,Arunachal Pradesh,17,10,1,5,33,Pass
Rohan Verma,28-04-2005,783732,Kerala,9,8,9,9,35,Pass
Mathew Verma,05-03-2005,555627,Rajasthan,8,15,19,18,60,Pass
Rohan Fernandes,22-10-2005,869806,Jammu & Kashmir + Ladakh,4,5,5,10,24,Pass
Harjeet Fernandes,23-01-2006,242163,Kerala,11,0,1,4,16,Pass
Krishna Verma,11-12-2005,214056,Delhi,23,12,17,12,64,Fail
Farhan Chopra,29-08-2005,811093,Jharkhand,5,17,5,18,45,Pass
Aryan Pillai,31-07-2005,732652,Rajasthan,17,19,20,9,65,Pass
Aarav Reddy,20-03-2006,853323,Gujarat,4,6,0,16,26,Pass
Yash Sharma,05-02-2006,611875,Rajasthan,19,24,1,0,44,Pass
Kunal Mehta,29-01-2006,968872,Haryana,1,4,16,14,35,Pass
Gurpreet Reddy,02-03-2006,103045,Gujarat,3,4,12,8,27,Pass
Krishna Pillai,13-03-2005,525995,Rajasthan,7,6,5,20,38,Pass
Zaid Mehta,13-07-2005,496417,Odisha,12,17,11,4,44,Pass
Aarav Chopra,19-11-2004,156627,Jharkhand,13,21,0,17,51,Pass
Krishna Sharma,12-01-2006,110320,Uttar Pradesh,13,5,22,14,54,Pass
Gurpreet Khan,12-01-2006,503961,Himachal Pradesh,0,8,1,19,28,Pass
Peter Verma,18-04-2006,211218,Uttar Pradesh,21,5,6,8,40,Pass
Manpreet Pillai,14-04-2005,737530,Tamil Nadu,14,24,20,4,62,Pass
Aryan Singh,11-07-2005,516933,Bihar,17,12,1,21,51,Pass
Kunal D'Souza,30-05-2005,307569,Jammu & Kashmir + Ladakh,20,3,6,4,33,Pass
Balbir Sharma,21-09-2005,426422,Assam,8,7,9,23,47,Pass
Aryan Reddy,30-07-2005,645179,Tamil Nadu,8,17,4,7,36,Pass
Ishaan Pillai,21-12-2005,604426,Rajasthan,6,11,12,22,51,Pass
Krishna Khan,03-02-2006,576710,Uttar Pradesh,21,5,3,20,49,Pass
Krishna Singh,28-10-2005,807575,Rajasthan,23,16,6,8,53,Pass
Manpreet Sharma,02-07-2005,148320,Uttar Pradesh,12,5,7,23,47,Pass
Rohan Pillai,20-05-2005,452495,West Bengal,9,4,2,19,34,Pass
Aarav Pillai,15-09-2005,943050,Tamil Nadu,11,24,18,20,73,Pass
John Verma,17-04-2006,236034,Jharkhand,2,10,24,5,41,Pass
Aarav Mehta,12-11-2004,839543,Uttar Pradesh,2,5,24,14,45,Pass
Balbir D'Souza,13-09-2005,193725,Bihar,5,5,23,7,40,Pass
Krishna Verma,17-12-2004,725225,Andhra Pradesh,24,0,13,23,60,Pass
Mathew Pillai,26-02-2006,381323,Uttar Pradesh,18,5,17,1,41,Pass
Raj Chopra,23-11-2004,964184,Punjab,20,12,3,16,51,Pass
Paul Singh,09-12-2005,538978,Karnataka,7,12,16,11,46,Pass
Aarav Verma,18-06-2005,799771,Uttar Pradesh,13,5,0,4,22,Pass
Kunal Singh,21-09-2005,880151,Puducherry,6,5,20,12,43,Pass
Vivaan Singh,11-11-2005,238088,Telangana,23,20,2,0,45,Pass
Rohan Verma,17-03-2006,403565,Uttar Pradesh,6,5,6,11,28,Pass
Krishna Pillai,22-05-2005,382190,West Bengal,3,22,14,9,48,Pass
Ishaan Mehta,22-06-2005,631437,Rajasthan,10,2,4,3,19,Pass
Ishaan Mehta,23-07-2005,444271,Punjab,23,10,1,3,37,Pass
Gurpreet Verma,29-03-2005,857208,Karnataka,4,5,6,8,23,Pass
Gurpreet Sharma,04-03-2006,247944,Telangana,20,3,22,4,49,Pass
Paul Singh,09-04-2006,623850,Uttarakhand,6,13,2,22,43,Pass
Raj Khan,15-04-2005,171914,Madhya Pradesh,22,4,7,0,33,Pass
Vivaan Mehta,02-01-2005,617210,Delhi,0,23,16,9,48,Fail
Yash Sharma,21-04-2006,988438,Bihar,3,4,10,16,33,Pass
Aryan Verma,07-02-2006,875115,Haryana,3,9,2,2,16,Pass
Yash Sharma,13-03-2005,205198,Jammu & Kashmir + Ladakh,9,6,7,7,29,Pass
Krishna Singh,02-03-2005,358787,Karnataka,9,5,5,7,26,Pass
Yash Fernandes,20-09-2005,604604,Madhya Pradesh,10,2,24,10,46,Pass
Gurpreet Pillai,07-03-2005,146123,Gujarat,5,21,24,5,55,Pass
Yash Sharma,05-12-2004,558172,Jammu & Kashmir + Ladakh,4,12,11,4,31,Pass
Raj Pillai,29-12-2005,785151,Bihar,2,3,10,1,16,Pass
Aryan Khan,27-01-2006,676066,Telangana,7,9,24,23,63,Pass
Balbir Fernandes,11-11-2005,256865,Rajasthan,13,22,20,16,71,Pass
Gurpreet Khan,21-12-2004,251495,Telangana,14,7,5,5,31,Pass
Vivaan Pillai,06-09-2005,582260,Madhya Pradesh,7,19,18,6,50,Pass
Vivaan Sharma,19-11-2004,776817,Andhra Pradesh,0,4,13,0,17,Pass
Aryan Sharma,01-03-2006,205465,Punjab,16,10,8,4,38,Pass
David Khan,29-01-2005,552493,Gujarat,15,12,16,5,48,Pass
Raj Pillai,19-04-2006,358419,Punjab,19,0,13,17,49,Pass
Raj Verma,18-04-2005,950384,Andhra Pradesh,7,17,21,10,55,Pass
Yash Fernandes,06-06-2005,921503,Uttar Pradesh,6,5,11,4,26,Pass
Raj Pillai,25-01-2005,707436,Andhra Pradesh,13,11,15,24,63,Pass
Aditya Fernandes,27-10-2005,243835,Delhi,13,22,11,6,52,Fail
Aarav Pillai,14-11-2004,105499,Madhya Pradesh,6,0,12,18,36,Pass
Raj Reddy,21-02-2005,489775,Gujarat,22,14,3,2,41,Pass
Rohan Singh,23-04-2005,853232,Uttar Pradesh,7,5,0,5,17,Pass
Manpreet Verma,13-04-2006,265759,Kerala,17,4,5,14,40,Pass
Aditya Sharma,26-05-2005,771808,Madhya Pradesh,1,24,21,4,50,Pass
Ishaan Sharma,13-12-2004,229444,Rajasthan,23,19,0,17,59,Pass
Vivaan Pillai,15-12-2004,837568,West Bengal,3,8,20,22,53,Pass
Harjeet Pillai,26-09-2005,561580,Odisha,5,6,23,6,40,Pass
Aryan Sharma,23-09-2005,622815,Kerala,8,8,11,15,42,Pass
Krishna Sharma,30-12-2004,493641,Karnataka,13,19,18,12,62,Pass
Raj Mehta,22-11-2004,691772,Bihar,7,19,19,12,57,Pass
Krishna Chopra,02-05-2006,930938,Telangana,18,18,11,10,57,Pass
Vivaan Verma,02-05-2005,826592,Bihar,23,5,16,23,67,Pass
Raj Verma,17-12-2004,823871,Maharashtra,4,4,17,18,43,Pass
Vivaan Pillai,07-03-2005,747430,Uttar Pradesh,13,5,9,22,49,Pass
Aditya Sharma,16-02-2006,973793,Punjab,0,5,16,1,22,Pass
Krishna Sharma,25-07-2005,985146,Uttar Pradesh,9,5,11,4,29,Pass
Ayaan Fernandes,16-11-2005,872454,Tamil Nadu,21,22,2,16,61,Pass
Kunal Sharma,28-07-2005,414228,Uttar Pradesh,15,5,15,15,50,Pass
Harjeet Sharma,15-03-2006,204349,Assam,9,21,1,7,38,Pass
Vivaan Mehta,11-06-2005,871481,Delhi,8,16,19,24,67,Fail
David Chopra,31-10-2005,975260,Rajasthan,24,0,8,0,32,Pass
Yash Chopra,20-04-2006,674880,Rajasthan,24,2,3,19,48,Pass
Sukhwinder Singh,09-03-2006,993543,Haryana,19,5,12,18,54,Pass
Rohan Khan,11-02-2006,747551,Rajasthan,10,10,18,14,52,Pass
Paul Sharma,10-12-2005,666812,Gujarat,12,8,2,7,29,Pass
Krishna Pillai,20-07-2005,830049,Bihar,11,23,20,6,60,Pass
Harjeet Pillai,13-12-2004,560799,Rajasthan,13,4,0,16,33,Pass
Raj Reddy,05-05-2006,170825,West Bengal,4,10,15,3,32,Pass
Aarav Chopra,06-03-2006,652804,Rajasthan,14,19,9,3,45,Pass
Yash D'Souza,12-02-2006,231648,Uttar Pradesh,16,5,12,1,34,Pass
Vivaan Reddy,08-02-2005,821385,Assam,5,7,2,1,15,Pass
Aarav Mehta,23-11-2004,172196,Karnataka,7,6,22,8,43,Pass
Vivaan Khan,07-10-2005,706261,Bihar,4,16,4,7,31,Pass
Rohan Chopra,16-11-2004,154975,Kerala,21,22,15,9,67,Pass
Vivaan Fernandes,24-02-2006,113736,Bihar,11,2,9,24,46,Pass
Raj D'Souza,18-05-2005,878249,Haryana,18,20,0,13,51,Pass
Sukhwinder Sharma,08-11-2005,564759,Delhi,2,19,20,19,60,Fail
Ayaan Verma,09-09-2005,729739,Karnataka,12,5,16,10,43,Pass
Rehan Verma,14-04-2006,361516,Maharashtra,18,4,16,7,45,Pass
Vivaan Reddy,16-10-2005,885922,West Bengal,24,3,17,4,48,Pass
Raj Reddy,16-01-2006,890252,Goa,1,7,4,9,21,Pass
Vivaan Reddy,22-06-2005,312023,Uttar Pradesh,23,5,16,9,53,Pass
Vivaan Chopra,01-02-2005,281524,Assam,7,22,12,7,48,Pass
Imran Chopra,17-02-2005,723598,Rajasthan,18,19,4,15,56,Pass
Sukhwinder Singh,28-02-2005,125071,Odisha,7,16,24,9,56,Pass
Paul Fernandes,10-07-2005,231895,Tamil Nadu,13,23,18,16,70,Pass
Raj Khan,07-05-2006,193126,Punjab,18,10,1,14,43,Pass
Aditya Fernandes,28-05-2005,253673,Himachal Pradesh,17,22,21,1,61,Pass
Vivaan Khan,21-12-2005,771343,Telangana,1,16,3,2,22,Pass
Vivaan D'Souza,30-08-2005,828853,Madhya Pradesh,7,5,7,9,28,Pass
Peter Khan,27-05-2005,151123,Telangana,15,23,3,21,62,Pass
Gurpreet Fernandes,13-04-2006,933043,Jharkhand,6,8,20,1,35,Pass
Krishna Khan,12-10-2005,344145,Andhra Pradesh,13,4,12,20,49,Pass
Rohan Khan,02-02-2006,145166,Bihar,3,18,20,1,42,Pass
Vivaan Verma,19-07-2005,418132,Bihar,9,15,16,17,57,Pass
Kunal Chopra,29-11-2004,339310,Uttarakhand,3,17,1,23,44,Pass
Paul Fernandes,25-10-2005,219236,Manipur,4,20,23,24,71,Pass
Aditya Reddy,25-04-2006,548349,Bihar,22,13,21,17,73,Pass
Raj Khan,26-05-2005,201392,Madhya Pradesh,16,16,2,13,47,Pass
Krishna Khan,30-10-2005,872961,Uttar Pradesh,1,5,12,4,22,Pass
Aditya Verma,17-04-2006,178156,Bihar,12,12,13,22,59,Pass
Ishaan Sharma,19-05-2005,229906,Andhra Pradesh,17,8,4,8,37,Pass
Raj Pillai,14-04-2006,352865,Uttar Pradesh,21,5,11,8,45,Pass
Yash D'Souza,27-04-2006,695822,Telangana,23,0,6,0,29,Pass
Rohan Sharma,03-04-2005,580142,Haryana,14,10,4,7,35,Pass
Paul Pillai,01-02-2005,879706,Jharkhand,18,1,9,10,38,Pass
John Fernandes,12-04-2005,394199,Punjab,13,12,3,21,49,Pass
Aditya Mehta,09-03-2005,673569,Gujarat,21,7,14,22,64,Pass
Aarav Sharma,27-10-2005,309482,Maharashtra,11,1,5,6,23,Pass
Manpreet D'Souza,26-02-2006,213790,Maharashtra,23,4,22,0,49,Pass
Raj D'Souza,23-06-2005,589982,Maharashtra,10,4,15,13,42,Pass
Aarav Pillai,05-07-2005,151923,Haryana,24,16,0,9,49,Pass
Krishna Singh,16-11-2004,926654,Gujarat,16,21,5,3,45,Pass
Mathew Sharma,28-03-2005,237098,Haryana,18,3,3,24,48,Pass
Vivaan Singh,08-07-2005,932564,Bihar,9,14,17,0,40,Pass
Kunal Fernandes,14-03-2005,363215,Uttarakhand,3,21,22,19,65,Pass
Sukhwinder Reddy,08-11-2004,419315,Uttarakhand,15,0,17,8,40,Pass
Kunal Khan,01-03-2006,468560,Maharashtra,17,4,20,5,46,Pass
Vivaan Verma,11-03-2006,615924,Uttar Pradesh,16,5,4,5,30,Pass
Krishna Verma,14-09-2005,653556,Andhra Pradesh,5,5,23,16,49,Pass
Paul Mehta,29-10-2005,891904,Uttar Pradesh,17,5,23,24,69,Pass
Rehan Fernandes,25-06-2005,160811,Chhattisgarh,15,0,19,3,37,Pass
Peter Verma,05-07-2005,991759,Kerala,4,14,18,23,59,Pass
Kunal Sharma,26-10-2005,581678,Punjab,1,24,3,13,41,Pass
Aditya Khan,14-04-2005,968135,Andhra Pradesh,14,13,18,16,61,Pass
Rohan Fernandes,26-07-2005,255279,Madhya Pradesh,19,18,0,7,44,Pass
Vivaan Pillai,04-05-2006,748558,Uttar Pradesh,21,5,24,2,52,Pass
Aditya Khan,30-08-2005,993071,Uttar Pradesh,16,5,11,5,37,Pass
Mathew Chopra,11-06-2005,682886,Uttar Pradesh,23,5,2,13,43,Pass
Aditya Sharma,01-03-2005,584961,Madhya Pradesh,18,13,8,6,45,Pass
Kunal Reddy,15-03-2005,958319,Madhya Pradesh,2,15,23,11,51,Pass
Raj Sharma,13-05-2005,478816,Assam,11,8,9,22,50,Pass
Aditya D'Souza,03-03-2006,723173,West Bengal,15,20,2,6,43,Pass
Sukhwinder Pillai,11-03-2006,263836,Chhattisgarh,7,11,18,1,37,Pass
Yash Reddy,06-04-2006,734353,Uttar Pradesh,17,5,8,4,34,Pass
Vivaan Khan,10-11-2005,613506,Uttar Pradesh,6,5,24,23,58,Pass
Rohan Pillai,22-11-2004,812388,Uttar Pradesh,6,5,24,6,41,Pass
Raj Mehta,23-04-2005,428417,Kerala,16,15,3,3,37,Pass
Mathew D'Souza,19-11-2004,230085,Odisha,23,19,9,16,67,Pass
Ishaan Khan,25-04-2006,648778,Rajasthan,18,19,17,5,59,Pass
Yash Singh,29-05-2005,371218,Rajasthan,0,5,21,8,34,Pass
Sukhwinder Khan,01-07-2005,201447,Telangana,8,24,20,5,57,Pass
Aarav Reddy,22-12-2005,702641,Bihar,9,21,23,6,59,Pass
Rohan Singh,15-10-2005,204291,Maharashtra,12,3,8,16,39,Pass
Rohan Pillai,21-10-2005,152580,Telangana,13,24,23,3,63,Pass
Harjeet Khan,15-11-2005,189879,Odisha,24,6,1,17,48,Pass
Rohan Sharma,18-01-2006,158064,Uttar Pradesh,11,5,4,21,41,Pass
Aarav Chopra,29-06-2005,687076,Gujarat,10,12,23,10,55,Pass
Imran D'Souza,07-04-2005,483298,Uttar Pradesh,16,5,19,20,60,Pass
Aarav Singh,24-01-2005,779507,Punjab,15,15,12,3,45,Pass
Aditya Sharma,06-08-2005,986809,Bihar,7,22,13,1,43,Pass
Ishaan D'Souza,06-08-2005,823782,Odisha,5,15,1,6,27,Pass
Aryan Khan,30-07-2005,796966,West Bengal,15,19,1,6,41,Pass
Vivaan Singh,11-06-2005,946633,Karnataka,6,14,6,8,34,Pass
Rohan Reddy,19-03-2005,763076,Delhi,16,18,4,11,49,Fail
Mathew Pillai,09-12-2005,433726,Gujarat,19,24,14,18,75,Pass
David Singh,31-05-2005,487057,Telangana,5,11,9,8,33,Pass
Krishna Mehta,01-06-2005,186211,Chhattisgarh,22,21,0,8,51,Pass
Zaid D'Souza,22-02-2006,810555,Madhya Pradesh,4,8,6,17,35,Pass
Kunal D'Souza,06-11-2005,379712,Kerala,10,5,12,9,36,Pass
Gurpreet D'Souza,29-11-2004,672910,Haryana,11,20,9,0,40,Pass
Peter Khan,08-09-2005,232579,Kerala,13,21,11,19,64,Pass
Gurpreet Pillai,17-04-2005,664687,Andhra Pradesh,10,20,10,16,56,Pass
Yash Sharma,05-05-2005,206180,West Bengal,5,24,2,12,43,Pass
Peter Reddy,20-04-2005,589051,Haryana,19,0,0,22,41,Pass
Harjeet Fernandes,21-02-2006,998955,Rajasthan,22,14,14,2,52,Pass
Ayaan Chopra,28-04-2005,220182,Uttar Pradesh,3,5,21,24,53,Pass
Aryan Mehta,14-09-2005,378686,Tamil Nadu,5,4,13,23,45,Pass
Manpreet Verma,17-01-2005,206078,Jharkhand,18,17,15,11,61,Pass
Ishaan Singh,15-02-2006,542074,Himachal Pradesh,6,15,14,14,49,Pass
Harjeet Pillai,21-04-2005,784692,Rajasthan,14,5,9,17,45,Pass
Ishaan Reddy,15-02-2006,486303,Madhya Pradesh,4,17,0,1,22,Pass
Kunal Mehta,05-02-2006,157063,Uttar Pradesh,10,5,1,20,36,Pass
Aarav Mehta,27-02-2005,971034,Maharashtra,22,2,5,8,37,Pass
Ishaan Pillai,03-12-2004,127554,Karnataka,12,4,11,9,36,Pass
Aryan Verma,01-11-2005,638359,Bihar,17,20,16,4,57,Pass
Sukhwinder Singh,30-11-2005,946475,Maharashtra,10,14,14,0,38,Pass
David Pillai,26-03-2006,191046,Madhya Pradesh,9,8,17,7,41,Pass
Aditya Singh,14-11-2005,916518,Delhi,16,18,21,21,76,Fail
Manpreet Fernandes,29-12-2005,830225,Odisha,21,17,1,15,54,Pass
Gurpreet Reddy,30-03-2006,998126,West Bengal,3,6,6,23,38,Pass
Ishaan Singh,30-07-2005,122565,Chhattisgarh,24,17,10,2,53,Pass
David Sharma,02-05-2006,117605,Punjab,5,18,20,6,49,Pass
Ishaan Sharma,03-05-2005,518252,West Bengal,3,18,23,23,67,Pass
Rohan D'Souza,17-01-2005,838912,Uttar Pradesh,17,5,0,13,35,Pass
Ishaan Pillai,23-12-2004,686394,Bihar,23,9,14,4,50,Pass
Rohan Verma,30-04-2005,282428,West Bengal,3,16,15,21,55,Pass
Manpreet Verma,21-02-2005,734035,Delhi,5,14,22,0,41,Fail
Krishna Pillai,11-04-2006,468499,Manipur,4,18,3,12,37,Pass
Kunal Verma,01-12-2004,790091,Assam,2,2,8,3,15,Pass
David Reddy,08-11-2005,563302,Uttar Pradesh,14,5,9,21,49,Pass
Peter Sharma,22-04-2006,967388,Rajasthan,22,19,4,17,62,Pass
Ishaan Chopra,24-02-2006,249453,Assam,1,18,0,11,30,Pass
Mathew Singh,21-12-2004,231724,Maharashtra,7,4,24,13,48,Pass
Harjeet Sharma,09-10-2005,611700,Meghalaya,6,2,1,22,31,Pass
Imran Reddy,01-02-2005,360861,Karnataka,20,7,16,21,64,Pass
Yash D'Souza,16-10-2005,738902,Bihar,1,23,11,12,47,Pass
Gurpreet Khan,22-03-2006,400966,Maharashtra,14,4,17,18,53,Pass
Kunal Mehta,28-05-2005,991411,Karnataka,16,3,23,21,63,Pass
Aarav Khan,05-12-2005,988492,Himachal Pradesh,8,10,19,21,58,Pass
Kunal Pillai,16-04-2005,606405,Assam,17,3,11,9,40,Pass
Raj Chopra,26-05-2005,485628,Kerala,21,22,11,1,55,Pass
Aryan Fernandes,15-12-2005,303180,West Bengal,3,19,19,14,55,Pass
Aarav Reddy,22-05-2005,810785,Tamil Nadu,5,4,2,9,20,Pass
Imran Singh,16-04-2005,201021,Andhra Pradesh,1,18,22,18,59,Pass
Farhan Chopra,26-07-2005,496084,Odisha,4,2,10,0,16,Pass
Gurpreet Verma,15-01-2006,209908,Delhi,5,3,3,1,12,Fail
Imran Chopra,03-02-2005,499810,Kerala,6,5,7,5,23,Pass
Ishaan Mehta,08-01-2006,432062,Bihar,17,15,18,5,55,Pass
Ishaan Reddy,24-08-2005,220864,Uttar Pradesh,24,5,7,15,51,Pass
Manpreet Fernandes,23-03-2005,219864,Haryana,21,20,18,7,66,Pass
Manpreet Mehta,28-09-2005,942757,Haryana,6,12,6,17,41,Pass
Balbir Sharma,20-06-2005,537250,Maharashtra,7,4,22,21,54,Pass
John Singh,31-10-2005,455766,Madhya Pradesh,18,11,9,14,52,Pass
Ishaan Singh,22-04-2005,689153,Tamil Nadu,9,14,19,1,43,Pass
Aditya Sharma,19-11-2004,843546,Maharashtra,9,2,15,10,36,Pass
Ishaan D'Souza,10-07-2005,917555,Kerala,7,19,3,2,31,Pass
Aryan Pillai,02-07-2005,743179,Jharkhand,23,10,17,13,63,Pass
Yash Singh,17-10-2005,213109,Tamil Nadu,13,6,20,21,60,Pass
Aarav Pillai,16-11-2005,770563,Madhya Pradesh,5,22,20,4,51,Pass
Aarav Singh,13-11-2004,387140,West Bengal,3,6,13,17,39,Pass
Yash Sharma,18-04-2006,405300,Bihar,8,13,22,5,48,Pass
Krishna Verma,24-12-2005,857066,Maharashtra,18,11,12,1,42,Pass
Ishaan Mehta,18-12-2004,981993,Telangana,1,18,7,15,41,Pass
Krishna Reddy,05-07-2005,275079,Jammu & Kashmir + Ladakh,1,21,11,8,41,Pass
Aditya Khan,27-01-2006,273180,Maharashtra,4,0,23,2,29,Pass
Ishaan Chopra,14-07-2005,400823,Rajasthan,9,24,1,11,45,Pass
Balbir Pillai,11-12-2005,281888,Uttar Pradesh,8,5,13,22,48,Pass
Aarav Mehta,22-12-2005,944102,Himachal Pradesh,3,13,11,11,38,Pass
Ishaan Khan,03-09-2005,274499,Goa,5,5,5,5,20,Pass
Yash Pillai,20-10-2005,472323,Andhra Pradesh,10,10,6,14,40,Pass
Kunal Mehta,08-01-2006,389846,Karnataka,19,0,24,13,56,Pass
Raj Pillai,16-03-2006,926316,Bihar,14,11,12,5,42,Pass
Aarav Chopra,14-01-2006,691264,Maharashtra,15,20,1,11,47,Pass
Yash Verma,05-02-2005,446997,Maharashtra,24,4,19,17,64,Pass
Balbir Sharma,13-05-2005,414020,Jammu & Kashmir + Ladakh,20,22,4,13,59,Pass
Aryan Khan,09-11-2004,531439,Chhattisgarh,16,2,16,2,36,Pass
Aditya D'Souza,01-08-2005,674979,Tamil Nadu,1,5,1,14,21,Pass
Ishaan D'Souza,11-10-2005,809900,Bihar,0,6,5,10,21,Pass
Manpreet Fernandes,22-11-2004,152438,Haryana,14,23,5,17,59,Pass
Gurpreet Verma,08-03-2006,260967,Tamil Nadu,8,4,17,22,51,Pass
Krishna Khan,26-01-2006,126256,Andhra Pradesh,21,5,24,6,56,Pass
Sukhwinder Singh,20-04-2005,674829,Meghalaya,11,5,16,5,37,Pass
Balbir Reddy,25-03-2006,304363,Bihar,3,12,14,16,45,Pass
Vivaan Mehta,18-07-2005,952418,Odisha,19,11,14,6,50,Pass
Yash Pillai,13-12-2004,191929,Uttar Pradesh,15,5,12,4,36,Pass
Aryan Sharma,29-11-2004,500673,Madhya Pradesh,18,24,16,4,62,Pass
Ishaan Khan,20-01-2006,348000,Jharkhand,5,1,9,20,35,Pass
Aditya Fernandes,21-05-2005,993198,Bihar,11,18,18,8,55,Pass
Aditya Sharma,20-07-2005,432680,Uttar Pradesh,10,5,0,22,37,Pass
Ishaan Reddy,19-04-2005,532562,West Bengal,7,13,2,17,39,Pass
Aarav Khan,22-05-2005,116885,Tamil Nadu,4,21,3,9,37,Pass
Yash Pillai,24-12-2005,984169,Rajasthan,10,2,3,3,18,Pass
Krishna Reddy,16-04-2005,532816,Uttar Pradesh,18,5,6,18,47,Pass
Aditya Pillai,19-11-2004,274796,Maharashtra,7,0,9,8,24,Pass
Ishaan Verma,30-09-2005,459773,Rajasthan,20,11,7,10,48,Pass
Aryan Khan,01-03-2005,394389,Maharashtra,17,4,14,23,58,Pass
Paul D'Souza,03-02-2005,509321,Bihar,11,16,18,0,45,Pass
Vivaan Chopra,05-05-2005,200634,Bihar,16,23,14,6,59,Pass
Ishaan Mehta,16-08-2005,409475,West Bengal,3,22,12,7,44,Pass
Gurpreet D'Souza,11-01-2005,549170,Rajasthan,4,8,1,23,36,Pass
Vivaan Khan,07-05-2006,136393,Rajasthan,2,10,16,6,34,Pass
Krishna D'Souza,14-11-2004,428619,Bihar,2,0,3,5,10,Pass
Aarav Mehta,17-03-2006,837589,Uttarakhand,3,20,20,0,43,Pass
Farhan Chopra,12-03-2005,982604,Punjab,9,22,24,0,55,Pass
Aditya Pillai,02-02-2005,181668,Maharashtra,13,4,13,19,49,Pass
Mathew Chopra,20-05-2005,939386,Uttar Pradesh,1,5,20,21,47,Pass
Krishna Singh,15-05-2005,555682,Andhra Pradesh,17,18,22,6,63,Pass
Vivaan Fernandes,28-04-2005,916558,Rajasthan,0,2,2,1,5,Pass
Vivaan Pillai,30-12-2005,741751,Maharashtra,7,4,18,20,49,Pass
Raj Verma,01-01-2006,148802,Madhya Pradesh,16,23,1,13,53,Pass
Raj D'Souza,15-05-2005,102249,West Bengal,3,22,21,10,56,Pass
Gurpreet Pillai,10-06-2005,763191,Rajasthan,16,2,24,9,51,Pass
Rohan Khan,12-12-2004,354277,Haryana,0,2,18,9,29,Pass
Paul Singh,17-10-2005,530869,Gujarat,2,16,14,15,47,Pass
Krishna D'Souza,12-07-2005,882792,Odisha,0,10,18,24,52,Pass
Krishna Mehta,01-11-2005,877407,Maharashtra,22,4,16,11,53,Pass
Aarav Singh,07-12-2004,817856,Jharkhand,8,23,7,5,43,Pass
David Sharma,25-08-2005,998231,Karnataka,8,7,2,20,37,Pass
Paul Reddy,26-08-2005,350024,West Bengal,3,11,1,24,39,Pass
Yash Reddy,02-02-2006,195241,Punjab,17,10,6,14,47,Pass
Krishna Mehta,20-04-2006,776863,Uttar Pradesh,16,5,6,7,34,Pass
Yash Singh,22-04-2006,552163,Jharkhand,6,5,6,6,23,Pass
John Reddy,06-12-2005,710992,Karnataka,21,23,11,6,61,Pass
Manpreet Pillai,03-09-2005,363606,Punjab,11,0,2,24,37,Pass
Rohan D'Souza,07-03-2005,988606,Rajasthan,1,6,10,5,22,Pass
Balbir Sharma,15-01-2005,839405,Himachal Pradesh,5,19,11,11,46,Pass
Aarav Pillai,13-02-2005,822097,Bihar,16,13,12,6,47,Pass
Aarav Khan,26-01-2006,595141,Tamil Nadu,21,14,4,12,51,Pass
Aarav Fernandes,06-03-2006,162645,Punjab,22,15,17,22,76,Pass
Krishna Singh,28-04-2006,847800,Telangana,11,16,14,4,45,Pass
Sukhwinder Reddy,01-06-2005,526778,Kerala,6,2,24,4,36,Pass
Rohan Verma,08-11-2004,782125,Uttar Pradesh,24,5,0,22,51,Pass
Krishna Verma,08-08-2005,896146,Bihar,16,15,11,4,46,Pass
Rohan D'Souza,18-12-2005,191662,West Bengal,8,1,14,5,28,Pass
John Fernandes,27-02-2006,112154,Delhi,17,11,13,22,63,Fail
Mathew Pillai,16-03-2006,827716,Himachal Pradesh,20,21,7,13,61,Pass
Raj D'Souza,30-11-2004,473068,West Bengal,19,14,6,14,53,Pass
Yash Khan,08-03-2006,289635,Madhya Pradesh,8,1,13,18,40,Pass
Yash D'Souza,01-04-2006,803686,Uttarakhand,3,15,8,2,28,Pass
Manpreet Mehta,26-11-2004,681647,Himachal Pradesh,8,13,5,10,36,Pass
Sukhwinder Pillai,15-03-2006,222318,Rajasthan,24,16,3,3,46,Pass
Balbir Mehta,02-02-2006,365166,Karnataka,24,11,2,10,47,Pass
Aryan Chopra,31-10-2005,388495,Gujarat,10,21,24,22,77,Pass
Gurpreet Sharma,26-11-2005,900481,Telangana,16,12,4,19,51,Pass
Farhan Verma,23-12-2004,417944,Tamil Nadu,18,20,23,17,78,Pass
Manpreet Mehta,24-04-2006,716308,Bihar,2,21,14,19,56,Pass
Rohan Sharma,23-02-2005,536221,Bihar,6,21,0,20,47,Pass
Krishna Sharma,28-01-2005,430747,Andhra Pradesh,0,5,10,12,27,Pass
Vivaan D'Souza,28-10-2005,384338,Punjab,9,23,20,4,56,Pass
Vivaan Fernandes,16-06-2005,810666,Assam,23,14,1,19,57,Pass
Aarav Khan,01-01-2006,271571,Andhra Pradesh,18,12,10,2,42,Pass
Ishaan Mehta,02-12-2004,365582,Maharashtra,0,4,20,13,37,Pass
Rohan Reddy,10-03-2006,341042,Uttar Pradesh,3,5,16,16,40,Pass
Yash Reddy,29-12-2004,772221,Rajasthan,3,23,16,1,43,Pass
Raj Reddy,01-12-2004,694573,Gujarat,13,22,23,14,72,Pass
Aditya Khan,08-05-2006,300814,Rajasthan,7,8,4,21,40,Pass
Rohan D'Souza,25-12-2005,987653,Bihar,22,5,8,3,38,Pass
Vivaan Mehta,11-04-2005,617128,Karnataka,6,23,8,1,38,Pass
Raj Pillai,25-12-2005,884997,Punjab,12,3,11,20,46,Pass
Gurpreet Fernandes,23-12-2005,826547,Gujarat,11,23,12,22,68,Pass
Rohan D'Souza,28-11-2005,592220,Chhattisgarh,9,1,3,21,34,Pass
Paul Verma,08-09-2005,358712,Madhya Pradesh,20,22,4,2,48,Pass
Ishaan Reddy,02-01-2006,235077,Himachal Pradesh,0,24,11,19,54,Pass
Gurpreet Verma,19-11-2004,259043,Uttar Pradesh,23,5,20,0,48,Pass
Aditya Singh,18-02-2006,289935,Punjab,14,18,3,12,47,Pass
Paul Mehta,21-08-2005,272018,Bihar,17,11,2,13,43,Pass
Sukhwinder Reddy,03-05-2006,850437,Delhi,6,6,15,20,47,Fail
Harjeet Khan,27-12-2005,143003,Telangana,13,20,0,15,48,Pass
Mathew Pillai,21-01-2006,146642,Uttar Pradesh,0,5,19,23,47,Pass
Aditya Reddy,11-05-2005,651222,Assam,3,24,22,4,53,Pass
Balbir Sharma,24-11-2004,431054,Andhra Pradesh,0,22,0,10,32,Pass
Krishna Pillai,01-01-2006,950553,Haryana,8,8,10,3,29,Pass
Krishna Mehta,19-12-2004,789138,Rajasthan,4,4,16,15,39,Pass
Yash Fernandes,29-12-2005,386066,Arunachal Pradesh,2,21,15,11,49,Pass
Farhan Fernandes,29-03-2005,966671,West Bengal,5,18,9,21,53,Pass
Harjeet Khan,21-03-2005,917384,Telangana,24,20,3,10,57,Pass
Rohan Fernandes,13-11-2004,116208,Haryana,22,13,5,17,57,Pass
Imran Singh,08-03-2006,598949,Punjab,4,1,21,14,40,Pass
Manpreet D'Souza,31-01-2006,392470,Rajasthan,3,10,7,14,34,Pass
Krishna Singh,07-04-2006,975557,Bihar,8,17,20,24,69,Pass
Harjeet Mehta,23-11-2005,367864,Jharkhand,8,18,19,7,52,Pass
Rohan Chopra,16-06-2005,759321,Haryana,18,4,20,17,59,Pass
Kunal Verma,05-12-2004,109505,West Bengal,3,18,23,6,50,Pass
Kunal Reddy,29-10-2005,466027,Kerala,19,20,5,22,66,Pass
Harjeet Mehta,02-08-2005,861143,Madhya Pradesh,0,11,22,18,51,Pass
Krishna Fernandes,25-08-2005,853088,Bihar,18,24,17,19,78,Pass
Ishaan Sharma,10-07-2005,608957,West Bengal,17,3,5,4,29,Pass
Aarav Fernandes,23-11-2005,130121,Karnataka,20,17,7,15,59,Pass
Manpreet Khan,26-05-2005,316224,Andhra Pradesh,1,4,18,18,41,Pass
Kunal D'Souza,30-01-2005,928563,Telangana,1,19,7,1,28,Pass
Kunal Mehta,05-01-2006,249942,Bihar,11,3,13,18,45,Pass
Harjeet Chopra,30-01-2005,421146,Tamil Nadu,15,7,11,23,56,Pass
Balbir Mehta,17-08-2005,652924,Rajasthan,6,4,3,15,28,Pass
Kunal Sharma,24-03-2005,943039,Assam,1,5,17,3,26,Pass
Ishaan Fernandes,08-02-2005,119275,Gujarat,6,21,2,21,50,Pass
David Chopra,20-11-2004,705054,Chhattisgarh,11,0,8,5,24,Pass
Gurpreet Pillai,19-08-2005,246354,Rajasthan,23,15,12,24,74,Pass
Rohan Verma,08-12-2005,955881,Tripura,19,2,22,2,45,Pass
Balbir Chopra,25-08-2005,524914,Himachal Pradesh,3,18,12,14,47,Pass
David Verma,03-01-2006,647818,Bihar,6,17,1,5,29,Pass
Kunal Verma,10-09-2005,691034,Rajasthan,11,3,6,15,35,Pass
Aarav Reddy,20-02-2005,889433,Meghalaya,5,6,11,8,30,Pass
Farhan Khan,14-03-2005,156292,Madhya Pradesh,11,8,6,22,47,Pass
Raj Khan,25-06-2005,285514,Uttar Pradesh,5,5,8,7,25,Pass
Rohan Fernandes,05-05-2006,265991,Uttar Pradesh,3,5,11,23,42,Pass
David Fernandes,21-06-2005,788885,Sikkim,6,17,6,5,34,Pass
Gurpreet Verma,23-11-2005,423515,Rajasthan,4,4,8,21,37,Pass
Ishaan Mehta,29-11-2005,525327,Jammu & Kashmir + Ladakh,17,0,24,24,65,Pass
Farhan Chopra,15-06-2005,865495,Maharashtra,21,4,24,9,58,Pass
Raj Reddy,18-10-2005,612872,Madhya Pradesh,17,0,24,10,51,Pass
Yash Verma,12-04-2006,734198,Gujarat,22,19,21,23,85,Pass
Balbir Pillai,16-08-2005,255629,Madhya Pradesh,6,2,0,18,26,Pass
Aditya Pillai,18-09-2005,871292,Uttar Pradesh,3,5,15,22,45,Pass
Rohan Khan,24-04-2005,528932,Haryana,0,4,24,4,32,Pass
Aarav Pillai,15-12-2005,348893,Punjab,11,19,15,14,59,Pass
Raj Verma,02-10-2005,694552,Punjab,24,10,8,1,43,Pass
Yash Singh,09-03-2005,491420,Telangana,3,1,22,8,34,Pass
Ishaan Sharma,15-11-2004,769474,Punjab,2,23,1,1,27,Pass
Krishna Reddy,10-10-2005,287765,West Bengal,3,19,18,17,57,Pass
Manpreet Khan,11-11-2004,238714,Maharashtra,2,5,6,22,35,Pass
Harjeet Khan,06-04-2005,883969,West Bengal,3,20,19,9,51,Pass
Harjeet Chopra,13-02-2005,326480,West Bengal,6,19,8,17,50,Pass
Harjeet Pillai,09-02-2006,118648,Tamil Nadu,11,3,24,3,41,Pass
Krishna D'Souza,08-04-2006,808945,Rajasthan,13,19,12,15,59,Pass
Krishna Verma,31-03-2006,845550,Telangana,1,23,18,5,47,Pass
Rohan Mehta,10-03-2006,846217,Andhra Pradesh,0,20,16,9,45,Pass
Aryan Singh,11-11-2005,386067,Kerala,18,17,7,13,55,Pass
David Fernandes,12-01-2005,799815,West Bengal,18,11,19,1,49,Pass
Yash Chopra,11-03-2005,342940,Haryana,3,23,23,8,57,Pass
Vivaan Pillai,29-12-2005,133498,Jharkhand,13,12,11,4,40,Pass
Kunal Sharma,20-12-2004,385975,Manipur,9,12,10,2,33,Pass
Krishna Verma,14-03-2005,955278,Bihar,12,17,12,12,53,Pass
Gurpreet Fernandes,04-02-2005,302180,West Bengal,3,3,10,3,19,Pass
Ayaan Mehta,26-01-2005,970379,West Bengal,3,22,21,24,70,Pass
Sukhwinder Pillai,15-07-2005,158320,Karnataka,17,11,6,4,38,Pass
Imran Fernandes,01-07-2005,296792,Haryana,20,21,22,16,79,Pass
Aditya D'Souza,31-05-2005,388611,West Bengal,0,17,24,6,47,Pass
Imran Mehta,27-04-2005,895588,Haryana,21,17,8,23,69,Pass
Vivaan Fernandes,25-07-2005,610026,Assam,5,5,16,22,48,Pass
Harjeet Verma,15-03-2005,707017,Telangana,1,3,21,2,27,Pass
Vivaan Fernandes,22-06-2005,620929,Uttarakhand,6,10,15,7,38,Pass
Raj Chopra,18-03-2006,517204,Uttarakhand,3,14,19,3,39,Pass
Aryan Sharma,19-05-2005,691581,Assam,10,1,23,13,47,Pass
Manpreet Singh,06-06-2005,740760,Rajasthan,0,1,4,7,12,Pass
Ishaan Verma,14-07-2005,434164,Uttarakhand,10,4,11,22,47,Pass
Raj Chopra,25-12-2004,142606,Madhya Pradesh,11,6,19,8,44,Pass
Vivaan Chopra,31-08-2005,289602,Andhra Pradesh,15,14,8,4,41,Pass
Raj D'Souza,01-12-2004,253445,Rajasthan,13,8,15,17,53,Pass
Balbir Mehta,20-07-2005,636281,Bihar,1,14,10,6,31,Pass
Ishaan Verma,01-11-2005,789397,Andhra Pradesh,11,15,10,20,56,Pass
Aditya Reddy,18-02-2005,987140,Uttar Pradesh,1,5,19,16,41,Pass
Aryan Mehta,24-10-2005,240808,Uttar Pradesh,24,5,13,5,47,Pass
Aryan D'Souza,27-09-2005,350432,Jharkhand,3,5,11,19,38,Pass
Gurpreet Khan,22-06-2005,740455,Bihar,12,14,10,0,36,Pass
Yash Pillai,10-03-2005,864307,Tamil Nadu,13,14,9,18,54,Pass
Peter Mehta,14-08-2005,698426,Odisha,3,0,7,20,30,Pass
Paul Singh,11-09-2005,861890,Bihar,24,10,3,11,48,Pass
Vivaan Reddy,25-11-2005,402777,Haryana,9,8,16,15,48,Pass
Harjeet Pillai,03-09-2005,118172,Kerala,15,23,21,5,64,Pass
Balbir D'Souza,12-04-2005,507296,Gujarat,9,20,7,23,59,Pass
Rohan Mehta,23-12-2004,185029,Gujarat,21,24,24,22,91,Pass
Aryan Mehta,09-11-2005,642677,Rajasthan,21,15,13,11,60,Pass
Aryan Fernandes,24-04-2005,262266,Haryana,0,0,1,23,24,Pass
Mathew Mehta,16-04-2005,613917,Telangana,3,15,20,16,54,Pass
Rohan Verma,23-06-2005,433790,Odisha,8,21,21,6,56,Pass
Aryan D'Souza,23-10-2005,960888,Gujarat,24,2,15,12,53,Pass
Harjeet Verma,22-09-2005,875813,Maharashtra,9,7,10,7,33,Pass
Gurpreet Fernandes,27-04-2005,404748,Uttar Pradesh,10,5,8,20,43,Pass
Zaid Sharma,15-09-2005,589893,Maharashtra,10,0,5,9,24,Pass
Vivaan D'Souza,05-07-2005,610177,Maharashtra,19,4,13,8,44,Pass
Harjeet D'Souza,21-09-2005,315252,Haryana,22,3,12,14,51,Pass
Balbir D'Souza,16-02-2005,330767,Gujarat,22,1,2,13,38,Pass
Ishaan Mehta,02-05-2006,166398,Gujarat,11,3,20,2,36,Pass
Kunal Reddy,25-06-2005,761622,Tamil Nadu,24,1,17,18,60,Pass
Yash Singh,16-05-2005,686745,Himachal Pradesh,24,8,13,9,54,Pass
Vivaan Sharma,16-12-2004,208149,Gujarat,21,8,24,10,63,Pass
Vivaan Reddy,24-09-2005,827834,Andhra Pradesh,11,15,1,6,33,Pass
Aditya Verma,13-04-2006,209955,Madhya Pradesh,13,23,23,4,63,Pass
Yash D'Souza,02-11-2005,854713,Uttar Pradesh,12,5,9,17,43,Pass
Yash Chopra,30-07-2005,433554,Uttarakhand,2,4,18,4,28,Pass
Sukhwinder D'Souza,27-05-2005,332613,Haryana,21,3,2,13,39,Pass
Kunal Khan,03-12-2004,358190,Punjab,3,3,13,22,41,Pass
Ishaan Mehta,17-12-2004,737219,Tamil Nadu,2,15,24,2,43,Pass
Krishna Chopra,03-09-2005,624582,Punjab,8,17,7,24,56,Pass
Sukhwinder Fernandes,13-10-2005,360855,Odisha,12,2,4,5,23,Pass
Paul Chopra,16-10-2005,164345,Chhattisgarh,19,22,15,2,58,Pass
Vivaan Verma,21-11-2005,477650,Tamil Nadu,11,6,4,23,44,Pass
Paul Sharma,21-11-2005,923620,Andhra Pradesh,24,13,0,21,58,Pass
Mathew Sharma,07-03-2006,679763,Rajasthan,20,13,19,19,71,Pass
Rohan Sharma,18-11-2004,974854,Bihar,0,7,7,12,26,Pass
Ishaan Mehta,23-11-2005,969238,Maharashtra,8,13,0,5,26,Pass
Aarav Singh,18-06-2005,570270,Telangana,11,12,7,21,51,Pass
Aarav Pillai,31-10-2005,731801,Delhi,15,12,17,1,45,Fail
Paul Sharma,09-07-2005,106368,Delhi,24,14,19,17,74,Fail
Kunal Pillai,14-11-2005,641349,Chhattisgarh,3,1,16,5,25,Pass
Yash Fernandes,02-12-2004,265728,Bihar,15,5,1,7,28,Pass
Aarav Singh,24-09-2005,729920,Bihar,22,21,3,11,57,Pass
Rohan Mehta,14-03-2005,170874,Madhya Pradesh,18,13,7,12,50,Pass
Raj D'Souza,11-01-2006,807311,Bihar,7,0,23,12,42,Pass
Ishaan Khan,24-04-2006,448801,Manipur,4,20,24,1,49,Pass
Yash Pillai,19-11-2005,820439,Jammu & Kashmir + Ladakh,15,19,22,10,66,Pass
Rehan D'Souza,09-01-2006,708655,Bihar,15,7,3,17,42,Pass
Harjeet Singh,10-12-2005,249538,Rajasthan,5,4,16,17,42,Pass
John Fernandes,07-01-2006,747585,Uttarakhand,11,8,18,5,42,Pass
Rohan D'Souza,19-06-2005,549610,Gujarat,16,18,12,0,46,Pass
Rehan Khan,25-10-2005,801648,Madhya Pradesh,11,21,4,14,50,Pass
Mathew Sharma,19-04-2006,980951,Bihar,18,23,7,5,53,Pass
Raj Fernandes,18-12-2004,189560,Maharashtra,3,21,7,10,41,Pass
John Verma,23-01-2006,909275,Andhra Pradesh,8,14,5,11,38,Pass
Aryan Fernandes,08-05-2005,696404,Jammu & Kashmir + Ladakh,12,4,24,8,48,Pass
Rohan Fernandes,05-01-2005,605181,Delhi,13,24,12,13,62,Fail
Peter Reddy,15-05-2005,170682,Bihar,22,18,4,8,52,Pass
Yash Mehta,16-09-2005,562693,Tamil Nadu,22,11,17,16,66,Pass
David Singh,30-03-2006,666635,Madhya Pradesh,0,22,6,0,28,Pass
Harjeet Reddy,26-02-2005,436199,Jharkhand,18,22,19,0,59,Pass
Paul Mehta,04-06-2005,303321,Gujarat,6,0,21,4,31,Pass
Yash Pillai,12-11-2004,271504,Odisha,12,11,2,5,30,Pass
Yash Khan,17-04-2005,272755,Tamil Nadu,4,17,2,10,33,Pass
Ishaan Singh,19-04-2006,547810,Jammu & Kashmir + Ladakh,12,5,13,11,41,Pass
Yash Mehta,28-02-2006,954278,Kerala,11,11,10,22,54,Pass
John D'Souza,28-03-2005,639242,Odisha,12,22,14,22,70,Pass
Paul Reddy,29-11-2004,616134,Haryana,4,2,23,23,52,Pass
Raj Sharma,21-09-2005,297257,Jharkhand,19,9,1,7,36,Pass
Aryan Mehta,02-04-2005,480197,Uttar Pradesh,8,5,8,19,40,Pass
Raj Khan,20-03-2006,313899,Madhya Pradesh,3,24,9,13,49,Pass
Sukhwinder Sharma,09-07-2005,102869,West Bengal,3,18,23,4,48,Pass
Raj D'Souza,08-04-2006,299004,Madhya Pradesh,7,8,14,7,36,Pass
Aditya Mehta,24-11-2004,793712,Madhya Pradesh,5,9,7,13,34,Pass
Aarav Mehta,07-07-2005,915377,Bihar,11,22,3,18,54,Pass
Aarav Pillai,25-08-2005,903403,Rajasthan,24,14,8,16,62,Pass
Krishna Singh,08-03-2006,538886,Haryana,17,6,24,4,51,Pass
Raj Fernandes,20-05-2005,807116,Punjab,11,14,20,0,45,Pass
Aryan Pillai,14-04-2005,982979,Himachal Pradesh,1,21,9,13,44,Pass
Gurpreet Khan,23-06-2005,836809,Bihar,21,3,1,17,42,Pass
David Pillai,18-02-2006,694588,Kerala,12,1,19,12,44,Pass
Raj Sharma,05-08-2005,309732,Andhra Pradesh,11,22,10,20,63,Pass
Aditya Khan,11-06-2005,530085,Karnataka,16,13,24,4,57,Pass
Manpreet Fernandes,23-12-2004,899692,Delhi,21,18,8,24,71,Fail
Sukhwinder Verma,23-08-2005,578342,Bihar,10,24,19,10,63,Pass
Vivaan Reddy,31-01-2006,348071,Rajasthan,4,1,14,12,31,Pass
Yash Reddy,19-04-2006,347906,Kerala,11,10,0,18,39,Pass
Kunal Singh,25-01-2005,587325,Maharashtra,5,13,1,15,34,Pass
Yash Sharma,25-09-2005,308709,Haryana,11,9,9,7,36,Pass
Gurpreet Khan,21-08-2005,380502,Andhra Pradesh,7,7,2,8,24,Pass
Aditya Mehta,23-07-2005,708471,Tamil Nadu,1,18,8,7,34,Pass
Aarav D'Souza,17-09-2005,230389,Uttar Pradesh,18,5,13,16,52,Pass
Ishaan Chopra,16-02-2006,260510,West Bengal,3,16,23,13,55,Pass
Ishaan Singh,04-12-2005,440475,Kerala,10,4,2,22,38,Pass
Aryan Mehta,01-10-2005,342484,Kerala,9,18,18,20,65,Pass
Aarav Reddy,16-07-2005,502562,Punjab,1,11,19,8,39,Pass
Balbir Sharma,16-03-2006,794321,Punjab,24,8,11,15,58,Pass
Kunal Khan,27-01-2006,155366,Bihar,6,18,13,17,54,Pass
Yash Sharma,28-10-2005,211914,West Bengal,1,13,21,10,45,Pass
Ishaan Sharma,03-04-2006,746640,Rajasthan,12,21,1,13,47,Pass
Aryan Sharma,06-05-2006,384912,Punjab,11,13,22,9,55,Pass
Vivaan Singh,02-10-2005,396290,Tamil Nadu,1,7,15,20,43,Pass
Krishna Pillai,08-12-2004,394701,Punjab,8,11,6,21,46,Pass
Gurpreet Chopra,22-11-2004,168542,Jharkhand,10,11,13,6,40,Pass
Aryan Verma,26-03-2006,162784,Maharashtra,17,4,19,21,61,Pass
Aditya Reddy,04-05-2005,870561,Madhya Pradesh,8,9,16,6,39,Pass
John Reddy,20-01-2005,801876,Tamil Nadu,21,23,23,13,80,Pass
Manpreet Reddy,24-05-2005,445677,Jammu & Kashmir + Ladakh,22,9,9,9,49,Pass
Manpreet Singh,14-03-2006,540849,Karnataka,20,12,3,3,38,Pass
Yash Khan,15-06-2005,830408,Madhya Pradesh,13,9,4,0,26,Pass
Raj Fernandes,17-03-2006,796076,Odisha,10,0,8,15,33,Pass
Vivaan Pillai,12-12-2005,996740,Madhya Pradesh,8,5,2,1,16,Pass
Manpreet Pillai,12-12-2005,993068,Maharashtra,5,12,11,9,37,Pass
Aarav Chopra,27-11-2005,689094,Jammu & Kashmir + Ladakh,21,2,19,17,59,Pass
Yash Khan,12-01-2006,770182,Telangana,8,11,20,23,62,Pass
David Mehta,27-01-2005,645642,Maharashtra,7,15,9,8,39,Pass
Vivaan Khan,13-11-2004,726776,Delhi,4,15,4,0,23,Fail
Harjeet Fernandes,02-11-2005,511281,Tamil Nadu,2,22,6,5,35,Pass
Vivaan D'Souza,10-01-2006,467436,Uttar Pradesh,20,5,2,20,47,Pass
Sukhwinder Reddy,05-07-2005,352325,Rajasthan,23,1,19,14,57,Pass
Rohan D'Souza,16-03-2006,666291,Assam,8,3,3,21,35,Pass
Raj Pillai,06-01-2005,120990,Haryana,15,20,23,13,71,Pass
Mathew Mehta,19-02-2006,673203,Telangana,0,6,2,4,12,Pass
Krishna Reddy,27-11-2005,258849,Meghalaya,12,18,18,8,56,Pass
Vivaan Sharma,13-02-2006,527429,Punjab,13,2,20,14,49,Pass
Krishna Fernandes,21-02-2006,387595,Haryana,16,20,10,10,56,Pass
Aarav D'Souza,28-11-2004,776757,West Bengal,2,7,8,7,24,Pass
Vivaan Reddy,08-06-2005,742040,Bihar,7,8,5,12,32,Pass
Manpreet Singh,14-12-2004,595690,Bihar,9,21,24,15,69,Pass
Aryan Pillai,11-10-2005,534232,Uttar Pradesh,6,5,13,24,48,Pass
Raj Verma,08-01-2006,523481,Madhya Pradesh,3,0,8,21,32,Pass
Aditya D'Souza,28-01-2005,588658,West Bengal,3,2,8,22,35,Pass
Peter Pillai,27-05-2005,375819,Haryana,24,3,14,19,60,Pass
Yash Pillai,04-07-2005,717529,Andhra Pradesh,12,4,13,5,34,Pass
Aditya Fernandes,08-07-2005,561792,West Bengal,1,3,11,4,19,Pass
Ishaan Chopra,12-06-2005,553259,Uttar Pradesh,10,5,5,6,26,Pass
Raj Mehta,07-08-2005,951444,Haryana,10,3,8,17,38,Pass
Aditya Mehta,08-06-2005,780222,Maharashtra,1,4,16,15,36,Pass
Aarav D'Souza,28-11-2004,827267,Punjab,20,8,0,7,35,Pass
Yash Fernandes,14-02-2005,306025,Odisha,22,17,24,15,78,Pass
Ishaan Sharma,21-11-2005,976197,Madhya Pradesh,6,6,5,22,39,Pass
Paul D'Souza,14-12-2004,489597,Odisha,5,11,14,6,36,Pass
Kunal D'Souza,18-03-2005,193885,Bihar,0,9,19,13,41,Pass
Rohan Sharma,26-01-2005,726079,Punjab,3,21,22,19,65,Pass
Ayaan Fernandes,06-03-2006,600368,Bihar,13,22,16,2,53,Pass
Manpreet Sharma,13-05-2005,535029,Uttar Pradesh,8,5,13,11,37,Pass
Aarav Mehta,09-07-2005,115482,Manipur,6,16,18,5,45,Pass
Gurpreet Singh,05-04-2006,591306,Haryana,14,7,5,7,33,Pass
Krishna Reddy,09-11-2005,600536,Uttar Pradesh,10,5,23,19,57,Pass
Ishaan Chopra,12-04-2006,882732,Kerala,2,21,4,19,46,Pass
Aryan Fernandes,02-08-2005,330635,Rajasthan,23,8,4,19,54,Pass
Rohan Chopra,10-02-2005,683104,Jharkhand,12,3,8,2,25,Pass
David Khan,25-03-2006,387624,Telangana,21,8,19,20,68,Pass
Aarav Reddy,04-08-2005,503460,Uttar Pradesh,15,5,7,0,27,Pass
Raj Sharma,04-12-2004,909520,Andhra Pradesh,16,19,9,7,51,Pass
Aditya Sharma,07-12-2004,903760,Uttar Pradesh,7,5,9,21,42,Pass
Raj Reddy,09-03-2005,259782,Himachal Pradesh,5,14,9,18,46,Pass
Balbir D'Souza,11-05-2005,662906,Jharkhand,21,14,1,7,43,Pass
Yash Fernandes,06-06-2005,992167,Haryana,6,16,18,22,62,Pass
Zaid Singh,21-03-2006,587432,Madhya Pradesh,3,21,20,4,48,Pass
Ishaan Chopra,12-12-2004,574404,Uttarakhand,10,7,4,9,30,Pass
Rohan Pillai,23-05-2005,698902,Telangana,18,20,14,2,54,Pass
Gurpreet Mehta,21-07-2005,473207,Uttar Pradesh,2,5,3,6,16,Pass
Krishna Mehta,29-05-2005,867599,Bihar,10,18,12,8,48,Pass
Yash Chopra,14-09-2005,338252,Madhya Pradesh,21,8,23,4,56,Pass
Zaid Chopra,02-08-2005,650513,Jharkhand,16,8,4,18,46,Pass
Paul Khan,19-12-2005,495149,Gujarat,11,17,12,0,40,Pass
Aryan Verma,01-05-2005,510167,Punjab,18,16,14,7,55,Pass
Aryan Verma,08-03-2006,828152,Madhya Pradesh,9,20,18,4,51,Pass
Ishaan Fernandes,28-12-2004,355450,Gujarat,10,15,11,5,41,Pass
Yash Khan,12-12-2005,376210,Uttar Pradesh,10,5,4,11,30,Pass
Sukhwinder Chopra,06-07-2005,470523,Andhra Pradesh,12,2,24,17,55,Pass
Aditya Mehta,06-02-2005,196678,Madhya Pradesh,22,15,11,2,50,Pass
Vivaan Pillai,02-06-2005,965597,Telangana,20,18,14,8,60,Pass
Raj Mehta,20-12-2005,163435,Jammu & Kashmir + Ladakh,20,20,5,6,51,Pass
Aryan Reddy,01-04-2006,944806,Haryana,2,11,22,14,49,Pass
Yash Sharma,13-03-2005,670553,Uttar Pradesh,17,5,22,13,57,Pass
Krishna Singh,04-03-2006,885733,Haryana,20,15,19,13,67,Pass
Aditya Fernandes,15-12-2005,672869,Madhya Pradesh,4,10,23,9,46,Pass
Gurpreet Sharma,07-01-2005,156935,Rajasthan,1,4,13,12,30,Pass
Aryan Singh,08-08-2005,623187,Chhattisgarh,11,0,24,6,41,Pass
Krishna Reddy,29-06-2005,854774,Andaman & Nicobar,7,20,17,6,50,Pass
Aditya Verma,01-03-2006,209008,Uttar Pradesh,10,5,14,21,50,Pass
Kunal Chopra,09-10-2005,929395,Tamil Nadu,19,0,2,14,35,Pass
Aditya Sharma,30-04-2005,594341,Rajasthan,21,18,0,20,59,Pass
Rohan Singh,27-04-2005,146486,Uttar Pradesh,21,5,10,9,45,Pass
Paul D'Souza,31-01-2006,391052,Maharashtra,18,3,17,9,47,Pass
Vivaan Mehta,30-12-2004,673974,Odisha,2,9,13,3,27,Pass
Aryan Khan,28-04-2006,252313,Uttar Pradesh,18,5,9,21,53,Pass
Rehan Verma,25-12-2004,298483,Odisha,16,22,5,12,55,Pass
Krishna Chopra,03-12-2004,734480,West Bengal,9,4,10,2,25,Pass
Vivaan Chopra,05-02-2006,415919,Rajasthan,23,13,8,3,47,Pass
Vivaan Khan,06-12-2004,556195,Gujarat,7,12,6,20,45,Pass
Ishaan Khan,11-09-2005,275839,Bihar,1,4,18,18,41,Pass
Aarav Fernandes,27-12-2005,975842,Bihar,21,22,7,22,72,Pass
Yash Khan,19-10-2005,731366,Bihar,5,20,19,24,68,Pass
Vivaan Khan,25-04-2005,666544,Bihar,12,4,7,21,44,Pass
Aditya Chopra,12-05-2005,291112,Sikkim,3,20,5,17,45,Pass
Kunal Fernandes,01-05-2006,319641,Andhra Pradesh,10,14,4,16,44,Pass
Vivaan D'Souza,10-01-2005,676506,West Bengal,3,19,1,18,41,Pass
Krishna Verma,26-11-2005,619404,Uttarakhand,3,16,10,24,53,Pass
Mathew Khan,03-11-2005,987478,Uttar Pradesh,7,5,2,8,22,Pass
Imran D'Souza,03-12-2004,281917,Nagaland,3,0,17,14,34,Pass
Raj Verma,04-03-2006,550511,Odisha,4,6,18,11,39,Pass
Kunal Verma,27-12-2005,511410,Rajasthan,10,15,9,7,41,Pass
Rohan Khan,17-02-2005,101094,Bihar,10,20,14,6,50,Pass
Aryan Mehta,11-07-2005,184923,Maharashtra,2,11,14,10,37,Pass
Krishna Verma,24-05-2005,230163,Bihar,1,6,20,18,45,Pass
Rohan Chopra,21-06-2005,459674,Bihar,4,9,0,13,26,Pass
Ishaan Mehta,14-02-2006,808472,Odisha,4,14,8,15,41,Pass
Raj Mehta,06-03-2006,471296,Haryana,13,2,9,3,27,Pass
Raj Mehta,18-04-2006,148908,Assam,6,22,3,10,41,Pass
Aryan Chopra,15-03-2005,196966,Bihar,23,4,11,7,45,Pass
Sukhwinder Singh,22-10-2005,649216,Rajasthan,7,8,12,24,51,Pass
Rehan Chopra,15-09-2005,583069,Madhya Pradesh,2,20,14,2,38,Pass
Raj D'Souza,03-05-2006,872273,Uttar Pradesh,6,5,17,22,50,Pass
Vivaan Khan,15-11-2005,246119,Maharashtra,18,4,5,13,40,Pass
Vivaan Fernandes,13-12-2004,104002,Haryana,21,8,6,3,38,Pass
Rohan Mehta,10-01-2006,841406,West Bengal,3,20,9,17,49,Pass
Aditya Singh,28-03-2006,236596,Uttarakhand,1,2,20,15,38,Pass
Aarav D'Souza,14-09-2005,803837,Uttar Pradesh,4,5,9,13,31,Pass
Rohan Pillai,26-12-2004,753410,Rajasthan,13,19,14,6,52,Pass
Manpreet Mehta,07-01-2005,613601,Tamil Nadu,18,22,6,12,58,Pass
Gurpreet Fernandes,20-01-2006,281775,Delhi,11,2,5,13,31,Fail
Yash Pillai,05-06-2005,390568,Bihar,12,1,5,24,42,Pass
Paul Mehta,15-04-2005,319355,Madhya Pradesh,23,13,24,4,64,Pass
Kunal Reddy,29-10-2005,855691,Assam,7,11,12,22,52,Pass
Zaid Mehta,25-02-2006,366272,Chhattisgarh,16,19,2,7,44,Pass
David Verma,08-11-2005,514257,Andhra Pradesh,9,23,14,4,50,Pass
Peter Mehta,10-04-2005,202136,Andhra Pradesh,11,12,15,0,38,Pass
Mathew Mehta,24-11-2004,288561,West Bengal,7,6,3,14,30,Pass
Krishna Verma,15-11-2004,681466,Andhra Pradesh,18,10,1,13,42,Pass
Ishaan Chopra,13-04-2006,367608,Tamil Nadu,18,19,15,7,59,Pass
Rohan Fernandes,19-01-2006,241457,Punjab,16,3,15,23,57,Pass
Krishna Khan,22-01-2005,328910,Uttar Pradesh,13,5,20,3,41,Pass
Aditya D'Souza,23-08-2005,439442,Telangana,12,3,3,6,24,Pass
Aditya Fernandes,30-04-2005,223673,Maharashtra,0,10,8,3,21,Pass
Kunal Reddy,21-11-2005,712846,Chhattisgarh,20,20,23,21,84,Pass
Yash Verma,04-05-2006,486600,Tamil Nadu,9,17,23,10,59,Pass
Rohan Fernandes,18-07-2005,898902,Madhya Pradesh,13,14,7,6,40,Pass
Aryan D'Souza,05-02-2005,988667,Bihar,22,19,4,23,68,Pass
Raj Singh,18-02-2005,556202,Rajasthan,17,6,1,10,34,Pass
Mathew Chopra,01-02-2006,645591,Tamil Nadu,9,20,10,21,60,Pass
Vivaan Verma,23-11-2004,456427,Rajasthan,23,2,21,1,47,Pass
Krishna Khan,20-03-2005,782965,Mizoram,1,10,8,21,40,Pass
Kunal Khan,19-09-2005,568718,Rajasthan,24,22,4,13,63,Pass
Aryan Pillai,25-11-2005,921527,Madhya Pradesh,24,18,1,4,47,Pass
Rohan Reddy,25-04-2006,644484,Rajasthan,7,11,12,11,41,Pass
Aarav Khan,24-04-2006,931728,Rajasthan,5,8,14,22,49,Pass
Ishaan Verma,26-01-2006,956337,Uttar Pradesh,8,5,4,10,27,Pass
Harjeet Khan,24-02-2005,951203,Rajasthan,17,1,20,15,53,Pass
Raj Chopra,22-03-2006,830349,Arunachal Pradesh,3,5,22,0,30,Pass
Aarav Reddy,18-08-2005,995986,Maharashtra,8,3,5,1,17,Pass
Krishna Verma,03-09-2005,579276,Rajasthan,5,18,3,20,46,Pass
Manpreet Khan,30-01-2006,649029,Telangana,5,6,8,16,35,Pass
Balbir Singh,06-05-2005,233403,Rajasthan,7,0,9,8,24,Pass
Raj D'Souza,04-02-2006,803529,Rajasthan,14,10,13,12,49,Pass
Ishaan Reddy,06-02-2006,353585,Tamil Nadu,22,4,8,3,37,Pass
Paul Reddy,28-11-2004,746995,Haryana,1,7,4,21,33,Pass
Raj Singh,13-08-2005,682038,Bihar,14,13,3,0,30,Pass
Zaid Sharma,19-10-2005,847132,Chhattisgarh,11,11,20,13,55,Pass
Gurpreet Mehta,01-05-2005,555073,Uttar Pradesh,21,5,18,15,59,Pass
Harjeet Khan,18-05-2005,554394,Uttar Pradesh,3,5,16,1,25,Pass
Raj Singh,11-12-2004,281051,Telangana,6,18,24,11,59,Pass
Balbir Khan,22-11-2004,781697,Madhya Pradesh,13,23,22,4,62,Pass
Aryan Khan,29-12-2004,626974,Bihar,21,7,9,11,48,Pass
Paul Verma,30-06-2005,927928,Maharashtra,3,0,21,15,39,Pass
Krishna Pillai,05-05-2005,148156,Uttar Pradesh,24,5,6,12,47,Pass
Ishaan D'Souza,24-10-2005,800073,Karnataka,8,4,0,11,23,Pass
John Singh,29-12-2005,297159,Punjab,22,16,12,8,58,Pass
Yash Pillai,26-12-2004,342313,Madhya Pradesh,12,23,14,7,56,Pass
Gurpreet Verma,09-11-2004,458687,Punjab,24,21,3,0,48,Pass
Farhan Verma,10-01-2006,352378,Bihar,24,1,7,2,34,Pass
Ishaan Khan,20-10-2005,431795,Andhra Pradesh,8,5,3,14,30,Pass
Raj Pillai,10-12-2004,335592,Karnataka,1,20,7,9,37,Pass
Yash D'Souza,28-03-2005,431982,Jammu & Kashmir + Ladakh,16,12,2,11,41,Pass
Aarav Reddy,04-09-2005,822330,West Bengal,0,6,17,16,39,Pass
Yash Fernandes,17-01-2006,262710,Uttarakhand,4,5,16,15,40,Pass
Vivaan Sharma,02-04-2005,259115,Maharashtra,21,4,23,4,52,Pass
Rohan Fernandes,22-05-2005,905780,Odisha,16,13,10,23,62,Pass
Rohan Pillai,20-09-2005,339690,Maharashtra,17,3,7,17,44,Pass
Raj Verma,21-03-2005,167855,West Bengal,16,16,12,5,49,Pass
Ishaan Reddy,24-03-2006,822748,West Bengal,3,20,7,8,38,Pass
Aditya Reddy,22-02-2005,506998,West Bengal,3,5,22,14,44,Pass
Aarav Pillai,05-04-2005,504687,Rajasthan,2,18,0,22,42,Pass
Harjeet Reddy,27-10-2005,963185,Maharashtra,10,6,6,2,24,Pass
Aarav D'Souza,25-09-2005,158444,Rajasthan,18,19,2,4,43,Pass
Aditya Fernandes,23-10-2005,171097,Haryana,4,8,14,8,34,Pass
Harjeet D'Souza,18-07-2005,906585,Gujarat,5,0,2,15,22,Pass
Manpreet Pillai,19-12-2005,368771,Haryana,15,6,23,6,50,Pass
Ishaan Reddy,03-12-2004,768419,Tamil Nadu,15,16,9,19,59,Pass
Aditya Chopra,04-05-2006,439986,Tripura,5,13,19,4,41,Pass
Manpreet Fernandes,26-04-2005,110178,Chhattisgarh,6,3,4,22,35,Pass
Aditya Pillai,18-04-2006,319278,Jharkhand,24,0,11,1,36,Pass
Krishna Khan,29-05-2005,655936,Tamil Nadu,12,6,1,3,22,Pass
Rohan Singh,09-08-2005,539441,Bihar,20,10,7,18,55,Pass
Krishna Verma,01-06-2005,424615,Uttar Pradesh,12,5,2,9,28,Pass
Gurpreet Sharma,27-09-2005,721750,Jharkhand,8,2,9,19,38,Pass
Mathew Mehta,02-12-2005,937534,Tripura,12,6,8,19,45,Pass
Aditya Sharma,08-04-2006,104611,Gujarat,24,16,22,23,85,Pass
Zaid Mehta,06-01-2005,424825,Assam,10,14,5,15,44,Pass
Rohan Verma,31-05-2005,346012,Assam,4,14,17,23,58,Pass
Rohan Reddy,28-03-2005,105148,Rajasthan,19,6,8,7,40,Pass
Aditya Fernandes,07-04-2005,990488,Madhya Pradesh,12,6,24,10,52,Pass
Kunal Sharma,06-11-2005,949144,Haryana,22,17,8,16,63,Pass
Krishna Pillai,01-12-2005,945869,Rajasthan,3,11,12,20,46,Pass
Farhan Sharma,06-04-2005,328546,Maharashtra,15,4,19,18,56,Pass
Aarav Sharma,18-10-2005,568289,West Bengal,10,11,3,5,29,Pass
Krishna Sharma,30-03-2006,875741,Rajasthan,2,4,7,0,13,Pass
Aryan Pillai,05-10-2005,160153,Assam,8,16,24,9,57,Pass
Peter Sharma,28-04-2006,302359,Madhya Pradesh,16,15,23,0,54,Pass
Kunal Pillai,25-02-2006,833180,Bihar,4,14,9,23,50,Pass
Krishna Verma,17-02-2005,786109,Maharashtra,0,1,5,1,7,Pass
Gurpreet Singh,19-02-2006,218144,Odisha,16,13,1,13,43,Pass
Vivaan Chopra,03-12-2005,363457,West Bengal,21,7,15,1,44,Pass
Krishna Mehta,10-06-2005,753176,Karnataka,5,11,4,19,39,Pass
Balbir Pillai,27-09-2005,300693,Rajasthan,7,13,17,14,51,Pass
Aryan Sharma,25-07-2005,339448,Bihar,7,19,6,3,35,Pass
Harjeet Reddy,28-03-2006,746101,Punjab,9,10,11,0,30,Pass
Krishna Sharma,09-11-2005,998381,Tamil Nadu,9,14,21,2,46,Pass
Ishaan D'Souza,01-02-2006,298180,West Bengal,13,2,0,0,15,Pass
Yash Verma,26-12-2004,770904,Telangana,21,11,14,5,51,Pass
Aditya Sharma,28-11-2004,895982,West Bengal,3,20,11,2,36,Pass
Balbir Reddy,13-03-2006,421359,Telangana,0,11,20,23,54,Pass
Raj Mehta,18-11-2005,333613,Karnataka,6,21,6,10,43,Pass
Rohan Singh,22-06-2005,537889,Rajasthan,17,0,14,9,40,Pass
Sukhwinder Pillai,14-09-2005,403544,Andhra Pradesh,17,14,5,17,53,Pass
Manpreet Fernandes,28-01-2006,187696,West Bengal,11,19,10,0,40,Pass
Aryan Khan,01-12-2004,266581,Haryana,13,5,6,2,26,Pass
Vivaan Chopra,14-11-2004,109560,Maharashtra,21,4,14,7,46,Pass
Aryan Chopra,08-03-2006,780498,Jharkhand,23,4,12,15,54,Pass
Kunal Singh,06-11-2005,543109,Andhra Pradesh,12,9,4,6,31,Pass
Krishna Fernandes,13-01-2005,401602,Uttar Pradesh,14,5,18,9,46,Pass
Rohan Pillai,15-02-2005,838057,Haryana,12,24,11,14,61,Pass
Aryan D'Souza,22-02-2005,945081,Punjab,19,5,21,0,45,Pass
Manpreet Fernandes,19-02-2005,786341,Bihar,1,13,5,15,34,Pass
Raj Singh,22-03-2006,794272,Bihar,16,0,15,2,33,Pass
Krishna Chopra,05-08-2005,448115,Bihar,21,10,12,17,60,Pass
Vivaan Khan,29-01-2006,435716,Delhi,22,9,8,17,56,Fail
Sukhwinder Sharma,14-11-2004,644232,Maharashtra,7,4,20,17,48,Pass
Raj Mehta,03-01-2005,272553,Uttarakhand,3,19,16,24,62,Pass
Ishaan Sharma,22-04-2005,501302,Nagaland,4,4,4,5,17,Pass
Zaid Khan,23-07-2005,181464,Rajasthan,16,22,23,6,67,Pass
Aarav Fernandes,05-07-2005,291491,Rajasthan,2,12,3,3,20,Pass
Vivaan Khan,10-05-2005,535449,Meghalaya,21,6,4,5,36,Pass
Rohan D'Souza,06-03-2006,372456,Tamil Nadu,4,22,19,3,48,Pass
Ishaan Mehta,23-07-2005,272821,Himachal Pradesh,5,10,11,11,37,Pass
Aarav Verma,07-06-2005,391470,Madhya Pradesh,10,16,22,2,50,Pass
Balbir Chopra,04-04-2006,952243,Bihar,5,2,18,3,28,Pass
Harjeet Singh,19-10-2005,423088,Rajasthan,21,17,3,14,55,Pass
Harjeet Pillai,25-02-2006,920913,Haryana,19,2,14,19,54,Pass
Aditya Fernandes,17-04-2005,899390,Bihar,20,0,14,19,53,Pass
Peter Verma,03-08-2005,965913,Tripura,1,24,15,16,56,Pass
Aditya Verma,25-01-2005,604465,Andhra Pradesh,17,17,15,22,71,Pass
Aditya Singh,12-12-2004,718770,Andhra Pradesh,4,21,16,14,55,Pass
Raj Sharma,14-08-2005,231631,Rajasthan,5,22,20,20,67,Pass
Yash Singh,08-05-2006,856085,Rajasthan,10,13,4,21,48,Pass
Balbir Verma,19-05-2005,914487,Haryana,13,11,16,5,45,Pass
Rohan D'Souza,18-06-2005,855777,Rajasthan,1,0,10,0,11,Pass
Aditya Reddy,28-10-2005,371084,Uttar Pradesh,8,5,22,17,52,Pass
Rohan Khan,28-10-2005,818601,Jammu & Kashmir + Ladakh,4,16,16,18,54,Pass
Krishna Chopra,19-02-2005,482478,Gujarat,7,5,10,21,43,Pass
Sukhwinder Verma,08-04-2005,307912,Uttar Pradesh,5,5,10,0,20,Pass
Balbir Chopra,25-05-2005,547435,Tamil Nadu,4,22,12,6,44,Pass
Aditya D'Souza,12-02-2005,523332,Karnataka,13,17,8,11,49,Pass
Aryan Khan,29-08-2005,883199,Punjab,4,12,7,0,23,Pass
Harjeet Fernandes,11-01-2005,848020,Madhya Pradesh,9,6,16,12,43,Pass
Vivaan Fernandes,24-11-2004,530417,Haryana,0,14,4,23,41,Pass
Sukhwinder Chopra,31-03-2006,525908,Madhya Pradesh,12,13,7,16,48,Pass
Ishaan Sharma,11-12-2004,492082,Madhya Pradesh,13,0,12,7,32,Pass
Raj Pillai,09-04-2006,345977,Bihar,1,2,19,12,34,Pass
Peter Pillai,02-12-2004,863595,Uttar Pradesh,8,5,20,22,55,Pass
Kunal Fernandes,06-04-2006,899006,Andhra Pradesh,0,0,3,7,10,Pass
Ayaan Verma,01-09-2005,294826,Manipur,4,24,15,3,46,Pass
Kunal D'Souza,23-04-2006,359319,Odisha,20,23,11,7,61,Pass
Harjeet Sharma,11-04-2006,689886,Haryana,15,6,17,20,58,Pass
Gurpreet Sharma,01-04-2006,352625,Rajasthan,4,14,5,21,44,Pass
Raj D'Souza,15-01-2005,302910,Haryana,17,23,12,20,72,Pass
John Fernandes,08-11-2004,343232,Madhya Pradesh,7,19,8,4,38,Pass
Raj Chopra,06-01-2006,764609,Rajasthan,16,2,21,14,53,Pass
John Sharma,09-12-2004,410202,Jharkhand,14,5,10,22,51,Pass
Raj Fernandes,31-12-2004,285075,Madhya Pradesh,13,14,14,15,56,Pass
Aarav Verma,26-01-2005,542655,Rajasthan,1,23,24,21,69,Pass
Sukhwinder Khan,16-08-2005,547217,Chhattisgarh,20,12,12,13,57,Pass
Harjeet Verma,08-12-2005,852317,Andhra Pradesh,12,11,13,11,47,Pass
John Singh,19-01-2005,613277,Rajasthan,1,6,17,13,37,Pass
Gurpreet Khan,10-03-2005,904846,Madhya Pradesh,3,5,11,24,43,Pass
Aarav Reddy,17-08-2005,146014,Maharashtra,21,4,18,14,57,Pass
Raj Chopra,02-11-2005,438588,Uttar Pradesh,9,5,24,8,46,Pass
Yash Mehta,26-07-2005,718130,Rajasthan,17,16,10,22,65,Pass
Aarav Singh,19-01-2006,221631,Maharashtra,3,20,10,3,36,Pass
Aditya Mehta,16-03-2005,524002,Daman & Diu / D&N Haveli,6,8,7,11,32,Pass
Aryan Mehta,06-10-2005,958225,Rajasthan,6,15,1,0,22,Pass
Vivaan Chopra,03-11-2005,386926,Andhra Pradesh,8,2,10,23,43,Pass
Krishna Verma,19-03-2006,676529,Bihar,13,0,12,14,39,Pass
Vivaan Singh,07-12-2005,381425,Uttar Pradesh,12,5,18,6,41,Pass
Farhan Mehta,17-10-2005,476089,Maharashtra,22,4,9,21,56,Pass
Rohan Mehta,30-12-2005,622416,Telangana,20,22,18,9,69,Pass
Rohan Mehta,30-01-2006,287550,Rajasthan,21,18,13,14,66,Pass
Yash Khan,19-09-2005,866126,Rajasthan,21,24,8,20,73,Pass
Yash Fernandes,19-01-2005,369287,Bihar,19,14,12,4,49,Pass
Raj Reddy,07-03-2005,489364,Delhi,8,13,21,17,59,Fail
Raj Singh,31-12-2004,590175,Haryana,15,3,2,1,21,Pass
Yash Pillai,12-03-2006,415640,Rajasthan,20,10,20,11,61,Pass
Ayaan Pillai,21-04-2005,941478,Odisha,0,1,7,21,29,Pass
Raj Singh,11-11-2005,746748,Punjab,0,19,7,23,49,Pass
Aarav Fernandes,13-03-2006,946608,Madhya Pradesh,16,16,8,11,51,Pass
Ishaan Sharma,03-08-2005,391434,Rajasthan,7,24,24,19,74,Pass
Yash Reddy,31-12-2005,878850,Madhya Pradesh,24,0,5,8,37,Pass
Rohan Chopra,08-02-2005,669365,West Bengal,8,15,14,10,47,Pass
David Fernandes,05-01-2005,483628,West Bengal,19,15,7,11,52,Pass
Ishaan Verma,13-07-2005,303570,Haryana,11,18,21,4,54,Pass
Imran Sharma,13-02-2005,907646,Tamil Nadu,23,17,18,16,74,Pass
Vivaan Mehta,16-02-2005,296925,Madhya Pradesh,4,2,1,21,28,Pass
Sukhwinder Reddy,04-05-2005,214059,Himachal Pradesh,21,12,3,11,47,Pass
Aryan Singh,12-01-2006,526997,Assam,1,11,13,20,45,Pass
Aryan Reddy,14-01-2005,920214,Rajasthan,14,17,13,8,52,Pass
Sukhwinder Chopra,27-12-2005,351779,Rajasthan,16,15,4,17,52,Pass
Aarav Fernandes,16-09-2005,235765,Jharkhand,14,7,19,3,43,Pass
Vivaan Khan,25-09-2005,594541,Bihar,6,17,0,16,39,Pass
Aarav Sharma,14-08-2005,484644,Tamil Nadu,22,14,12,2,50,Pass
Harjeet D'Souza,29-03-2006,750112,Jharkhand,4,8,0,19,31,Pass
Raj Pillai,26-11-2004,261741,Andhra Pradesh,0,10,21,22,53,Pass
Krishna Sharma,17-07-2005,249321,Bihar,9,11,18,2,40,Pass
Yash D'Souza,13-02-2005,611633,Assam,13,22,18,14,67,Pass
Ishaan Sharma,26-11-2005,678387,Madhya Pradesh,10,4,16,12,42,Pass
Yash Khan,06-10-2005,339020,Meghalaya,12,10,4,18,44,Pass
Krishna Reddy,27-10-2005,257123,Madhya Pradesh,23,23,19,4,69,Pass
Balbir Verma,30-04-2005,241357,Punjab,19,19,23,21,82,Pass
Yash Sharma,26-01-2006,753071,Andhra Pradesh,10,18,24,21,73,Pass
Vivaan Mehta,06-02-2005,978942,Delhi,13,1,13,8,35,Fail
Aryan Reddy,14-02-2006,927362,Andhra Pradesh,21,7,12,21,61,Pass
Aryan D'Souza,22-10-2005,309430,Assam,9,22,2,13,46,Pass
Harjeet D'Souza,19-11-2004,859376,Tamil Nadu,6,9,9,12,36,Pass
Aryan Singh,10-03-2006,702938,West Bengal,9,12,5,6,32,Pass
John Verma,12-04-2006,882297,Tamil Nadu,24,12,21,8,65,Pass
Raj Fernandes,29-03-2006,266990,Assam,10,16,3,19,48,Pass
Rohan Verma,25-12-2004,779791,Uttar Pradesh,12,5,21,19,57,Pass
Kunal Verma,01-01-2005,367683,Rajasthan,21,21,10,2,54,Pass
Rohan Singh,28-02-2005,585977,Bihar,6,24,0,12,42,Pass
Raj Chopra,17-11-2005,354655,Tamil Nadu,20,1,9,14,44,Pass
Raj Pillai,17-03-2006,812437,West Bengal,1,1,8,12,22,Pass
Aarav Singh,30-11-2004,578118,Meghalaya,8,18,8,7,41,Pass
Rohan Sharma,22-06-2005,557153,Jharkhand,18,1,22,20,61,Pass
Harjeet Reddy,02-12-2005,214563,Gujarat,18,8,19,12,57,Pass
Vivaan Verma,28-11-2004,170930,Assam,4,17,9,15,45,Pass
Paul Singh,13-11-2005,453556,Tamil Nadu,17,6,3,22,48,Pass
John Mehta,21-04-2005,383423,Madhya Pradesh,15,24,20,4,63,Pass
David Khan,18-04-2006,819778,Uttar Pradesh,3,5,21,15,44,Pass
Ishaan Sharma,07-01-2005,165537,West Bengal,0,18,11,21,50,Pass
Yash Verma,02-04-2005,705724,Karnataka,2,2,8,18,30,Pass
Ishaan Reddy,26-06-2005,677261,Madhya Pradesh,2,0,21,14,37,Pass
Kunal Singh,26-10-2005,134138,Gujarat,24,13,23,5,65,Pass
Gurpreet Chopra,06-05-2005,209115,Uttar Pradesh,1,5,13,20,39,Pass
Ishaan Pillai,08-09-2005,335623,Maharashtra,21,4,5,16,46,Pass
Aryan Khan,25-12-2005,209951,Nagaland,5,4,4,4,17,Pass
Ishaan Singh,29-03-2006,722293,Telangana,5,14,24,10,53,Pass
Sukhwinder Singh,15-01-2005,761924,Madhya Pradesh,19,21,12,2,54,Pass
Aarav Pillai,29-11-2005,367191,Delhi,8,14,20,11,53,Fail
Aditya Khan,23-03-2006,239971,Delhi,0,6,12,22,40,Fail
Manpreet Fernandes,11-03-2005,806597,Goa,7,6,11,7,31,Pass
Krishna Verma,05-02-2005,224751,West Bengal,0,0,7,22,29,Pass
Raj Fernandes,27-11-2004,308201,Madhya Pradesh,2,4,2,21,29,Pass
Vivaan Mehta,30-04-2005,123333,Madhya Pradesh,19,18,12,4,53,Pass
Yash Fernandes,07-08-2005,737571,Madhya Pradesh,4,20,7,21,52,Pass
Vivaan Khan,30-04-2006,276558,Delhi,14,22,2,8,46,Fail
Raj Chopra,17-05-2005,147637,Rajasthan,0,17,11,24,52,Pass
Imran D'Souza,17-03-2006,379593,Madhya Pradesh,0,2,21,7,30,Pass
Vivaan Fernandes,11-03-2006,705252,Bihar,15,14,10,9,48,Pass
Krishna Singh,02-12-2005,933834,Kerala,9,9,8,9,35,Pass
Aarav Reddy,05-02-2005,412369,Uttar Pradesh,24,5,10,12,51,Pass
Paul Chopra,03-12-2004,605772,Gujarat,13,21,8,9,51,Pass
Aryan Pillai,08-07-2005,192024,Madhya Pradesh,5,4,1,20,30,Pass
Manpreet Mehta,05-01-2006,994107,Manipur,4,7,10,22,43,Pass
Rohan Fernandes,31-01-2005,534264,Bihar,10,7,8,20,45,Pass
Krishna Khan,14-01-2005,222471,Uttar Pradesh,14,5,9,0,28,Pass
Raj Reddy,31-01-2005,395866,Tamil Nadu,1,23,16,1,41,Pass
David Mehta,06-07-2005,386814,Assam,11,21,10,7,49,Pass
Ishaan Singh,21-10-2005,651872,Uttar Pradesh,4,5,15,21,45,Pass
Krishna Chopra,05-05-2006,117519,Uttar Pradesh,3,5,24,15,47,Pass
Aditya Verma,30-03-2006,212688,Himachal Pradesh,21,20,11,0,52,Pass
Rohan Pillai,15-07-2005,451981,West Bengal,23,6,0,21,50,Pass
Ishaan Sharma,03-01-2005,300359,Chhattisgarh,15,18,22,11,66,Pass
Aditya Sharma,30-05-2005,891578,West Bengal,3,13,20,8,44,Pass
Ishaan Sharma,15-08-2005,972133,West Bengal,10,6,7,5,28,Pass
Rohan Fernandes,03-09-2005,281304,Odisha,3,4,15,22,44,Pass
Kunal Pillai,24-11-2004,502062,Maharashtra,17,15,1,1,34,Pass
Aarav Sharma,16-04-2005,103902,Madhya Pradesh,0,21,20,4,45,Pass
Ishaan Khan,19-03-2005,986407,Bihar,17,12,3,6,38,Pass
Raj Sharma,14-04-2005,210679,Jharkhand,13,4,7,22,46,Pass
Rohan Pillai,13-11-2004,934815,West Bengal,24,1,0,4,29,Pass
Aarav Verma,28-03-2005,371687,Jammu & Kashmir + Ladakh,3,14,6,16,39,Pass
Aarav Chopra,26-03-2006,425234,Uttar Pradesh,1,5,10,2,18,Pass
Harjeet Reddy,21-10-2005,265705,West Bengal,17,20,4,5,46,Pass
Raj Sharma,21-12-2004,878285,Uttar Pradesh,18,5,15,5,43,Pass
Farhan Singh,20-02-2005,738030,Telangana,15,6,16,17,54,Pass
Krishna Singh,06-04-2005,519897,Odisha,17,14,21,17,69,Pass
Aarav Chopra,09-04-2006,199225,Jharkhand,0,15,10,16,41,Pass
Kunal Sharma,28-05-2005,365540,Tamil Nadu,23,7,17,24,71,Pass
Aryan Reddy,15-11-2004,404207,Andhra Pradesh,4,7,2,6,19,Pass
Kunal Reddy,04-06-2005,249966,Maharashtra,15,14,13,7,49,Pass
Kunal Reddy,15-12-2005,269449,Punjab,15,14,9,6,44,Pass
Peter Verma,11-07-2005,466218,Rajasthan,11,10,6,8,35,Pass
Rehan Verma,22-10-2005,652977,Uttar Pradesh,6,5,14,10,35,Pass
Raj Verma,11-03-2006,367604,Telangana,11,20,15,17,63,Pass
Ishaan Khan,11-01-2005,132515,Bihar,14,24,10,10,58,Pass
Rohan Reddy,13-05-2005,400134,Chhattisgarh,19,12,3,0,34,Pass
Rohan Mehta,26-12-2004,701710,Uttar Pradesh,19,5,21,16,61,Pass
John Fernandes,17-05-2005,195519,Madhya Pradesh,20,14,5,4,43,Pass
Kunal Singh,14-03-2006,532789,Maharashtra,5,5,9,4,23,Pass
Vivaan Khan,14-06-2005,693400,Uttarakhand,19,8,15,8,50,Pass
Krishna Verma,03-04-2005,612457,Telangana,1,17,1,7,26,Pass
Krishna Sharma,07-01-2005,835108,Rajasthan,1,10,20,10,41,Pass
Aryan Singh,26-02-2006,224345,Karnataka,1,20,20,12,53,Pass
Raj Singh,09-02-2005,793105,West Bengal,19,0,11,10,40,Pass
Raj Reddy,28-07-2005,721177,Karnataka,19,14,0,18,51,Pass
Aditya Khan,22-01-2006,894211,Madhya Pradesh,3,6,1,14,24,Pass
Aditya Singh,21-03-2006,723868,West Bengal,22,11,9,12,54,Pass
Aditya Khan,26-08-2005,872246,Bihar,13,0,9,13,35,Pass
Mathew Sharma,10-04-2005,148556,Rajasthan,22,23,15,12,72,Pass
Rohan Singh,15-10-2005,172482,Madhya Pradesh,6,7,24,4,41,Pass
Balbir Khan,12-06-2005,616912,Assam,10,13,21,0,44,Pass
Aarav Pillai,28-02-2005,235768,Uttar Pradesh,12,5,1,20,38,Pass
Sukhwinder Sharma,17-12-2004,437075,Arunachal Pradesh,2,0,18,18,38,Pass
Aarav Khan,02-04-2006,480739,Manipur,1,7,0,3,11,Pass
Yash Sharma,01-10-2005,959914,West Bengal,22,9,7,12,50,Pass
Paul Pillai,19-04-2005,502961,Chhattisgarh,3,23,24,7,57,Pass
John D'Souza,03-09-2005,988743,Jharkhand,22,0,23,2,47,Pass
Sukhwinder D'Souza,03-04-2005,931854,Bihar,11,4,17,4,36,Pass
Aarav Pillai,10-02-2006,854002,Odisha,20,8,14,23,65,Pass
Aarav Khan,07-12-2005,643650,Punjab,24,1,13,3,41,Pass
Aryan Khan,15-01-2005,229401,Meghalaya,4,14,3,21,42,Pass
Ishaan Fernandes,11-04-2006,717635,Uttar Pradesh,1,5,12,13,31,Pass
Kunal Khan,23-07-2005,508791,Rajasthan,23,9,6,24,62,Pass
Aditya Reddy,11-11-2005,995019,Odisha,3,19,0,12,34,Pass
Yash Singh,09-04-2006,643771,Rajasthan,23,22,3,23,71,Pass
Raj Khan,30-04-2005,341834,Andhra Pradesh,13,18,13,11,55,Pass
Krishna Khan,20-09-2005,637074,Meghalaya,5,10,6,8,29,Pass
Aryan Verma,16-03-2005,808656,Karnataka,6,22,21,16,65,Pass
Manpreet D'Souza,15-02-2006,267938,Uttar Pradesh,22,5,24,23,74,Pass
Rohan Reddy,01-01-2006,591466,Haryana,0,13,6,8,27,Pass
Vivaan Fernandes,12-01-2005,365889,Tamil Nadu,13,24,10,8,55,Pass
Rohan Mehta,28-09-2005,215894,Maharashtra,11,4,19,18,52,Pass
Aditya Pillai,05-09-2005,597676,Tamil Nadu,10,20,11,4,45,Pass
Gurpreet D'Souza,27-12-2005,704739,Andhra Pradesh,22,19,15,9,65,Pass
Aditya Chopra,16-01-2005,600670,Uttar Pradesh,19,5,11,22,57,Pass
Aryan Verma,18-11-2004,289116,Uttar Pradesh,6,5,16,14,41,Pass
Krishna Reddy,25-04-2005,301448,Tamil Nadu,14,6,10,15,45,Pass
Rohan Reddy,30-04-2005,820759,Maharashtra,20,4,22,19,65,Pass
Gurpreet Fernandes,27-08-2005,442762,Bihar,24,14,11,0,49,Pass
Vivaan Fernandes,25-02-2005,561465,Karnataka,13,21,20,5,59,Pass
Aarav Sharma,22-01-2006,184283,Jammu & Kashmir + Ladakh,19,12,6,21,58,Pass
Yash Mehta,19-11-2004,296802,Maharashtra,16,9,3,0,28,Pass
Gurpreet Singh,17-02-2006,724067,Assam,2,12,2,20,36,Pass
Aryan Khan,31-08-2005,747349,Jharkhand,3,10,8,8,29,Pass
Mathew Reddy,05-05-2006,832824,Kerala,13,5,13,14,45,Pass
Balbir Khan,17-10-2005,170423,Himachal Pradesh,8,6,2,10,26,Pass
Aditya Mehta,20-01-2006,848423,Punjab,9,20,18,7,54,Pass
Aarav Khan,07-12-2004,458689,Rajasthan,19,9,0,16,44,Pass
Gurpreet D'Souza,20-01-2006,488860,Punjab,10,6,22,3,41,Pass
Yash Sharma,08-08-2005,806280,Rajasthan,16,21,7,22,66,Pass
Aarav Reddy,09-11-2005,632542,Punjab,20,14,7,12,53,Pass
Krishna Verma,13-04-2006,834572,Bihar,7,15,17,10,49,Pass
Kunal Fernandes,16-10-2005,805804,Uttarakhand,15,5,17,4,41,Pass
Yash Khan,30-08-2005,469852,Chhattisgarh,23,15,22,2,62,Pass
Sukhwinder Pillai,12-12-2004,421649,Bihar,7,1,6,12,26,Pass
Krishna Sharma,09-06-2005,878476,Tamil Nadu,15,11,16,16,58,Pass
Aditya Fernandes,23-11-2005,861968,Jharkhand,22,0,22,20,64,Pass
Yash Chopra,04-01-2005,401628,Assam,5,5,0,19,29,Pass
Yash Pillai,16-01-2005,135321,Rajasthan,7,4,19,9,39,Pass
John Singh,02-08-2005,584304,Rajasthan,20,10,16,21,67,Pass
Vivaan Reddy,07-11-2005,350382,Uttar Pradesh,24,5,2,19,50,Pass
Peter Reddy,14-06-2005,261688,Uttar Pradesh,3,5,6,3,17,Pass
Krishna Verma,23-10-2005,806885,Maharashtra,24,4,12,12,52,Pass
Peter Mehta,15-02-2005,206803,Jharkhand,3,2,23,13,41,Pass
Ishaan Mehta,23-02-2006,719714,Maharashtra,4,5,2,8,19,Pass
Krishna Sharma,18-06-2005,439535,Bihar,0,19,14,13,46,Pass
Farhan Sharma,07-10-2005,117423,Gujarat,24,13,8,16,61,Pass
Ishaan Reddy,07-10-2005,451143,Delhi,2,5,12,16,35,Fail
Rohan Singh,07-02-2006,980105,Uttar Pradesh,19,5,0,9,33,Pass
Sukhwinder Fernandes,19-05-2005,838409,Maharashtra,19,0,21,9,49,Pass
Vivaan Chopra,19-03-2005,227256,West Bengal,5,11,9,0,25,Pass
Ishaan Verma,08-08-2005,114344,Odisha,8,13,8,21,50,Pass
Aarav Chopra,11-03-2006,740429,West Bengal,10,5,14,4,33,Pass
Krishna Khan,18-01-2006,493378,Madhya Pradesh,16,10,6,22,54,Pass
Farhan Chopra,07-11-2005,837111,Bihar,24,3,7,7,41,Pass
Aarav Pillai,13-11-2005,132876,Punjab,0,0,16,1,17,Pass
Rohan Chopra,09-12-2004,397059,Uttar Pradesh,8,5,13,17,43,Pass
Manpreet Singh,06-09-2005,749898,Karnataka,24,13,10,10,57,Pass
Vivaan Sharma,06-03-2006,501794,Delhi,24,2,12,12,50,Fail
Ishaan Sharma,15-12-2005,598389,Madhya Pradesh,1,6,10,0,17,Pass
Imran D'Souza,23-11-2004,900403,Haryana,17,1,18,15,51,Pass
Balbir D'Souza,06-01-2006,921438,Punjab,19,18,20,18,75,Pass
Ishaan Mehta,18-12-2004,804037,Rajasthan,15,9,6,9,39,Pass
Raj Mehta,25-02-2006,929756,Andhra Pradesh,9,22,7,14,52,Pass
Yash Chopra,12-04-2006,906277,Chhattisgarh,16,24,10,13,63,Pass
Mathew Khan,28-02-2006,164538,Madhya Pradesh,16,4,3,6,29,Pass
Aditya D'Souza,07-06-2005,759272,Uttarakhand,19,19,1,5,44,Pass
Paul Singh,04-12-2005,499050,Bihar,4,14,19,18,55,Pass
Rohan D'Souza,04-06-2005,919160,Rajasthan,15,13,4,20,52,Pass
Harjeet Verma,02-06-2005,197095,Bihar,15,17,12,12,56,Pass
Aditya Chopra,04-04-2006,269912,Odisha,1,23,16,23,63,Pass
Yash Reddy,11-02-2006,799883,West Bengal,9,12,3,16,40,Pass
Aarav Reddy,23-09-2005,133218,Goa,9,6,6,6,27,Pass
Gurpreet Singh,05-07-2005,224939,Tamil Nadu,17,23,19,16,75,Pass
Ishaan Singh,18-03-2006,205185,Madhya Pradesh,18,14,5,4,41,Pass
Aarav Fernandes,13-02-2005,197599,Andhra Pradesh,20,4,1,0,25,Pass
Aditya Pillai,21-08-2005,337120,Assam,3,17,15,6,41,Pass
Rehan Pillai,25-11-2005,744580,Gujarat,2,23,20,2,47,Pass
Aarav Fernandes,02-09-2005,782658,Bihar,14,1,22,9,46,Pass
Vivaan Verma,06-09-2005,544788,Madhya Pradesh,7,9,23,16,55,Pass
Vivaan Khan,08-02-2006,804498,Jammu & Kashmir + Ladakh,20,10,24,12,66,Pass
Krishna Chopra,28-11-2004,631893,Uttar Pradesh,17,5,6,22,50,Pass
Rohan Singh,10-01-2006,723659,Delhi,19,17,20,21,77,Fail
Aditya Verma,13-09-2005,555675,Uttar Pradesh,11,5,24,11,51,Pass
Farhan Singh,25-02-2006,250840,Bihar,12,16,0,19,47,Pass
Aarav Chopra,26-01-2006,826933,Uttar Pradesh,12,5,9,2,28,Pass
Aditya Fernandes,27-02-2006,330971,Bihar,23,1,18,2,44,Pass
Rohan Reddy,03-01-2005,898831,Odisha,20,22,1,24,67,Pass
Peter Sharma,03-04-2005,561634,Uttar Pradesh,3,5,24,4,36,Pass
Manpreet D'Souza,26-03-2006,992827,Manipur,16,2,15,18,51,Pass
Krishna Sharma,16-04-2005,439047,Punjab,1,20,15,11,47,Pass
Raj Mehta,05-12-2005,818397,Uttarakhand,5,6,0,4,15,Pass
Aryan D'Souza,18-08-2005,449689,Madhya Pradesh,22,11,11,8,52,Pass
Krishna D'Souza,20-03-2006,285650,Tamil Nadu,0,16,1,3,20,Pass
Mathew Reddy,01-11-2005,904617,Tamil Nadu,5,23,24,5,57,Pass
Peter Chopra,06-08-2005,426035,Andhra Pradesh,20,15,18,12,65,Pass
Yash Pillai,09-09-2005,354740,West Bengal,14,8,14,7,43,Pass
Aarav Verma,07-06-2005,229662,Uttar Pradesh,7,5,11,17,40,Pass
Balbir Khan,06-08-2005,933334,Punjab,16,15,14,16,61,Pass
Balbir Sharma,19-07-2005,870104,Haryana,19,14,23,1,57,Pass
Vivaan Mehta,27-02-2005,541369,Karnataka,3,5,0,2,10,Pass
Balbir Mehta,19-11-2004,652379,Maharashtra,10,0,16,7,33,Pass
Kunal Khan,27-05-2005,249443,Telangana,12,9,22,9,52,Pass
Raj Singh,11-02-2006,508770,Karnataka,2,7,1,6,16,Pass
Krishna Mehta,12-03-2006,687001,West Bengal,17,5,16,12,50,Pass
Aarav Verma,02-08-2005,780349,Punjab,17,0,10,6,33,Pass
Manpreet Khan,19-03-2005,110768,Andhra Pradesh,11,14,3,16,44,Pass
Ishaan Singh,24-03-2006,153628,Punjab,15,13,2,2,32,Pass
Krishna Reddy,04-03-2005,331709,Karnataka,10,2,15,0,27,Pass
Ishaan D'Souza,06-08-2005,241784,Maharashtra,14,4,4,15,37,Pass
Peter Chopra,02-02-2005,567891,Chhattisgarh,1,12,14,6,33,Pass
Yash Reddy,14-11-2005,722821,Rajasthan,8,14,10,3,35,Pass
Rehan Singh,25-12-2004,717750,Maharashtra,21,1,21,3,46,Pass
Rohan D'Souza,15-11-2004,593893,Uttarakhand,3,20,13,10,46,Pass
Rohan Reddy,27-03-2006,381823,Tamil Nadu,13,20,22,23,78,Pass
Gurpreet Sharma,03-10-2005,967106,Uttarakhand,3,7,19,18,47,Pass
Manpreet Khan,22-06-2005,169937,West Bengal,16,5,0,2,23,Pass
Kunal Sharma,11-02-2005,170138,West Bengal,3,16,20,6,45,Pass
Balbir Khan,29-12-2004,988911,Rajasthan,24,14,21,3,62,Pass
Yash Mehta,11-10-2005,960338,Madhya Pradesh,12,3,24,9,48,Pass
Ishaan Chopra,21-02-2005,805717,Rajasthan,6,24,23,9,62,Pass
Aarav D'Souza,01-03-2006,834777,Tamil Nadu,14,4,4,1,23,Pass
Aryan Chopra,02-12-2005,658092,Tripura,5,1,5,3,14,Pass
Vivaan Chopra,18-11-2004,812674,Maharashtra,14,16,3,2,35,Pass
Kunal Khan,01-05-2005,314490,Haryana,10,14,11,2,37,Pass
David Singh,06-04-2005,525674,Karnataka,19,19,7,19,64,Pass
Rehan Chopra,07-09-2005,325519,Madhya Pradesh,16,18,23,4,61,Pass
Ishaan Fernandes,21-05-2005,214444,Bihar,22,22,15,19,78,Pass
Aditya Chopra,28-02-2006,769850,Rajasthan,8,12,20,12,52,Pass
Aditya Mehta,02-10-2005,421489,Andhra Pradesh,14,8,22,2,46,Pass
Harjeet Chopra,24-03-2006,584904,Assam,6,15,7,1,29,Pass
Farhan Fernandes,27-02-2005,389146,Uttar Pradesh,9,5,2,17,33,Pass
Kunal Chopra,16-05-2005,560295,Andhra Pradesh,7,5,6,18,36,Pass
Gurpreet Mehta,19-03-2005,353006,Assam,5,4,5,12,26,Pass
Yash Khan,21-05-2005,327584,Himachal Pradesh,22,12,16,6,56,Pass
Rohan Fernandes,21-12-2004,788049,Haryana,1,19,7,24,51,Pass
Raj Verma,24-03-2006,151291,Telangana,19,11,18,9,57,Pass
John Reddy,08-09-2005,514871,Haryana,4,11,16,1,32,Pass
Ishaan Chopra,06-03-2005,677838,Uttar Pradesh,19,5,14,10,48,Pass
Yash Chopra,12-11-2005,484856,Andhra Pradesh,23,22,24,17,86,Pass
Ishaan Reddy,03-07-2005,611721,Odisha,14,23,4,6,47,Pass
Aarav Verma,10-01-2005,825524,Maharashtra,2,4,17,16,39,Pass
Ishaan Khan,16-03-2006,665762,Telangana,5,1,15,24,45,Pass
Vivaan Fernandes,17-09-2005,812400,Uttar Pradesh,10,5,15,6,36,Pass
Paul Chopra,26-07-2005,117575,Rajasthan,5,21,16,18,60,Pass
Ishaan Chopra,20-04-2006,327859,Bihar,13,15,8,0,36,Pass
Aarav Reddy,14-03-2005,454920,Bihar,15,5,19,11,50,Pass
Zaid Pillai,18-01-2005,242957,Punjab,2,0,24,4,30,Pass
Balbir Fernandes,23-02-2005,138545,Punjab,2,5,2,17,26,Pass
Yash Pillai,18-06-2005,137553,Tamil Nadu,18,24,12,0,54,Pass
Zaid Reddy,09-03-2005,626263,Assam,18,11,2,10,41,Pass
Manpreet Khan,28-04-2005,270219,Assam,19,12,23,18,72,Pass
Vivaan Fernandes,02-02-2006,254039,Bihar,2,4,2,10,18,Pass
Farhan Singh,30-10-2005,305623,Haryana,10,1,11,19,41,Pass
Manpreet Chopra,20-04-2005,287542,Madhya Pradesh,4,2,16,16,38,Pass
Aryan Pillai,09-02-2006,398778,Maharashtra,16,4,5,24,49,Pass
Rohan Khan,14-03-2006,442032,Punjab,7,14,9,16,46,Pass
Farhan D'Souza,21-12-2005,474804,Karnataka,18,5,11,8,42,Pass
Aditya Singh,30-01-2006,310114,West Bengal,3,14,6,22,45,Pass
Raj Singh,13-02-2005,114912,Punjab,12,11,18,3,44,Pass
Vivaan Mehta,24-08-2005,982750,Uttarakhand,11,15,11,5,42,Pass
Gurpreet Verma,04-10-2005,136007,Kerala,13,10,7,0,30,Pass
Rohan D'Souza,24-07-2005,990348,Uttarakhand,24,7,11,3,45,Pass
Aryan Pillai,16-03-2005,126919,Uttar Pradesh,23,5,24,9,61,Pass
Aryan D'Souza,29-04-2005,282244,Uttar Pradesh,4,5,24,12,45,Pass
Kunal Chopra,15-12-2005,222970,Gujarat,8,3,15,19,45,Pass
Yash Chopra,12-01-2006,796212,Rajasthan,12,5,13,0,30,Pass
Aryan Mehta,25-02-2005,928293,Kerala,9,0,22,8,39,Pass
Yash Fernandes,30-01-2005,537921,Karnataka,5,4,20,12,41,Pass
David Reddy,26-09-2005,412657,Uttar Pradesh,16,5,9,0,30,Pass
Paul Verma,01-03-2005,845175,Gujarat,17,14,6,22,59,Pass
Rohan Fernandes,15-09-2005,962482,Maharashtra,18,4,21,12,55,Pass
Aditya Pillai,30-03-2005,950990,Maharashtra,8,20,11,2,41,Pass
Manpreet D'Souza,03-05-2006,490900,Gujarat,0,6,3,21,30,Pass
Aditya Khan,04-01-2006,200299,West Bengal,3,9,21,15,48,Pass
Ishaan Pillai,02-07-2005,120379,Andhra Pradesh,2,17,14,13,46,Pass
Kunal Khan,14-05-2005,846204,Punjab,5,18,23,9,55,Pass
Zaid Singh,19-08-2005,113927,Rajasthan,7,13,5,16,41,Pass
Raj Singh,27-09-2005,235787,Karnataka,5,19,6,9,39,Pass
Ishaan Sharma,17-02-2005,972446,Chhattisgarh,2,23,8,9,42,Pass
Mathew Singh,28-01-2005,577020,Tamil Nadu,1,22,12,4,39,Pass
Vivaan Singh,08-06-2005,330113,Haryana,4,3,16,16,39,Pass
Ishaan Mehta,19-02-2005,332425,Himachal Pradesh,6,19,16,12,53,Pass
Raj Verma,30-12-2005,624845,Bihar,12,1,8,9,30,Pass
Zaid Chopra,07-06-2005,195353,Madhya Pradesh,23,20,8,4,55,Pass
Rohan Reddy,02-09-2005,394187,Maharashtra,18,1,4,1,24,Pass
Rehan Sharma,15-07-2005,821376,Madhya Pradesh,6,7,5,13,31,Pass
Paul Chopra,19-11-2004,659554,Uttar Pradesh,22,5,18,6,51,Pass
Krishna Reddy,28-01-2005,402707,Maharashtra,24,4,6,17,51,Pass
Aditya Khan,09-05-2005,164260,Maharashtra,22,2,18,3,45,Pass
Vivaan Chopra,26-03-2006,873716,West Bengal,11,5,9,0,25,Pass
Rohan Verma,16-10-2005,933713,Madhya Pradesh,14,20,15,1,50,Pass
Aryan Khan,15-07-2005,301302,Uttar Pradesh,6,5,3,21,35,Pass
Kunal Reddy,20-09-2005,118455,Maharashtra,3,7,2,9,21,Pass
Zaid D'Souza,07-03-2006,913198,Uttar Pradesh,16,5,10,16,47,Pass
Aarav Reddy,12-03-2006,904950,Kerala,9,8,15,18,50,Pass
Rohan D'Souza,01-01-2006,591061,Andhra Pradesh,18,16,13,21,68,Pass
Rohan Fernandes,09-09-2005,398389,Rajasthan,18,20,4,2,44,Pass
Kunal Reddy,15-04-2006,422816,Punjab,3,18,21,17,59,Pass
Aditya D'Souza,05-07-2005,955115,Assam,9,0,6,11,26,Pass
Vivaan D'Souza,14-03-2006,287750,Rajasthan,2,15,4,24,45,Pass
Aarav D'Souza,02-04-2005,572381,Bihar,4,16,0,10,30,Pass
Krishna Chopra,21-02-2005,252289,Bihar,13,18,18,2,51,Pass
Sukhwinder Khan,10-11-2005,327744,Jammu & Kashmir + Ladakh,13,22,20,5,60,Pass
Aditya Reddy,19-07-2005,663916,Bihar,20,7,7,19,53,Pass
Ishaan Mehta,13-07-2005,309217,West Bengal,3,13,20,19,55,Pass
Paul Sharma,27-05-2005,804282,Gujarat,16,8,23,18,65,Pass
Raj Pillai,13-01-2006,715974,Madhya Pradesh,11,10,1,12,34,Pass
Sukhwinder Fernandes,01-10-2005,936518,Bihar,22,18,18,6,64,Pass
Aryan Mehta,07-01-2006,421464,Odisha,16,13,2,8,39,Pass
Raj D'Souza,29-06-2005,161379,Rajasthan,6,24,2,17,49,Pass
John D'Souza,04-10-2005,742761,Karnataka,8,24,6,20,58,Pass
Raj Sharma,19-12-2004,474407,Tripura,24,3,18,4,49,Pass
Aarav Reddy,03-01-2006,799759,Uttar Pradesh,22,5,16,12,55,Pass
Imran Sharma,19-05-2005,227443,Tamil Nadu,10,8,21,6,45,Pass
Krishna Reddy,05-05-2006,127698,Punjab,3,19,15,6,43,Pass
Rohan Mehta,08-01-2005,746868,West Bengal,6,7,4,2,19,Pass
Aryan Singh,01-05-2006,371428,Uttar Pradesh,19,5,11,23,58,Pass
Krishna Khan,03-04-2006,288380,Bihar,13,6,17,14,50,Pass
Raj Verma,18-04-2006,860296,Bihar,7,1,8,19,35,Pass
Krishna Mehta,13-12-2004,688759,Madhya Pradesh,0,3,17,6,26,Pass
Raj Sharma,29-03-2006,383377,Madhya Pradesh,7,9,4,3,23,Pass
Aditya Singh,12-02-2006,121181,Uttar Pradesh,14,5,17,7,43,Pass
Aryan Singh,06-11-2005,975698,Bihar,17,24,11,11,63,Pass
Sukhwinder Khan,07-05-2006,812518,Uttarakhand,14,9,18,1,42,Pass
Vivaan Mehta,10-01-2006,488733,Tamil Nadu,4,3,12,17,36,Pass
Sukhwinder Verma,04-12-2005,930714,West Bengal,21,11,12,6,50,Pass
Kunal Mehta,07-02-2005,386102,Rajasthan,16,4,6,2,28,Pass
Rehan Verma,23-09-2005,529848,Madhya Pradesh,11,9,1,10,31,Pass
Peter Reddy,01-01-2006,239248,Andhra Pradesh,0,1,10,17,28,Pass
Rohan Khan,05-07-2005,866667,Haryana,6,6,0,23,35,Pass
Sukhwinder Singh,15-11-2004,319008,Haryana,18,10,4,6,38,Pass
Aryan Verma,13-06-2005,205931,Bihar,2,13,16,18,49,Pass
Kunal Sharma,11-06-2005,673210,Tamil Nadu,10,12,20,9,51,Pass
Vivaan Mehta,13-11-2004,470410,Andhra Pradesh,11,0,8,11,30,Pass
Harjeet Pillai,21-02-2006,683022,Bihar,3,17,11,13,44,Pass
Ishaan Verma,28-04-2005,799609,Madhya Pradesh,10,20,3,23,56,Pass
Aditya Reddy,19-12-2004,892694,Punjab,3,22,14,14,53,Pass
Aryan Verma,02-03-2006,356825,Delhi,0,22,13,24,59,Fail
Ishaan Singh,03-10-2005,566831,Uttar Pradesh,4,5,7,6,22,Pass
John Chopra,12-07-2005,414480,Telangana,24,11,15,15,65,Pass
Aarav Khan,05-06-2005,616216,Uttar Pradesh,10,5,0,17,32,Pass
Kunal Reddy,10-01-2006,452083,Delhi,19,24,4,6,53,Fail
Imran Pillai,12-02-2006,775152,Karnataka,8,18,5,6,37,Pass
Rohan D'Souza,25-11-2004,465863,Kerala,4,17,15,19,55,Pass
Balbir Verma,09-11-2005,745235,West Bengal,5,0,13,16,34,Pass
Paul Verma,03-10-2005,964431,Odisha,0,12,16,8,36,Pass
Aditya Chopra,26-04-2005,105130,Madhya Pradesh,6,6,15,9,36,Pass
Krishna Reddy,12-08-2005,197958,Maharashtra,14,4,24,2,44,Pass
Aarav Chopra,16-04-2006,822518,Maharashtra,13,6,7,14,40,Pass
Kunal Sharma,04-01-2006,619527,Uttar Pradesh,6,5,14,19,44,Pass
Aryan Mehta,07-04-2005,266106,Uttar Pradesh,1,5,2,5,13,Pass
Gurpreet Khan,08-01-2006,452312,Rajasthan,4,13,16,7,40,Pass
Yash Pillai,01-04-2005,619161,Madhya Pradesh,17,4,1,22,44,Pass
Harjeet Singh,03-04-2005,766803,Rajasthan,11,16,13,4,44,Pass
Harjeet Mehta,18-01-2005,858122,Tamil Nadu,1,20,8,6,35,Pass
Krishna Verma,12-12-2005,552821,Punjab,8,4,22,24,58,Pass
Aryan Khan,17-11-2005,828447,Nagaland,6,5,7,5,23,Pass
Kunal Pillai,12-02-2006,236143,Tamil Nadu,10,20,24,22,76,Pass
Aditya Verma,15-12-2004,633053,Rajasthan,6,13,2,11,32,Pass
John Pillai,20-01-2005,615603,Odisha,6,4,8,4,22,Pass
Ayaan Verma,14-09-2005,852722,Rajasthan,12,8,24,2,46,Pass
Vivaan Mehta,17-11-2005,856417,Telangana,8,22,4,4,38,Pass
Yash Fernandes,12-02-2005,280344,Haryana,22,11,7,17,57,Pass
Mathew D'Souza,17-02-2005,489046,Gujarat,13,22,11,4,50,Pass
Aryan Reddy,20-09-2005,626635,Maharashtra,9,20,5,14,48,Pass
Yash Fernandes,15-08-2005,577152,Manipur,11,15,13,4,43,Pass
Yash Khan,18-03-2006,192676,Maharashtra,21,4,11,16,52,Pass
Kunal Khan,20-03-2005,429833,Bihar,0,16,19,6,41,Pass
Aditya D'Souza,03-08-2005,460960,Karnataka,6,11,5,11,33,Pass
Aarav Sharma,02-01-2005,822649,Rajasthan,5,14,17,22,58,Pass
Krishna Sharma,17-02-2005,471331,Andhra Pradesh,9,8,3,0,20,Pass
Aryan Singh,14-04-2005,555630,Maharashtra,0,13,13,19,45,Pass
Aditya Fernandes,11-04-2006,804402,Rajasthan,11,6,0,16,33,Pass
Vivaan Sharma,18-02-2006,833275,Rajasthan,11,24,10,21,66,Pass
Aditya Chopra,28-11-2004,384087,Rajasthan,12,13,22,3,50,Pass
Peter Chopra,26-03-2006,864717,Bihar,7,24,21,7,59,Pass
Aryan Chopra,18-12-2004,654937,Uttar Pradesh,9,5,10,0,24,Pass
Sukhwinder Khan,18-03-2006,568578,Rajasthan,12,6,5,14,37,Pass
Yash Fernandes,21-04-2005,226146,Himachal Pradesh,22,21,1,10,54,Pass
Yash Mehta,25-01-2005,690680,Himachal Pradesh,13,10,24,15,62,Pass
Imran Fernandes,16-11-2004,816482,Uttar Pradesh,18,5,19,10,52,Pass
Rohan Reddy,22-12-2004,722084,Odisha,6,18,10,11,45,Pass
Ishaan D'Souza,20-05-2005,617062,Uttar Pradesh,16,5,3,12,36,Pass
Rohan Singh,24-11-2005,223822,Bihar,6,4,2,21,33,Pass
Yash Pillai,15-04-2005,510559,Uttarakhand,3,12,21,13,49,Pass
Aryan Sharma,25-03-2006,342897,Madhya Pradesh,23,4,2,12,41,Pass
Farhan Khan,19-11-2004,811463,Punjab,15,24,0,1,40,Pass
Sukhwinder Pillai,09-10-2005,255947,Bihar,24,10,24,3,61,Pass
Yash Chopra,01-04-2006,104684,Rajasthan,9,2,22,20,53,Pass
Vivaan D'Souza,10-06-2005,368362,Assam,9,14,14,14,51,Pass
Yash Khan,18-11-2005,509416,Bihar,1,16,21,10,48,Pass
Rohan Fernandes,26-09-2005,329586,Tripura,3,17,7,22,49,Pass
Krishna Mehta,27-02-2005,749003,Uttar Pradesh,3,5,14,19,41,Pass
Ishaan Mehta,15-04-2006,806531,Rajasthan,7,22,18,0,47,Pass
Yash Singh,19-01-2005,765388,Bihar,19,24,5,9,57,Pass
Yash Mehta,19-01-2005,484029,Rajasthan,8,6,9,14,37,Pass
David Sharma,29-01-2006,549628,Maharashtra,3,22,9,4,38,Pass
Manpreet Mehta,17-03-2005,695487,Uttar Pradesh,18,5,14,20,57,Pass
Sukhwinder Fernandes,07-09-2005,545333,Maharashtra,3,7,13,19,42,Pass
Rohan Mehta,31-08-2005,273309,Uttar Pradesh,3,5,21,13,42,Pass
Mathew Reddy,05-12-2004,523832,Maharashtra,13,17,4,1,35,Pass
Aryan Chopra,27-01-2006,610165,Maharashtra,10,4,10,24,48,Pass
Balbir Pillai,27-06-2005,969935,Himachal Pradesh,0,7,10,3,20,Pass
Krishna D'Souza,13-05-2005,187235,Bihar,12,7,9,24,52,Pass
Raj Reddy,31-10-2005,502409,Punjab,19,3,15,15,52,Pass
Krishna Singh,29-06-2005,991577,Uttar Pradesh,14,5,9,24,52,Pass
Yash Fernandes,30-03-2005,906592,Chhattisgarh,3,10,2,13,28,Pass
Krishna Singh,17-12-2004,992501,Bihar,16,14,1,18,49,Pass
Aarav Sharma,28-05-2005,563555,Haryana,3,15,14,12,44,Pass
Rohan Pillai,24-11-2004,874420,Haryana,11,8,8,0,27,Pass
Yash Singh,22-10-2005,825968,West Bengal,19,18,3,6,46,Pass
Kunal Sharma,04-03-2005,276455,Uttar Pradesh,18,5,15,12,50,Pass
Yash D'Souza,21-10-2005,667730,Rajasthan,14,21,1,15,51,Pass
Vivaan Verma,17-03-2006,930314,Kerala,9,4,17,22,52,Pass
Krishna Reddy,31-08-2005,902443,Uttar Pradesh,11,4,21,16,52,Pass
Ayaan Reddy,18-03-2006,820606,Madhya Pradesh,5,15,5,7,32,Pass
Aditya D'Souza,12-09-2005,860133,Uttar Pradesh,4,18,16,15,53,Pass
Aarav Fernandes,04-09-2005,681081,Maharashtra,13,3,0,12,28,Pass
Yash D'Souza,24-02-2005,350381,Kerala,18,17,1,4,40,Pass
Aditya Chopra,05-01-2006,654332,Odisha,7,23,15,8,53,Pass
Mathew D'Souza,09-01-2005,474088,Punjab,7,24,3,19,53,Pass
Imran Mehta,28-10-2005,582076,Maharashtra,16,4,24,17,61,Pass
Krishna Mehta,12-01-2006,322906,Jammu & Kashmir + Ladakh,15,23,14,7,59,Pass
Vivaan D'Souza,01-01-2005,645996,Rajasthan,1,10,19,12,42,Pass
Aarav Singh,23-01-2005,667606,West Bengal,0,21,18,8,47,Pass
Vivaan Reddy,03-06-2005,278479,Bihar,13,11,14,21,59,Pass
Vivaan Chopra,28-01-2005,203077,Haryana,11,0,4,13,28,Pass
Yash Singh,16-05-2005,369191,Gujarat,5,0,0,18,23,Pass
John D'Souza,19-04-2005,162615,Chhattisgarh,20,17,19,19,75,Pass
Rohan Reddy,11-12-2005,557050,Andhra Pradesh,17,12,2,14,45,Pass
Manpreet Chopra,02-05-2005,994720,Telangana,3,6,19,13,41,Pass
Yash Reddy,24-07-2005,257791,Maharashtra,22,4,2,13,41,Pass
Yash Sharma,25-02-2006,306580,Andhra Pradesh,2,10,21,17,50,Pass
Yash Pillai,18-12-2004,247627,Rajasthan,5,16,4,15,40,Pass
Aditya Singh,16-08-2005,167145,Telangana,11,9,21,24,65,Pass
Raj Reddy,02-07-2005,644001,Punjab,17,13,3,21,54,Pass
Ishaan Singh,12-10-2005,446120,Telangana,0,12,20,21,53,Pass
Rehan Singh,01-10-2005,128381,Uttar Pradesh,0,9,17,20,46,Pass
Gurpreet Reddy,05-04-2006,822582,Maharashtra,23,4,19,6,52,Pass
Aryan Khan,01-04-2006,624789,Assam,8,8,22,0,38,Pass
Aryan Chopra,13-11-2005,415564,West Bengal,3,16,20,24,63,Pass
Aditya Verma,25-04-2006,732046,Maharashtra,5,1,22,1,29,Pass
Krishna Fernandes,12-08-2005,978572,Bihar,8,12,8,20,48,Pass
Aryan Fernandes,26-02-2005,671379,Andhra Pradesh,5,20,11,13,49,Pass
Kunal Reddy,27-04-2006,317396,Tamil Nadu,12,22,21,7,62,Pass
Raj Sharma,21-01-2006,665633,Jharkhand,11,5,3,17,36,Pass
Krishna Chopra,01-12-2004,662481,Haryana,21,16,8,21,66,Pass
Ishaan D'Souza,06-03-2006,191456,West Bengal,16,21,10,3,50,Pass
Vivaan Khan,08-01-2006,882357,Haryana,11,8,22,24,65,Pass
Aditya D'Souza,22-11-2005,993293,Bihar,8,23,22,23,76,Pass
Kunal Khan,23-01-2006,251357,Uttar Pradesh,0,15,18,10,43,Pass
Kunal Chopra,11-09-2005,284094,West Bengal,14,12,13,6,45,Pass
Aditya D'Souza,09-10-2005,609946,Rajasthan,18,3,15,16,52,Pass
Krishna D'Souza,05-03-2005,283170,Bihar,11,2,15,9,37,Pass
Raj Pillai,08-12-2005,416858,Uttar Pradesh,0,19,8,5,32,Pass
Aryan Khan,17-02-2006,296322,Gujarat,0,13,4,14,31,Pass
Ishaan Verma,04-01-2006,960436,Punjab,20,24,23,19,86,Pass
Aryan Pillai,07-12-2004,611878,Bihar,2,1,12,24,39,Pass
Vivaan Mehta,12-10-2005,453593,Gujarat,6,4,5,11,26,Pass
Aditya Pillai,01-09-2005,390247,Maharashtra,16,4,4,21,45,Pass
Zaid Pillai,09-01-2006,259497,Kerala,8,9,8,9,34,Pass
Aryan Chopra,20-09-2005,356073,Uttarakhand,19,1,10,17,47,Pass
Krishna Pillai,28-03-2005,869939,West Bengal,20,9,16,0,45,Pass
Kunal Fernandes,08-10-2005,448346,Maharashtra,17,4,22,11,54,Pass
Rohan Pillai,18-01-2005,852147,Bihar,8,21,23,20,72,Pass
Vivaan Fernandes,09-05-2006,688312,Madhya Pradesh,21,9,0,18,48,Pass
Aarav Reddy,12-12-2004,588864,Tamil Nadu,18,7,10,8,43,Pass
Krishna Sharma,18-04-2005,591978,Madhya Pradesh,21,4,15,7,47,Pass
Harjeet Sharma,19-02-2005,812675,Jharkhand,24,10,10,9,53,Pass
Aditya Fernandes,21-10-2005,284297,Uttar Pradesh,0,20,7,19,46,Pass
Sukhwinder Fernandes,16-02-2005,110929,Rajasthan,19,17,20,13,69,Pass
Kunal Pillai,06-07-2005,164992,Karnataka,1,11,17,6,35,Pass
Aditya Verma,22-11-2004,715124,Punjab,5,8,14,6,33,Pass
Aditya Verma,02-01-2006,842703,Bihar,20,11,8,12,51,Pass
Yash Mehta,25-01-2005,753907,Uttar Pradesh,0,19,18,5,42,Pass
Rohan Pillai,21-04-2005,901219,Himachal Pradesh,5,24,21,4,54,Pass
Aryan D'Souza,30-12-2004,784178,Bihar,23,22,1,20,66,Pass
Rohan Chopra,10-03-2006,285444,West Bengal,1,4,6,11,22,Pass
Vivaan Fernandes,01-04-2006,919502,Uttar Pradesh,0,4,4,10,18,Pass
Kunal Singh,29-06-2005,828403,West Bengal,15,5,21,7,48,Pass
Aarav D'Souza,31-07-2005,847005,Rajasthan,23,5,22,13,63,Pass
Harjeet Reddy,02-05-2005,391369,Karnataka,7,2,10,24,43,Pass
Yash Verma,22-10-2005,388706,Maharashtra,5,4,24,14,47,Pass
Aryan Khan,07-12-2004,625457,Tamil Nadu,24,16,20,5,65,Pass
Harjeet Reddy,25-02-2006,901196,Bihar,22,10,16,20,68,Pass
Rohan Sharma,13-02-2006,838472,Maharashtra,12,4,22,18,56,Pass
Yash Fernandes,10-11-2004,422140,Andhra Pradesh,20,5,1,7,33,Pass
Aditya Khan,18-11-2005,186788,Uttar Pradesh,0,10,7,21,38,Pass
Aryan Chopra,22-12-2004,343982,Himachal Pradesh,2,12,1,9,24,Pass
Aryan Verma,07-11-2005,574311,Tamil Nadu,22,12,22,0,56,Pass
Ishaan Singh,05-04-2005,724520,Assam,9,15,9,19,52,Pass
Sukhwinder Mehta,16-02-2006,415607,Jharkhand,17,0,2,1,20,Pass
Rohan Verma,15-11-2004,711249,Odisha,18,17,5,12,52,Pass
Vivaan Singh,09-10-2005,135023,Jharkhand,18,2,4,2,26,Pass
Krishna Sharma,14-08-2005,757282,Tamil Nadu,18,2,12,3,35,Pass
Aditya Khan,23-08-2005,936254,Maharashtra,11,4,20,18,53,Pass
Aditya Pillai,22-11-2005,999951,Karnataka,4,5,4,11,24,Pass
Yash Pillai,14-04-2005,645950,Bihar,10,7,20,23,60,Pass
Yash Khan,24-06-2005,425524,Jharkhand,10,3,21,14,48,Pass
Aarav Singh,30-11-2004,336644,Gujarat,6,22,11,18,57,Pass
Manpreet Pillai,17-01-2006,712248,Maharashtra,23,4,1,23,51,Pass
Krishna Fernandes,07-04-2005,695081,Madhya Pradesh,24,14,3,4,45,Pass
Ishaan Fernandes,05-05-2005,942872,Madhya Pradesh,24,4,3,22,53,Pass
Yash Reddy,17-01-2006,313714,Bihar,23,14,6,17,60,Pass
Gurpreet Reddy,19-01-2005,199485,Tamil Nadu,23,23,9,3,58,Pass
Yash Singh,28-12-2005,974956,Karnataka,18,15,15,12,60,Pass
Vivaan Fernandes,09-01-2005,742911,Jharkhand,10,11,1,18,40,Pass
Farhan Mehta,28-11-2005,455951,Uttar Pradesh,0,1,7,23,31,Pass
Kunal Mehta,19-10-2005,607008,Maharashtra,3,5,3,2,13,Pass
Aditya Singh,20-06-2005,936602,Telangana,14,12,7,13,46,Pass
Aarav Reddy,25-08-2005,161820,Maharashtra,13,4,7,18,42,Pass
Sukhwinder Pillai,08-12-2004,250656,West Bengal,3,2,19,13,37,Pass
Aarav Fernandes,24-06-2005,561370,Tamil Nadu,12,23,16,13,64,Pass
Peter Reddy,02-04-2006,938587,Andhra Pradesh,18,5,0,1,24,Pass
Krishna Mehta,08-10-2005,658241,Himachal Pradesh,17,13,5,13,48,Pass
Rohan Singh,05-01-2006,635636,West Bengal,12,1,7,18,38,Pass
Rohan Singh,30-08-2005,647349,Maharashtra,23,4,1,14,42,Pass
Peter Pillai,10-01-2005,931245,Bihar,22,16,14,8,60,Pass
Vivaan Chopra,17-11-2004,925043,Uttar Pradesh,0,12,21,6,39,Pass
Kunal Pillai,24-04-2005,726000,Madhya Pradesh,5,11,24,3,43,Pass
Ishaan Singh,11-11-2005,340176,Karnataka,8,4,15,17,44,Pass
Yash Mehta,23-04-2006,613846,Rajasthan,1,1,11,17,30,Pass
Rohan Fernandes,06-09-2005,302621,Uttar Pradesh,0,18,9,15,42,Pass
Ishaan Chopra,08-05-2006,635538,Himachal Pradesh,21,5,9,6,41,Pass
Kunal Reddy,24-05-2005,157278,Uttar Pradesh,0,24,4,15,43,Pass
Yash Chopra,29-09-2005,533289,Madhya Pradesh,6,21,18,4,49,Pass
Aarav Reddy,05-02-2005,935030,Maharashtra,8,12,4,1,25,Pass
Vivaan Fernandes,09-06-2005,346341,Maharashtra,16,4,22,2,44,Pass
Mathew Singh,27-12-2004,593074,Tamil Nadu,24,20,18,19,81,Pass
David Pillai,05-09-2005,390359,Bihar,5,6,22,12,45,Pass
Balbir Singh,14-02-2005,518229,Uttar Pradesh,0,8,13,23,44,Pass
Vivaan Pillai,08-03-2005,167045,Tripura,22,12,6,7,47,Pass
Balbir Reddy,22-02-2006,603038,Telangana,10,6,5,24,45,Pass
Kunal Reddy,27-02-2006,989637,Rajasthan,6,13,17,9,45,Pass
Mathew Khan,30-07-2005,205485,Odisha,0,3,22,3,28,Pass
Imran Sharma,19-07-2005,583318,Uttar Pradesh,0,14,0,15,29,Pass
Harjeet Singh,08-06-2005,257228,Madhya Pradesh,5,4,10,11,30,Pass
Kunal Sharma,20-06-2005,958381,Maharashtra,1,12,7,22,42,Pass
David Singh,25-02-2006,977682,Punjab,5,11,14,21,51,Pass
Krishna Khan,27-04-2005,449099,Rajasthan,15,6,18,0,39,Pass
Aarav Sharma,09-05-2006,914191,Madhya Pradesh,3,18,2,22,45,Pass
Yash Pillai,22-04-2005,267659,Rajasthan,20,1,20,24,65,Pass
Sukhwinder Reddy,10-12-2005,365609,Haryana,24,4,20,12,60,Pass
Aarav Singh,25-11-2004,789994,Chhattisgarh,0,17,15,5,37,Pass
Gurpreet Mehta,13-06-2005,445281,Telangana,15,1,15,15,46,Pass
Aditya Singh,02-08-2005,178829,Maharashtra,20,13,10,0,43,Pass
Vivaan Sharma,23-05-2005,994215,Madhya Pradesh,9,22,14,4,49,Pass
Peter Sharma,05-06-2005,462889,Punjab,23,15,18,3,59,Pass
Kunal Chopra,08-02-2006,177687,Uttarakhand,24,18,5,3,50,Pass
Rohan Pillai,03-04-2005,407571,Madhya Pradesh,5,8,10,9,32,Pass
Aditya Mehta,17-10-2005,598636,Maharashtra,16,4,22,21,63,Pass
Kunal D'Souza,07-10-2005,568589,Gujarat,6,5,23,18,52,Pass
John Verma,08-12-2005,607713,Andhra Pradesh,7,8,1,4,20,Pass
Aarav Sharma,20-11-2005,223142,Assam,0,14,10,23,47,Pass
John Reddy,09-11-2004,744976,Punjab,8,10,10,7,35,Pass
Raj Khan,22-11-2004,454075,Uttarakhand,20,0,13,14,47,Pass
Manpreet D'Souza,10-10-2005,839366,Maharashtra,21,4,21,15,61,Pass
Rohan Mehta,18-03-2005,989247,Uttar Pradesh,0,13,1,22,36,Pass
Farhan Reddy,20-04-2005,365418,Assam,7,7,9,4,27,Pass
Rohan Pillai,14-11-2005,218742,Rajasthan,7,4,3,19,33,Pass
Ishaan Singh,21-03-2005,748664,West Bengal,9,10,16,6,41,Pass
Yash D'Souza,31-05-2005,729657,Rajasthan,3,9,11,13,36,Pass
Gurpreet Fernandes,22-03-2005,257059,Uttar Pradesh,0,8,11,16,35,Pass
Kunal Verma,10-01-2006,664001,Punjab,11,15,3,16,45,Pass
Kunal Pillai,02-11-2005,849988,Haryana,11,19,13,10,53,Pass
Aarav Singh,26-03-2005,992384,West Bengal,7,10,12,1,30,Pass
Ayaan Fernandes,17-10-2005,496108,Tamil Nadu,6,24,1,17,48,Pass
Mathew Mehta,16-10-2005,538740,Gujarat,14,0,4,19,37,Pass
Aarav Sharma,06-05-2006,124571,West Bengal,23,13,0,18,54,Pass
Aditya Singh,26-09-2005,762758,Telangana,6,12,17,11,46,Pass
David D'Souza,25-10-2005,568121,Bihar,8,17,21,19,65,Pass
Rohan Reddy,02-03-2006,332234,Haryana,18,0,9,3,30,Pass
Aryan Pillai,18-05-2005,241218,Gujarat,23,16,17,0,56,Pass
Farhan Chopra,20-03-2005,994732,Bihar,16,21,14,7,58,Pass
Gurpreet Reddy,06-12-2005,847677,Karnataka,14,22,11,0,47,Pass
Krishna Mehta,15-04-2005,414969,Assam,2,17,17,8,44,Pass
Kunal D'Souza,07-12-2005,801807,Madhya Pradesh,16,23,16,4,59,Pass
Manpreet Sharma,07-03-2006,657972,Madhya Pradesh,0,14,8,17,39,Pass
David D'Souza,31-03-2005,467127,Karnataka,22,1,22,11,56,Pass
Krishna Reddy,14-12-2005,597896,Meghalaya,5,14,2,10,31,Pass
Ishaan Verma,23-06-2005,156386,Bihar,13,16,20,4,53,Pass
Paul Mehta,11-11-2004,152283,Tamil Nadu,8,7,24,15,54,Pass
Aryan D'Souza,23-11-2004,768334,Punjab,22,7,2,7,38,Pass
Manpreet Singh,09-02-2006,935605,Tamil Nadu,8,21,23,10,62,Pass
Ishaan Singh,05-05-2005,635741,Bihar,11,24,14,18,67,Pass
Gurpreet Chopra,04-03-2005,202111,Telangana,17,4,20,4,45,Pass
Ayaan Verma,03-06-2005,832722,Andhra Pradesh,15,6,0,12,33,Pass
Zaid Chopra,26-05-2005,633988,Kerala,3,16,13,16,48,Pass
Sukhwinder D'Souza,24-07-2005,287867,Bihar,21,14,16,7,58,Pass
Yash D'Souza,13-06-2005,839956,Rajasthan,12,23,7,10,52,Pass
Yash Sharma,10-05-2005,870995,Madhya Pradesh,0,10,11,2,23,Pass
Aditya Chopra,16-01-2005,423057,Delhi,2,6,10,15,33,Fail
Rohan Sharma,30-04-2005,167976,Rajasthan,19,2,5,21,47,Pass
Krishna Mehta,08-07-2005,974823,Bihar,23,17,21,24,85,Pass
Rohan Mehta,21-02-2006,511545,Rajasthan,6,13,18,18,55,Pass
Rohan Verma,10-03-2005,276074,Rajasthan,7,13,16,1,37,Pass
Aarav Singh,13-01-2005,816581,Karnataka,21,9,15,17,62,Pass
Rohan Reddy,07-01-2006,818353,Rajasthan,15,17,12,24,68,Pass
Ishaan Singh,24-04-2005,610207,Uttar Pradesh,0,6,6,7,19,Pass
Harjeet Reddy,24-02-2006,913428,Chhattisgarh,19,14,1,0,34,Pass
Aryan Sharma,28-09-2005,575359,Bihar,2,1,7,14,24,Pass
Manpreet Fernandes,24-02-2006,613550,Maharashtra,13,19,5,5,42,Pass
Harjeet Singh,17-02-2006,627107,Gujarat,22,9,1,20,52,Pass
Krishna Reddy,15-08-2005,397261,Rajasthan,7,19,1,22,49,Pass
Yash Mehta,09-02-2005,424037,Tamil Nadu,21,18,1,16,56,Pass
Aryan Sharma,28-04-2005,734181,Chhattisgarh,13,21,20,18,72,Pass
Farhan Chopra,14-02-2006,433455,Rajasthan,19,24,3,16,62,Pass
Yash Reddy,05-02-2006,884341,Jharkhand,5,16,0,14,35,Pass
Raj Pillai,05-03-2006,444823,Telangana,16,24,10,11,61,Pass
Sukhwinder Mehta,14-06-2005,902438,Uttar Pradesh,0,7,3,1,11,Pass
Mathew Khan,30-11-2005,374369,Bihar,20,21,23,17,81,Pass
Manpreet Chopra,29-06-2005,286236,Maharashtra,20,4,13,14,51,Pass
Vivaan Sharma,05-05-2006,535692,Uttar Pradesh,0,21,16,12,49,Pass
Kunal Khan,25-09-2005,676721,Karnataka,14,11,3,20,48,Pass
Raj D'Souza,16-07-2005,243153,Madhya Pradesh,22,18,5,4,49,Pass
Aarav Reddy,25-10-2005,889378,Bihar,20,16,11,11,58,Pass
Raj Sharma,12-04-2006,970591,Gujarat,21,24,6,12,63,Pass
David Fernandes,20-02-2006,524390,Bihar,11,13,14,15,53,Pass
Aryan Singh,03-09-2005,206920,Maharashtra,11,5,14,12,42,Pass
Yash D'Souza,31-01-2006,522336,Bihar,7,1,19,4,31,Pass
Aarav Pillai,03-02-2006,863373,Kerala,16,8,15,19,58,Pass
Kunal Khan,11-02-2005,707595,Maharashtra,23,4,16,21,64,Pass
Yash Pillai,06-02-2005,547559,Gujarat,22,1,14,23,60,Pass
Aryan D'Souza,25-08-2005,884310,Maharashtra,3,4,8,15,30,Pass
Raj Pillai,19-02-2006,177166,Bihar,24,0,2,23,49,Pass
Ishaan Pillai,12-08-2005,597322,Himachal Pradesh,8,18,0,8,34,Pass
Krishna D'Souza,07-08-2005,935798,Rajasthan,14,9,23,23,69,Pass
Balbir Khan,04-11-2005,419926,Andhra Pradesh,2,16,5,7,30,Pass
John Reddy,17-01-2006,579681,Rajasthan,12,1,17,12,42,Pass
Rohan Chopra,17-12-2005,471676,Tamil Nadu,23,17,7,21,68,Pass
Kunal D'Souza,29-10-2005,594144,Arunachal Pradesh,20,22,1,19,62,Pass
Peter Sharma,16-02-2006,778234,Maharashtra,19,4,6,11,40,Pass
Kunal Singh,03-04-2006,108697,Odisha,24,12,20,0,56,Pass
Aditya Fernandes,14-06-2005,253230,Madhya Pradesh,5,19,6,11,41,Pass
Aarav Pillai,04-02-2006,900870,Bihar,0,6,11,20,37,Pass
Krishna Singh,12-12-2005,796832,Bihar,9,8,17,22,56,Pass
Vivaan Singh,05-05-2005,211691,Haryana,6,22,1,13,42,Pass
Aarav Singh,01-02-2005,145349,Tamil Nadu,1,15,7,9,32,Pass
Balbir Singh,11-04-2006,449233,Andhra Pradesh,3,17,23,24,67,Pass
Raj Sharma,05-02-2005,498307,Uttar Pradesh,0,8,22,0,30,Pass
Aditya Khan,08-04-2006,673839,Uttarakhand,0,17,14,12,43,Pass
Paul Singh,15-01-2006,402567,Himachal Pradesh,5,1,15,10,31,Pass
Raj Sharma,14-03-2006,164145,Himachal Pradesh,22,8,2,5,37,Pass
Ishaan Khan,16-09-2005,664752,Bihar,20,24,18,13,75,Pass
Raj Khan,28-01-2006,579181,Chhattisgarh,21,0,21,22,64,Pass
Rohan Verma,20-11-2004,268726,Chhattisgarh,10,19,15,3,47,Pass
Aditya Reddy,30-11-2004,149820,Punjab,13,1,1,23,38,Pass
Kunal Verma,01-10-2005,773637,Punjab,7,2,17,11,37,Pass
Vivaan Pillai,10-02-2006,955203,Bihar,19,12,24,18,73,Pass
Vivaan Pillai,26-08-2005,842751,Haryana,18,14,7,12,51,Pass
David Singh,29-12-2005,934471,Maharashtra,22,4,23,2,51,Pass
Zaid Sharma,27-09-2005,430899,Bihar,14,11,11,11,47,Pass
Imran Fernandes,29-04-2006,436825,Uttar Pradesh,0,10,22,22,54,Pass
Aarav Reddy,19-07-2005,714092,Uttar Pradesh,0,7,10,17,34,Pass
Yash Verma,02-03-2005,795614,Haryana,7,13,9,7,36,Pass
Yash Khan,18-11-2005,588501,Assam,7,14,13,15,49,Pass
Raj Khan,01-12-2004,117439,Maharashtra,3,4,23,20,50,Pass
Yash Sharma,15-03-2006,420890,Karnataka,23,9,18,14,64,Pass
Gurpreet D'Souza,19-02-2006,459710,Bihar,19,15,21,20,75,Pass
Paul Fernandes,30-12-2004,402040,West Bengal,3,1,24,15,43,Pass
Ishaan Chopra,06-12-2005,693299,Bihar,0,10,18,8,36,Pass
Krishna Mehta,14-03-2006,520974,Uttar Pradesh,0,1,12,10,23,Pass
Vivaan D'Souza,02-01-2006,277019,Uttarakhand,3,23,12,22,60,Pass
Sukhwinder Fernandes,17-02-2006,404217,Rajasthan,7,16,10,11,44,Pass
Kunal Mehta,01-01-2005,572195,Andhra Pradesh,21,9,5,2,37,Pass
Balbir D'Souza,19-01-2005,609473,Odisha,18,1,3,0,22,Pass
Krishna Verma,24-01-2006,487495,Assam,19,7,6,6,38,Pass
Yash Verma,28-04-2006,139757,Karnataka,16,22,2,18,58,Pass
Ayaan Khan,14-11-2005,699343,Karnataka,2,16,20,17,55,Pass
Yash Reddy,25-06-2005,335627,Rajasthan,11,21,7,0,39,Pass
Aryan Reddy,26-11-2004,194843,Uttar Pradesh,0,15,2,1,18,Pass
Vivaan Mehta,15-03-2005,858158,Uttar Pradesh,0,17,3,5,25,Pass
Krishna Singh,09-11-2005,451030,Nagaland,4,9,4,2,19,Pass
Yash Verma,07-12-2005,179163,Uttarakhand,3,21,14,13,51,Pass
Rohan D'Souza,06-01-2005,129484,West Bengal,1,7,7,20,35,Pass
Ishaan Chopra,12-07-2005,782869,Assam,3,11,5,20,39,Pass
Vivaan Fernandes,24-02-2006,273143,Jharkhand,4,10,2,10,26,Pass
Kunal Pillai,02-04-2005,589989,Bihar,16,17,10,15,58,Pass
Aditya Fernandes,09-09-2005,274962,Rajasthan,14,4,12,12,42,Pass
Ishaan Khan,21-09-2005,347629,Assam,7,19,1,14,41,Pass
John Reddy,03-04-2005,739000,Punjab,16,6,5,0,27,Pass
Yash Mehta,22-06-2005,113519,Himachal Pradesh,5,19,12,6,42,Pass
Ishaan Fernandes,08-01-2005,808394,Chhattisgarh,16,24,15,3,58,Pass
Vivaan Pillai,01-01-2006,389330,Himachal Pradesh,11,20,5,10,46,Pass
Kunal Pillai,02-05-2005,562017,Odisha,22,13,3,19,57,Pass
Ishaan D'Souza,10-11-2005,130066,Assam,13,17,8,4,42,Pass
Krishna D'Souza,27-01-2006,813298,Punjab,9,3,20,15,47,Pass
Aditya Khan,19-08-2005,632872,West Bengal,0,3,13,1,17,Pass
Manpreet Pillai,05-02-2005,233448,Assam,2,16,21,9,48,Pass
Aditya Mehta,20-07-2005,813912,Nagaland,4,22,4,2,32,Pass
Balbir Khan,17-01-2005,343216,Maharashtra,20,4,9,22,55,Pass
Balbir Chopra,22-11-2005,669774,Punjab,1,18,23,14,56,Pass
Yash Khan,17-01-2006,463322,Uttar Pradesh,0,9,9,0,18,Pass
Balbir Khan,09-01-2006,435917,Odisha,16,7,5,10,38,Pass
Aarav Singh,02-01-2006,925118,Jammu & Kashmir + Ladakh,20,18,13,3,54,Pass
Krishna Fernandes,16-02-2005,946304,Tamil Nadu,9,18,9,22,58,Pass
Vivaan Sharma,15-11-2005,605740,Bihar,12,17,24,24,77,Pass
Paul Pillai,04-05-2005,114112,Uttar Pradesh,0,11,21,20,52,Pass
Aditya Verma,04-11-2005,606743,Haryana,18,0,17,14,49,Pass
Imran Reddy,25-12-2005,136069,Rajasthan,5,3,21,5,34,Pass
Kunal Sharma,05-12-2005,899904,Andhra Pradesh,6,5,16,17,44,Pass
Aarav Khan,28-06-2005,997704,Assam,9,18,16,11,54,Pass
Aditya D'Souza,06-04-2006,851795,Rajasthan,13,1,4,13,31,Pass
Vivaan Pillai,08-11-2005,528767,Tamil Nadu,9,11,17,13,50,Pass
Aditya Reddy,16-08-2005,982992,Karnataka,18,22,13,12,65,Pass
Yash Reddy,23-09-2005,939803,Rajasthan,13,20,20,8,61,Pass
Aarav Pillai,26-03-2006,354165,Haryana,18,3,6,18,45,Pass
Aditya Fernandes,25-05-2005,602700,Bihar,22,16,8,8,54,Pass
Ishaan Fernandes,10-02-2006,471313,Daman & Diu / D&N Haveli,8,8,6,9,31,Pass
Ishaan Fernandes,19-07-2005,428535,Rajasthan,5,5,3,21,34,Pass
Aryan Verma,11-03-2006,351392,Madhya Pradesh,15,21,19,4,59,Pass
Paul Reddy,23-01-2006,698873,Punjab,14,14,23,22,73,Pass
Aarav Fernandes,29-12-2005,234503,Gujarat,11,11,18,20,60,Pass
Aryan D'Souza,12-01-2005,950678,Jammu & Kashmir + Ladakh,4,16,18,10,48,Pass
Manpreet Fernandes,16-01-2005,210798,Gujarat,6,1,23,8,38,Pass
Vivaan Reddy,08-02-2005,140539,Telangana,13,10,20,5,48,Pass
Kunal Reddy,05-10-2005,667428,Bihar,22,20,17,19,78,Pass
Aryan Fernandes,30-11-2005,149985,Rajasthan,1,15,15,17,48,Pass
Harjeet Chopra,19-12-2004,735174,Uttar Pradesh,0,5,22,22,49,Pass
Aarav Mehta,09-02-2006,918649,Madhya Pradesh,13,14,14,4,45,Pass
Ishaan Pillai,20-12-2005,996108,Punjab,16,7,19,9,51,Pass
Ishaan Sharma,30-06-2005,767775,Jharkhand,17,2,13,2,34,Pass
Paul Singh,26-01-2006,102237,Odisha,2,12,21,20,55,Pass
Kunal D'Souza,23-11-2005,870453,Jharkhand,5,2,16,6,29,Pass
Aarav Verma,17-02-2005,639584,Rajasthan,14,21,9,9,53,Pass
Ishaan Chopra,01-01-2005,823947,Assam,0,16,19,2,37,Pass
Aditya D'Souza,16-08-2005,274898,Rajasthan,10,1,19,8,38,Pass
Raj Fernandes,16-12-2005,680268,Madhya Pradesh,15,22,21,4,62,Pass
Zaid Mehta,08-05-2006,457724,Telangana,2,15,19,7,43,Pass
Aditya Chopra,18-05-2005,730420,Karnataka,3,3,17,15,38,Pass
Aditya Fernandes,09-03-2006,405202,Assam,8,20,7,7,42,Pass
Aryan Sharma,17-02-2005,644538,Maharashtra,21,4,2,8,35,Pass
Aarav Reddy,28-08-2005,133877,Tamil Nadu,15,23,20,10,68,Pass
Aryan Singh,17-12-2005,686634,Uttar Pradesh,0,0,23,9,32,Pass
Yash Mehta,12-12-2005,758337,Uttar Pradesh,0,7,13,14,34,Pass
Ishaan Khan,05-08-2005,830781,Rajasthan,16,7,13,24,60,Pass
Aarav Sharma,07-09-2005,867684,Bihar,24,2,6,17,49,Pass
John Sharma,29-04-2005,692211,Rajasthan,0,15,21,20,56,Pass
Ishaan Verma,15-12-2004,581458,Madhya Pradesh,11,18,10,4,43,Pass
Balbir Chopra,03-03-2005,864155,Madhya Pradesh,5,16,15,4,40,Pass
Rohan Sharma,24-02-2005,624682,Chhattisgarh,7,6,4,17,34,Pass
Ishaan Khan,02-01-2006,864062,Telangana,0,13,15,21,49,Pass
Aryan D'Souza,03-11-2005,805167,Tamil Nadu,20,5,11,4,40,Pass
Ishaan Sharma,28-12-2005,970252,Odisha,1,1,4,13,19,Pass
Vivaan Fernandes,01-01-2006,711599,Andhra Pradesh,11,10,8,1,30,Pass
Ayaan Khan,03-03-2006,845895,Gujarat,8,8,24,6,46,Pass
Aarav Verma,09-11-2004,372635,Odisha,18,24,3,24,69,Pass
Ishaan Reddy,18-10-2005,576999,Uttar Pradesh,0,5,12,22,39,Pass
Peter D'Souza,01-04-2005,116201,Kerala,15,7,23,1,46,Pass
Aarav Khan,18-02-2005,500192,Uttar Pradesh,0,24,0,11,35,Pass
Vivaan Singh,18-11-2005,347319,Maharashtra,15,4,24,6,49,Pass
Paul Reddy,15-10-2005,832516,Chhattisgarh,15,6,8,20,49,Pass
Aryan Sharma,17-07-2005,194570,Andhra Pradesh,15,18,20,6,59,Pass
John Singh,12-04-2005,418431,Uttar Pradesh,0,17,5,3,25,Pass
Aarav Reddy,25-02-2005,843396,West Bengal,3,23,23,12,61,Pass
Aryan Khan,17-10-2005,228955,Andhra Pradesh,11,19,6,8,44,Pass
Manpreet Mehta,06-05-2006,775362,Punjab,23,17,21,19,80,Pass
Aryan Chopra,21-04-2006,652120,Madhya Pradesh,8,16,11,17,52,Pass
Kunal Singh,06-08-2005,459788,Assam,11,23,13,11,58,Pass
Rohan Chopra,21-12-2005,221290,Bihar,16,6,13,3,38,Pass
Raj Reddy,29-11-2005,319954,Haryana,1,19,24,24,68,Pass
John Pillai,16-12-2005,605481,Odisha,0,17,5,12,34,Pass
Kunal Singh,25-12-2005,365673,Tamil Nadu,1,4,0,18,23,Pass
Vivaan Sharma,27-09-2005,585793,West Bengal,4,18,18,10,50,Pass
Balbir Khan,15-10-2005,999067,Uttar Pradesh,0,13,20,20,53,Pass
Aarav Verma,20-06-2005,966925,Bihar,6,18,0,18,42,Pass
Yash Fernandes,27-01-2006,937633,Bihar,12,9,22,0,43,Pass
Ishaan Verma,06-04-2005,744652,Haryana,20,15,9,8,52,Pass
Raj D'Souza,23-09-2005,782237,Jharkhand,3,7,14,3,27,Pass
Vivaan Fernandes,16-08-2005,683180,Punjab,13,19,2,14,48,Pass
Aarav Chopra,24-02-2006,142019,Rajasthan,9,4,11,9,33,Pass
Raj Sharma,20-04-2005,227753,Odisha,4,9,24,11,48,Pass
Sukhwinder D'Souza,13-06-2005,849493,Bihar,6,9,16,19,50,Pass
Aarav Singh,26-07-2005,477297,Punjab,12,15,6,15,48,Pass
Yash D'Souza,25-02-2005,214284,Uttar Pradesh,0,7,21,4,32,Pass
Krishna Pillai,01-03-2005,436939,Maharashtra,19,23,0,7,49,Pass
Ishaan Reddy,29-03-2005,876555,Assam,6,5,7,16,34,Pass
Vivaan Singh,17-04-2006,701686,Andhra Pradesh,16,12,10,20,58,Pass
Yash Chopra,31-03-2005,531260,Gujarat,17,18,2,12,49,Pass
Kunal Fernandes,28-11-2004,327303,Odisha,6,1,6,16,29,Pass
Kunal Reddy,13-07-2005,841222,Rajasthan,23,2,13,11,49,Pass
John Verma,30-12-2005,995671,Odisha,13,12,2,6,33,Pass
Aryan Chopra,21-12-2005,827752,Uttar Pradesh,0,12,0,9,21,Pass
John Reddy,06-03-2006,761513,Bihar,17,8,15,8,48,Pass
Vivaan Mehta,24-02-2005,440821,Haryana,10,19,0,8,37,Pass
Raj Mehta,24-04-2006,352327,Maharashtra,24,4,21,11,60,Pass
Yash Fernandes,22-02-2006,788466,Haryana,21,24,4,4,53,Pass
Aditya Sharma,09-02-2006,479963,Rajasthan,16,5,4,17,42,Pass
Imran Verma,23-04-2005,467115,Assam,21,0,7,19,47,Pass
Yash Singh,18-09-2005,539621,Karnataka,2,20,23,10,55,Pass
Kunal Pillai,13-02-2005,609494,Bihar,4,6,21,11,42,Pass
Raj Pillai,24-11-2004,615866,West Bengal,18,17,4,14,53,Pass
Aarav Mehta,23-08-2005,146859,Bihar,21,21,12,4,58,Pass
Kunal Mehta,25-06-2005,388771,Punjab,7,15,3,14,39,Pass
Aryan D'Souza,08-01-2006,606312,Tamil Nadu,24,21,8,1,54,Pass
Gurpreet Khan,21-03-2005,409205,Tamil Nadu,14,15,12,1,42,Pass
Sukhwinder Chopra,22-11-2005,847049,West Bengal,19,9,15,4,47,Pass
Krishna Chopra,13-03-2006,558493,Manipur,4,18,23,11,56,Pass
Aryan Verma,22-01-2005,113164,Uttar Pradesh,0,7,13,15,35,Pass
Aditya Chopra,20-07-2005,512498,Maharashtra,17,14,8,10,49,Pass
Harjeet Chopra,20-02-2006,487915,Haryana,9,7,22,12,50,Pass
Krishna Reddy,14-09-2005,976863,Punjab,3,7,13,22,45,Pass
Aditya Verma,28-04-2006,812229,Telangana,3,0,16,1,20,Pass
Yash Mehta,24-01-2006,166308,Tamil Nadu,11,4,21,14,50,Pass
Raj Sharma,11-02-2006,757284,Uttar Pradesh,0,14,9,5,28,Pass
Yash Reddy,19-11-2005,167827,Bihar,7,24,2,4,37,Pass
Ayaan D'Souza,22-09-2005,346991,Odisha,10,19,2,16,47,Pass
Farhan Reddy,23-09-2005,805581,Uttar Pradesh,0,9,19,10,38,Pass
Yash Pillai,26-04-2006,661201,Manipur,7,0,23,11,41,Pass
Aditya Reddy,12-03-2005,791472,Haryana,6,14,16,4,40,Pass
Aditya Mehta,17-03-2005,429853,Chhattisgarh,11,2,16,16,45,Pass
Mathew Chopra,29-03-2005,860568,Uttar Pradesh,0,7,6,21,34,Pass
Ishaan Pillai,07-03-2005,338741,Gujarat,22,19,21,20,82,Pass
Ishaan Reddy,29-01-2005,731728,Rajasthan,12,8,16,24,60,Pass
Manpreet Verma,05-04-2006,619793,Gujarat,15,15,24,12,66,Pass
Sukhwinder Fernandes,22-11-2005,245650,Maharashtra,5,5,23,5,38,Pass
Mathew Khan,20-11-2004,905186,Telangana,16,24,8,6,54,Pass
Gurpreet Verma,15-12-2004,230298,Rajasthan,23,8,13,5,49,Pass
Peter Verma,22-01-2006,164232,Karnataka,8,9,7,7,31,Pass
Imran Khan,05-04-2006,922124,Tamil Nadu,20,7,20,22,69,Pass
Vivaan Sharma,18-04-2006,697138,Uttar Pradesh,0,24,24,10,58,Pass
Paul Reddy,08-08-2005,276813,Jharkhand,5,14,5,2,26,Pass
Harjeet Singh,28-01-2005,189491,Odisha,16,18,12,22,68,Pass
Yash Verma,31-01-2005,360240,Maharashtra,4,15,6,15,40,Pass
Peter Pillai,25-01-2006,202560,Tripura,6,8,17,22,53,Pass
Aarav Singh,23-07-2005,570124,Jharkhand,11,9,4,7,31,Pass
Aryan Reddy,02-12-2005,814533,Karnataka,7,7,19,2,35,Pass
Raj Reddy,04-07-2005,286491,Maharashtra,0,1,14,3,18,Pass
Ishaan Chopra,03-07-2005,670878,Rajasthan,13,8,8,6,35,Pass
Peter Reddy,09-04-2005,742083,Jharkhand,23,5,4,9,41,Pass
Sukhwinder D'Souza,12-01-2006,768196,Rajasthan,21,22,7,23,73,Pass
Aarav Chopra,29-08-2005,367324,Uttar Pradesh,0,4,0,12,16,Pass
John Khan,01-03-2005,100415,Uttar Pradesh,0,7,4,1,12,Pass
Zaid D'Souza,25-01-2006,404531,Jharkhand,19,24,3,5,51,Pass
Zaid D'Souza,05-12-2004,245226,Madhya Pradesh,6,13,9,1,29,Pass
Yash Chopra,18-02-2005,762479,Madhya Pradesh,1,20,14,7,42,Pass
Vivaan Sharma,06-05-2005,288176,Tamil Nadu,21,10,4,13,48,Pass
Kunal Singh,15-01-2005,461879,Tamil Nadu,20,13,12,19,64,Pass
Yash Singh,16-05-2005,526870,Uttar Pradesh,0,1,19,7,27,Pass
Rohan Chopra,16-01-2006,412547,Uttarakhand,3,24,19,19,65,Pass
Krishna Sharma,03-07-2005,770540,Bihar,10,4,3,15,32,Pass
Mathew Fernandes,04-03-2006,343936,Bihar,4,2,1,16,23,Pass
Rohan Mehta,06-04-2005,553875,Jharkhand,5,9,20,8,42,Pass
Krishna Pillai,20-05-2005,301585,Assam,21,6,8,11,46,Pass
David Khan,17-02-2006,180137,Uttar Pradesh,0,10,12,19,41,Pass
Raj Khan,18-02-2005,169831,Punjab,13,21,17,6,57,Pass
Harjeet Pillai,03-04-2005,659303,Odisha,10,13,20,1,44,Pass
John Singh,18-04-2005,528834,Tamil Nadu,17,0,6,11,34,Pass
Paul Pillai,21-11-2005,886223,Uttar Pradesh,0,17,7,11,35,Pass
Aditya Reddy,13-01-2006,148922,Uttar Pradesh,0,18,17,23,58,Pass
Krishna Fernandes,25-11-2005,432655,Haryana,8,4,9,4,25,Pass
Ishaan D'Souza,01-03-2005,339301,Odisha,3,12,6,5,26,Pass
Ishaan Reddy,03-07-2005,107263,Kerala,19,15,5,24,63,Pass
Raj Verma,03-05-2005,190507,Bihar,1,7,1,6,15,Pass
Aarav Sharma,21-12-2004,210442,Tamil Nadu,3,7,0,5,15,Pass
Aarav Fernandes,19-05-2005,965654,Tamil Nadu,14,10,23,20,67,Pass
Aditya Sharma,05-07-2005,549914,Rajasthan,11,15,14,2,42,Pass
Peter Sharma,31-12-2005,868896,Kerala,7,1,16,20,44,Pass
Aryan Fernandes,14-02-2006,107801,Uttar Pradesh,0,12,17,23,52,Pass
Farhan Mehta,09-07-2005,863547,Maharashtra,19,4,23,12,58,Pass
Aryan D'Souza,28-11-2004,230114,Jammu & Kashmir + Ladakh,9,9,23,8,49,Pass
Sukhwinder Chopra,01-05-2006,462030,Uttar Pradesh,0,1,9,7,17,Pass
Raj Mehta,31-03-2005,126016,West Bengal,3,12,22,24,61,Pass
Ishaan Fernandes,20-12-2004,374708,Uttar Pradesh,0,1,5,4,10,Pass
Aditya Pillai,10-04-2005,933269,Madhya Pradesh,19,1,10,13,43,Pass
Yash Mehta,16-03-2005,580726,Punjab,2,6,11,18,37,Pass
Krishna Khan,10-01-2005,977116,Haryana,19,23,16,21,79,Pass
Balbir Verma,18-06-2005,310223,Maharashtra,22,4,18,19,63,Pass
Paul Chopra,22-04-2005,856766,Assam,6,8,1,3,18,Pass
Aditya Reddy,14-05-2005,233389,Bihar,22,17,15,12,66,Pass
Vivaan Mehta,16-03-2006,357389,Jharkhand,2,4,0,8,14,Pass
Vivaan Sharma,08-09-2005,172895,Chhattisgarh,4,13,12,19,48,Pass
Vivaan Mehta,18-12-2005,357667,Uttar Pradesh,0,11,6,17,34,Pass
John Verma,08-11-2005,319650,Rajasthan,23,0,19,21,63,Pass
Vivaan Chopra,30-06-2005,185208,Kerala,9,9,8,18,44,Pass
Peter Sharma,13-12-2004,691046,Rajasthan,3,20,23,20,66,Pass
Krishna Fernandes,22-06-2005,376995,Andhra Pradesh,6,7,9,4,26,Pass
Kunal Khan,14-06-2005,789654,Bihar,8,15,16,1,40,Pass
Rohan Chopra,25-02-2005,338568,Rajasthan,21,4,21,24,70,Pass
Rohan D'Souza,18-08-2005,940077,Madhya Pradesh,24,20,9,4,57,Pass
Balbir Verma,13-02-2006,752771,Jharkhand,24,0,1,8,33,Pass
Kunal Mehta,25-12-2005,619248,Rajasthan,8,22,16,7,53,Pass
Krishna Pillai,22-01-2005,428061,Andhra Pradesh,17,8,21,22,68,Pass
Vivaan Pillai,17-12-2004,755831,Bihar,12,3,17,10,42,Pass
Manpreet Chopra,14-01-2005,323972,Nagaland,2,0,21,5,28,Pass
John Singh,15-06-2005,148416,Chhattisgarh,0,6,20,8,34,Pass
Raj Reddy,27-11-2005,721784,Andhra Pradesh,13,17,4,14,48,Pass
Rohan Fernandes,16-09-2005,783874,Uttar Pradesh,0,2,0,3,5,Pass
Krishna Verma,21-01-2005,264540,Madhya Pradesh,22,1,17,4,44,Pass
Vivaan Chopra,13-06-2005,784782,Uttar Pradesh,0,8,18,6,32,Pass
Ayaan Pillai,02-09-2005,292638,Rajasthan,19,21,23,18,81,Pass
Vivaan Pillai,10-01-2006,502386,Jharkhand,11,13,2,20,46,Pass
Harjeet Fernandes,24-08-2005,213673,Jharkhand,7,24,12,3,46,Pass
Krishna Mehta,14-12-2004,512628,Assam,2,23,2,4,31,Pass
Aryan Mehta,16-02-2005,413401,Punjab,10,24,1,8,43,Pass
Balbir Verma,29-04-2006,427711,Madhya Pradesh,14,3,11,14,42,Pass
Mathew D'Souza,04-04-2005,835046,Uttar Pradesh,0,20,16,18,54,Pass
Rohan Singh,06-05-2006,397359,Karnataka,24,2,20,9,55,Pass
Kunal D'Souza,18-02-2006,312277,Maharashtra,18,4,22,5,49,Pass
Aditya Mehta,21-02-2006,780037,Tamil Nadu,4,16,12,16,48,Pass
Peter Sharma,06-02-2005,156128,Jharkhand,13,6,19,21,59,Pass
Ishaan Verma,02-03-2006,556837,Kerala,19,15,24,3,61,Pass
Vivaan Singh,05-11-2005,753092,Maharashtra,13,8,7,3,31,Pass
Krishna Mehta,13-01-2005,164583,Tamil Nadu,2,2,2,16,22,Pass
Raj Chopra,15-02-2005,912675,Tripura,20,10,3,8,41,Pass
Aarav Singh,08-04-2005,319315,Maharashtra,13,4,19,17,53,Pass
Balbir Khan,22-01-2005,609487,Rajasthan,17,21,6,15,59,Pass
Raj Singh,30-01-2005,567004,Odisha,10,12,7,0,29,Pass
Paul Verma,08-01-2006,495635,West Bengal,14,17,3,14,48,Pass
Raj Mehta,10-01-2005,554691,Rajasthan,11,6,9,6,32,Pass
Aditya Fernandes,01-02-2005,419023,Punjab,9,3,23,24,59,Pass
Harjeet Fernandes,10-03-2005,741397,Telangana,19,12,17,5,53,Pass
Kunal Mehta,26-09-2005,582601,Madhya Pradesh,10,16,9,19,54,Pass
Kunal D'Souza,28-08-2005,234046,Karnataka,2,6,4,9,21,Pass
Kunal Verma,04-11-2005,936114,Bihar,8,15,19,4,46,Pass
Kunal Chopra,25-09-2005,449696,Jammu & Kashmir + Ladakh,9,8,21,5,43,Pass
Gurpreet Mehta,14-02-2006,170258,Rajasthan,0,22,22,1,45,Pass
Yash Singh,24-02-2006,846361,Jharkhand,17,14,3,4,38,Pass
Aarav D'Souza,02-02-2006,555082,Tamil Nadu,9,23,3,14,49,Pass
John Chopra,01-05-2006,593536,Maharashtra,0,12,24,0,36,Pass
Balbir Reddy,22-02-2005,783185,Haryana,20,3,8,7,38,Pass
Krishna Fernandes,28-01-2005,834249,West Bengal,3,24,16,7,50,Pass
Mathew Singh,14-08-2005,891414,Andhra Pradesh,1,21,18,8,48,Pass
Ishaan Singh,09-01-2006,283016,Assam,8,16,7,15,46,Pass
Rohan Chopra,06-08-2005,609509,Jammu & Kashmir + Ladakh,11,14,10,6,41,Pass
Ishaan Singh,18-09-2005,813224,Maharashtra,13,15,2,18,48,Pass
Krishna Fernandes,23-11-2005,109636,Haryana,15,20,11,23,69,Pass
Kunal Mehta,07-01-2005,725342,Uttar Pradesh,0,20,19,23,62,Pass
Aditya D'Souza,21-02-2006,238434,Bihar,2,19,22,4,47,Pass
Gurpreet Reddy,13-11-2005,480332,Rajasthan,9,11,23,0,43,Pass
Rohan Fernandes,19-03-2005,353449,Uttar Pradesh,0,24,0,6,30,Pass
Vivaan Fernandes,19-06-2005,807065,Assam,22,15,0,7,44,Pass
Paul Fernandes,23-02-2005,112809,Gujarat,7,10,15,23,55,Pass
Aditya Singh,20-07-2005,580134,Assam,12,19,19,0,50,Pass
Aditya Mehta,21-05-2005,156414,Karnataka,24,2,0,22,48,Pass
Ishaan Khan,14-03-2006,871766,Rajasthan,16,17,10,0,43,Pass
Krishna Sharma,11-07-2005,109242,Telangana,5,21,0,16,42,Pass
Rohan Chopra,24-04-2006,659891,Arunachal Pradesh,12,7,3,22,44,Pass
Rohan Reddy,18-03-2005,958612,Tamil Nadu,4,24,2,7,37,Pass
Rohan Pillai,21-11-2005,812798,Rajasthan,12,15,12,18,57,Pass
Rohan Khan,25-03-2005,474842,Chhattisgarh,17,3,17,20,57,Pass
Ishaan D'Souza,26-11-2005,738390,Chhattisgarh,19,20,0,1,40,Pass
Aarav Singh,24-11-2004,165448,Bihar,13,21,21,1,56,Pass
Rohan Chopra,19-11-2004,119969,Punjab,11,14,2,2,29,Pass
Raj D'Souza,24-12-2004,209000,Rajasthan,0,17,5,0,22,Pass
Rohan Mehta,25-12-2004,272449,Rajasthan,15,6,2,10,33,Pass
Vivaan Chopra,22-02-2005,507117,Delhi,5,17,21,4,47,Fail
Rohan Pillai,13-11-2004,811713,Rajasthan,24,5,12,3,44,Pass
Krishna Chopra,16-11-2004,575772,Kerala,13,8,9,1,31,Pass
Krishna D'Souza,23-11-2005,358914,Madhya Pradesh,15,2,20,11,48,Pass
Yash Singh,05-05-2006,500440,Maharashtra,22,4,24,8,58,Pass
Raj D'Souza,23-02-2006,312726,Bihar,13,15,12,12,52,Pass
Ishaan Mehta,14-03-2006,310632,Tamil Nadu,22,21,10,21,74,Pass
Kunal Pillai,18-07-2005,465655,Rajasthan,1,9,0,3,13,Pass
Ishaan Singh,22-10-2005,645297,Punjab,6,0,4,17,27,Pass
Balbir D'Souza,10-12-2004,290081,Karnataka,4,19,24,17,64,Pass
Balbir Fernandes,19-08-2005,679913,Punjab,3,21,23,9,56,Pass
Harjeet Verma,03-04-2005,885775,Bihar,12,21,14,23,70,Pass
Rohan Khan,02-12-2004,108162,Rajasthan,17,1,2,2,22,Pass
Vivaan Khan,21-08-2005,631375,Uttar Pradesh,0,11,5,21,37,Pass
Aditya Reddy,31-12-2004,223868,Haryana,15,13,4,10,42,Pass
Aarav Mehta,18-12-2005,873165,Punjab,22,1,0,21,44,Pass
Krishna Verma,08-07-2005,324178,Bihar,14,11,18,24,67,Pass
Kunal Singh,11-03-2005,563166,Bihar,17,11,18,20,66,Pass
Vivaan Khan,06-02-2006,381125,West Bengal,15,24,3,8,50,Pass
Aditya D'Souza,11-12-2005,109920,Odisha,19,21,16,14,70,Pass
Raj Reddy,01-04-2005,737554,Bihar,2,1,14,2,19,Pass
Kunal Pillai,11-11-2005,420352,Jharkhand,11,9,16,4,40,Pass
Raj Singh,20-01-2006,643454,Tamil Nadu,0,12,19,6,37,Pass
Ishaan Sharma,02-07-2005,490433,Assam,15,23,7,8,53,Pass
Yash Verma,15-03-2006,130152,Uttarakhand,15,1,2,4,22,Pass
Vivaan Pillai,04-12-2005,736544,Bihar,13,22,15,4,54,Pass
Kunal D'Souza,27-01-2005,662773,Andhra Pradesh,10,11,9,11,41,Pass
Paul Fernandes,31-07-2005,275341,Uttarakhand,13,2,4,5,24,Pass
Balbir D'Souza,02-09-2005,161546,Madhya Pradesh,6,3,11,23,43,Pass
Aarav Chopra,01-11-2005,801353,Punjab,24,24,7,18,73,Pass
Paul Singh,07-12-2005,852306,Punjab,2,14,17,3,36,Pass
Manpreet Pillai,14-02-2006,720259,Maharashtra,8,12,1,14,35,Pass
Ishaan Pillai,19-11-2005,244395,Bihar,7,7,17,20,51,Pass
Krishna Pillai,16-07-2005,846617,Gujarat,19,21,17,6,63,Pass
Gurpreet Reddy,16-07-2005,681840,Rajasthan,15,24,4,20,63,Pass
John Singh,08-07-2005,969262,Rajasthan,7,16,22,23,68,Pass
John Verma,28-08-2005,508243,Karnataka,8,9,20,24,61,Pass
Aditya Mehta,27-02-2006,937199,Uttarakhand,14,6,0,11,31,Pass
Yash Khan,18-12-2005,632347,Punjab,3,17,15,22,57,Pass
Rohan Khan,01-08-2005,402518,Gujarat,12,10,16,7,45,Pass
Ishaan Fernandes,04-04-2005,731159,Uttar Pradesh,0,9,22,22,53,Pass
Aarav Sharma,28-12-2005,772126,Haryana,5,7,1,23,36,Pass
Ishaan Reddy,21-02-2006,842402,Gujarat,23,3,18,9,53,Pass
Kunal Chopra,16-07-2005,923274,Uttar Pradesh,0,18,24,16,58,Pass
Peter Fernandes,05-10-2005,684399,Bihar,11,14,21,14,60,Pass
Farhan D'Souza,02-01-2006,306038,Assam,9,23,15,4,51,Pass
Raj D'Souza,21-06-2005,804318,Odisha,9,10,5,16,40,Pass
Gurpreet Mehta,22-08-2005,110412,Chhattisgarh,2,19,23,11,55,Pass
Yash Fernandes,15-10-2005,435591,West Bengal,18,1,11,20,50,Pass
Balbir Mehta,10-10-2005,571040,Telangana,3,6,8,22,39,Pass
Manpreet Singh,16-11-2005,229881,Bihar,12,3,23,6,44,Pass
Krishna Mehta,27-03-2006,209436,Uttarakhand,3,18,6,17,44,Pass
Mathew Mehta,27-09-2005,912300,Chhattisgarh,21,0,16,17,54,Pass
Aarav Fernandes,20-03-2005,860965,Bihar,17,8,3,5,33,Pass
Raj Chopra,26-04-2006,623823,Haryana,16,10,5,1,32,Pass
Kunal Sharma,07-03-2006,425905,Rajasthan,10,22,22,3,57,Pass
Krishna Fernandes,05-09-2005,216147,Rajasthan,20,14,9,20,63,Pass
Balbir Verma,21-11-2005,871436,Bihar,1,12,3,8,24,Pass
Vivaan D'Souza,03-07-2005,839402,Delhi,19,9,6,16,50,Fail
Aditya Reddy,02-12-2004,339280,Andhra Pradesh,5,17,15,23,60,Pass
Aryan Pillai,19-05-2005,128436,Odisha,4,16,4,16,40,Pass
Aditya D'Souza,03-06-2005,921516,Uttar Pradesh,0,24,3,1,28,Pass
Aryan Singh,20-02-2005,317655,Telangana,9,5,13,14,41,Pass
Raj Pillai,05-09-2005,129878,Rajasthan,6,16,11,10,43,Pass
Aarav Pillai,28-04-2006,810282,Rajasthan,9,23,8,3,43,Pass
Aarav D'Souza,14-12-2004,329795,Bihar,18,20,5,22,65,Pass
Yash Pillai,19-08-2005,523694,Andhra Pradesh,24,18,8,11,61,Pass
Manpreet D'Souza,23-02-2005,594593,Maharashtra,22,4,11,12,49,Pass
Yash D'Souza,21-06-2005,173518,Maharashtra,15,20,4,9,48,Pass
Kunal Reddy,05-06-2005,314448,Punjab,23,8,11,15,57,Pass
Aryan D'Souza,04-04-2006,111543,Uttar Pradesh,0,13,11,16,40,Pass
Harjeet D'Souza,01-03-2006,518364,Delhi,7,8,20,6,41,Fail
Ishaan Chopra,17-08-2005,765315,Uttar Pradesh,0,20,24,18,62,Pass
Aryan Mehta,19-10-2005,992015,Madhya Pradesh,12,20,0,1,33,Pass
Peter Verma,08-12-2005,512947,Maharashtra,1,18,4,13,36,Pass
Aditya D'Souza,14-01-2005,495533,Haryana,1,18,9,19,47,Pass
Sukhwinder D'Souza,19-03-2005,720884,Karnataka,18,18,17,11,64,Pass
Raj Pillai,13-04-2005,767911,Rajasthan,4,23,1,0,28,Pass
Sukhwinder Fernandes,07-08-2005,177673,Bihar,15,7,14,19,55,Pass
Raj Singh,30-09-2005,462723,Bihar,10,1,24,10,45,Pass
Aarav Mehta,30-01-2006,190024,Delhi,3,14,18,11,46,Fail
Rohan Fernandes,11-05-2005,150168,Bihar,20,23,13,21,77,Pass
Rohan Verma,08-08-2005,126495,West Bengal,3,2,20,23,48,Pass
Rohan Fernandes,07-01-2006,280881,Haryana,12,16,23,6,57,Pass
Krishna Reddy,14-11-2005,787109,Bihar,4,2,1,12,19,Pass
Aditya D'Souza,12-03-2005,862793,Uttar Pradesh,0,19,23,6,48,Pass
Balbir Singh,16-01-2005,327414,Rajasthan,19,11,22,23,75,Pass
Rohan Sharma,15-03-2005,285461,Maharashtra,1,1,13,13,28,Pass
Yash Fernandes,12-01-2005,404329,Odisha,16,15,23,0,54,Pass
Imran Fernandes,22-11-2004,184990,Arunachal Pradesh,3,5,8,16,32,Pass
Aditya Reddy,14-04-2005,347271,Jharkhand,4,11,23,14,52,Pass
David Fernandes,09-04-2006,891788,Karnataka,5,23,0,14,42,Pass
Gurpreet Khan,09-03-2005,261097,Assam,5,7,5,4,21,Pass
Vivaan Sharma,06-06-2005,341949,Andhra Pradesh,14,12,16,24,66,Pass
Aarav Sharma,15-05-2005,707798,Telangana,21,11,3,8,43,Pass
Gurpreet Khan,20-02-2005,189565,Telangana,16,3,18,20,57,Pass
Aarav Sharma,21-02-2005,703711,West Bengal,3,20,12,21,56,Pass
Vivaan Verma,27-01-2005,977113,Maharashtra,3,4,22,13,42,Pass
Krishna Mehta,19-04-2005,431914,Jharkhand,19,21,1,14,55,Pass
Raj Reddy,18-08-2005,955743,Bihar,15,16,2,0,33,Pass
Harjeet Verma,08-02-2006,337418,Gujarat,4,15,14,20,53,Pass
Kunal D'Souza,22-01-2006,819661,Madhya Pradesh,14,9,21,4,48,Pass
Rohan Fernandes,26-02-2006,453107,Uttar Pradesh,0,19,2,11,32,Pass
Rehan Reddy,08-05-2005,449131,Rajasthan,4,16,5,7,32,Pass
Zaid Fernandes,20-07-2005,530685,Haryana,19,17,16,22,74,Pass
Aryan Singh,14-02-2005,500908,Karnataka,16,23,10,0,49,Pass
Peter Khan,17-09-2005,653737,Jammu & Kashmir + Ladakh,24,15,8,11,58,Pass
Rohan Mehta,04-03-2006,114029,Chhattisgarh,4,5,12,19,40,Pass
Ishaan D'Souza,12-10-2005,656310,Maharashtra,19,4,8,14,45,Pass
Ishaan Sharma,22-04-2006,409209,West Bengal,3,10,20,16,49,Pass
Raj D'Souza,19-01-2006,441628,Maharashtra,0,4,22,24,50,Pass
Vivaan Reddy,13-12-2004,384947,Maharashtra,4,4,23,10,41,Pass
Krishna Singh,12-04-2006,507013,Odisha,7,2,10,7,26,Pass
Raj Sharma,16-09-2005,690245,Bihar,15,14,17,1,47,Pass
Yash Chopra,06-12-2005,113473,Punjab,22,17,17,3,59,Pass
Raj Pillai,16-11-2005,738903,Rajasthan,0,23,16,5,44,Pass
Vivaan Verma,19-09-2005,947499,Maharashtra,7,10,9,1,27,Pass
Rohan Fernandes,02-07-2005,468701,Mizoram,4,0,1,8,13,Pass
Aarav Reddy,26-07-2005,639980,Telangana,1,0,20,5,26,Pass
Aditya Singh,28-04-2005,805743,Rajasthan,20,23,18,24,85,Pass
Rohan Khan,02-10-2005,258267,Jharkhand,15,5,7,5,32,Pass
Aarav Fernandes,03-06-2005,721004,Rajasthan,22,13,13,7,55,Pass
Rohan Verma,26-01-2005,294282,Tamil Nadu,3,15,19,14,51,Pass
Mathew Fernandes,11-03-2006,628316,Madhya Pradesh,13,9,6,10,38,Pass
Imran Singh,18-02-2006,904602,Haryana,1,6,22,14,43,Pass
Vivaan Mehta,07-02-2005,619764,Maharashtra,16,5,9,7,37,Pass
Sukhwinder Reddy,05-08-2005,861438,Jammu & Kashmir + Ladakh,14,1,10,15,40,Pass
Peter Verma,22-07-2005,699153,Gujarat,8,16,16,5,45,Pass
Vivaan Fernandes,14-12-2005,328027,Andhra Pradesh,15,21,9,3,48,Pass
Rohan Sharma,10-02-2005,505284,Rajasthan,1,6,8,22,37,Pass
John D'Souza,10-10-2005,491591,Haryana,5,10,21,11,47,Pass
Manpreet Fernandes,10-01-2006,854519,Telangana,24,15,0,0,39,Pass
Peter Reddy,23-12-2004,167733,Uttar Pradesh,0,16,11,11,38,Pass
Peter Verma,14-09-2005,568009,Uttar Pradesh,0,11,10,13,34,Pass
Ishaan Verma,11-06-2005,147364,Rajasthan,6,21,18,12,57,Pass
Gurpreet Fernandes,18-03-2005,206573,West Bengal,3,23,10,10,46,Pass
John D'Souza,07-01-2005,270332,Maharashtra,1,6,21,3,31,Pass
Aarav Khan,17-02-2005,965281,Rajasthan,20,16,21,9,66,Pass
Harjeet Fernandes,11-11-2005,492440,Tamil Nadu,23,17,13,12,65,Pass
Zaid Khan,17-12-2005,916580,Gujarat,18,8,12,9,47,Pass
Paul Reddy,18-06-2005,488615,West Bengal,3,12,24,17,56,Pass
Aryan Fernandes,09-03-2005,106900,Rajasthan,15,15,1,14,45,Pass
Aryan Khan,14-09-2005,437184,Uttarakhand,3,15,19,22,59,Pass
Krishna Verma,01-01-2005,383435,Rajasthan,8,22,1,0,31,Pass
Yash Fernandes,17-04-2005,395097,Jammu & Kashmir + Ladakh,2,4,5,18,29,Pass
Manpreet Pillai,26-03-2006,955971,Uttar Pradesh,0,24,4,14,42,Pass
Raj Fernandes,28-03-2006,157784,West Bengal,9,5,2,2,18,Pass
Krishna Mehta,15-06-2005,112555,Jammu & Kashmir + Ladakh,23,11,7,4,45,Pass
Mathew Singh,16-10-2005,155863,Uttarakhand,3,16,11,21,51,Pass
Yash Sharma,11-02-2006,289713,Andhra Pradesh,11,15,15,18,59,Pass
Yash Reddy,14-04-2005,281955,Odisha,0,14,9,4,27,Pass
Gurpreet Mehta,05-03-2006,223448,Assam,9,21,5,7,42,Pass
Vivaan Sharma,03-05-2005,612824,Haryana,16,22,13,10,61,Pass
Raj Singh,18-10-2005,143521,Rajasthan,2,2,8,1,13,Pass
Rohan Fernandes,29-10-2005,615489,Madhya Pradesh,9,7,19,0,35,Pass
David Khan,28-11-2005,328589,Jammu & Kashmir + Ladakh,6,17,1,11,35,Pass
Raj D'Souza,23-12-2004,639888,Rajasthan,9,1,1,6,17,Pass
Imran Chopra,20-03-2005,372694,Assam,7,0,23,21,51,Pass
Vivaan Singh,12-02-2006,122126,Odisha,9,5,24,0,38,Pass
Yash Sharma,28-01-2005,271498,Andhra Pradesh,6,6,10,13,35,Pass
Aditya Mehta,11-05-2005,937522,Karnataka,14,19,19,10,62,Pass
Harjeet Pillai,04-07-2005,454769,Odisha,8,8,11,5,32,Pass
Kunal Verma,05-12-2005,879242,Kerala,12,23,8,5,48,Pass
Ishaan Fernandes,25-01-2005,891157,Tamil Nadu,4,15,5,14,38,Pass
John Khan,11-05-2005,644000,Bihar,6,11,0,5,22,Pass
Aditya Singh,07-08-2005,139347,Rajasthan,19,24,0,22,65,Pass
Manpreet Sharma,19-04-2005,946569,Assam,7,23,24,23,77,Pass
Raj Khan,25-04-2005,100594,Punjab,24,11,3,20,58,Pass
Raj Pillai,17-06-2005,922850,Gujarat,13,15,13,1,42,Pass
Rohan D'Souza,26-06-2005,548384,Nagaland,2,9,5,7,23,Pass
Aryan Singh,07-03-2005,883312,West Bengal,3,4,24,19,50,Pass
Peter Pillai,30-08-2005,212664,Maharashtra,17,14,11,2,44,Pass
Rohan Sharma,27-08-2005,382792,Bihar,17,17,12,10,56,Pass
Aarav Verma,18-01-2005,271191,Tamil Nadu,19,9,5,21,54,Pass
Aditya Verma,30-12-2004,170412,Gujarat,10,5,11,4,30,Pass
Yash Pillai,20-06-2005,120016,Bihar,16,16,14,7,53,Pass
Mathew Chopra,24-01-2006,564331,Haryana,4,22,8,21,55,Pass
Harjeet Mehta,24-04-2006,439427,Punjab,10,21,21,7,59,Pass
Ishaan Singh,15-07-2005,319226,Madhya Pradesh,1,8,3,4,16,Pass
Balbir D'Souza,04-12-2004,189391,Andhra Pradesh,5,21,16,4,46,Pass
Aarav Chopra,22-09-2005,660499,Uttar Pradesh,0,4,2,15,21,Pass
Vivaan Fernandes,10-10-2005,506493,Meghalaya,22,23,4,4,53,Pass
John Singh,21-08-2005,431219,West Bengal,14,3,9,0,26,Pass
John Mehta,26-05-2005,707858,Uttar Pradesh,0,19,6,21,46,Pass
Raj Verma,01-08-2005,603645,Rajasthan,15,4,23,17,59,Pass
Vivaan Pillai,23-01-2006,396541,Kerala,8,9,8,9,34,Pass
Kunal Sharma,09-12-2004,760416,Haryana,5,19,24,11,59,Pass
Aditya Mehta,28-12-2005,347773,Karnataka,11,14,9,17,51,Pass
Aarav Pillai,25-12-2005,703213,Tamil Nadu,9,15,18,16,58,Pass
Yash Chopra,24-02-2006,897924,Maharashtra,15,7,21,2,45,Pass
Vivaan Khan,09-08-2005,807977,Bihar,2,0,6,14,22,Pass
Ayaan Verma,25-08-2005,837905,Uttarakhand,3,14,9,13,39,Pass
Aditya Chopra,03-05-2006,769228,West Bengal,5,3,20,11,39,Pass
Sukhwinder Verma,24-01-2006,227876,Gujarat,21,17,8,13,59,Pass
Yash Fernandes,21-05-2005,964729,Chhattisgarh,9,19,9,18,55,Pass
Manpreet Sharma,29-01-2006,328938,Maharashtra,6,7,18,7,38,Pass
Krishna Pillai,22-04-2006,631510,Uttar Pradesh,0,11,0,10,21,Pass
Balbir Chopra,07-03-2006,850521,West Bengal,3,14,24,15,56,Pass
Sukhwinder Verma,07-10-2005,412374,Punjab,20,3,13,15,51,Pass
John Sharma,07-05-2005,206417,West Bengal,2,6,22,16,46,Pass
Yash Pillai,02-04-2005,777458,Andhra Pradesh,12,23,9,7,51,Pass
Yash Khan,01-06-2005,735607,Haryana,21,2,20,14,57,Pass
Aditya Sharma,08-01-2005,931739,Punjab,20,15,1,5,41,Pass
Kunal Singh,29-08-2005,808827,Maharashtra,14,4,14,20,52,Pass
Vivaan Sharma,07-09-2005,131746,Tamil Nadu,6,3,23,17,49,Pass
Aarav D'Souza,11-01-2006,690828,Uttar Pradesh,0,7,10,20,37,Pass
Kunal Reddy,18-03-2005,591829,Rajasthan,20,21,12,15,68,Pass
Aarav Pillai,10-06-2005,282253,Tamil Nadu,11,14,11,9,45,Pass
Aryan Pillai,05-12-2004,354297,Andhra Pradesh,10,6,12,20,48,Pass
Rohan Khan,23-06-2005,904946,Telangana,4,7,5,8,24,Pass
Gurpreet Sharma,09-01-2005,784350,Punjab,5,13,3,24,45,Pass
Manpreet Mehta,28-01-2006,483004,Madhya Pradesh,4,16,23,4,47,Pass
Kunal Fernandes,21-04-2006,157073,Maharashtra,11,4,22,24,61,Pass
Yash Sharma,02-04-2006,459362,Rajasthan,12,12,14,12,50,Pass
Raj D'Souza,25-04-2006,131050,Punjab,19,12,19,13,63,Pass
Krishna Khan,05-07-2005,285665,Uttar Pradesh,0,9,17,16,42,Pass
Yash Khan,23-04-2005,895749,Kerala,19,9,17,19,64,Pass
Raj Khan,10-04-2006,298315,Bihar,9,10,4,5,28,Pass
Yash Khan,21-01-2005,131111,West Bengal,0,8,20,13,41,Pass
Vivaan Mehta,25-12-2004,238284,Manipur,4,22,24,8,58,Pass
Raj Mehta,02-12-2004,780046,Punjab,9,21,9,1,40,Pass
John Sharma,02-12-2005,145204,Rajasthan,12,10,1,13,36,Pass
Aditya Fernandes,14-03-2006,912971,Andhra Pradesh,18,17,12,4,51,Pass
Raj Reddy,18-07-2005,105058,Telangana,19,11,8,10,48,Pass
Gurpreet Pillai,19-02-2005,569782,Punjab,7,19,12,11,49,Pass
David Singh,11-02-2005,619528,Andhra Pradesh,3,18,10,21,52,Pass
Aarav Pillai,22-09-2005,255264,Bihar,23,17,10,13,63,Pass
Yash Sharma,23-11-2004,421320,Uttar Pradesh,0,1,2,21,24,Pass
Yash Mehta,15-04-2005,638100,Bihar,5,3,21,14,43,Pass
Vivaan Verma,03-09-2005,266137,Kerala,9,7,9,8,33,Pass
Aditya Khan,09-06-2005,252477,Gujarat,24,21,3,21,69,Pass
Harjeet Singh,15-12-2004,175135,Rajasthan,9,9,17,17,52,Pass
Harjeet Chopra,19-11-2005,935331,Karnataka,8,24,12,16,60,Pass
Vivaan Sharma,25-06-2005,146029,Bihar,8,1,2,18,29,Pass
Gurpreet D'Souza,11-06-2005,249071,Odisha,4,14,6,21,45,Pass
Aditya Khan,19-04-2005,324732,Uttar Pradesh,0,1,10,1,12,Pass
Farhan Singh,03-01-2005,351527,Assam,8,24,4,10,46,Pass
Manpreet Singh,17-03-2006,234449,Bihar,7,21,22,19,69,Pass
Peter Mehta,24-09-2005,194701,Punjab,6,20,3,3,32,Pass
Manpreet Fernandes,17-05-2005,126902,Maharashtra,1,7,1,8,17,Pass
Gurpreet Mehta,21-04-2005,478175,Andhra Pradesh,19,16,15,9,59,Pass
Peter Chopra,27-07-2005,259064,Punjab,14,4,14,11,43,Pass
Ishaan Sharma,30-04-2005,611823,Maharashtra,11,4,8,15,38,Pass
Balbir Pillai,02-09-2005,337205,Bihar,17,11,6,11,45,Pass
Aditya Khan,15-03-2005,354737,Tamil Nadu,22,5,6,1,34,Pass
Kunal Mehta,11-07-2005,954197,Bihar,0,13,5,3,21,Pass
Gurpreet Pillai,18-01-2005,294572,Uttar Pradesh,0,5,0,11,16,Pass
Balbir Pillai,13-12-2005,721940,Jharkhand,11,17,11,6,45,Pass
Ishaan Verma,01-03-2006,486953,Uttar Pradesh,0,13,9,1,23,Pass
Rohan Sharma,27-11-2005,758137,Bihar,9,0,11,5,25,Pass
Aryan D'Souza,19-12-2005,352175,Gujarat,0,6,16,23,45,Pass
Kunal Singh,10-04-2006,462219,Uttar Pradesh,0,16,15,14,45,Pass
Aarav Pillai,24-09-2005,761882,Gujarat,19,20,3,5,47,Pass
Raj D'Souza,31-12-2005,918904,West Bengal,3,11,18,19,51,Pass
Sukhwinder Pillai,03-01-2005,546343,Uttar Pradesh,0,16,0,14,30,Pass
Aarav D'Souza,04-08-2005,638420,Assam,15,24,10,15,64,Pass
Yash Pillai,12-03-2006,514026,Maharashtra,14,12,17,4,47,Pass
Raj Reddy,28-11-2004,858685,Karnataka,19,11,6,1,37,Pass
Krishna Singh,28-01-2006,302540,Rajasthan,23,0,13,3,39,Pass
Yash Reddy,04-03-2005,276707,Maharashtra,12,4,20,20,56,Pass
Aarav Sharma,11-04-2006,639370,Uttar Pradesh,0,8,15,19,42,Pass
Aryan Pillai,24-02-2006,762701,Rajasthan,23,19,6,21,69,Pass
Aryan Chopra,14-11-2004,854440,Maharashtra,18,4,20,1,43,Pass
Rohan Verma,17-02-2006,468910,Telangana,2,22,12,11,47,Pass
Paul Sharma,19-12-2004,688797,Tamil Nadu,4,9,2,6,21,Pass
Mathew Reddy,08-10-2005,180519,Uttar Pradesh,0,0,21,15,36,Pass
Yash Khan,01-11-2005,961351,Rajasthan,20,20,16,9,65,Pass
Yash Pillai,20-08-2005,925263,Telangana,17,21,12,10,60,Pass
Vivaan D'Souza,01-04-2005,847962,Telangana,15,20,9,5,49,Pass
Kunal Pillai,03-12-2004,598062,West Bengal,19,16,3,4,42,Pass
Yash Reddy,03-10-2005,351747,Maharashtra,12,11,15,0,38,Pass
Harjeet Mehta,06-06-2005,779085,Madhya Pradesh,13,13,7,4,37,Pass
Krishna D'Souza,26-01-2006,195164,Assam,15,22,22,6,65,Pass
Aarav Fernandes,04-01-2006,199405,Kerala,16,3,19,1,39,Pass
Peter D'Souza,17-02-2006,639314,Bihar,21,21,13,0,55,Pass
Krishna Reddy,08-01-2005,613333,Bihar,6,11,6,4,27,Pass
Aarav Singh,17-11-2005,406907,Maharashtra,13,4,19,20,56,Pass
Peter Fernandes,17-06-2005,527634,Himachal Pradesh,19,12,20,19,70,Pass
Krishna Fernandes,27-01-2005,926224,West Bengal,18,1,21,3,43,Pass
Imran Pillai,07-04-2006,243317,Punjab,16,2,6,14,38,Pass
Yash Singh,25-01-2006,178763,Rajasthan,10,24,1,2,37,Pass
Harjeet D'Souza,04-05-2006,548085,Telangana,3,21,13,14,51,Pass
Aarav Chopra,11-01-2005,691123,Uttar Pradesh,0,11,19,2,32,Pass
Aryan D'Souza,12-02-2005,772235,West Bengal,5,3,6,3,17,Pass
Raj Khan,22-11-2004,292595,Haryana,8,20,15,19,62,Pass
Sukhwinder Singh,18-11-2004,747745,Bihar,16,7,20,22,65,Pass
Gurpreet Reddy,18-11-2005,480021,Haryana,18,15,4,7,44,Pass
Kunal Sharma,16-11-2004,473120,Uttar Pradesh,0,2,10,23,35,Pass
Raj Khan,12-04-2005,802404,Andhra Pradesh,8,2,16,12,38,Pass
Aditya Khan,25-05-2005,187179,Bihar,23,10,7,13,53,Pass
Balbir Sharma,16-04-2005,986167,Madhya Pradesh,16,8,12,13,49,Pass
Aditya Pillai,05-02-2006,208589,Telangana,0,15,1,11,27,Pass
Aryan Mehta,13-04-2005,786792,Odisha,3,13,19,19,54,Pass
Raj Verma,29-08-2005,958197,West Bengal,3,18,9,19,49,Pass
Aditya Khan,21-07-2005,384897,Uttar Pradesh,0,11,13,6,30,Pass
Kunal Khan,15-08-2005,224340,Uttarakhand,3,16,22,12,53,Pass
Vivaan Khan,17-02-2006,889912,Uttar Pradesh,0,17,8,22,47,Pass
Ayaan Reddy,21-09-2005,210091,Manipur,4,4,16,20,44,Pass
Gurpreet Singh,08-05-2005,624151,Rajasthan,17,15,3,3,38,Pass
Raj Mehta,01-04-2006,492378,Uttar Pradesh,0,10,1,11,22,Pass
Aarav Verma,28-01-2006,113828,Tamil Nadu,6,1,3,17,27,Pass
Krishna Khan,31-01-2006,639096,Uttar Pradesh,0,23,8,1,32,Pass
Rohan Mehta,29-10-2005,204249,Andhra Pradesh,1,18,15,1,35,Pass
Yash Mehta,08-10-2005,761314,Odisha,13,23,11,6,53,Pass
Aarav Mehta,23-04-2005,530714,Uttar Pradesh,0,17,18,15,50,Pass
Gurpreet Mehta,04-04-2006,541465,Rajasthan,10,23,6,12,51,Pass
Aditya Khan,24-03-2005,681749,Andhra Pradesh,10,10,14,16,50,Pass
Aditya Mehta,09-01-2006,966296,West Bengal,8,5,16,6,35,Pass
Imran Fernandes,04-02-2006,696441,Punjab,0,20,22,24,66,Pass
Paul Mehta,05-11-2005,542080,Andhra Pradesh,4,17,8,21,50,Pass
Ishaan Singh,20-04-2005,746826,Uttar Pradesh,0,21,0,7,28,Pass
Aryan Pillai,16-04-2006,103537,Assam,9,22,21,8,60,Pass
John Singh,09-06-2005,288275,Punjab,5,16,16,16,53,Pass
Ishaan Khan,10-07-2005,689878,Rajasthan,14,24,9,18,65,Pass
Balbir Chopra,13-05-2005,709742,Uttar Pradesh,0,5,16,8,29,Pass
Ishaan Reddy,16-11-2005,181423,Himachal Pradesh,3,22,12,9,46,Pass
Aditya Verma,07-11-2004,267046,Uttar Pradesh,0,0,11,6,17,Pass
John Sharma,07-06-2005,435516,Tamil Nadu,3,17,20,23,63,Pass
Krishna Mehta,07-02-2005,250296,Andhra Pradesh,15,22,0,0,37,Pass
Kunal D'Souza,12-12-2005,268901,Gujarat,19,16,9,9,53,Pass
Krishna Khan,10-12-2005,213828,Karnataka,13,17,20,17,67,Pass
Krishna Khan,26-10-2005,823751,Bihar,4,14,17,16,51,Pass
Yash Khan,07-04-2006,243269,Andhra Pradesh,0,1,2,11,14,Pass
Rohan Singh,03-02-2006,765838,Telangana,6,18,20,19,63,Pass
Harjeet Pillai,09-05-2005,592342,Tamil Nadu,14,18,1,6,39,Pass
Aarav Mehta,09-09-2005,633259,Punjab,22,9,13,2,46,Pass
Kunal Fernandes,21-06-2005,416056,Uttar Pradesh,0,16,9,8,33,Pass
Aarav Singh,14-02-2005,605707,Bihar,20,17,19,7,63,Pass
Raj Fernandes,21-04-2005,286127,Himachal Pradesh,24,0,20,15,59,Pass
Aditya Verma,12-03-2006,184043,Karnataka,1,10,24,3,38,Pass
Rohan Pillai,12-07-2005,502754,Bihar,19,3,6,21,49,Pass
Aarav Reddy,08-05-2005,751306,Bihar,1,6,7,9,23,Pass
Aryan D'Souza,10-02-2006,306643,Uttar Pradesh,0,9,20,6,35,Pass
Zaid Reddy,09-11-2005,840781,Tamil Nadu,10,0,10,4,24,Pass
Yash Reddy,01-02-2006,871886,Madhya Pradesh,19,23,23,4,69,Pass
Aryan Khan,01-02-2005,965942,Madhya Pradesh,21,24,18,4,67,Pass
Aditya Reddy,02-09-2005,389145,Bihar,5,22,20,23,70,Pass
Aditya Reddy,03-10-2005,948715,Andhra Pradesh,6,24,8,10,48,Pass
Rohan Sharma,18-02-2006,466887,Bihar,5,4,20,22,51,Pass
Kunal Reddy,03-01-2005,794282,Andhra Pradesh,20,6,4,6,36,Pass
Aryan Verma,07-08-2005,942042,Haryana,14,17,18,18,67,Pass
Kunal Khan,14-01-2006,294031,Bihar,21,24,7,13,65,Pass
Aryan Verma,21-06-2005,876288,Rajasthan,22,3,19,13,57,Pass
David Fernandes,10-11-2005,878070,Maharashtra,10,4,12,18,44,Pass
Rohan Pillai,10-04-2006,342094,Bihar,17,24,15,4,60,Pass
Krishna Sharma,02-01-2006,144424,West Bengal,13,10,15,7,45,Pass
Vivaan Singh,23-05-2005,857310,Madhya Pradesh,13,9,19,14,55,Pass
Aarav Sharma,13-09-2005,597784,Uttar Pradesh,0,0,18,2,20,Pass
Raj Sharma,21-12-2005,427182,Assam,5,23,7,11,46,Pass
Balbir Verma,02-04-2005,950681,Bihar,21,3,6,3,33,Pass
Yash Reddy,23-11-2004,585047,Andhra Pradesh,22,17,11,9,59,Pass
John Reddy,20-03-2006,132416,Puducherry,5,12,5,9,31,Pass
Sukhwinder Mehta,29-03-2006,842353,Bihar,20,15,5,3,43,Pass
Mathew Reddy,08-01-2005,768546,Rajasthan,17,11,16,9,53,Pass
Harjeet Pillai,12-07-2005,462868,Madhya Pradesh,8,13,9,17,47,Pass
Aryan Singh,04-03-2006,542401,Rajasthan,2,2,9,2,15,Pass
Balbir Verma,04-01-2006,644299,Odisha,9,16,18,9,52,Pass
David Mehta,04-02-2005,156883,Uttar Pradesh,0,17,2,1,20,Pass
Aryan Reddy,03-03-2006,524666,Rajasthan,13,4,3,14,34,Pass
Rohan Fernandes,25-01-2005,765942,Madhya Pradesh,17,21,14,4,56,Pass
Sukhwinder Pillai,25-03-2006,600722,Tamil Nadu,22,16,11,8,57,Pass
Aarav Verma,21-12-2004,304334,Tamil Nadu,7,14,4,13,38,Pass
Paul Khan,19-05-2005,346444,Jharkhand,8,23,7,16,54,Pass
Ishaan Singh,25-11-2004,870099,Odisha,15,23,20,1,59,Pass
Aryan Reddy,23-04-2006,522397,Tamil Nadu,18,16,11,9,54,Pass
Aditya D'Souza,15-03-2006,477011,Gujarat,6,18,13,19,56,Pass
Aarav Mehta,10-12-2005,716546,Maharashtra,10,0,14,13,37,Pass
Aditya Chopra,16-01-2006,694468,Uttar Pradesh,0,23,15,20,58,Pass
Gurpreet Singh,16-01-2006,610713,Rajasthan,3,16,22,19,60,Pass
Rohan Fernandes,22-08-2005,520692,Rajasthan,2,22,12,22,58,Pass
Vivaan Singh,19-03-2005,803703,Jharkhand,16,0,3,23,42,Pass
Aryan Mehta,14-03-2005,206366,West Bengal,3,21,9,23,56,Pass
Gurpreet Khan,03-01-2005,704731,Maharashtra,9,6,5,21,41,Pass
Manpreet Chopra,14-11-2004,900759,Bihar,19,2,21,15,57,Pass
Kunal Khan,28-04-2006,931640,Bihar,1,18,15,15,49,Pass
Aditya Reddy,15-09-2005,906142,Uttarakhand,13,0,14,18,45,Pass
Rohan Sharma,25-06-2005,317636,Sikkim,6,1,10,3,20,Pass
Rohan Khan,07-01-2006,569863,Madhya Pradesh,21,22,7,4,54,Pass
Manpreet Reddy,28-09-2005,369829,West Bengal,19,21,11,2,53,Pass
Yash Sharma,14-02-2006,409692,Maharashtra,1,4,15,24,44,Pass
Paul Reddy,06-07-2005,989708,Uttar Pradesh,0,23,0,4,27,Pass
Paul D'Souza,26-12-2004,710608,West Bengal,20,5,13,0,38,Pass
Yash Khan,15-12-2005,806030,Assam,16,21,4,18,59,Pass
Krishna Pillai,17-09-2005,474123,Uttarakhand,10,9,18,10,47,Pass
Yash Verma,30-06-2005,169091,Maharashtra,18,10,10,0,38,Pass
Vivaan D'Souza,29-06-2005,725724,Bihar,22,9,12,16,59,Pass
Aarav Chopra,21-10-2005,409122,Odisha,13,20,19,0,52,Pass
Yash Mehta,21-06-2005,651219,Maharashtra,1,3,22,5,31,Pass
Aarav Khan,03-04-2006,138574,Karnataka,17,24,11,4,56,Pass
Manpreet Fernandes,28-07-2005,768518,Telangana,9,0,14,3,26,Pass
John D'Souza,31-01-2005,942760,Jharkhand,7,5,1,2,15,Pass
John Chopra,03-07-2005,818203,Telangana,15,18,16,15,64,Pass
Sukhwinder Khan,15-09-2005,574770,Uttar Pradesh,0,22,8,3,33,Pass
Balbir Mehta,04-03-2006,284722,Karnataka,21,18,3,11,53,Pass
Kunal Khan,14-10-2005,786548,West Bengal,3,14,20,13,50,Pass
Paul Fernandes,22-05-2005,978981,Madhya Pradesh,12,8,21,0,41,Pass
Aditya D'Souza,16-12-2005,282842,Uttar Pradesh,0,7,5,0,12,Pass
Rohan Reddy,20-07-2005,790751,Meghalaya,10,7,0,7,24,Pass
Rohan Khan,14-02-2005,238098,Uttarakhand,16,9,5,17,47,Pass
Aarav Mehta,25-03-2006,759048,Haryana,1,6,17,3,27,Pass
Balbir D'Souza,10-09-2005,383683,Madhya Pradesh,21,2,1,21,45,Pass
Raj Singh,18-08-2005,115154,Maharashtra,6,7,24,3,40,Pass
Raj Reddy,28-11-2005,872345,Bihar,10,0,23,4,37,Pass
Harjeet Khan,10-11-2005,959369,Himachal Pradesh,3,16,8,17,44,Pass
Aditya Sharma,26-02-2005,455067,Maharashtra,3,4,22,20,49,Pass
Rohan Pillai,12-09-2005,467483,Punjab,23,21,10,4,58,Pass
Farhan Singh,09-06-2005,151475,Kerala,21,17,18,2,58,Pass
Ishaan Verma,12-05-2005,395759,Jammu & Kashmir + Ladakh,23,5,4,15,47,Pass
Ishaan Fernandes,24-07-2005,866010,Himachal Pradesh,0,13,7,14,34,Pass
Aditya Mehta,30-11-2004,119324,Chhattisgarh,21,15,24,9,69,Pass
Harjeet Pillai,22-04-2005,248436,Rajasthan,7,0,2,20,29,Pass
Rohan Mehta,19-08-2005,479189,Uttar Pradesh,0,11,8,16,35,Pass
Vivaan Fernandes,18-06-2005,605282,Tamil Nadu,8,14,21,2,45,Pass
Aditya Fernandes,14-11-2005,980881,Jharkhand,14,2,0,10,26,Pass
Farhan Chopra,14-12-2004,199736,Assam,7,11,13,18,49,Pass
Vivaan Reddy,13-04-2005,652909,Kerala,20,6,12,24,62,Pass
Peter Khan,13-10-2005,382899,Maharashtra,1,23,2,8,34,Pass
Krishna Reddy,02-04-2006,669166,Andhra Pradesh,3,2,0,0,5,Pass
Yash Mehta,21-02-2005,160711,Bihar,14,10,18,14,56,Pass
Kunal Singh,16-12-2004,941908,Bihar,19,12,16,12,59,Pass
Krishna Reddy,21-12-2004,717211,Bihar,22,24,5,10,61,Pass
Zaid Chopra,29-03-2005,508605,Andhra Pradesh,14,17,12,13,56,Pass
Kunal Chopra,14-11-2004,383407,Kerala,20,10,24,10,64,Pass
Kunal Mehta,01-02-2005,476931,Maharashtra,3,14,17,9,43,Pass
Krishna Reddy,04-03-2006,246739,Assam,0,24,6,4,34,Pass
Kunal D'Souza,31-03-2005,356854,Maharashtra,16,7,4,5,32,Pass
Aryan Singh,15-03-2006,479393,Tamil Nadu,0,4,20,8,32,Pass
David Sharma,26-07-2005,386155,Delhi,20,23,17,5,65,Fail
Vivaan Khan,06-11-2005,272841,Maharashtra,7,13,1,12,33,Pass
Vivaan Fernandes,13-12-2004,264637,Daman & Diu / D&N Haveli,8,8,8,7,31,Pass
Vivaan Khan,06-03-2005,723784,Bihar,8,13,15,17,53,Pass
Aditya Chopra,13-04-2005,617228,Assam,11,3,20,15,49,Pass
Kunal Chopra,11-08-2005,165392,Madhya Pradesh,11,10,19,4,44,Pass
Aarav Fernandes,27-12-2005,806813,Andhra Pradesh,19,18,11,9,57,Pass
Ishaan Fernandes,28-01-2006,458295,Rajasthan,2,24,7,5,38,Pass
Harjeet Singh,07-11-2004,825575,Gujarat,14,20,7,7,48,Pass
Imran Chopra,23-06-2005,263271,Rajasthan,23,12,6,8,49,Pass
Harjeet Fernandes,24-10-2005,184022,Kerala,17,0,0,15,32,Pass
Rohan Mehta,03-09-2005,868784,West Bengal,4,22,5,13,44,Pass
Aditya Chopra,12-12-2005,983976,Telangana,3,10,3,1,17,Pass
Krishna Mehta,25-03-2005,922343,Uttarakhand,3,18,17,0,38,Pass
Aditya D'Souza,21-06-2005,822999,West Bengal,3,16,20,24,63,Pass
David Khan,16-10-2005,945504,West Bengal,3,16,13,18,50,Pass
Aarav Pillai,30-07-2005,923207,Rajasthan,21,23,10,2,56,Pass
Aditya Verma,22-06-2005,373945,Uttar Pradesh,0,15,10,2,27,Pass
Aarav Sharma,18-07-2005,792396,Uttar Pradesh,0,18,20,14,52,Pass
Aryan Reddy,01-06-2005,797249,West Bengal,1,22,12,14,49,Pass
Farhan Singh,21-01-2006,431832,Rajasthan,12,12,9,8,41,Pass
Farhan Verma,13-02-2006,748424,Rajasthan,10,18,7,9,44,Pass
Peter Verma,02-04-2006,996689,Uttar Pradesh,0,21,12,18,51,Pass
Manpreet Singh,10-03-2006,252378,Tamil Nadu,13,16,0,12,41,Pass
Aarav Verma,24-08-2005,135530,Kerala,7,4,18,8,37,Pass
Krishna D'Souza,30-03-2005,658657,Rajasthan,4,18,9,11,42,Pass
Aditya Verma,01-07-2005,805366,Tamil Nadu,15,5,14,5,39,Pass
Kunal D'Souza,21-11-2005,870637,Bihar,8,22,19,16,65,Pass
Ishaan Reddy,13-08-2005,133497,Uttar Pradesh,0,7,0,13,20,Pass
Sukhwinder Pillai,22-12-2004,308126,Gujarat,17,5,21,5,48,Pass
Aditya Sharma,16-01-2005,448618,Madhya Pradesh,16,12,19,4,51,Pass
Aditya Fernandes,03-03-2005,697178,Chhattisgarh,19,3,1,7,30,Pass
Krishna Fernandes,17-09-2005,547609,Rajasthan,20,6,20,17,63,Pass
Aarav Reddy,03-08-2005,787802,Karnataka,8,16,22,2,48,Pass
Ishaan Verma,02-10-2005,495459,Bihar,20,20,9,10,59,Pass
Kunal Reddy,06-03-2006,742763,Telangana,19,12,18,4,53,Pass
Ishaan Fernandes,24-10-2005,166611,West Bengal,3,21,1,22,47,Pass
Paul Mehta,19-05-2005,566000,Uttar Pradesh,0,21,12,1,34,Pass
Aditya Pillai,24-11-2005,751272,Uttarakhand,13,4,6,19,42,Pass
Yash Khan,26-02-2005,381397,Rajasthan,20,18,8,7,53,Pass
John Pillai,24-06-2005,485013,Rajasthan,17,5,4,5,31,Pass
Sukhwinder Verma,17-06-2005,349122,Haryana,5,9,14,2,30,Pass
Rohan Khan,16-08-2005,452894,Delhi,6,3,21,21,51,Fail
Aditya Verma,13-06-2005,416285,Karnataka,3,11,19,20,53,Pass
Vivaan Verma,27-02-2006,388435,Rajasthan,20,8,1,11,40,Pass
Rohan Verma,22-03-2005,267634,Rajasthan,20,15,20,24,79,Pass
David Verma,16-11-2005,690137,Punjab,0,12,10,1,23,Pass
Vivaan Reddy,27-02-2005,660813,Bihar,14,0,12,20,46,Pass
Aditya Verma,13-09-2005,173010,Delhi,3,9,20,6,38,Fail
Imran Reddy,19-10-2005,262600,West Bengal,6,21,1,2,30,Pass
Kunal Verma,12-05-2005,346592,Uttar Pradesh,0,8,16,16,40,Pass
Aryan Pillai,28-06-2005,488618,Rajasthan,24,24,6,13,67,Pass
Paul Singh,25-12-2004,164653,Andhra Pradesh,5,15,11,10,41,Pass
Raj Sharma,05-12-2005,747021,Uttarakhand,3,23,19,12,57,Pass
Krishna Khan,09-01-2005,477214,Telangana,0,4,11,0,15,Pass
John Khan,29-09-2005,356827,Arunachal Pradesh,24,1,12,6,43,Pass
Yash Singh,15-05-2005,893058,Maharashtra,18,16,9,5,48,Pass
Aditya Verma,01-12-2004,893532,Odisha,10,20,13,12,55,Pass
Ishaan Pillai,10-03-2005,986711,Jharkhand,5,0,21,15,41,Pass
David Khan,08-07-2005,461611,Rajasthan,9,15,5,6,35,Pass
Kunal Sharma,05-07-2005,901137,Rajasthan,6,4,4,13,27,Pass
Harjeet Sharma,11-11-2005,161439,Madhya Pradesh,10,12,1,0,23,Pass
Sukhwinder Chopra,04-07-2005,335423,Uttar Pradesh,0,13,4,1,18,Pass
Kunal Singh,27-11-2005,895691,Karnataka,8,11,2,21,42,Pass
Paul Verma,12-04-2006,778771,Punjab,21,16,17,3,57,Pass
Raj Mehta,13-05-2005,469347,Madhya Pradesh,1,17,15,18,51,Pass
Ishaan Khan,16-01-2006,803785,Gujarat,18,14,22,24,78,Pass
Aryan Sharma,22-10-2005,181092,Jharkhand,5,6,7,0,18,Pass
Rehan Reddy,28-12-2004,645533,Chhattisgarh,21,15,24,17,77,Pass
Farhan Sharma,20-06-2005,360141,Haryana,7,7,23,1,38,Pass
Harjeet Verma,16-11-2005,404219,Chhattisgarh,11,9,20,0,40,Pass
Krishna Verma,26-04-2005,319295,Madhya Pradesh,6,24,19,4,53,Pass
Kunal Pillai,27-08-2005,745094,Karnataka,16,15,0,21,52,Pass
Ishaan Singh,11-12-2004,407498,Bihar,3,6,13,15,37,Pass
Aditya Sharma,15-09-2005,260072,Chhattisgarh,6,4,17,23,50,Pass
Zaid Fernandes,22-04-2006,383522,Tripura,11,8,3,21,43,Pass
Manpreet Khan,21-04-2006,405994,Madhya Pradesh,4,3,2,17,26,Pass
Raj Sharma,03-02-2005,746154,Bihar,14,22,24,22,82,Pass
Balbir Khan,10-04-2005,491787,Uttar Pradesh,0,3,17,0,20,Pass
Aarav Mehta,13-01-2005,603200,Assam,7,13,1,16,37,Pass
Yash Singh,27-02-2006,358374,Meghalaya,8,2,3,10,23,Pass
Imran Reddy,31-07-2005,807125,Rajasthan,5,6,20,13,44,Pass
Rehan Reddy,08-12-2005,571184,Uttar Pradesh,0,20,6,0,26,Pass
Yash Khan,27-09-2005,205423,Karnataka,4,22,2,8,36,Pass
Aarav Mehta,05-02-2005,492952,Maharashtra,10,17,2,19,48,Pass
Rohan Reddy,18-12-2005,707721,Andhra Pradesh,0,2,18,1,21,Pass
Rohan Sharma,06-02-2006,605914,Rajasthan,18,12,17,10,57,Pass
Aryan Singh,18-07-2005,922656,Gujarat,12,24,21,14,71,Pass
Manpreet Verma,24-09-2005,825311,Tamil Nadu,5,3,13,22,43,Pass
Ayaan D'Souza,10-09-2005,860058,West Bengal,5,15,3,0,23,Pass
Aarav Verma,17-02-2005,438222,Uttar Pradesh,0,8,3,22,33,Pass
Kunal Pillai,17-02-2005,886451,Madhya Pradesh,7,20,4,3,34,Pass
Rohan Pillai,10-11-2004,125160,Odisha,7,19,17,2,45,Pass
Aarav Reddy,09-04-2005,191815,Madhya Pradesh,0,2,18,16,36,Pass
Raj Khan,25-11-2004,375704,Telangana,11,17,6,2,36,Pass
Rohan Chopra,05-01-2005,263561,Rajasthan,7,18,10,1,36,Pass
Peter Sharma,07-03-2006,843468,Manipur,4,13,22,5,44,Pass
Farhan Verma,06-02-2005,683939,Uttar Pradesh,0,1,16,24,41,Pass
Ishaan Khan,04-12-2005,375836,Uttar Pradesh,0,13,16,16,45,Pass
Kunal Singh,05-01-2005,893086,Punjab,4,22,22,10,58,Pass
Balbir Verma,13-03-2006,110170,Kerala,14,13,15,22,64,Pass
Rohan Verma,16-04-2006,897067,Haryana,13,7,0,4,24,Pass
Ishaan Fernandes,22-09-2005,439624,West Bengal,3,15,13,9,40,Pass
Rohan Mehta,29-07-2005,710446,Assam,6,0,13,2,21,Pass
Aditya Mehta,03-01-2006,111271,Tamil Nadu,14,24,13,24,75,Pass
Harjeet Verma,16-11-2004,165294,West Bengal,17,5,6,21,49,Pass
Raj Khan,03-09-2005,100949,Jharkhand,22,3,16,4,45,Pass
Raj Pillai,15-10-2005,253630,Odisha,23,3,20,4,50,Pass
Gurpreet Chopra,26-07-2005,141817,Karnataka,2,12,13,7,34,Pass
Mathew Fernandes,25-06-2005,419063,Tamil Nadu,9,16,17,23,65,Pass
Kunal Sharma,25-08-2005,237003,Madhya Pradesh,12,11,7,18,48,Pass
Kunal Singh,11-06-2005,473452,Madhya Pradesh,16,22,23,4,65,Pass
Raj D'Souza,15-10-2005,670314,Bihar,10,1,23,16,50,Pass
Aditya D'Souza,23-05-2005,460775,Bihar,12,22,15,19,68,Pass
Gurpreet Verma,15-02-2006,469436,Bihar,19,1,17,2,39,Pass
Imran Sharma,27-06-2005,234277,Tamil Nadu,8,2,11,9,30,Pass
Mathew Pillai,13-03-2006,296034,Punjab,12,19,8,5,44,Pass
Manpreet Reddy,05-03-2005,801249,Uttar Pradesh,0,8,17,20,45,Pass
Imran Sharma,11-10-2005,616849,West Bengal,15,7,15,11,48,Pass
Vivaan Chopra,06-01-2005,881402,Bihar,18,20,17,13,68,Pass
David Verma,17-06-2005,757624,Haryana,20,4,7,20,51,Pass
Krishna Khan,27-01-2005,159596,Tamil Nadu,3,8,21,17,49,Pass
Aarav Reddy,03-10-2005,894572,Jharkhand,23,16,14,13,66,Pass
Rohan Pillai,04-02-2006,667875,Chhattisgarh,13,19,6,2,40,Pass
Raj Mehta,18-11-2005,704930,West Bengal,3,0,23,24,50,Pass
Yash Chopra,29-09-2005,423362,Uttar Pradesh,0,17,0,12,29,Pass
Rehan Verma,06-08-2005,578762,Puducherry,5,6,6,7,24,Pass
Sukhwinder Pillai,11-02-2005,100409,Madhya Pradesh,18,9,14,4,45,Pass
Raj Fernandes,18-12-2004,623997,Arunachal Pradesh,0,4,5,1,10,Pass
Aarav Verma,01-01-2006,328633,Jammu & Kashmir + Ladakh,17,19,22,0,58,Pass
Peter Chopra,10-05-2005,776123,West Bengal,1,14,1,10,26,Pass
Kunal Pillai,17-08-2005,856826,Bihar,0,18,15,24,57,Pass
Aditya Verma,06-01-2005,837512,Haryana,15,16,6,7,44,Pass
Kunal Singh,28-11-2005,858278,Rajasthan,17,3,2,18,40,Pass
John Mehta,28-07-2005,837389,Tamil Nadu,24,13,6,16,59,Pass
Aarav Pillai,17-03-2006,474647,Gujarat,8,15,3,22,48,Pass
Kunal Fernandes,17-07-2005,477131,Chhattisgarh,2,9,7,0,18,Pass
Rohan D'Souza,01-05-2005,723577,Tamil Nadu,14,3,15,8,40,Pass
Ishaan Pillai,09-04-2005,660244,Madhya Pradesh,18,14,10,4,46,Pass
Vivaan Mehta,22-01-2005,161890,Haryana,9,14,17,6,46,Pass
Krishna Fernandes,28-04-2005,612686,Andhra Pradesh,24,13,1,9,47,Pass
Kunal Mehta,01-03-2006,945083,Chhattisgarh,17,0,2,21,40,Pass
Peter Khan,15-02-2005,888167,Haryana,21,21,11,21,74,Pass
Raj D'Souza,08-08-2005,564303,Rajasthan,9,3,5,2,19,Pass
Aarav Chopra,24-03-2005,703591,Maharashtra,13,4,17,20,54,Pass
Vivaan Chopra,26-09-2005,867795,Bihar,22,21,16,14,73,Pass
Vivaan Fernandes,27-12-2004,867662,Madhya Pradesh,9,3,21,4,37,Pass
Kunal Khan,19-05-2005,445838,Jharkhand,15,6,14,4,39,Pass
Paul Pillai,11-05-2005,571786,Himachal Pradesh,24,8,5,12,49,Pass
Raj Sharma,26-11-2004,386442,Tamil Nadu,2,4,6,24,36,Pass
Aarav D'Souza,22-04-2006,775521,Delhi,16,3,6,5,30,Fail
David Verma,14-12-2004,853764,Uttar Pradesh,0,21,4,10,35,Pass
Mathew Pillai,04-04-2006,903451,Gujarat,19,23,15,18,75,Pass
Farhan Khan,03-02-2005,177741,Jharkhand,23,6,8,19,56,Pass
Gurpreet Chopra,27-12-2005,938830,Jharkhand,0,19,11,4,34,Pass
Vivaan Khan,15-02-2005,692541,Uttar Pradesh,0,21,19,24,64,Pass
Sukhwinder Mehta,12-04-2006,604265,Uttar Pradesh,0,13,13,16,42,Pass
Yash Khan,23-02-2006,584753,Jharkhand,9,7,5,20,41,Pass
Balbir D'Souza,26-04-2005,326051,Madhya Pradesh,12,8,13,8,41,Pass
Rohan Mehta,07-02-2005,403996,Gujarat,24,20,12,19,75,Pass
Kunal Sharma,06-02-2005,482862,Gujarat,14,0,14,2,30,Pass
Ishaan Sharma,07-03-2006,112290,Rajasthan,5,6,16,10,37,Pass
Aryan Mehta,06-01-2005,301122,Meghalaya,10,1,4,22,37,Pass
Kunal Reddy,27-02-2006,344980,West Bengal,15,10,4,18,47,Pass
Peter Sharma,12-11-2005,708376,Uttar Pradesh,0,24,6,24,54,Pass
Mathew Verma,19-04-2006,789674,Andhra Pradesh,14,19,19,5,57,Pass
Aryan Chopra,14-12-2005,930228,Telangana,11,16,7,7,41,Pass
Rehan Chopra,05-01-2006,674016,West Bengal,0,13,14,20,47,Pass
Paul Reddy,20-02-2005,657616,Maharashtra,11,4,21,5,41,Pass
Aditya Mehta,07-03-2005,669828,Bihar,19,17,21,5,62,Pass
Krishna Singh,07-04-2005,956608,Maharashtra,13,15,8,12,48,Pass
John Chopra,28-07-2005,433728,Uttar Pradesh,0,23,12,19,54,Pass
Vivaan Chopra,20-10-2005,385381,Madhya Pradesh,24,19,23,4,70,Pass
Krishna Chopra,14-08-2005,806829,Bihar,18,22,1,10,51,Pass
Vivaan Singh,27-11-2004,452049,Chhattisgarh,24,20,14,7,65,Pass
Ishaan D'Souza,24-03-2006,832074,Tamil Nadu,16,24,20,4,64,Pass
Yash D'Souza,17-10-2005,586380,Madhya Pradesh,2,9,24,9,44,Pass
Krishna Singh,07-03-2005,949304,Bihar,6,15,24,21,66,Pass
Raj Fernandes,01-04-2005,603224,Gujarat,1,8,18,14,41,Pass
Manpreet D'Souza,24-01-2005,451006,Madhya Pradesh,10,2,21,2,35,Pass
Paul Mehta,17-11-2005,464754,Punjab,11,0,21,16,48,Pass
Sukhwinder Sharma,02-01-2006,614136,Kerala,20,2,4,8,34,Pass
Paul Verma,13-03-2006,544082,Uttar Pradesh,0,2,1,9,12,Pass
Ishaan Singh,04-09-2005,220862,Jammu & Kashmir + Ladakh,12,22,3,13,50,Pass
Gurpreet Pillai,20-01-2005,924576,Madhya Pradesh,23,23,10,4,60,Pass
Manpreet D'Souza,19-11-2005,797195,Uttar Pradesh,0,5,4,0,9,Pass
Manpreet Pillai,10-03-2006,896642,Jharkhand,8,11,7,12,38,Pass
Yash Reddy,20-02-2005,771864,Kerala,16,1,16,23,56,Pass
Mathew D'Souza,05-03-2005,362181,Tripura,2,2,20,5,29,Pass
Kunal Sharma,07-12-2004,202609,Rajasthan,12,5,18,15,50,Pass
Aarav Singh,22-01-2005,809649,Tamil Nadu,16,16,17,20,69,Pass
Kunal Reddy,12-09-2005,832579,West Bengal,16,1,20,0,37,Pass
Raj Pillai,01-08-2005,810518,Bihar,10,20,17,17,64,Pass
Krishna Verma,05-07-2005,700664,Haryana,23,3,16,19,61,Pass
John Mehta,08-11-2005,581361,Rajasthan,20,12,6,20,58,Pass
Raj Mehta,09-08-2005,526094,Gujarat,18,13,5,9,45,Pass
Aryan Fernandes,22-04-2006,393685,Bihar,18,3,16,0,37,Pass
Ishaan Mehta,06-05-2005,612685,Jharkhand,20,14,0,13,47,Pass
Balbir Sharma,28-03-2006,945015,Maharashtra,20,4,15,22,61,Pass
Aarav Chopra,28-10-2005,939177,Tamil Nadu,0,3,14,10,27,Pass
Vivaan Pillai,01-02-2006,306455,Maharashtra,11,17,10,5,43,Pass
David Verma,19-01-2005,935782,West Bengal,9,22,8,8,47,Pass
Rehan D'Souza,02-04-2006,920595,Maharashtra,9,18,6,2,35,Pass
Ishaan D'Souza,25-04-2005,184227,Uttarakhand,24,4,3,18,49,Pass
David Verma,01-04-2006,669794,Uttar Pradesh,0,23,21,5,49,Pass
Harjeet D'Souza,05-04-2006,297657,Telangana,7,11,22,22,62,Pass
Aditya Verma,05-01-2005,566558,Uttar Pradesh,0,15,7,11,33,Pass
Aarav Verma,15-01-2005,808072,Rajasthan,0,23,21,24,68,Pass
Sukhwinder Mehta,05-12-2004,928959,Himachal Pradesh,5,24,4,11,44,Pass
Ishaan Khan,01-12-2004,233486,Kerala,11,13,12,8,44,Pass
Raj D'Souza,14-01-2006,494993,Chhattisgarh,12,12,7,19,50,Pass
Aditya Sharma,01-04-2006,631240,Uttar Pradesh,0,2,2,9,13,Pass
Aarav Fernandes,19-11-2004,629669,Jharkhand,9,13,24,15,61,Pass
Paul Khan,30-12-2005,481282,Andhra Pradesh,23,8,6,24,61,Pass
Kunal Fernandes,02-03-2006,287545,Uttar Pradesh,0,2,22,23,47,Pass
Gurpreet Khan,22-02-2006,331388,Uttar Pradesh,0,23,18,17,58,Pass
Ishaan Singh,11-07-2005,831392,Rajasthan,1,0,3,1,5,Pass
David D'Souza,14-06-2005,531945,Assam,7,14,20,1,42,Pass
Manpreet Chopra,05-08-2005,993177,Bihar,13,7,13,4,37,Pass
Ishaan Sharma,01-05-2005,295493,Jharkhand,20,21,4,10,55,Pass
Aarav Pillai,13-03-2006,138106,Kerala,12,16,13,17,58,Pass
David Fernandes,07-11-2004,196548,Maharashtra,15,2,22,0,39,Pass
Kunal Pillai,15-06-2005,102345,Maharashtra,14,12,1,16,43,Pass
Kunal D'Souza,26-03-2005,387527,Chhattisgarh,18,12,2,8,40,Pass
Aryan D'Souza,13-09-2005,299750,Chhattisgarh,16,14,0,0,30,Pass
Vivaan Verma,06-05-2005,426791,Bihar,23,20,11,20,74,Pass
Aarav Fernandes,08-02-2006,433181,Uttar Pradesh,0,12,12,23,47,Pass
Rohan Sharma,19-03-2005,404817,Haryana,15,2,2,6,25,Pass
Aryan Singh,03-01-2005,627289,Haryana,16,10,15,10,51,Pass
Peter Verma,30-01-2006,702440,Jammu & Kashmir + Ladakh,22,18,16,0,56,Pass
Raj Khan,24-01-2006,416465,Rajasthan,20,12,4,13,49,Pass
Sukhwinder Pillai,22-09-2005,894870,Tamil Nadu,4,18,9,8,39,Pass
Krishna Verma,09-11-2005,632669,Odisha,14,20,8,6,48,Pass
Krishna Sharma,08-02-2005,812973,Himachal Pradesh,22,21,0,19,62,Pass
Gurpreet Chopra,18-11-2005,478727,Maharashtra,24,4,21,21,70,Pass
David Fernandes,23-04-2005,133067,Uttar Pradesh,0,17,20,19,56,Pass
Aarav Sharma,15-03-2005,890238,Delhi,9,13,0,7,29,Fail
Yash Chopra,28-01-2005,727136,Rajasthan,10,24,14,7,55,Pass
Aarav Singh,15-06-2005,540982,Tripura,24,1,6,13,44,Pass
Aryan Mehta,18-02-2006,412576,Rajasthan,1,1,20,14,36,Pass
Krishna Verma,02-10-2005,628411,Rajasthan,3,19,8,24,54,Pass
Kunal Pillai,25-02-2005,105681,Uttar Pradesh,0,18,22,20,60,Pass
Vivaan Reddy,23-10-2005,213219,Gujarat,17,0,19,7,43,Pass
David Khan,26-08-2005,424955,Bihar,6,6,9,10,31,Pass
Kunal Mehta,31-12-2004,290942,Maharashtra,18,4,12,16,50,Pass
Yash Fernandes,21-10-2005,549595,Uttar Pradesh,0,13,16,24,53,Pass
Sukhwinder Pillai,22-02-2005,825959,West Bengal,3,14,22,8,47,Pass
Paul Verma,18-04-2006,887686,Uttar Pradesh,0,13,7,16,36,Pass
Sukhwinder Verma,22-03-2005,102647,Andhra Pradesh,9,12,21,10,52,Pass
Aditya Pillai,23-04-2006,113426,West Bengal,17,5,7,11,40,Pass
Aryan Verma,17-12-2005,730198,Bihar,3,10,16,11,40,Pass
Paul D'Souza,26-12-2005,385265,Bihar,19,6,13,21,59,Pass
Aryan Fernandes,06-01-2006,266748,Uttar Pradesh,0,2,1,15,18,Pass
Kunal Sharma,20-06-2005,377540,Rajasthan,22,14,3,15,54,Pass
Yash Pillai,09-05-2005,749338,Punjab,3,7,17,17,44,Pass
Krishna Verma,16-09-2005,120289,Karnataka,7,21,6,9,43,Pass
Raj Sharma,01-10-2005,508733,Maharashtra,9,4,14,15,42,Pass
Balbir Reddy,29-12-2004,197561,Bihar,0,7,22,7,36,Pass
Manpreet Singh,14-02-2005,873897,Maharashtra,4,1,11,23,39,Pass
Aditya D'Souza,27-04-2005,482265,Karnataka,3,2,11,11,27,Pass
Harjeet Singh,18-01-2006,825159,Uttar Pradesh,0,8,10,10,28,Pass
Aditya Khan,06-10-2005,491339,Madhya Pradesh,2,1,12,13,28,Pass
Yash Sharma,06-05-2005,574375,Chhattisgarh,18,19,11,0,48,Pass
Yash Verma,23-11-2005,238406,Rajasthan,24,15,11,7,57,Pass
Ishaan D'Souza,24-02-2006,403284,Haryana,18,21,22,4,65,Pass
David Chopra,30-11-2005,656732,Punjab,6,5,0,1,12,Pass
Aryan Fernandes,19-10-2005,242023,Jammu & Kashmir + Ladakh,3,16,24,5,48,Pass
Manpreet D'Souza,22-12-2004,172907,Jharkhand,2,15,13,0,30,Pass
Aarav Khan,02-11-2005,490701,Bihar,7,14,14,0,35,Pass
Rohan Pillai,09-09-2005,438777,Bihar,4,6,7,12,29,Pass
Kunal Khan,12-09-2005,190639,Delhi,7,15,18,5,45,Fail
Kunal Reddy,13-08-2005,864267,Bihar,8,13,8,21,50,Pass
Aryan Khan,01-12-2004,755495,Madhya Pradesh,22,2,19,4,47,Pass
Aditya Pillai,26-02-2006,634762,Punjab,11,20,6,4,41,Pass
Aditya Fernandes,13-01-2006,652671,Rajasthan,3,20,23,19,65,Pass
Mathew Verma,30-12-2004,134310,Madhya Pradesh,20,23,21,4,68,Pass
Yash Mehta,04-10-2005,265990,Andhra Pradesh,11,12,19,10,52,Pass
Yash Pillai,19-01-2006,141550,Assam,2,5,6,24,37,Pass
Harjeet Pillai,01-08-2005,799837,Tamil Nadu,10,13,20,21,64,Pass
David Chopra,28-06-2005,228539,Tamil Nadu,21,8,10,10,49,Pass
Vivaan Sharma,20-10-2005,299176,Uttar Pradesh,0,2,1,14,17,Pass
Ishaan Verma,18-09-2005,150401,Bihar,14,12,23,21,70,Pass
Kunal Singh,25-01-2006,500319,Bihar,13,2,18,22,55,Pass
Aarav Sharma,08-02-2005,686302,Punjab,19,0,11,3,33,Pass
Yash Sharma,23-10-2005,791937,Bihar,5,9,8,13,35,Pass
Peter Mehta,01-12-2004,425449,Rajasthan,11,17,8,1,37,Pass
Aarav Fernandes,23-02-2005,394136,Uttar Pradesh,0,15,17,17,49,Pass
Kunal Sharma,31-10-2005,609538,Uttar Pradesh,0,5,16,9,30,Pass
Vivaan Fernandes,07-11-2005,439750,Rajasthan,9,6,23,12,50,Pass
Vivaan Singh,23-11-2005,607328,Madhya Pradesh,4,22,4,13,43,Pass
Rohan Khan,28-02-2006,576608,Punjab,9,6,24,2,41,Pass
Raj Mehta,12-09-2005,430161,Rajasthan,19,1,11,10,41,Pass
Aryan Khan,05-11-2005,363312,Manipur,4,2,7,15,28,Pass
Yash D'Souza,21-10-2005,301292,Uttar Pradesh,0,20,10,9,39,Pass
Vivaan Mehta,12-09-2005,229646,Odisha,3,18,3,15,39,Pass
Yash Sharma,30-12-2004,546010,Tamil Nadu,15,17,0,23,55,Pass
Rehan Sharma,01-01-2005,789296,Bihar,10,24,18,18,70,Pass
Manpreet Khan,23-12-2004,593923,Tamil Nadu,24,19,19,19,81,Pass
Aryan Verma,29-05-2005,273978,Gujarat,10,11,1,14,36,Pass
Raj Pillai,07-03-2005,602294,West Bengal,12,7,5,24,48,Pass
Aditya Khan,04-01-2006,957403,Telangana,1,15,17,6,39,Pass
Ishaan Fernandes,23-03-2005,982096,Rajasthan,5,0,17,9,31,Pass
Yash Fernandes,01-02-2005,445519,Tamil Nadu,17,10,15,18,60,Pass
Aditya Singh,05-02-2006,869847,Madhya Pradesh,6,4,20,9,39,Pass
Ishaan Chopra,19-02-2006,572906,Punjab,4,16,4,17,41,Pass
Aarav Khan,22-11-2005,834102,Kerala,11,13,4,15,43,Pass
Gurpreet Singh,02-05-2006,962816,Andhra Pradesh,17,12,10,19,58,Pass
Ishaan D'Souza,14-04-2005,829601,Madhya Pradesh,1,23,5,3,32,Pass
Rohan Mehta,01-10-2005,194589,Himachal Pradesh,3,24,17,4,48,Pass
Farhan Mehta,30-10-2005,224429,Himachal Pradesh,12,6,22,6,46,Pass
Balbir Mehta,08-08-2005,513263,Haryana,17,10,2,15,44,Pass
Yash Mehta,22-08-2005,264901,Maharashtra,14,4,18,24,60,Pass
Aryan Chopra,24-02-2005,289604,Maharashtra,11,4,23,8,46,Pass
Aditya Sharma,15-03-2006,750829,Rajasthan,20,21,16,14,71,Pass
Ishaan Singh,16-02-2005,404364,Uttar Pradesh,0,6,2,22,30,Pass
Mathew Verma,26-07-2005,696949,Tamil Nadu,3,14,4,17,38,Pass
Krishna Verma,13-04-2005,104341,Gujarat,15,18,3,5,41,Pass
Peter Sharma,11-01-2005,896871,Uttar Pradesh,0,10,1,12,23,Pass
Ayaan Khan,27-11-2004,607693,Madhya Pradesh,9,2,1,21,33,Pass
Rohan Mehta,16-04-2006,322656,Delhi,0,10,19,4,33,Fail
Raj D'Souza,20-04-2005,843999,Assam,4,13,3,24,44,Pass
Kunal D'Souza,25-05-2005,776978,Rajasthan,9,21,17,11,58,Pass
Raj Fernandes,31-03-2005,619415,Kerala,7,8,9,9,33,Pass
Vivaan Mehta,10-07-2005,239976,Chhattisgarh,17,1,8,14,40,Pass
John Verma,23-03-2005,808059,Rajasthan,2,6,19,8,35,Pass
Mathew Chopra,15-09-2005,588661,Maharashtra,2,23,5,3,33,Pass
Vivaan Verma,02-01-2006,873778,Andhra Pradesh,14,4,2,2,22,Pass
Vivaan Khan,03-09-2005,387196,Karnataka,13,17,8,24,62,Pass
Raj Singh,04-04-2006,633706,Bihar,0,15,7,24,46,Pass
Ishaan Chopra,31-01-2005,450049,Punjab,24,18,8,8,58,Pass
Aarav Verma,02-02-2005,238178,Bihar,16,10,12,3,41,Pass
Vivaan Mehta,13-02-2006,818394,Assam,1,10,16,16,43,Pass
Rohan Mehta,10-01-2005,800938,Tamil Nadu,21,11,24,16,72,Pass
Rohan Chopra,27-12-2004,505663,Odisha,14,3,24,1,42,Pass
Aryan Mehta,15-02-2005,684472,Kerala,7,4,19,11,41,Pass
Kunal Sharma,24-08-2005,806120,Kerala,9,7,16,22,54,Pass
Aditya Khan,21-03-2005,146554,Assam,3,18,8,7,36,Pass
Aditya Singh,06-02-2005,178649,Punjab,12,7,15,12,46,Pass
Harjeet Sharma,08-04-2006,821522,Odisha,23,7,0,18,48,Pass
Rohan Khan,09-12-2005,687649,Karnataka,12,16,8,21,57,Pass
Vivaan Fernandes,02-05-2006,345446,Uttar Pradesh,0,18,17,18,53,Pass
Paul Fernandes,12-10-2005,480425,Bihar,14,24,12,14,64,Pass
Aditya Khan,15-01-2006,654032,Himachal Pradesh,13,2,24,11,50,Pass
Vivaan Chopra,15-11-2005,359639,Telangana,2,8,15,15,40,Pass
Kunal Chopra,17-11-2005,750273,West Bengal,3,15,20,16,54,Pass
Raj Mehta,27-05-2005,489149,Haryana,15,5,22,15,57,Pass
Yash Chopra,18-10-2005,484758,Madhya Pradesh,22,6,19,5,52,Pass
Krishna Verma,08-08-2005,375363,Meghalaya,24,22,20,11,77,Pass
Krishna Sharma,13-01-2005,954992,Bihar,3,18,19,10,50,Pass
Aarav Singh,06-12-2005,574187,Rajasthan,19,8,8,22,57,Pass
John Singh,01-09-2005,712251,Uttarakhand,17,5,0,0,22,Pass
Vivaan Singh,06-08-2005,311963,Uttar Pradesh,0,8,15,16,39,Pass
Yash Mehta,13-02-2005,357198,Uttar Pradesh,0,21,20,5,46,Pass
Yash Fernandes,25-04-2005,289133,Maharashtra,17,4,4,1,26,Pass
Aryan Fernandes,16-02-2005,432278,Punjab,0,2,3,5,10,Pass
Gurpreet Khan,14-07-2005,914748,Meghalaya,16,16,6,16,54,Pass
Aditya Sharma,07-02-2006,549182,Andhra Pradesh,24,8,16,7,55,Pass
Vivaan Sharma,19-07-2005,362681,West Bengal,3,6,12,16,37,Pass
David Sharma,17-03-2006,279011,Uttar Pradesh,0,0,9,16,25,Pass
Ishaan Verma,25-01-2006,228016,Jharkhand,6,6,7,7,26,Pass
Raj Singh,21-04-2005,310679,Haryana,12,4,9,21,46,Pass
Paul Chopra,09-08-2005,745329,Madhya Pradesh,21,16,18,4,59,Pass
Yash Sharma,07-06-2005,335605,Uttar Pradesh,0,18,10,24,52,Pass
Yash Pillai,02-05-2005,217574,Rajasthan,22,19,3,11,55,Pass
Aryan Mehta,23-06-2005,356692,Bihar,17,7,2,24,50,Pass
Ayaan Reddy,18-12-2004,334371,Madhya Pradesh,9,13,2,0,24,Pass
Rehan Reddy,30-12-2005,843488,Uttar Pradesh,0,11,13,13,37,Pass
Kunal Fernandes,15-02-2005,199052,Nagaland,4,4,1,4,13,Pass
Aditya Sharma,09-04-2006,334454,Uttar Pradesh,0,9,0,15,24,Pass
Gurpreet Verma,20-08-2005,100895,Bihar,7,6,4,22,39,Pass
Peter Pillai,26-12-2005,210529,Tripura,19,19,1,3,42,Pass
Harjeet Singh,10-10-2005,132439,Bihar,5,13,9,19,46,Pass
Harjeet Pillai,05-09-2005,648821,Punjab,16,7,18,15,56,Pass
Kunal Khan,05-04-2005,576798,Bihar,20,15,0,19,54,Pass
Gurpreet Pillai,28-12-2005,560372,Rajasthan,15,10,18,5,48,Pass
Manpreet D'Souza,06-05-2006,435525,West Bengal,12,3,8,8,31,Pass
Vivaan Sharma,07-01-2006,739283,Uttar Pradesh,0,24,4,17,45,Pass
Aditya Fernandes,19-02-2006,265086,Rajasthan,16,22,14,22,74,Pass
John Singh,28-11-2004,582071,Haryana,19,15,8,1,43,Pass
Krishna Pillai,31-12-2004,461886,Bihar,16,14,19,20,69,Pass
Aditya Fernandes,06-02-2006,709475,Telangana,10,4,0,24,38,Pass
Aarav Mehta,07-05-2005,110073,Rajasthan,9,24,13,14,60,Pass
Aditya D'Souza,08-05-2006,535009,Haryana,17,10,23,12,62,Pass
Ishaan Chopra,10-12-2005,172900,Gujarat,16,13,15,6,50,Pass
Aarav Mehta,12-01-2006,322619,Delhi,16,18,4,21,59,Fail
Aditya Reddy,03-02-2006,385616,Jharkhand,11,14,6,14,45,Pass
Raj Verma,23-12-2004,335984,Meghalaya,18,14,6,22,60,Pass
Kunal Pillai,27-03-2006,399006,Madhya Pradesh,10,0,1,15,26,Pass
Kunal Singh,08-03-2006,480705,Kerala,7,22,9,8,46,Pass
Aditya Khan,04-06-2005,567565,Chhattisgarh,11,15,9,3,38,Pass
Raj Chopra,03-07-2005,641957,Maharashtra,16,14,12,2,44,Pass
Raj D'Souza,04-02-2006,797883,Gujarat,2,11,13,7,33,Pass
Sukhwinder Singh,31-10-2005,857446,Assam,0,24,13,4,41,Pass
Aryan Sharma,02-07-2005,543985,Uttar Pradesh,0,15,1,16,32,Pass
Rohan Sharma,01-11-2005,232887,Uttar Pradesh,0,19,0,19,38,Pass
Aditya D'Souza,19-04-2005,862116,Rajasthan,11,2,9,3,25,Pass
Raj Singh,19-01-2005,638830,Maharashtra,3,4,14,13,34,Pass
Balbir Khan,07-08-2005,689205,Maharashtra,22,4,22,18,66,Pass
Yash D'Souza,11-09-2005,686983,Madhya Pradesh,23,17,3,4,47,Pass
Raj Verma,09-05-2006,715241,Punjab,19,19,3,4,45,Pass
Kunal Singh,28-05-2005,268254,Gujarat,22,8,22,7,59,Pass
Raj Mehta,10-04-2006,634902,West Bengal,14,9,1,8,32,Pass
Krishna Fernandes,05-02-2006,917704,Manipur,4,21,24,9,58,Pass
Yash Chopra,19-07-2005,504482,Madhya Pradesh,23,21,18,4,66,Pass
Manpreet Singh,03-04-2005,761229,Jharkhand,10,0,15,17,42,Pass
Aryan D'Souza,27-12-2005,709350,Telangana,24,3,23,19,69,Pass
Aarav Reddy,02-06-2005,692517,Madhya Pradesh,9,17,7,11,44,Pass
Aarav Chopra,27-02-2005,383097,Uttar Pradesh,0,22,2,7,31,Pass
Yash Pillai,14-07-2005,131154,Odisha,5,6,19,14,44,Pass
Sukhwinder D'Souza,16-12-2004,199115,Assam,1,20,21,6,48,Pass
Aarav Chopra,13-04-2006,848794,Tamil Nadu,1,14,13,10,38,Pass
Harjeet Fernandes,11-12-2005,712595,Rajasthan,24,20,17,12,73,Pass
Raj Sharma,30-09-2005,923844,Karnataka,20,10,3,0,33,Pass
Kunal Reddy,06-03-2005,415756,Chhattisgarh,3,5,3,2,13,Pass
Aryan Verma,30-12-2004,539411,Telangana,18,8,14,12,52,Pass
Paul Reddy,02-11-2005,777217,Andhra Pradesh,17,0,1,24,42,Pass
Raj Sharma,06-04-2005,477647,Chhattisgarh,16,10,23,23,72,Pass
Rohan Fernandes,09-02-2005,302706,Maharashtra,24,6,4,13,47,Pass
Vivaan Mehta,05-04-2005,798986,Tamil Nadu,1,21,19,1,42,Pass
Kunal Mehta,30-08-2005,376694,Bihar,1,3,23,23,50,Pass
Vivaan Singh,20-04-2005,915842,Haryana,19,3,13,6,41,Pass
Raj Fernandes,25-11-2004,327385,Madhya Pradesh,0,5,7,8,20,Pass
Peter Sharma,10-05-2005,867203,Maharashtra,1,10,18,15,44,Pass
Rohan Singh,01-01-2005,422914,Rajasthan,20,4,3,23,50,Pass
Rohan Sharma,07-12-2004,650782,Bihar,7,23,18,24,72,Pass
Aditya Verma,14-03-2006,776357,Arunachal Pradesh,1,19,20,24,64,Pass
Rohan Chopra,26-06-2005,227263,Telangana,21,8,4,20,53,Pass
Raj D'Souza,25-11-2005,982519,Maharashtra,1,9,15,15,40,Pass
Ishaan Singh,05-02-2006,991848,Madhya Pradesh,20,2,1,10,33,Pass
Rohan Singh,14-07-2005,434803,Karnataka,3,8,7,11,29,Pass
Aarav D'Souza,01-03-2006,188324,Gujarat,15,20,0,22,57,Pass
Yash Mehta,27-04-2005,481405,Jharkhand,2,18,8,3,31,Pass
Krishna Khan,24-06-2005,354949,Karnataka,12,11,22,12,57,Pass
Ishaan Khan,12-06-2005,835039,Uttar Pradesh,0,5,5,17,27,Pass
Paul Reddy,28-06-2005,432651,Uttar Pradesh,0,1,7,3,11,Pass
Raj Khan,04-01-2005,129479,Madhya Pradesh,10,23,10,3,46,Pass
Yash Sharma,09-11-2005,762785,Uttarakhand,3,24,0,23,50,Pass
Kunal Pillai,18-04-2006,841758,Rajasthan,21,17,24,10,72,Pass
Yash D'Souza,10-06-2005,661350,Maharashtra,11,4,20,9,44,Pass
Gurpreet Singh,13-04-2005,832472,Bihar,16,21,17,4,58,Pass
Sukhwinder Fernandes,20-06-2005,222724,Madhya Pradesh,7,12,22,4,45,Pass
Kunal Singh,29-09-2005,871817,Rajasthan,7,17,13,10,47,Pass
John Fernandes,09-07-2005,208394,Telangana,21,24,3,22,70,Pass
Yash Mehta,11-10-2005,355697,Madhya Pradesh,15,0,2,2,19,Pass
Yash Pillai,14-12-2004,998310,Odisha,1,16,14,16,47,Pass
Ishaan Singh,09-07-2005,616789,Andhra Pradesh,0,7,8,14,29,Pass
Raj Sharma,30-04-2005,490441,Uttar Pradesh,0,10,13,9,32,Pass
Harjeet Sharma,26-05-2005,379407,Maharashtra,10,1,20,15,46,Pass
Imran Khan,21-11-2004,792238,Assam,1,17,12,3,33,Pass
Vivaan Pillai,05-07-2005,129301,Uttar Pradesh,0,24,1,18,43,Pass
Gurpreet Khan,10-03-2005,406918,Andhra Pradesh,1,21,5,20,47,Pass
Vivaan Sharma,20-09-2005,295629,Haryana,24,19,3,2,48,Pass
Yash Fernandes,11-06-2005,558975,Bihar,4,22,13,17,56,Pass
Vivaan Sharma,19-10-2005,980522,Punjab,21,18,3,3,45,Pass
Rohan Pillai,24-12-2004,728203,Odisha,19,17,24,4,64,Pass
Aditya Mehta,11-08-2005,488312,Telangana,4,12,12,17,45,Pass
Yash Mehta,17-02-2006,639536,Bihar,17,0,22,1,40,Pass
Aditya Khan,06-01-2005,101668,Karnataka,2,9,15,12,38,Pass
Harjeet Khan,08-12-2005,712098,Andhra Pradesh,7,12,22,1,42,Pass
Aditya Verma,02-01-2006,650844,Bihar,20,12,18,8,58,Pass
Ishaan Pillai,05-10-2005,800168,Uttarakhand,3,23,8,16,50,Pass
Kunal Sharma,24-02-2006,266308,Bihar,0,0,13,10,23,Pass
David Pillai,04-02-2005,453738,Bihar,5,19,17,18,59,Pass
Aarav Singh,29-10-2005,102232,Uttar Pradesh,10,17,3,14,44,Pass
Krishna D'Souza,13-12-2005,407001,Jammu & Kashmir + Ladakh,6,19,9,9,43,Pass
Harjeet Fernandes,27-11-2004,391293,Punjab,4,6,23,2,35,Pass
Rehan Fernandes,15-02-2005,741275,Karnataka,6,3,15,19,43,Pass
Yash Fernandes,04-07-2005,293552,West Bengal,4,16,2,23,45,Pass
Kunal Chopra,23-05-2005,513682,Tamil Nadu,20,1,18,2,41,Pass
Aditya Fernandes,10-07-2005,972224,Rajasthan,13,22,16,1,52,Pass
Rehan Fernandes,05-08-2005,973943,Andhra Pradesh,13,7,24,5,49,Pass
Raj Singh,12-08-2005,162491,Haryana,11,14,24,18,67,Pass
Vivaan Mehta,08-11-2004,248310,Jharkhand,7,7,13,17,44,Pass
Krishna Singh,18-07-2005,264235,Punjab,24,1,3,1,29,Pass
Aarav Fernandes,25-02-2005,922681,Tamil Nadu,2,6,10,18,36,Pass
Balbir Sharma,28-06-2005,721792,Assam,23,5,5,11,44,Pass
Aarav Mehta,13-12-2004,561027,Himachal Pradesh,8,16,6,3,33,Pass
Krishna Fernandes,08-01-2005,819227,West Bengal,7,2,5,9,23,Pass
Aditya Pillai,11-12-2004,889688,Uttar Pradesh,5,1,21,10,37,Pass
Gurpreet Verma,28-05-2005,859989,Uttar Pradesh,21,1,22,15,59,Pass
Yash Fernandes,09-11-2004,404452,Haryana,13,13,7,20,53,Pass
Aditya Chopra,23-05-2005,422195,Jammu & Kashmir + Ladakh,5,5,5,8,23,Pass
Manpreet Reddy,01-01-2006,127230,Tamil Nadu,16,22,12,24,74,Pass
Krishna Chopra,15-03-2005,657248,Meghalaya,17,10,5,4,36,Pass
Paul Khan,17-11-2004,381858,Uttar Pradesh,9,1,5,19,34,Pass
Yash Singh,07-10-2005,822964,Maharashtra,2,4,14,3,23,Pass
Zaid Pillai,08-03-2005,745377,West Bengal,15,11,7,10,43,Pass
Aryan Fernandes,25-09-2005,850222,Bihar,10,24,21,3,58,Pass
Krishna Reddy,06-06-2005,491485,Chhattisgarh,7,12,19,4,42,Pass
Krishna Fernandes,29-01-2006,298813,Bihar,5,2,4,17,28,Pass
Aarav Fernandes,27-12-2005,658621,Bihar,23,19,21,9,72,Pass
Raj Mehta,29-01-2006,913994,Haryana,15,0,17,16,48,Pass
Mathew Verma,13-01-2006,966738,Haryana,0,21,24,21,66,Pass
Rohan Khan,07-01-2005,902813,Haryana,3,24,10,21,58,Pass
Manpreet Khan,10-01-2006,384984,Gujarat,19,20,20,9,68,Pass
Aarav Mehta,21-08-2005,739165,Uttar Pradesh,23,1,6,7,37,Pass
Gurpreet Singh,13-07-2005,534791,Assam,0,12,23,2,37,Pass
Vivaan Sharma,23-01-2005,725674,Uttarakhand,3,19,17,14,53,Pass
John Mehta,10-12-2005,584403,Jammu & Kashmir + Ladakh,10,14,22,2,48,Pass
Aarav Reddy,09-07-2005,352481,Rajasthan,8,1,3,9,21,Pass
Vivaan Sharma,30-10-2005,858126,Jharkhand,11,18,11,2,42,Pass
Kunal Reddy,02-08-2005,535671,Madhya Pradesh,17,3,22,4,46,Pass
Krishna Khan,23-04-2006,861246,Uttar Pradesh,20,1,10,22,53,Pass
Aryan Verma,05-09-2005,686514,Maharashtra,14,4,13,18,49,Pass
Balbir Reddy,18-01-2005,540321,Bihar,14,21,12,15,62,Pass
Raj Reddy,09-03-2006,193403,Gujarat,12,7,20,12,51,Pass
Rohan Sharma,17-10-2005,906778,Bihar,13,7,7,16,43,Pass
David Fernandes,03-11-2005,788082,Gujarat,3,4,5,13,25,Pass
Aryan Reddy,01-03-2005,500474,Rajasthan,15,11,18,17,61,Pass
Balbir Pillai,02-03-2005,220176,Gujarat,14,0,0,10,24,Pass
Kunal Singh,03-03-2006,429176,Bihar,20,1,6,21,48,Pass
John D'Souza,08-05-2006,407672,Bihar,19,22,19,18,78,Pass
Aditya Singh,15-02-2006,952521,Haryana,12,11,8,20,51,Pass
Vivaan Chopra,07-08-2005,337284,Gujarat,19,20,12,10,61,Pass
John Mehta,31-03-2005,797377,Maharashtra,14,12,1,8,35,Pass
Raj Pillai,06-03-2005,704712,Haryana,3,9,9,5,26,Pass
Raj Fernandes,08-01-2006,336664,Uttar Pradesh,19,1,2,18,40,Pass
Paul Sharma,22-10-2005,356082,Himachal Pradesh,22,15,10,1,48,Pass
Raj Sharma,03-10-2005,217563,Tamil Nadu,18,5,12,1,36,Pass
Ishaan Khan,06-03-2005,635938,Maharashtra,24,4,10,23,61,Pass
Ishaan Pillai,02-03-2005,938626,Karnataka,17,15,12,14,58,Pass
Krishna Verma,28-12-2005,461263,Uttar Pradesh,19,1,21,12,53,Pass
Yash Sharma,22-12-2005,570758,Bihar,2,18,5,8,33,Pass
Paul Reddy,26-10-2005,250595,West Bengal,3,17,3,19,42,Pass
Krishna Singh,15-02-2006,487228,Bihar,24,1,3,13,41,Pass
Balbir Sharma,12-10-2005,286472,Rajasthan,8,22,4,6,40,Pass
Rohan Verma,30-11-2004,108616,Himachal Pradesh,8,9,13,13,43,Pass
Aditya D'Souza,02-07-2005,404952,Telangana,4,14,17,2,37,Pass
Aditya D'Souza,14-01-2005,518471,Madhya Pradesh,0,4,1,8,13,Pass
Yash D'Souza,08-03-2006,589726,West Bengal,3,16,7,19,45,Pass
Ishaan Reddy,07-02-2006,961177,Punjab,20,3,10,23,56,Pass
Aarav Singh,14-03-2005,398642,Bihar,14,17,2,20,53,Pass
Yash Singh,16-01-2005,216941,West Bengal,3,17,16,13,49,Pass
Farhan Reddy,17-02-2005,870088,Madhya Pradesh,20,10,6,14,50,Pass
Yash Khan,27-11-2004,697250,Maharashtra,7,2,22,5,36,Pass
Aditya Khan,15-01-2005,230727,Maharashtra,4,4,10,18,36,Pass
Krishna Pillai,14-11-2004,754214,Assam,3,3,9,7,22,Pass
Krishna Singh,02-05-2005,679204,Jharkhand,23,16,9,12,60,Pass
Rohan Singh,26-10-2005,647540,Madhya Pradesh,4,21,15,16,56,Pass
Aarav Verma,30-10-2005,595949,Maharashtra,13,4,24,20,61,Pass
Kunal Singh,03-02-2005,382799,Uttarakhand,8,17,3,11,39,Pass
Peter Reddy,22-01-2005,714990,Odisha,19,4,5,21,49,Pass
Balbir Chopra,02-06-2005,245093,Andhra Pradesh,15,5,20,1,41,Pass
Rohan Verma,28-11-2005,131383,West Bengal,19,5,16,0,40,Pass
Aarav Khan,02-03-2006,109555,Karnataka,17,20,3,10,50,Pass
Krishna Verma,06-04-2005,736807,Karnataka,5,11,11,23,50,Pass
Farhan Reddy,17-09-2005,670350,Bihar,5,7,3,9,24,Pass
Vivaan Chopra,05-06-2005,954593,Uttar Pradesh,16,1,8,17,42,Pass
Mathew Khan,22-05-2005,859079,Uttar Pradesh,16,1,19,1,37,Pass
Aryan Fernandes,01-09-2005,705635,Andhra Pradesh,18,9,18,18,63,Pass
Manpreet Mehta,09-06-2005,822633,Bihar,7,3,24,6,40,Pass
Zaid Khan,26-12-2004,324526,Karnataka,6,19,3,3,31,Pass
Manpreet D'Souza,20-07-2005,714449,West Bengal,14,0,5,24,43,Pass
Krishna Singh,16-09-2005,416488,Nagaland,5,6,11,19,41,Pass
Raj Sharma,11-09-2005,717795,Telangana,22,16,23,1,62,Pass
Kunal Pillai,28-05-2005,509355,Bihar,0,23,17,10,50,Pass
Kunal D'Souza,16-01-2005,558760,Bihar,1,18,18,17,54,Pass
Rehan Sharma,24-11-2005,318959,Uttar Pradesh,21,1,5,0,27,Pass
Aarav Singh,24-02-2006,601247,Odisha,23,14,21,21,79,Pass
Aditya Fernandes,14-03-2006,885079,Haryana,11,13,0,0,24,Pass
Aryan Khan,16-10-2005,681495,Odisha,15,8,3,11,37,Pass
Aryan Singh,09-08-2005,218158,Jammu & Kashmir + Ladakh,3,1,0,10,14,Pass
Rohan Pillai,30-10-2005,986734,West Bengal,3,18,10,18,49,Pass
Aarav Singh,15-07-2005,828824,Chhattisgarh,19,10,12,12,53,Pass
Vivaan Chopra,27-01-2005,441287,Maharashtra,3,21,11,1,36,Pass
Paul Pillai,04-04-2005,101598,Uttar Pradesh,4,1,24,4,33,Pass
Aryan Reddy,16-03-2005,667186,Delhi,10,11,22,1,44,Fail
Farhan Sharma,21-01-2006,953456,Maharashtra,20,0,15,12,47,Pass
Raj Sharma,07-06-2005,625687,Karnataka,14,17,10,8,49,Pass
Krishna Khan,21-11-2005,322110,Assam,1,16,16,12,45,Pass
Aarav Chopra,27-09-2005,576040,Punjab,10,12,7,24,53,Pass
Krishna Khan,17-02-2005,222425,Andhra Pradesh,18,12,23,4,57,Pass
Raj Fernandes,09-06-2005,266338,Rajasthan,1,9,0,9,19,Pass
Aditya Fernandes,30-12-2005,486119,Jharkhand,20,12,5,18,55,Pass
Gurpreet Fernandes,17-11-2005,499070,Delhi,22,9,20,6,57,Fail
Yash Verma,19-12-2005,346089,Maharashtra,8,4,18,22,52,Pass
Aditya Reddy,14-06-2005,451318,Bihar,21,7,4,19,51,Pass
Aryan Fernandes,15-05-2005,319422,Bihar,11,5,11,23,50,Pass
Aryan Mehta,08-12-2004,764123,Chhattisgarh,24,10,11,18,63,Pass
Raj Fernandes,12-11-2005,819911,Andhra Pradesh,3,8,5,1,17,Pass
Peter Singh,24-08-2005,872324,Rajasthan,24,0,19,18,61,Pass
Aditya Chopra,11-05-2005,394416,Telangana,16,2,18,23,59,Pass
Rohan Chopra,20-03-2006,779098,Madhya Pradesh,1,4,18,14,37,Pass
Yash Khan,05-12-2004,747620,Telangana,18,17,21,3,59,Pass
Vivaan Chopra,11-07-2005,507647,Maharashtra,7,4,19,18,48,Pass
Ishaan Chopra,13-11-2004,689744,Maharashtra,22,4,3,0,29,Pass
Raj Khan,04-10-2005,638223,Uttar Pradesh,5,1,10,17,33,Pass
Rohan Singh,24-03-2006,875682,Punjab,23,23,21,14,81,Pass
Yash Reddy,09-08-2005,200499,Jammu & Kashmir + Ladakh,17,13,7,7,44,Pass
Peter Sharma,10-03-2005,404610,Madhya Pradesh,12,7,5,2,26,Pass
Aditya Mehta,09-03-2005,427386,Telangana,19,7,4,12,42,Pass
Krishna D'Souza,28-06-2005,507801,Bihar,16,20,10,6,52,Pass
Ishaan Pillai,12-08-2005,385508,Rajasthan,6,11,9,9,35,Pass
Vivaan D'Souza,06-02-2005,126852,Gujarat,3,8,20,4,35,Pass
Harjeet Pillai,02-02-2006,243118,Himachal Pradesh,14,5,9,11,39,Pass
Yash D'Souza,08-10-2005,911379,Uttar Pradesh,20,1,9,8,38,Pass
Yash Mehta,22-01-2006,735127,Andhra Pradesh,10,24,1,12,47,Pass
Vivaan D'Souza,02-08-2005,195341,Madhya Pradesh,11,23,13,4,51,Pass
Aditya Chopra,05-02-2005,529778,Bihar,16,22,21,1,60,Pass
Sukhwinder Verma,03-02-2005,900420,Maharashtra,8,4,6,22,40,Pass
Raj Reddy,06-02-2005,437527,Uttar Pradesh,22,1,19,12,54,Pass
Aarav Khan,10-08-2005,326404,Odisha,12,18,4,12,46,Pass
David Verma,20-06-2005,570054,Telangana,4,6,9,0,19,Pass
Ayaan D'Souza,03-04-2006,514895,Andhra Pradesh,24,6,1,2,33,Pass
Rohan Khan,13-03-2005,178026,Uttar Pradesh,19,1,5,13,38,Pass
Farhan Pillai,31-01-2006,670768,Odisha,9,21,2,1,33,Pass
Yash Sharma,25-01-2006,317343,Andhra Pradesh,5,0,8,8,21,Pass
Balbir Mehta,24-02-2005,906397,Kerala,0,23,18,19,60,Pass
Raj Reddy,23-02-2005,779407,Delhi,17,0,16,22,55,Fail
Yash Reddy,10-11-2005,894507,Madhya Pradesh,9,24,8,4,45,Pass
Kunal Sharma,13-03-2005,630302,Gujarat,16,5,24,7,52,Pass
Ishaan Verma,01-09-2005,565688,Kerala,9,6,13,10,38,Pass
Raj Verma,20-02-2006,621490,Assam,3,17,2,22,44,Pass
Balbir Khan,17-03-2006,271293,Uttarakhand,3,22,1,11,37,Pass
Raj Reddy,21-01-2005,990593,Himachal Pradesh,20,8,13,23,64,Pass
Balbir Verma,01-05-2006,606739,Jharkhand,14,7,1,22,44,Pass
Aryan D'Souza,19-03-2006,455821,Gujarat,3,14,2,2,21,Pass
Aryan Mehta,06-04-2006,206274,West Bengal,11,21,14,6,52,Pass
Kunal Reddy,04-05-2005,405187,Assam,1,24,3,4,32,Pass
Yash Fernandes,19-12-2005,370699,Bihar,11,20,21,18,70,Pass
Vivaan Khan,17-07-2005,390856,West Bengal,5,7,16,16,44,Pass
Aditya Pillai,12-12-2005,206176,Uttar Pradesh,21,1,15,16,53,Pass
Rohan Sharma,17-03-2005,151346,West Bengal,5,2,4,2,13,Pass
Rohan Pillai,19-11-2005,881755,Haryana,6,17,24,19,66,Pass
Gurpreet Mehta,10-11-2004,241559,Maharashtra,1,11,5,16,33,Pass
Krishna Verma,22-08-2005,164883,Haryana,1,2,11,8,22,Pass
Yash Khan,21-04-2006,632483,Tamil Nadu,19,12,7,0,38,Pass
Aryan Pillai,08-12-2004,611011,West Bengal,5,1,13,5,24,Pass
Aarav Chopra,08-01-2006,711806,Himachal Pradesh,16,4,3,3,26,Pass
Sukhwinder Mehta,19-05-2005,922373,Gujarat,13,13,5,12,43,Pass
Aarav Khan,08-04-2005,889146,Tripura,23,23,3,5,54,Pass
Krishna Sharma,03-01-2005,197101,Bihar,3,19,7,17,46,Pass
Ayaan D'Souza,01-10-2005,299967,Maharashtra,11,3,23,2,39,Pass
David Pillai,27-03-2006,686241,Punjab,16,12,1,19,48,Pass
Krishna Sharma,02-11-2005,946746,Uttar Pradesh,9,1,14,19,43,Pass
Yash D'Souza,03-01-2005,267338,Uttar Pradesh,5,1,1,10,17,Pass
Zaid Singh,16-03-2006,774630,Uttar Pradesh,6,1,2,12,21,Pass
Aryan Chopra,28-03-2006,262315,Odisha,11,24,15,18,68,Pass
Aarav Reddy,27-03-2005,485258,Bihar,15,24,3,6,48,Pass
Sukhwinder Sharma,16-08-2005,965008,Punjab,3,9,8,20,40,Pass
Vivaan Fernandes,16-12-2004,834558,Karnataka,6,9,16,14,45,Pass
Krishna Sharma,29-07-2005,743618,Bihar,20,20,2,23,65,Pass
Balbir Pillai,04-04-2006,824470,Madhya Pradesh,17,0,4,12,33,Pass
Mathew Reddy,11-06-2005,392168,Gujarat,19,8,7,5,39,Pass
Krishna Chopra,18-11-2005,169616,Jammu & Kashmir + Ladakh,22,18,1,18,59,Pass
Kunal Sharma,14-10-2005,491750,Rajasthan,18,12,13,19,62,Pass
Yash Fernandes,22-01-2006,906052,Maharashtra,3,0,12,19,34,Pass
Aarav Pillai,17-11-2005,994817,Assam,21,19,3,19,62,Pass
Aarav Fernandes,12-06-2005,831683,Telangana,16,15,14,19,64,Pass
Ishaan Verma,04-12-2004,238871,Telangana,14,12,20,0,46,Pass
Aryan Singh,06-03-2006,193790,Delhi,5,20,1,19,45,Fail
Yash Khan,11-03-2006,898928,Haryana,21,15,12,14,62,Pass
Ishaan Singh,05-07-2005,619669,Bihar,8,17,16,2,43,Pass
Yash Singh,06-08-2005,378558,Jharkhand,15,8,12,5,40,Pass
Mathew D'Souza,27-04-2006,712244,Gujarat,12,8,0,18,38,Pass
Rohan Khan,12-01-2006,552019,Sikkim,0,18,4,14,36,Pass
Krishna Mehta,30-08-2005,943306,Bihar,6,16,18,20,60,Pass
Raj Sharma,04-05-2006,544550,Bihar,14,6,23,17,60,Pass
Manpreet Khan,12-07-2005,257696,Assam,10,24,18,9,61,Pass
Kunal Sharma,25-05-2005,391524,Odisha,0,16,0,23,39,Pass
Krishna Chopra,10-12-2004,355061,Telangana,2,3,14,2,21,Pass
Mathew Pillai,21-09-2005,342796,Uttar Pradesh,21,1,13,6,41,Pass
Raj D'Souza,23-09-2005,954217,Andhra Pradesh,20,16,6,11,53,Pass
Rohan D'Souza,14-03-2005,607257,Rajasthan,11,6,0,1,18,Pass
Aarav Chopra,28-08-2005,153924,Bihar,0,16,11,19,46,Pass
Ishaan Reddy,06-12-2005,717662,Bihar,4,1,5,1,11,Pass
Aditya Pillai,18-12-2004,224288,Tamil Nadu,19,22,15,21,77,Pass
Ishaan Khan,19-07-2005,357793,Rajasthan,21,16,3,19,59,Pass
Harjeet Mehta,12-04-2005,383321,Uttarakhand,19,12,0,5,36,Pass
Aryan Verma,05-01-2006,324597,Uttar Pradesh,22,1,21,16,60,Pass
Gurpreet Verma,11-05-2005,634838,Kerala,12,14,11,13,50,Pass
Yash Mehta,18-07-2005,912956,Maharashtra,14,5,15,6,40,Pass
Aryan Fernandes,27-04-2005,882530,Uttar Pradesh,12,1,18,5,36,Pass
Raj Sharma,11-03-2005,282118,Rajasthan,15,21,5,17,58,Pass
Yash Fernandes,17-12-2005,356381,Rajasthan,11,0,11,18,40,Pass
Raj Mehta,25-03-2005,203115,Telangana,19,13,8,8,48,Pass
Aryan Singh,07-05-2006,452800,Karnataka,9,1,3,19,32,Pass
David Pillai,08-03-2006,872857,Madhya Pradesh,13,19,13,4,49,Pass
Aarav Singh,05-06-2005,574819,Uttar Pradesh,19,1,5,17,42,Pass
Vivaan Fernandes,31-10-2005,589566,Bihar,14,12,24,15,65,Pass
Balbir Mehta,24-04-2005,260540,Jharkhand,3,8,22,5,38,Pass
Krishna Sharma,24-07-2005,846209,Rajasthan,4,7,1,11,23,Pass
Krishna Pillai,07-12-2004,275435,Manipur,23,0,6,22,51,Pass
Vivaan Pillai,15-12-2004,351262,Tamil Nadu,14,18,7,17,56,Pass
Raj Pillai,06-06-2005,566874,Gujarat,13,2,0,3,18,Pass
Aditya Verma,15-02-2005,960579,West Bengal,3,11,21,21,56,Pass
Kunal Chopra,02-04-2006,869144,West Bengal,6,23,4,3,36,Pass
Ishaan Verma,01-09-2005,549129,West Bengal,8,2,1,8,19,Pass
Aryan Verma,20-03-2005,151465,Tamil Nadu,19,8,19,24,70,Pass
Ishaan Fernandes,13-04-2005,693101,Bihar,10,13,6,13,42,Pass
Gurpreet Mehta,02-01-2005,420096,Madhya Pradesh,19,22,19,4,64,Pass
Aryan Fernandes,14-08-2005,803219,Punjab,3,23,3,12,41,Pass
Harjeet Pillai,29-03-2006,116429,Chhattisgarh,13,7,7,0,27,Pass
Raj Singh,22-11-2004,466245,Punjab,22,4,22,10,58,Pass
Rohan Khan,02-11-2005,848908,Punjab,18,19,3,10,50,Pass
Ishaan D'Souza,11-01-2006,633720,Maharashtra,21,4,18,24,67,Pass
Aryan D'Souza,22-11-2005,757977,Himachal Pradesh,10,18,14,11,53,Pass
Aarav Sharma,06-05-2005,429506,Bihar,20,18,12,19,69,Pass
Ishaan Sharma,13-09-2005,477809,Uttar Pradesh,24,1,19,1,45,Pass
David D'Souza,21-08-2005,274936,Madhya Pradesh,12,19,4,18,53,Pass
Sukhwinder D'Souza,18-10-2005,232538,Madhya Pradesh,8,13,23,4,48,Pass
Manpreet Chopra,22-12-2004,670820,Bihar,17,12,16,4,49,Pass
Rohan D'Souza,02-03-2005,866179,Rajasthan,23,5,16,5,49,Pass
Krishna Mehta,30-12-2005,976044,West Bengal,2,13,3,3,21,Pass
Balbir Chopra,06-05-2006,215368,Bihar,13,8,13,10,44,Pass
Paul Reddy,07-06-2005,256788,Punjab,16,3,5,24,48,Pass
Raj Khan,25-04-2005,378250,Uttar Pradesh,1,1,3,3,8,Pass
Ishaan Pillai,24-11-2005,647639,Haryana,24,14,14,4,56,Pass
Aarav Reddy,24-06-2005,674614,Uttar Pradesh,15,1,12,4,32,Pass
Raj Sharma,02-05-2005,337173,Telangana,23,20,3,24,70,Pass
Vivaan Singh,03-06-2005,974260,Punjab,24,3,6,12,45,Pass
Yash Pillai,18-12-2004,728837,Madhya Pradesh,20,11,17,0,48,Pass
Vivaan Pillai,17-03-2006,686056,Bihar,8,8,8,5,29,Pass
Raj Fernandes,12-11-2005,921251,Uttar Pradesh,6,1,6,13,26,Pass
Paul Pillai,06-08-2005,174164,Haryana,12,9,10,2,33,Pass
Ishaan Fernandes,15-03-2005,501206,Gujarat,18,18,9,23,68,Pass
Farhan Mehta,28-01-2005,376329,Bihar,14,16,20,5,55,Pass
Kunal Singh,24-08-2005,485296,Rajasthan,3,11,7,9,30,Pass
Harjeet Pillai,11-08-2005,564832,Bihar,22,4,18,12,56,Pass
Aryan Mehta,26-11-2005,146451,Assam,10,11,0,9,30,Pass
Gurpreet Fernandes,19-04-2006,691914,Madhya Pradesh,10,21,15,1,47,Pass
Vivaan Fernandes,10-04-2006,896422,Karnataka,14,14,11,8,47,Pass
Paul Verma,01-05-2006,880401,Haryana,5,2,9,6,22,Pass
Aarav Singh,11-02-2005,761664,Uttar Pradesh,3,1,12,7,23,Pass
Gurpreet D'Souza,03-02-2005,598007,Jharkhand,16,4,0,12,32,Pass
Aryan Reddy,22-06-2005,950028,Andhra Pradesh,18,20,3,16,57,Pass
Vivaan Sharma,29-01-2006,622160,Uttar Pradesh,15,1,10,16,42,Pass
John Mehta,13-02-2005,259496,Punjab,11,23,24,23,81,Pass
Peter Singh,02-04-2005,181946,Rajasthan,11,17,15,19,62,Pass
Aditya Sharma,26-11-2004,873201,Uttar Pradesh,6,1,2,13,22,Pass
Sukhwinder Pillai,08-05-2006,899317,Uttar Pradesh,2,1,23,7,33,Pass
Vivaan Reddy,28-07-2005,345066,Bihar,22,19,3,11,55,Pass
Aryan Sharma,24-06-2005,760395,Bihar,3,12,23,4,42,Pass
Kunal Pillai,17-02-2005,519650,Mizoram,5,21,0,8,34,Pass
Sukhwinder Chopra,07-04-2006,741412,Gujarat,10,24,7,5,46,Pass
Aryan Khan,20-04-2006,183553,Rajasthan,21,16,6,24,67,Pass
Ishaan Verma,27-11-2004,348423,Bihar,5,17,13,10,45,Pass
Aryan Verma,31-05-2005,222534,West Bengal,13,7,1,11,32,Pass
Kunal Sharma,23-11-2005,491760,Maharashtra,3,1,5,12,21,Pass
Aryan Sharma,18-04-2006,452838,Jammu & Kashmir + Ladakh,10,20,14,4,48,Pass
Gurpreet Mehta,11-05-2005,327637,Uttarakhand,3,24,13,18,58,Pass
Harjeet Mehta,04-07-2005,777560,Karnataka,3,24,15,7,49,Pass
Raj Chopra,03-07-2005,255872,Chhattisgarh,1,1,16,6,24,Pass
Harjeet Reddy,08-11-2004,700760,Uttarakhand,16,14,10,8,48,Pass
Gurpreet Khan,24-02-2006,958452,Punjab,12,1,7,2,22,Pass
Rehan Reddy,01-04-2006,867299,Karnataka,8,11,23,5,47,Pass
Aryan Mehta,19-01-2006,586699,Haryana,8,4,1,4,17,Pass
Krishna Fernandes,24-05-2005,314829,Rajasthan,0,20,21,4,45,Pass
Yash Khan,23-10-2005,273819,Jammu & Kashmir + Ladakh,10,7,7,0,24,Pass
Harjeet Fernandes,14-03-2005,622820,Jammu & Kashmir + Ladakh,5,19,2,10,36,Pass
Krishna Chopra,10-07-2005,593442,Himachal Pradesh,14,3,21,12,50,Pass
Aditya D'Souza,01-04-2005,812238,Bihar,1,5,8,22,36,Pass
Sukhwinder Chopra,11-01-2005,651551,Bihar,21,24,4,9,58,Pass
Kunal Pillai,11-02-2006,458610,Tamil Nadu,0,19,6,6,31,Pass
Aryan Sharma,22-11-2005,169276,Rajasthan,11,13,16,3,43,Pass
Ishaan Pillai,06-05-2005,939028,Rajasthan,7,10,17,11,45,Pass
Sukhwinder Verma,23-03-2006,140084,Chhattisgarh,8,12,16,23,59,Pass
Raj Chopra,01-07-2005,377008,West Bengal,3,5,24,7,39,Pass
John Reddy,11-06-2005,602974,Tamil Nadu,12,8,0,24,44,Pass
Paul Pillai,31-01-2005,888443,Gujarat,24,15,18,15,72,Pass
Yash Pillai,14-04-2005,861413,Telangana,20,3,24,23,70,Pass
Vivaan Fernandes,03-03-2005,228114,Punjab,4,24,3,24,55,Pass
Balbir Fernandes,02-09-2005,556403,Madhya Pradesh,11,3,18,6,38,Pass
Aryan Pillai,20-10-2005,364439,Rajasthan,15,2,6,20,43,Pass
Ishaan Chopra,21-03-2006,942382,Maharashtra,22,4,11,11,48,Pass
Paul Verma,10-11-2004,890713,Maharashtra,20,2,21,5,48,Pass
Rohan Fernandes,07-01-2006,350838,Chhattisgarh,11,5,20,24,60,Pass
Mathew Khan,10-02-2006,164579,Tamil Nadu,7,19,4,13,43,Pass
Yash D'Souza,18-10-2005,804039,Rajasthan,3,24,19,14,60,Pass
Raj Sharma,25-12-2005,510303,West Bengal,3,15,18,24,60,Pass
Aarav Reddy,02-04-2005,937721,West Bengal,3,15,2,3,23,Pass
Krishna Singh,11-02-2005,596984,Bihar,15,10,9,2,36,Pass
Aarav Chopra,23-01-2005,318044,Bihar,17,4,13,12,46,Pass
Krishna Reddy,20-05-2005,183487,Uttar Pradesh,8,1,13,20,42,Pass
Raj D'Souza,13-06-2005,497992,Bihar,10,13,20,12,55,Pass
Rohan Singh,03-01-2005,376956,Uttar Pradesh,7,1,1,17,26,Pass
Farhan Khan,29-12-2004,944286,Rajasthan,11,14,15,18,58,Pass
Raj Chopra,20-08-2005,107153,Rajasthan,13,9,9,3,34,Pass
Sukhwinder Fernandes,11-08-2005,547118,Haryana,14,1,20,12,47,Pass
Krishna Verma,23-01-2006,367109,Uttar Pradesh,13,1,14,6,34,Pass
Ishaan Khan,07-02-2006,532698,Uttar Pradesh,19,1,12,9,41,Pass
Aditya Singh,20-09-2005,592803,West Bengal,3,17,19,1,40,Pass
Ishaan Fernandes,18-12-2004,943981,Uttarakhand,3,20,15,24,62,Pass
Yash Pillai,13-02-2005,153868,Uttarakhand,4,0,22,5,31,Pass
Aarav Fernandes,19-01-2006,343188,Telangana,20,14,20,9,63,Pass
Peter Khan,22-01-2006,693763,Odisha,7,22,16,1,46,Pass
Gurpreet Pillai,26-04-2006,194114,Kerala,7,24,10,11,52,Pass
David Singh,20-04-2005,129164,Bihar,19,0,7,22,48,Pass
Aarav Pillai,24-01-2006,295730,Arunachal Pradesh,6,12,12,17,47,Pass
Aryan Khan,25-01-2006,141879,Delhi,22,24,23,24,93,Fail
Aryan Fernandes,30-01-2006,404149,Madhya Pradesh,12,10,15,1,38,Pass
Kunal Reddy,24-05-2005,494475,Andhra Pradesh,20,7,15,17,59,Pass
Aditya D'Souza,30-03-2005,189683,Uttar Pradesh,15,1,2,11,29,Pass
Vivaan Reddy,03-03-2005,864936,Assam,5,9,11,16,41,Pass
Harjeet Sharma,04-06-2005,203793,West Bengal,4,5,6,1,16,Pass
Vivaan Mehta,30-04-2006,323166,Maharashtra,18,4,21,8,51,Pass
Krishna Chopra,31-12-2005,144702,Punjab,16,2,4,24,46,Pass
Manpreet Mehta,20-10-2005,711537,Jharkhand,15,17,8,5,45,Pass
Imran Mehta,07-07-2005,997304,Bihar,6,6,24,16,52,Pass
Raj Mehta,14-02-2005,457314,Karnataka,20,4,24,1,49,Pass
Aarav Mehta,22-11-2004,567415,Andhra Pradesh,0,8,7,11,26,Pass
Ishaan Pillai,20-01-2006,179985,Kerala,6,13,5,6,30,Pass
Gurpreet Verma,19-02-2005,930450,Chhattisgarh,19,23,16,21,79,Pass
Yash Sharma,06-05-2005,736171,Uttar Pradesh,6,1,15,2,24,Pass
Manpreet Sharma,08-12-2005,262039,Uttar Pradesh,21,1,0,22,44,Pass
Rohan Fernandes,19-12-2005,871837,Uttar Pradesh,8,1,12,4,25,Pass
Aditya Pillai,16-05-2005,979798,Madhya Pradesh,10,15,7,16,48,Pass
Gurpreet Reddy,29-10-2005,927134,Assam,8,18,14,0,40,Pass
Peter Verma,04-02-2006,345697,Gujarat,5,21,12,22,60,Pass
Ishaan Chopra,23-02-2006,694380,Maharashtra,9,4,20,23,56,Pass
Kunal Mehta,09-12-2004,825013,Tamil Nadu,23,17,9,11,60,Pass
Harjeet Reddy,04-03-2005,926673,Gujarat,2,17,17,16,52,Pass
John Mehta,15-04-2006,825807,Maharashtra,23,4,15,6,48,Pass
Krishna Verma,26-04-2006,972584,West Bengal,1,21,24,7,53,Pass
Aarav Singh,29-03-2006,595469,Jammu & Kashmir + Ladakh,7,18,11,21,57,Pass
Yash Mehta,17-02-2005,307757,Tamil Nadu,1,13,22,22,58,Pass
Kunal Khan,12-03-2006,370469,Punjab,0,11,11,2,24,Pass
Aryan Reddy,24-05-2005,129232,Madhya Pradesh,14,12,10,9,45,Pass
John Pillai,09-03-2005,142828,Bihar,9,17,14,19,59,Pass
Farhan Pillai,31-01-2005,701150,Tamil Nadu,23,11,0,8,42,Pass
Aryan Khan,17-02-2005,689325,Chhattisgarh,19,22,2,9,52,Pass
Vivaan Verma,10-10-2005,405664,Madhya Pradesh,2,5,6,4,17,Pass
John Mehta,22-12-2004,652106,Uttar Pradesh,13,1,21,2,37,Pass
Ishaan Sharma,10-02-2005,868886,Tripura,24,9,3,21,57,Pass
Yash Fernandes,10-12-2004,908604,Haryana,6,10,11,0,27,Pass
Sukhwinder Mehta,12-05-2005,344271,Maharashtra,14,11,2,20,47,Pass
Sukhwinder Mehta,08-11-2004,358951,West Bengal,7,22,0,21,50,Pass
Rohan Reddy,14-09-2005,151994,West Bengal,11,4,10,15,40,Pass
Rohan D'Souza,15-05-2005,967416,Uttarakhand,10,6,13,9,38,Pass
Yash Verma,08-04-2005,677626,Jharkhand,4,6,20,21,51,Pass
Mathew Sharma,25-04-2005,564920,Tamil Nadu,8,11,3,10,32,Pass
Krishna Pillai,18-07-2005,154968,Punjab,22,14,8,9,53,Pass
Aarav Verma,07-03-2006,280243,Karnataka,8,4,11,18,41,Pass
Vivaan Singh,24-09-2005,598365,Tamil Nadu,8,22,21,10,61,Pass
Paul Chopra,14-12-2005,225322,Gujarat,12,21,19,23,75,Pass
Aryan Sharma,14-01-2005,192281,Maharashtra,24,4,0,17,45,Pass
Ishaan Mehta,03-07-2005,292675,West Bengal,3,15,18,20,56,Pass
Raj Chopra,06-04-2005,873322,Assam,20,20,7,0,47,Pass
Yash Mehta,26-11-2005,616497,Uttar Pradesh,1,1,10,3,15,Pass
Peter Mehta,18-09-2005,206533,Andhra Pradesh,14,12,21,3,50,Pass
Balbir Chopra,26-11-2004,923005,Uttar Pradesh,7,1,18,0,26,Pass
Kunal Reddy,20-03-2006,357152,Andhra Pradesh,15,11,15,9,50,Pass
Balbir Sharma,11-06-2005,899609,Rajasthan,14,13,17,2,46,Pass
Sukhwinder Reddy,18-12-2004,603373,Maharashtra,23,4,18,20,65,Pass
Aarav Khan,03-12-2005,548440,Tamil Nadu,4,24,19,6,53,Pass
Yash D'Souza,16-10-2005,259715,Madhya Pradesh,6,1,14,1,22,Pass
Krishna Reddy,25-02-2005,712424,Bihar,9,16,17,9,51,Pass
Ishaan Singh,22-10-2005,262744,Bihar,23,7,17,7,54,Pass
Raj Khan,05-02-2005,467983,West Bengal,3,21,7,13,44,Pass
Kunal Verma,20-11-2004,796063,Rajasthan,14,3,10,16,43,Pass
Yash Chopra,20-03-2006,849188,Jammu & Kashmir + Ladakh,4,8,21,11,44,Pass
Kunal Khan,17-03-2006,345632,Andhra Pradesh,4,23,6,5,38,Pass
Gurpreet Khan,24-02-2006,856208,Madhya Pradesh,11,13,12,4,40,Pass
Aarav Singh,03-11-2005,358902,Haryana,10,14,3,7,34,Pass
Aryan Chopra,10-06-2005,132186,Rajasthan,20,2,11,7,40,Pass
Ishaan Sharma,13-08-2005,716548,Maharashtra,23,4,19,13,59,Pass
Krishna Khan,03-12-2005,922813,West Bengal,1,19,13,12,45,Pass
Raj Reddy,17-09-2005,489450,Bihar,2,17,5,8,32,Pass
Yash Chopra,12-03-2006,690403,Maharashtra,1,2,22,7,32,Pass
Krishna D'Souza,04-06-2005,658206,Uttarakhand,3,23,14,0,40,Pass
Ishaan Khan,09-02-2005,124795,Jharkhand,22,20,13,5,60,Pass
Krishna Singh,19-01-2006,917363,Bihar,20,3,13,5,41,Pass
Aditya Pillai,11-02-2006,326873,Gujarat,24,15,4,5,48,Pass
Aditya Fernandes,17-02-2006,744284,Tamil Nadu,23,10,4,5,42,Pass
Aditya Mehta,20-04-2006,500122,Maharashtra,15,4,7,22,48,Pass
Krishna Fernandes,23-01-2005,135245,Gujarat,17,6,19,8,50,Pass
Aditya D'Souza,31-08-2005,180456,Assam,4,19,8,15,46,Pass
Harjeet D'Souza,28-01-2005,907317,Madhya Pradesh,21,12,17,4,54,Pass
Manpreet Chopra,11-10-2005,191619,Kerala,8,8,9,8,33,Pass
Aditya Singh,24-06-2005,743413,Gujarat,5,9,1,2,17,Pass
Rohan Verma,30-04-2005,526777,Andhra Pradesh,13,3,5,24,45,Pass
Sukhwinder Verma,15-11-2005,662156,Rajasthan,16,1,3,4,24,Pass
Vivaan Fernandes,27-01-2005,523662,Jammu & Kashmir + Ladakh,23,0,19,18,60,Pass
Raj Fernandes,27-08-2005,687630,Madhya Pradesh,21,5,17,4,47,Pass
John Verma,13-02-2005,945199,Jammu & Kashmir + Ladakh,5,6,1,8,20,Pass
Krishna Verma,24-11-2005,780709,Jharkhand,9,10,15,2,36,Pass
Balbir D'Souza,28-02-2005,359203,Kerala,16,7,5,3,31,Pass
Krishna Verma,23-12-2004,745130,Uttar Pradesh,3,1,11,8,23,Pass
Krishna Singh,01-04-2006,853002,Haryana,22,11,12,14,59,Pass
Rehan Sharma,23-10-2005,790284,Maharashtra,9,7,19,11,46,Pass
Vivaan Verma,11-01-2005,713809,Madhya Pradesh,8,0,8,10,26,Pass
Raj D'Souza,07-08-2005,860101,Madhya Pradesh,24,0,12,0,36,Pass
Ishaan Pillai,06-12-2004,850864,Assam,24,17,13,10,64,Pass
Sukhwinder Khan,20-09-2005,995519,Tamil Nadu,10,10,14,1,35,Pass
Ishaan Mehta,15-04-2005,488520,Maharashtra,10,0,23,3,36,Pass
Aditya Verma,08-11-2005,161616,Haryana,11,3,0,1,15,Pass
Vivaan Reddy,23-02-2005,271616,Uttar Pradesh,3,1,23,20,47,Pass
Yash Fernandes,12-04-2006,148268,Maharashtra,5,19,12,11,47,Pass
Krishna Verma,01-04-2005,719378,Uttarakhand,8,24,6,3,41,Pass
Yash Singh,12-08-2005,184894,Haryana,19,24,7,5,55,Pass
Vivaan Mehta,24-12-2005,306155,Uttar Pradesh,12,1,0,8,21,Pass
Peter D'Souza,08-04-2006,794315,Uttar Pradesh,24,1,13,21,59,Pass
Vivaan D'Souza,24-11-2004,229014,Sikkim,6,3,20,0,29,Pass
Vivaan Verma,06-11-2005,397158,Bihar,8,20,6,17,51,Pass
Paul Chopra,18-01-2006,956483,Andhra Pradesh,16,11,8,15,50,Pass
Sukhwinder Chopra,29-11-2004,622339,West Bengal,3,15,20,14,52,Pass
Aditya Fernandes,16-07-2005,657921,Uttar Pradesh,1,1,18,5,25,Pass
Yash Khan,07-02-2005,694453,Uttarakhand,8,2,4,1,15,Pass
Ishaan Verma,11-10-2005,580393,Uttar Pradesh,11,1,8,10,30,Pass
Gurpreet Khan,07-10-2005,270823,Uttar Pradesh,11,1,21,8,41,Pass
David Pillai,01-10-2005,122234,Gujarat,11,4,8,2,25,Pass
Yash Sharma,21-02-2005,944794,Bihar,9,19,7,5,40,Pass
Peter Reddy,01-12-2005,693956,Uttar Pradesh,9,1,22,3,35,Pass
Ayaan Fernandes,22-10-2005,678093,Assam,5,18,11,16,50,Pass
Vivaan Pillai,02-03-2005,430044,Kerala,18,0,24,13,55,Pass
Raj Reddy,19-12-2005,918934,Punjab,10,20,1,14,45,Pass
Raj Pillai,06-07-2005,652890,West Bengal,17,5,2,4,28,Pass
Aarav Khan,18-07-2005,409851,Punjab,16,7,22,21,66,Pass
John Singh,13-04-2006,370205,West Bengal,12,7,4,20,43,Pass
Ishaan D'Souza,24-03-2006,252282,Gujarat,24,10,11,9,54,Pass
Rohan D'Souza,28-08-2005,721861,Haryana,0,2,10,20,32,Pass
Raj Reddy,25-01-2005,890720,Maharashtra,18,4,18,4,44,Pass
Aarav Reddy,16-12-2004,455298,Rajasthan,15,24,4,16,59,Pass
Ayaan Chopra,25-12-2005,576251,Meghalaya,22,12,10,6,50,Pass
Gurpreet Khan,18-01-2006,788092,Bihar,17,10,12,10,49,Pass
Raj Pillai,30-08-2005,566984,Madhya Pradesh,15,22,2,4,43,Pass
Aditya Sharma,19-12-2005,952682,Bihar,4,15,3,21,43,Pass
Krishna Khan,14-08-2005,203527,Tamil Nadu,14,6,18,4,42,Pass
Paul Fernandes,04-05-2006,752837,Gujarat,24,18,3,1,46,Pass
Paul Chopra,08-02-2005,274468,Delhi,10,18,7,6,41,Fail
Farhan Khan,29-05-2005,574859,Uttar Pradesh,0,1,0,2,3,Pass
Aditya Verma,14-08-2005,333460,Uttar Pradesh,19,1,0,15,35,Pass
Ishaan Sharma,02-01-2006,959016,Maharashtra,12,21,6,3,42,Pass
David Verma,05-05-2006,858349,Tamil Nadu,6,22,13,6,47,Pass
David Chopra,28-02-2005,422685,Madhya Pradesh,6,10,20,20,56,Pass
Raj Singh,24-08-2005,933278,West Bengal,23,14,13,0,50,Pass
Rohan Singh,21-12-2004,501654,Karnataka,15,19,16,14,64,Pass
Ishaan Reddy,30-03-2005,427283,Uttar Pradesh,15,1,8,1,25,Pass
David D'Souza,08-08-2005,400712,Himachal Pradesh,16,11,21,18,66,Pass
Krishna Singh,17-12-2004,407172,West Bengal,11,20,5,4,40,Pass
Vivaan Verma,02-03-2006,532103,Kerala,0,15,5,21,41,Pass
Aditya Pillai,16-04-2005,907270,West Bengal,3,21,21,23,68,Pass
Aditya Singh,04-01-2006,171157,West Bengal,0,11,0,8,19,Pass
Aryan Mehta,24-04-2006,468937,Telangana,7,5,22,11,45,Pass
Imran Verma,12-07-2005,942669,Rajasthan,23,23,19,12,77,Pass
Farhan Reddy,29-11-2005,110473,Bihar,0,17,23,0,40,Pass
Rohan Khan,02-02-2006,251779,Haryana,24,21,21,12,78,Pass
Rohan Pillai,07-10-2005,677737,Kerala,12,15,3,13,43,Pass
Aditya Pillai,24-11-2005,251743,Bihar,18,17,21,22,78,Pass
Zaid Singh,31-07-2005,440115,Tamil Nadu,11,22,10,22,65,Pass
Raj Fernandes,05-02-2005,593716,Jharkhand,22,0,6,17,45,Pass
Krishna Singh,04-03-2006,664621,West Bengal,5,5,23,0,33,Pass
Ishaan Khan,19-03-2006,256885,Punjab,18,6,16,23,63,Pass
Ishaan Singh,31-01-2006,456124,Tamil Nadu,22,16,7,4,49,Pass
Kunal Fernandes,19-02-2005,924654,Chhattisgarh,15,15,4,7,41,Pass
Kunal Khan,29-01-2006,825830,West Bengal,3,23,0,16,42,Pass
Rohan Pillai,04-05-2006,224462,Uttar Pradesh,20,1,10,0,31,Pass
Ishaan Verma,27-07-2005,240789,Uttar Pradesh,10,1,22,17,50,Pass
Aditya Reddy,07-05-2005,913632,Punjab,20,9,22,7,58,Pass
Aarav Fernandes,03-11-2005,690761,Odisha,10,13,14,6,43,Pass
Aryan Khan,23-03-2005,320468,Uttar Pradesh,22,1,1,6,30,Pass
Aditya Sharma,26-11-2004,305515,Bihar,16,7,18,11,52,Pass
Aryan Khan,03-09-2005,314173,Uttar Pradesh,7,1,23,3,34,Pass
Sukhwinder Chopra,07-08-2005,512254,Karnataka,4,18,22,12,56,Pass
Aditya Singh,24-12-2005,467790,West Bengal,3,19,11,16,49,Pass
Rohan Fernandes,28-11-2005,523739,Maharashtra,23,4,10,17,54,Pass
Rohan Sharma,07-06-2005,171360,Karnataka,0,9,6,21,36,Pass
Sukhwinder Fernandes,28-12-2005,887691,Bihar,17,4,0,14,35,Pass
Aarav Reddy,20-06-2005,554183,Uttar Pradesh,7,1,22,6,36,Pass
Aarav Sharma,10-02-2006,500116,Haryana,9,5,24,21,59,Pass
Aditya D'Souza,11-11-2004,155772,Haryana,6,18,22,24,70,Pass
Ishaan D'Souza,15-05-2005,536276,Madhya Pradesh,1,14,24,11,50,Pass
Yash Khan,26-04-2006,748941,Maharashtra,15,4,20,8,47,Pass
Aarav Fernandes,16-03-2006,888466,Andhra Pradesh,16,8,12,24,60,Pass
John Khan,19-04-2005,615914,Uttar Pradesh,15,1,16,12,44,Pass
Aditya Singh,27-04-2006,815746,Bihar,15,17,6,1,39,Pass
Yash Khan,25-12-2004,820950,Bihar,23,4,12,4,43,Pass
Aditya Chopra,04-05-2006,691779,Haryana,18,5,11,21,55,Pass
Vivaan Sharma,16-12-2005,839212,Telangana,13,9,4,12,38,Pass
Ishaan Fernandes,07-07-2005,751183,Punjab,6,5,8,4,23,Pass
Kunal Reddy,14-11-2005,832589,Tamil Nadu,14,7,12,23,56,Pass
Harjeet Chopra,13-10-2005,549735,Andhra Pradesh,12,19,12,20,63,Pass
Rohan Fernandes,21-03-2005,603965,Jammu & Kashmir + Ladakh,10,21,24,7,62,Pass
Vivaan D'Souza,09-11-2004,939249,Rajasthan,2,8,24,0,34,Pass
Harjeet Verma,28-07-2005,101560,Uttarakhand,3,3,6,24,36,Pass
Krishna Sharma,25-01-2006,796255,Madhya Pradesh,19,7,22,4,52,Pass
Rehan Sharma,28-01-2005,494126,Punjab,1,6,18,0,25,Pass
Kunal Khan,23-02-2006,772159,Rajasthan,4,18,13,15,50,Pass
Aditya Khan,19-08-2005,749088,West Bengal,4,5,1,3,13,Pass
Kunal Mehta,28-04-2005,421912,Jharkhand,14,21,11,0,46,Pass
Aarav Verma,23-04-2006,992486,Punjab,16,1,8,23,48,Pass
Raj Mehta,08-11-2005,659038,Chhattisgarh,21,2,5,10,38,Pass
Kunal Sharma,26-08-2005,996674,Madhya Pradesh,10,13,14,14,51,Pass
John Sharma,13-08-2005,504958,Himachal Pradesh,4,11,18,1,34,Pass
Aryan Sharma,26-04-2005,205840,Jharkhand,7,6,14,14,41,Pass
Paul Reddy,25-03-2006,528097,Gujarat,4,15,0,20,39,Pass
Krishna Singh,01-11-2005,106147,Manipur,5,10,16,2,33,Pass
Rohan Mehta,01-02-2006,830159,Andhra Pradesh,7,14,6,23,50,Pass
Kunal Singh,08-03-2006,269601,Uttar Pradesh,9,1,8,7,25,Pass
Kunal Khan,28-06-2005,932674,Himachal Pradesh,7,8,20,8,43,Pass
Rohan D'Souza,14-04-2006,381840,Bihar,14,2,8,20,44,Pass
Vivaan Khan,21-04-2006,523269,Punjab,2,0,10,12,24,Pass
Imran Verma,18-08-2005,542645,Madhya Pradesh,8,22,9,6,45,Pass
Aditya Chopra,30-08-2005,519752,Maharashtra,8,15,18,1,42,Pass
Harjeet Reddy,24-04-2005,987571,Tamil Nadu,16,3,20,4,43,Pass
Raj Singh,18-02-2006,537632,Telangana,21,1,13,7,42,Pass
Harjeet Chopra,23-07-2005,732080,Tamil Nadu,18,1,8,7,34,Pass
Peter Verma,02-01-2005,357755,Rajasthan,6,13,11,14,44,Pass
Gurpreet D'Souza,23-04-2005,751155,Rajasthan,14,21,1,3,39,Pass
Yash Sharma,04-10-2005,914468,Bihar,24,21,19,5,69,Pass
Yash Singh,08-02-2005,213101,Uttar Pradesh,6,1,10,17,34,Pass
Krishna Khan,05-01-2006,586956,Meghalaya,24,12,12,9,57,Pass
Yash Reddy,02-01-2006,474915,Andhra Pradesh,16,1,14,20,51,Pass
Aditya Verma,28-12-2005,159108,Himachal Pradesh,13,10,11,24,58,Pass
Kunal Sharma,04-02-2005,995203,Bihar,1,18,4,22,45,Pass
Imran Mehta,11-01-2006,176463,Bihar,18,8,3,17,46,Pass
Kunal Chopra,14-05-2005,643316,Maharashtra,18,4,3,10,35,Pass
Manpreet Pillai,12-05-2005,798602,Uttarakhand,0,1,7,21,29,Pass
Paul Pillai,28-04-2005,641997,Maharashtra,16,3,0,9,28,Pass
Kunal Sharma,03-06-2005,547935,Madhya Pradesh,7,6,24,16,53,Pass
Raj Fernandes,20-12-2005,782329,Telangana,14,4,9,10,37,Pass
Aarav Chopra,22-06-2005,923634,Tamil Nadu,12,22,13,17,64,Pass
Peter Khan,30-01-2005,418450,Maharashtra,22,4,24,1,51,Pass
Aarav Verma,07-12-2004,845562,West Bengal,4,10,23,8,45,Pass
Rohan Khan,12-03-2005,585687,Uttar Pradesh,18,1,9,24,52,Pass
Raj Verma,20-04-2005,893661,Punjab,22,15,18,1,56,Pass
Harjeet Sharma,06-09-2005,766546,Gujarat,7,12,12,7,38,Pass
Aditya Singh,22-08-2005,842739,Punjab,3,12,16,9,40,Pass
Sukhwinder Chopra,24-02-2006,650761,Jammu & Kashmir + Ladakh,15,3,14,7,39,Pass
Manpreet Chopra,12-12-2004,157699,Uttarakhand,11,6,4,9,30,Pass
Aryan Khan,02-02-2005,891001,Rajasthan,11,3,24,22,60,Pass
Kunal Pillai,23-03-2006,156011,Andhra Pradesh,10,18,11,12,51,Pass
Aryan D'Souza,29-09-2005,825401,Telangana,18,12,0,0,30,Pass
Rohan Mehta,17-06-2005,446173,Gujarat,14,12,5,11,42,Pass
Kunal Singh,15-01-2005,150022,Madhya Pradesh,22,2,20,2,46,Pass
Gurpreet Reddy,09-04-2005,386117,Jharkhand,0,2,24,22,48,Pass
Kunal Chopra,10-04-2006,182885,Rajasthan,1,14,19,20,54,Pass
Yash Sharma,19-02-2006,405265,Tamil Nadu,7,13,4,14,38,Pass
Zaid Khan,07-04-2006,972134,Rajasthan,8,8,12,6,34,Pass
Krishna D'Souza,14-12-2005,973737,Tamil Nadu,7,1,16,15,39,Pass
Aryan Verma,13-01-2006,204196,Madhya Pradesh,23,6,24,4,57,Pass
Aryan D'Souza,04-12-2005,972690,Uttar Pradesh,21,1,19,8,49,Pass
Balbir Singh,02-03-2005,105992,Rajasthan,3,3,20,4,30,Pass
Aarav Fernandes,31-08-2005,213722,West Bengal,20,22,0,1,43,Pass
Yash Khan,13-02-2005,371259,Bihar,8,12,17,1,38,Pass
Gurpreet Mehta,24-04-2006,970888,Odisha,2,24,4,11,41,Pass
Rohan Reddy,07-11-2005,846295,Uttar Pradesh,6,1,18,5,30,Pass
Ishaan Mehta,22-01-2005,829159,Uttar Pradesh,8,1,12,7,28,Pass
Kunal Reddy,26-06-2005,675568,Chhattisgarh,15,15,16,22,68,Pass
John Khan,19-03-2006,809404,Uttarakhand,23,19,1,7,50,Pass
Krishna Singh,25-04-2006,903287,Karnataka,15,12,9,13,49,Pass
Raj Khan,08-11-2004,694445,West Bengal,19,8,12,15,54,Pass
Sukhwinder Mehta,29-03-2006,582804,Uttar Pradesh,14,1,17,23,55,Pass
Manpreet Reddy,26-12-2004,579470,Tamil Nadu,18,20,13,20,71,Pass
Raj Sharma,27-07-2005,133529,West Bengal,5,12,3,12,32,Pass
Raj Chopra,12-11-2005,787462,Assam,12,22,13,9,56,Pass
Kunal Sharma,26-11-2004,831861,Madhya Pradesh,3,4,10,13,30,Pass
Yash Khan,22-04-2005,771358,Bihar,19,24,2,24,69,Pass
Mathew Fernandes,08-12-2005,274045,Haryana,3,18,13,17,51,Pass
Krishna Chopra,16-06-2005,254767,West Bengal,0,2,20,9,31,Pass
Sukhwinder Singh,28-11-2004,851975,Uttar Pradesh,18,1,8,2,29,Pass
Balbir Pillai,24-10-2005,962382,Odisha,3,21,4,22,50,Pass
Rohan Verma,27-08-2005,282275,Uttar Pradesh,20,1,17,0,38,Pass
Sukhwinder Fernandes,23-03-2005,114935,Bihar,16,15,19,6,56,Pass
Krishna Mehta,17-12-2004,792874,Tamil Nadu,15,12,7,10,44,Pass
Aryan Verma,03-09-2005,628849,Uttar Pradesh,8,1,18,8,35,Pass
Rohan Singh,17-01-2006,893708,Tripura,12,13,14,5,44,Pass
Aarav Reddy,22-02-2005,502170,Bihar,10,3,10,6,29,Pass
Rehan Reddy,20-01-2006,443142,Andhra Pradesh,8,20,12,20,60,Pass
Krishna Pillai,04-01-2006,392351,Haryana,5,15,1,10,31,Pass
Kunal Reddy,28-03-2005,798408,Karnataka,5,5,5,7,22,Pass
Kunal Pillai,04-09-2005,951722,Madhya Pradesh,12,11,22,4,49,Pass
Aditya Reddy,16-02-2006,938648,Andhra Pradesh,11,21,16,13,61,Pass
Aryan Reddy,17-04-2005,535747,Bihar,24,20,13,6,63,Pass
Yash Singh,19-01-2006,488934,Delhi,2,11,18,16,47,Fail
Rohan Reddy,29-05-2005,411380,Jharkhand,3,0,13,22,38,Pass
Ayaan Verma,27-11-2005,655117,Karnataka,5,6,9,9,29,Pass
Mathew Reddy,03-04-2005,667634,Madhya Pradesh,12,5,13,21,51,Pass
Yash Pillai,16-03-2006,882339,Karnataka,15,7,9,9,40,Pass
Rohan Sharma,06-03-2005,863436,Andhra Pradesh,20,2,23,5,50,Pass
Manpreet Reddy,21-10-2005,902093,Maharashtra,9,6,10,5,30,Pass
Aryan D'Souza,25-04-2005,903925,West Bengal,17,5,20,4,46,Pass
Rohan Verma,11-01-2005,314476,Maharashtra,10,4,20,20,54,Pass
Raj Chopra,31-05-2005,503735,Jharkhand,6,8,14,6,34,Pass
Paul Verma,25-10-2005,806097,Madhya Pradesh,2,10,4,4,20,Pass
Aryan D'Souza,22-06-2005,135114,Gujarat,20,5,17,1,43,Pass
Balbir Mehta,26-07-2005,666680,West Bengal,5,20,18,9,52,Pass
Ishaan Mehta,09-01-2005,823649,Bihar,8,22,2,21,53,Pass
Manpreet Khan,22-09-2005,342180,Haryana,14,19,16,10,59,Pass
Aryan Singh,16-09-2005,624407,Haryana,9,22,6,18,55,Pass
Ishaan Reddy,26-03-2006,640003,Punjab,10,5,2,7,24,Pass
Vivaan Singh,12-04-2006,703211,Odisha,24,14,2,12,52,Pass
Gurpreet Khan,01-10-2005,776048,Kerala,13,8,8,9,38,Pass
Aryan Mehta,14-08-2005,531792,West Bengal,5,22,6,10,43,Pass
Aditya Singh,28-08-2005,663873,Bihar,22,10,10,15,57,Pass
Krishna Chopra,11-03-2005,337884,Gujarat,4,1,10,24,39,Pass
Kunal Mehta,23-11-2005,106280,Punjab,3,10,12,13,38,Pass
Raj Sharma,12-03-2005,617222,Jammu & Kashmir + Ladakh,14,5,7,19,45,Pass
Aryan Khan,10-06-2005,656225,Puducherry,15,3,18,5,41,Pass
Aryan Singh,24-12-2004,557824,Jharkhand,7,20,4,6,37,Pass
Kunal Verma,03-05-2005,415996,Odisha,21,7,14,23,65,Pass
Ishaan Pillai,19-10-2005,213131,Uttarakhand,3,9,16,4,32,Pass
Aarav Chopra,15-12-2004,326285,West Bengal,3,23,5,12,43,Pass
Zaid Verma,24-11-2004,637052,Punjab,0,12,20,18,50,Pass
Aryan Khan,08-12-2004,668688,Gujarat,19,2,5,1,27,Pass
Vivaan Chopra,27-03-2005,987244,Assam,6,22,14,3,45,Pass
Peter Pillai,08-12-2005,786273,Haryana,6,6,22,14,48,Pass
Vivaan Sharma,30-01-2005,393985,Haryana,21,15,17,9,62,Pass
Manpreet Sharma,23-02-2006,741628,Uttar Pradesh,22,1,5,24,52,Pass
Harjeet Chopra,13-06-2005,371174,Telangana,6,12,24,22,64,Pass
Kunal Singh,11-03-2005,101020,Uttarakhand,3,19,9,23,54,Pass
John Singh,07-02-2006,213261,Rajasthan,12,15,20,5,52,Pass
Aditya Pillai,11-12-2005,501173,Rajasthan,21,18,2,15,56,Pass
Yash Chopra,21-04-2005,210963,Uttar Pradesh,15,1,7,19,42,Pass
Ishaan D'Souza,12-10-2005,685026,Bihar,16,24,1,3,44,Pass
Aryan Singh,01-04-2005,815326,Punjab,5,13,20,11,49,Pass
Aarav Pillai,19-04-2005,354413,Rajasthan,11,15,13,0,39,Pass
Aarav Verma,28-10-2005,849134,West Bengal,9,14,10,21,54,Pass
Raj Reddy,20-01-2006,754373,Jharkhand,1,13,9,18,41,Pass
Aryan Reddy,28-03-2005,179756,Rajasthan,22,13,19,9,63,Pass
Krishna D'Souza,21-02-2006,856445,Bihar,16,13,23,3,55,Pass
Manpreet D'Souza,23-03-2006,669857,Uttar Pradesh,16,1,7,4,28,Pass
Ishaan Sharma,19-07-2005,502814,Haryana,16,6,12,15,49,Pass
Aarav Singh,01-01-2006,527390,Uttar Pradesh,0,1,21,5,27,Pass
Aditya Verma,03-01-2006,508902,Gujarat,24,22,0,0,46,Pass
Yash Fernandes,03-01-2006,638511,Andhra Pradesh,16,3,17,6,42,Pass
Yash Khan,19-12-2004,352638,Rajasthan,17,20,21,1,59,Pass
Raj Khan,02-01-2006,362013,Jharkhand,21,4,4,23,52,Pass
Raj Verma,22-09-2005,794362,Madhya Pradesh,18,14,22,4,58,Pass
Rohan Verma,13-12-2005,514663,Uttarakhand,12,9,13,7,41,Pass
Rehan Sharma,07-02-2006,662448,Telangana,7,12,5,19,43,Pass
Harjeet Fernandes,10-07-2005,911644,Tamil Nadu,5,20,17,14,56,Pass
Yash Sharma,31-12-2004,857304,Haryana,1,10,24,0,35,Pass
Ishaan Chopra,30-12-2004,862263,Andhra Pradesh,4,5,3,23,35,Pass
David Mehta,10-04-2005,391901,Manipur,4,24,13,18,59,Pass
Sukhwinder Pillai,23-02-2005,505838,Himachal Pradesh,23,4,18,8,53,Pass
Ishaan Sharma,24-06-2005,814375,Himachal Pradesh,10,9,23,4,46,Pass
Harjeet Reddy,10-03-2006,142433,Tamil Nadu,23,7,17,1,48,Pass
Yash Singh,02-05-2005,592683,Haryana,19,12,21,21,73,Pass
Aarav Verma,14-11-2005,836076,Telangana,5,1,14,4,24,Pass
Aarav Chopra,17-03-2005,837293,Assam,6,18,14,14,52,Pass
Krishna Verma,30-10-2005,810060,Madhya Pradesh,18,18,17,4,57,Pass
Manpreet Pillai,31-12-2005,418485,Haryana,24,4,9,10,47,Pass
Krishna Singh,20-09-2005,386521,Rajasthan,15,23,7,23,68,Pass
Aryan Chopra,30-01-2006,891820,West Bengal,2,20,7,0,29,Pass
Krishna Pillai,25-03-2006,946436,Uttar Pradesh,20,1,6,8,35,Pass
Peter Verma,12-04-2006,383257,Bihar,13,10,3,7,33,Pass
Aryan Mehta,28-11-2005,503240,Andhra Pradesh,0,13,9,23,45,Pass
Peter Khan,07-02-2005,333511,Maharashtra,11,8,23,2,44,Pass
Rohan D'Souza,10-02-2006,602665,Gujarat,7,24,0,4,35,Pass
Farhan Reddy,20-12-2005,464577,Jharkhand,11,22,5,7,45,Pass
Paul Reddy,01-05-2005,523858,Telangana,13,6,4,7,30,Pass
Kunal Sharma,25-02-2006,380115,Madhya Pradesh,7,22,22,4,55,Pass
Rohan D'Souza,26-07-2005,365386,Uttar Pradesh,13,1,15,14,43,Pass
Vivaan Fernandes,14-11-2004,654035,Rajasthan,10,8,20,19,57,Pass
Aditya Singh,01-07-2005,310296,Uttar Pradesh,4,1,9,9,23,Pass
Manpreet Verma,13-03-2005,359307,West Bengal,22,5,20,7,54,Pass
Balbir D'Souza,10-02-2005,332876,Uttarakhand,7,9,11,13,40,Pass
Manpreet Reddy,18-02-2005,297767,Odisha,0,19,16,21,56,Pass
Krishna Khan,03-03-2005,715917,Himachal Pradesh,19,21,9,1,50,Pass
Ishaan D'Souza,09-02-2005,153147,Haryana,7,9,0,20,36,Pass
Gurpreet Sharma,26-01-2006,433975,Tamil Nadu,24,14,22,6,66,Pass
Krishna Sharma,11-12-2005,828442,Uttar Pradesh,23,1,22,5,51,Pass
Aditya Verma,16-11-2005,475340,Uttar Pradesh,13,1,14,13,41,Pass
Yash Singh,02-05-2005,720512,Bihar,5,2,23,20,50,Pass
Ishaan Mehta,18-12-2004,487894,Uttar Pradesh,18,1,19,20,58,Pass
Gurpreet Reddy,16-03-2006,984740,Uttar Pradesh,21,1,6,17,45,Pass
Ishaan Verma,05-04-2005,502928,Kerala,19,3,19,5,46,Pass
Aarav D'Souza,24-11-2005,821246,Bihar,22,5,16,2,45,Pass
Rehan Singh,25-02-2006,187319,Uttarakhand,14,0,17,19,50,Pass
Ayaan Chopra,07-10-2005,988172,Haryana,12,0,24,21,57,Pass
Aditya Fernandes,03-10-2005,967890,Haryana,8,11,10,17,46,Pass
Paul Chopra,21-10-2005,197226,Rajasthan,18,1,0,9,28,Pass
Ishaan Mehta,26-12-2004,284469,Bihar,18,12,19,20,69,Pass
Krishna Fernandes,26-07-2005,352311,Tamil Nadu,10,14,17,0,41,Pass
Ishaan Fernandes,06-04-2006,112908,Bihar,13,21,2,8,44,Pass
Vivaan Verma,16-07-2005,464079,Andhra Pradesh,22,5,8,13,48,Pass
Aryan Pillai,31-12-2004,358736,Uttar Pradesh,9,1,1,21,32,Pass
Balbir Reddy,12-11-2004,551605,Punjab,12,2,12,9,35,Pass
Rehan Fernandes,09-07-2005,119967,Karnataka,8,14,12,13,47,Pass
Kunal Pillai,03-05-2006,790435,Punjab,9,19,13,3,44,Pass
Sukhwinder Khan,22-04-2005,741785,Karnataka,10,10,10,7,37,Pass
Aditya Pillai,10-01-2006,432988,Bihar,3,21,5,6,35,Pass
Ishaan Fernandes,02-07-2005,577568,Kerala,17,21,16,11,65,Pass
Krishna Fernandes,29-03-2005,767912,Bihar,3,5,11,1,20,Pass
David Sharma,11-08-2005,747691,Madhya Pradesh,24,10,4,7,45,Pass
Rohan Reddy,06-03-2005,967428,Uttar Pradesh,20,1,6,9,36,Pass
Aditya Singh,30-12-2005,977766,Bihar,10,6,11,15,42,Pass
Balbir Khan,30-08-2005,688199,Chhattisgarh,7,20,10,24,61,Pass
Sukhwinder Singh,20-11-2005,874686,Rajasthan,10,6,21,12,49,Pass
Raj Chopra,09-07-2005,906049,Maharashtra,4,4,23,24,55,Pass
Sukhwinder Mehta,30-07-2005,385322,Chhattisgarh,19,16,9,22,66,Pass
Yash Fernandes,26-03-2006,593380,Maharashtra,20,4,20,22,66,Pass
Harjeet D'Souza,24-04-2005,513550,Delhi,12,19,12,20,63,Fail
Paul Sharma,05-01-2005,353765,Maharashtra,1,13,13,15,42,Pass
Ishaan Singh,14-03-2006,906078,Haryana,20,8,7,8,43,Pass
Aarav Fernandes,10-09-2005,758819,Madhya Pradesh,8,5,7,2,22,Pass
Rohan Singh,26-12-2004,255228,Madhya Pradesh,23,24,8,4,59,Pass
Kunal Verma,16-08-2005,539729,Maharashtra,20,4,12,17,53,Pass
Krishna Singh,19-08-2005,953770,Himachal Pradesh,7,11,3,0,21,Pass
Mathew Verma,11-07-2005,446288,Haryana,23,8,21,14,66,Pass
Harjeet Fernandes,29-01-2006,922675,Madhya Pradesh,12,16,6,18,52,Pass
David Mehta,19-10-2005,145700,Bihar,13,1,19,9,42,Pass
Ishaan Sharma,19-12-2004,432377,Odisha,20,22,3,16,61,Pass
Rohan Reddy,31-12-2005,584187,Uttar Pradesh,16,1,24,16,57,Pass
Vivaan Mehta,11-02-2005,731636,Uttar Pradesh,1,1,1,16,19,Pass
Peter Verma,18-11-2004,855129,Andhra Pradesh,14,5,3,18,40,Pass
Raj Mehta,18-11-2004,643972,Rajasthan,16,20,18,15,69,Pass
Rohan Fernandes,20-01-2006,249239,Karnataka,24,10,19,3,56,Pass
Gurpreet Chopra,27-04-2005,557970,Rajasthan,3,22,3,6,34,Pass
Gurpreet Verma,29-05-2005,722505,Haryana,11,2,12,20,45,Pass
John D'Souza,30-01-2006,480664,Uttar Pradesh,20,1,1,20,42,Pass
Vivaan Pillai,29-08-2005,935700,Madhya Pradesh,5,14,2,8,29,Pass
Yash Pillai,21-11-2004,181532,West Bengal,17,11,11,0,39,Pass
Raj Mehta,13-03-2005,126001,Uttarakhand,18,4,7,16,45,Pass
Kunal Sharma,20-05-2005,191952,Bihar,10,6,17,8,41,Pass
Sukhwinder D'Souza,28-03-2005,174193,Rajasthan,11,6,4,4,25,Pass
Ishaan Verma,05-12-2004,899010,Punjab,9,18,4,0,31,Pass
Harjeet Khan,29-01-2006,983568,Karnataka,12,11,24,16,63,Pass
Mathew Verma,12-02-2005,702427,West Bengal,16,24,12,1,53,Pass
Vivaan Fernandes,09-02-2006,577737,Maharashtra,12,3,15,3,33,Pass
Ayaan Pillai,20-01-2005,268230,Haryana,13,5,24,23,65,Pass
Mathew Reddy,06-03-2005,309516,Delhi,9,21,11,9,50,Pass
Aryan Chopra,28-01-2005,862532,Tamil Nadu,24,20,9,13,66,Pass
Krishna D'Souza,14-09-2005,680200,Andhra Pradesh,12,22,4,20,58,Pass
Kunal Verma,14-04-2005,753144,Punjab,22,2,9,24,57,Pass
Paul Mehta,15-10-2005,144091,Karnataka,3,15,8,24,50,Pass
Ishaan Singh,04-01-2005,134653,Uttar Pradesh,20,1,23,11,55,Pass
Kunal Pillai,30-01-2005,515015,Andhra Pradesh,2,4,10,18,34,Pass
Krishna Reddy,30-09-2005,110304,Uttar Pradesh,4,1,23,0,28,Pass
Kunal D'Souza,25-11-2005,211009,Bihar,12,13,15,0,40,Pass
Vivaan Fernandes,24-04-2006,272828,Punjab,10,20,11,2,43,Pass
David Chopra,07-04-2006,152820,Uttarakhand,3,9,12,16,40,Pass
Kunal Verma,03-01-2006,851340,Uttar Pradesh,9,1,14,0,24,Pass
Zaid Mehta,28-05-2005,522023,Manipur,4,8,23,9,44,Pass
Farhan Pillai,18-06-2005,174710,West Bengal,9,0,15,14,38,Pass
Kunal Sharma,29-12-2005,842322,Rajasthan,1,22,4,13,40,Pass
Kunal Sharma,16-03-2006,143497,Himachal Pradesh,18,6,21,0,45,Pass
Sukhwinder Chopra,27-08-2005,644072,West Bengal,24,6,19,4,53,Pass
Zaid Mehta,05-03-2006,387180,Jammu & Kashmir + Ladakh,19,14,7,6,46,Pass
Rohan Mehta,22-02-2005,470359,Haryana,15,16,8,18,57,Pass
Vivaan Reddy,01-07-2005,964118,Bihar,3,6,20,3,32,Pass
Krishna Verma,23-08-2005,924397,Chhattisgarh,23,5,3,0,31,Pass
Krishna Fernandes,24-06-2005,902937,Madhya Pradesh,19,3,20,12,54,Pass
Rohan Singh,16-12-2004,841430,Punjab,23,17,16,23,79,Pass
Raj Khan,02-05-2006,973374,Uttar Pradesh,3,1,11,3,18,Pass
Raj Khan,12-11-2005,631992,Haryana,14,24,5,17,60,Pass
Aarav D'Souza,18-08-2005,213471,Chhattisgarh,9,13,7,23,52,Pass
Yash Chopra,06-04-2005,598145,Bihar,15,3,18,21,57,Pass
Aarav Singh,24-11-2004,372681,Bihar,23,19,16,19,77,Pass
Mathew Reddy,08-12-2004,806425,Haryana,18,12,12,12,54,Pass
Manpreet Reddy,06-12-2004,171155,Haryana,24,23,5,8,60,Pass
Aditya Fernandes,03-03-2006,527805,Karnataka,23,2,22,19,66,Pass
Raj Verma,04-07-2005,138548,Haryana,0,16,12,23,51,Pass
Aryan Sharma,08-10-2005,928203,Tamil Nadu,0,22,15,4,41,Pass
Vivaan Mehta,14-06-2005,388042,Himachal Pradesh,21,2,15,8,46,Pass
Vivaan Khan,08-11-2005,274794,Bihar,16,4,16,3,39,Pass
Manpreet Reddy,17-01-2006,220309,Punjab,23,11,16,24,74,Pass
Rohan Singh,22-07-2005,251389,Bihar,2,2,23,16,43,Pass
Vivaan Reddy,16-10-2005,267349,Maharashtra,3,19,4,3,29,Pass
Ayaan Khan,02-12-2004,145836,Haryana,2,1,21,20,44,Pass
Yash D'Souza,05-02-2006,979799,West Bengal,11,1,12,24,48,Pass
Vivaan Chopra,06-11-2005,957132,Uttar Pradesh,4,1,5,14,24,Pass
Aditya D'Souza,07-11-2004,971948,Uttarakhand,3,20,15,16,54,Pass
Aryan Reddy,15-02-2006,309225,Assam,5,18,9,3,35,Pass
Aditya Reddy,21-08-2005,221779,Uttar Pradesh,6,1,8,15,30,Pass
Paul Mehta,25-05-2005,703257,Himachal Pradesh,14,13,6,17,50,Pass
Manpreet Khan,20-04-2006,585798,Haryana,17,23,1,2,43,Pass
David Reddy,17-01-2005,933774,Punjab,9,3,20,23,55,Pass
Krishna Chopra,02-02-2006,679194,Uttar Pradesh,22,1,15,12,50,Pass
Krishna Fernandes,08-03-2006,897146,Bihar,24,21,5,18,68,Pass
Kunal Khan,03-03-2006,255532,Rajasthan,21,24,3,4,52,Pass
Kunal Fernandes,03-01-2005,301354,Gujarat,1,12,2,13,28,Pass
Kunal D'Souza,22-06-2005,128761,Uttar Pradesh,12,1,20,0,33,Pass
Ishaan Singh,19-06-2005,150885,Odisha,6,8,16,12,42,Pass
Aryan Verma,15-03-2005,741654,Uttar Pradesh,15,1,6,18,40,Pass
Vivaan Singh,01-12-2005,174383,Uttar Pradesh,11,1,14,16,42,Pass
Vivaan D'Souza,12-06-2005,102993,West Bengal,23,6,4,11,44,Pass
Kunal Fernandes,12-03-2005,292700,West Bengal,1,0,12,10,23,Pass
Vivaan Mehta,26-11-2004,545589,Rajasthan,21,5,3,14,43,Pass
Krishna Sharma,11-01-2005,722082,Bihar,11,7,4,6,28,Pass
David Chopra,22-04-2005,495189,Andhra Pradesh,11,3,9,5,28,Pass
Krishna Singh,10-02-2005,221119,Madhya Pradesh,24,19,3,9,55,Pass
Ishaan Khan,05-04-2005,932483,Assam,7,12,24,9,52,Pass
Aryan Reddy,30-09-2005,147859,Haryana,24,21,0,19,64,Pass
Yash Sharma,07-04-2006,898603,Rajasthan,14,22,18,15,69,Pass
Raj D'Souza,28-01-2005,169996,Bihar,19,6,15,21,61,Pass
Kunal Pillai,09-05-2005,643429,Karnataka,8,9,14,24,55,Pass
Zaid Reddy,18-08-2005,262447,Maharashtra,24,4,20,17,65,Pass
Krishna Fernandes,03-05-2005,483152,Rajasthan,7,17,15,16,55,Pass
Sukhwinder Pillai,07-12-2004,236615,Maharashtra,16,4,24,10,54,Pass
Aryan Pillai,21-01-2005,995339,Jharkhand,11,1,1,5,18,Pass
Yash Singh,14-10-2005,319768,Bihar,12,23,21,21,77,Pass
Rehan Singh,07-08-2005,726418,Bihar,23,9,8,21,61,Pass
Manpreet Fernandes,04-03-2005,979747,Bihar,13,12,13,24,62,Pass
Harjeet Fernandes,03-06-2005,902463,Tamil Nadu,0,16,8,5,29,Pass
Ishaan Fernandes,09-11-2004,198934,Jharkhand,4,18,0,23,45,Pass
Yash Fernandes,07-10-2005,653534,Madhya Pradesh,5,15,24,5,49,Pass
Yash Singh,27-01-2005,930955,Uttar Pradesh,14,1,7,20,42,Pass
Aarav Mehta,11-11-2005,394011,Arunachal Pradesh,12,6,16,23,57,Pass
Balbir Pillai,29-05-2005,818651,Tamil Nadu,13,13,16,1,43,Pass
Rohan D'Souza,05-11-2005,697408,Odisha,5,21,8,21,55,Pass
Kunal Sharma,19-07-2005,454144,Madhya Pradesh,10,17,11,7,45,Pass
Kunal Pillai,14-04-2005,453994,Madhya Pradesh,2,14,21,6,43,Pass
Rohan Singh,30-11-2005,894662,Chhattisgarh,1,14,19,12,46,Pass
Aryan Verma,15-12-2005,932148,Uttar Pradesh,2,1,17,17,37,Pass
Sukhwinder Mehta,03-06-2005,501306,West Bengal,15,10,15,10,50,Pass
David Singh,09-11-2005,678788,Madhya Pradesh,7,3,12,5,27,Pass
Aarav Khan,27-06-2005,871134,Odisha,5,12,12,13,42,Pass
Aditya Pillai,29-07-2005,775424,Uttar Pradesh,2,1,12,10,25,Pass
Aryan Singh,29-09-2005,629463,Karnataka,20,1,22,0,43,Pass
Ayaan D'Souza,27-09-2005,957172,Odisha,10,0,8,8,26,Pass
Aditya Sharma,16-12-2004,621750,Bihar,21,17,21,16,75,Pass
Harjeet Pillai,18-04-2005,662431,Haryana,19,11,17,17,64,Pass
Aarav Sharma,02-04-2006,249939,Maharashtra,0,15,18,6,39,Pass
Kunal Singh,23-12-2005,799333,West Bengal,17,10,12,9,48,Pass
Aarav Mehta,31-01-2005,755392,Rajasthan,5,6,2,0,13,Pass
Krishna Sharma,03-11-2005,664468,Rajasthan,6,4,0,19,29,Pass
Aryan Singh,23-01-2006,546689,Himachal Pradesh,9,19,19,7,54,Pass
Rohan Reddy,22-01-2005,378662,Punjab,10,23,0,22,55,Pass
Yash Khan,26-01-2005,254909,Maharashtra,12,4,3,16,35,Pass
Imran Reddy,12-12-2005,593094,Kerala,4,13,5,4,26,Pass
Kunal Khan,03-05-2006,915451,Uttar Pradesh,5,1,2,23,31,Pass
Vivaan Singh,31-03-2006,369566,Maharashtra,19,2,10,14,45,Pass
Kunal Pillai,17-02-2005,559393,Uttar Pradesh,6,1,2,11,20,Pass
Aditya Pillai,01-02-2005,282879,Haryana,19,20,22,4,65,Pass
Ishaan Chopra,12-07-2005,197110,Bihar,2,13,11,23,49,Pass
Aditya Chopra,07-06-2005,370809,Rajasthan,23,2,21,10,56,Pass
Harjeet D'Souza,27-01-2005,364308,Rajasthan,22,23,8,13,66,Pass
Sukhwinder Pillai,06-11-2005,606399,Uttar Pradesh,12,1,10,4,27,Pass
Aarav Mehta,20-01-2006,409085,Uttar Pradesh,21,1,18,2,42,Pass
Rohan Khan,30-12-2004,701761,Maharashtra,4,7,20,1,32,Pass
Aryan Pillai,13-04-2006,872449,Rajasthan,20,15,21,7,63,Pass
Krishna Fernandes,01-04-2006,116872,Bihar,5,24,2,1,32,Pass
Paul Singh,08-04-2005,823288,Maharashtra,18,4,18,3,43,Pass
Aarav Khan,25-01-2006,806074,Rajasthan,23,21,7,17,68,Pass
Balbir Mehta,01-06-2005,506974,Tamil Nadu,12,18,3,9,42,Pass
Aditya Khan,22-11-2005,201237,West Bengal,3,12,0,23,38,Pass
Zaid Chopra,03-03-2005,171422,Uttar Pradesh,6,1,6,23,36,Pass
Rohan D'Souza,06-04-2005,460950,Odisha,8,19,6,19,52,Pass
Kunal D'Souza,14-12-2005,771570,Uttar Pradesh,7,1,11,21,40,Pass
Aarav D'Souza,26-11-2004,805792,Haryana,3,5,2,9,19,Pass
Aryan Verma,24-08-2005,657038,West Bengal,3,22,7,22,54,Pass
Manpreet Sharma,17-10-2005,448035,Bihar,14,0,8,7,29,Pass
Kunal Singh,14-04-2006,854465,Maharashtra,6,4,21,20,51,Pass
Aditya Reddy,09-06-2005,682757,Punjab,23,10,15,22,70,Pass
Aditya Fernandes,12-10-2005,641549,Rajasthan,22,5,12,6,45,Pass
Rohan Fernandes,21-12-2005,925556,Himachal Pradesh,12,17,3,8,40,Pass
Krishna Fernandes,25-03-2006,970662,Haryana,13,19,3,17,52,Pass
Yash Fernandes,23-12-2005,949104,Uttar Pradesh,9,1,14,20,44,Pass
Krishna Fernandes,07-08-2005,656818,Andhra Pradesh,6,8,18,19,51,Pass
Krishna Fernandes,05-01-2006,162521,Uttar Pradesh,3,1,6,6,16,Pass
Harjeet D'Souza,27-03-2006,881575,Rajasthan,4,7,15,24,50,Pass
Aarav Singh,29-01-2005,214051,Chhattisgarh,7,12,21,17,57,Pass
Manpreet Chopra,21-01-2005,972533,Bihar,21,21,20,6,68,Pass
Ishaan Reddy,09-10-2005,416403,Delhi,21,10,18,19,68,Pass
Rohan Sharma,07-07-2005,763053,Bihar,7,9,11,12,39,Pass
Mathew Singh,17-06-2005,674505,Tamil Nadu,15,19,7,7,48,Pass
Manpreet Verma,17-11-2004,909278,Tamil Nadu,7,5,6,8,26,Pass
Rohan Mehta,04-04-2006,546625,Haryana,13,23,0,16,52,Pass
Rohan Sharma,14-11-2005,732028,Gujarat,22,20,23,12,77,Pass
Sukhwinder Singh,22-08-2005,745478,Rajasthan,19,8,0,6,33,Pass
Aryan Mehta,06-07-2005,871685,Manipur,24,2,2,20,48,Pass
Aryan Verma,26-04-2006,614157,Uttar Pradesh,18,1,4,16,39,Pass
Gurpreet Sharma,01-09-2005,973166,Andhra Pradesh,6,1,18,9,34,Pass
John Sharma,23-11-2005,930588,Jammu & Kashmir + Ladakh,17,24,14,3,58,Pass
Aryan D'Souza,30-05-2005,165214,Punjab,9,3,22,6,40,Pass
Rohan Pillai,09-04-2006,972975,Punjab,16,0,7,20,43,Pass
Sukhwinder Reddy,15-12-2005,181362,Haryana,15,23,24,21,83,Pass
Balbir Chopra,09-08-2005,254946,Gujarat,24,21,2,14,61,Pass
Aryan Fernandes,21-07-2005,902495,Maharashtra,17,4,19,4,44,Pass
Imran D'Souza,17-02-2005,470214,Uttar Pradesh,5,1,18,6,30,Pass
Sukhwinder Sharma,22-12-2004,154596,Uttar Pradesh,6,1,10,1,18,Pass
Rohan Singh,28-01-2006,420718,Madhya Pradesh,24,3,15,7,49,Pass
Krishna Pillai,10-02-2005,366944,Kerala,18,1,22,2,43,Pass
Aarav Khan,13-03-2005,785504,Maharashtra,22,1,16,7,46,Pass
Raj D'Souza,14-01-2005,676556,Nagaland,5,4,1,11,21,Pass
Raj Khan,10-06-2005,174279,Andhra Pradesh,17,6,4,13,40,Pass
Harjeet Reddy,17-10-2005,938897,Bihar,6,11,16,4,37,Pass
Sukhwinder Pillai,08-11-2005,652349,Bihar,2,24,13,3,42,Pass
Yash D'Souza,16-10-2005,836667,West Bengal,11,3,10,5,29,Pass
Aditya Singh,15-05-2005,898841,Jharkhand,8,12,4,19,43,Pass
Balbir Pillai,23-01-2005,707480,Bihar,12,12,13,17,54,Pass
Krishna Pillai,30-11-2005,113652,Kerala,8,19,16,0,43,Pass
Manpreet Reddy,04-09-2005,177457,Himachal Pradesh,24,7,16,13,60,Pass
Aditya Pillai,04-12-2004,957308,Bihar,0,7,2,12,21,Pass
Krishna Singh,26-02-2005,217033,Jharkhand,5,22,1,6,34,Pass
Aarav Chopra,17-12-2004,987616,Gujarat,16,11,18,13,58,Pass
Vivaan D'Souza,06-06-2005,361610,Tamil Nadu,7,21,11,7,46,Pass
Harjeet Chopra,01-04-2005,171656,Odisha,16,7,10,4,37,Pass
Rehan D'Souza,19-11-2004,303578,Uttar Pradesh,3,1,12,16,32,Pass
Aryan Fernandes,04-04-2005,716768,Haryana,1,16,22,22,61,Pass
Yash Reddy,30-08-2005,641589,Uttar Pradesh,7,1,17,21,46,Pass
Ishaan Mehta,01-04-2006,911038,Assam,8,12,21,2,43,Pass
Ishaan Sharma,20-05-2005,757150,Haryana,12,23,14,24,73,Pass
Sukhwinder Khan,28-10-2005,675913,Uttar Pradesh,1,1,17,17,36,Pass
Balbir Fernandes,11-01-2005,855011,Chhattisgarh,5,1,2,12,20,Pass
Yash Verma,04-12-2004,982687,Andhra Pradesh,16,20,13,8,57,Pass
Sukhwinder D'Souza,19-12-2004,201038,West Bengal,3,17,17,22,59,Pass
Kunal Singh,06-10-2005,447915,Tripura,10,14,14,23,61,Pass
Raj Pillai,09-01-2006,306890,Odisha,24,2,1,1,28,Pass
Rohan Khan,30-01-2005,714316,Rajasthan,13,24,22,22,81,Pass
Ishaan Chopra,13-11-2005,233200,Rajasthan,11,0,23,3,37,Pass
Kunal Singh,04-07-2005,836457,Himachal Pradesh,6,23,22,1,52,Pass
Aryan Sharma,18-08-2005,488034,Punjab,2,1,15,21,39,Pass
Ishaan Singh,05-04-2006,436405,Uttar Pradesh,4,1,23,11,39,Pass
Aryan Pillai,16-09-2005,538463,Madhya Pradesh,24,3,20,4,51,Pass
Vivaan Pillai,22-01-2006,380359,Madhya Pradesh,13,1,20,18,52,Pass
Mathew Singh,02-03-2006,711382,Maharashtra,10,3,2,21,36,Pass
Aarav Mehta,23-11-2004,449421,Delhi,17,22,16,3,58,Pass
Sukhwinder Khan,14-04-2005,318638,Rajasthan,22,2,9,10,43,Pass
Raj Fernandes,29-03-2006,734922,Uttar Pradesh,4,1,7,22,34,Pass
Aryan D'Souza,06-01-2006,907359,Bihar,12,14,0,2,28,Pass
Balbir Khan,12-01-2005,665879,Tamil Nadu,16,5,13,6,40,Pass
Aryan Singh,21-04-2005,813827,Uttarakhand,3,6,0,15,24,Pass
Aditya Verma,02-05-2005,239293,Bihar,2,14,16,20,52,Pass
Raj Singh,05-12-2005,409738,Goa,5,1,4,14,24,Pass
Ishaan Mehta,15-11-2004,656029,Rajasthan,21,23,2,21,67,Pass
Raj Reddy,12-11-2004,768360,Mizoram,18,3,11,7,39,Pass
Aryan Chopra,18-11-2004,913340,Jharkhand,7,7,23,12,49,Pass
Imran Verma,15-05-2005,567159,Maharashtra,18,20,9,2,49,Pass
Aditya Pillai,07-02-2006,334717,Maharashtra,7,4,15,18,44,Pass
Rohan Mehta,28-12-2005,262972,Odisha,13,1,21,2,37,Pass
Ishaan Chopra,21-09-2005,683271,Bihar,18,0,7,8,33,Pass
Ishaan Sharma,27-04-2005,414221,Haryana,24,14,23,0,61,Pass
Krishna Verma,23-07-2005,885600,Uttarakhand,3,21,14,0,38,Pass
Aditya Reddy,01-03-2006,564262,Uttar Pradesh,22,1,22,5,50,Pass
Krishna Pillai,09-08-2005,836383,Rajasthan,22,13,15,22,72,Pass
Rohan Khan,22-11-2004,344583,Bihar,13,19,15,20,67,Pass
Ishaan Chopra,05-12-2005,850905,Punjab,14,13,3,5,35,Pass
Krishna Singh,15-11-2004,665174,Bihar,16,18,16,6,56,Pass
Sukhwinder Fernandes,04-11-2005,321374,Bihar,20,13,8,10,51,Pass
Aryan Singh,07-03-2005,702256,Madhya Pradesh,2,6,1,11,20,Pass
Raj Chopra,31-12-2004,377955,Haryana,13,15,20,13,61,Pass
Rehan Chopra,12-04-2005,608149,Uttar Pradesh,11,1,6,4,22,Pass
Ishaan D'Souza,01-01-2005,218232,Madhya Pradesh,2,22,9,6,39,Pass
Paul Fernandes,30-03-2006,521660,Tamil Nadu,18,13,16,9,56,Pass
Gurpreet Singh,11-01-2005,545073,Goa,6,15,5,12,38,Pass
Aryan Fernandes,18-04-2005,548265,Maharashtra,21,4,9,21,55,Pass
Balbir Pillai,27-03-2005,982057,Bihar,13,0,6,5,24,Pass
Mathew Mehta,30-06-2005,465468,Punjab,14,24,16,15,69,Pass
David Mehta,28-06-2005,752216,Bihar,11,15,13,8,47,Pass
Aarav Fernandes,01-08-2005,433884,Gujarat,5,11,8,17,41,Pass
Rohan D'Souza,03-07-2005,293244,Bihar,14,22,7,21,64,Pass
Aryan Mehta,24-03-2006,832360,Tamil Nadu,6,17,20,5,48,Pass
Mathew Reddy,19-03-2006,250167,Maharashtra,1,7,3,21,32,Pass
Ishaan Verma,31-08-2005,186857,West Bengal,3,6,24,2,35,Pass
Harjeet Verma,17-05-2005,672223,Jharkhand,9,21,7,18,55,Pass
Rohan Singh,07-02-2005,479437,Jammu & Kashmir + Ladakh,13,7,2,6,28,Pass
Manpreet Khan,05-02-2005,283055,Jammu & Kashmir + Ladakh,24,7,14,2,47,Pass
Krishna Singh,22-06-2005,588811,Tamil Nadu,10,4,2,7,23,Pass
Imran Fernandes,09-05-2005,219436,Rajasthan,6,1,19,9,35,Pass
Mathew Chopra,09-02-2005,999479,Maharashtra,23,4,13,9,49,Pass
Aryan Chopra,30-03-2006,455350,Tamil Nadu,19,1,9,6,35,Pass
John Khan,18-12-2005,896489,West Bengal,4,7,21,9,41,Pass
Ishaan Khan,19-04-2005,608775,Rajasthan,14,10,1,2,27,Pass
Krishna Mehta,14-11-2004,911847,Bihar,9,10,18,22,59,Pass
Balbir Verma,03-05-2006,462826,Chhattisgarh,7,1,9,5,22,Pass
Krishna Fernandes,18-12-2004,218849,Madhya Pradesh,12,5,2,8,27,Pass
Ishaan Sharma,10-07-2005,122170,Delhi,7,9,7,15,38,Pass
John Fernandes,06-01-2006,109750,Bihar,1,5,3,12,21,Pass
Krishna Reddy,30-10-2005,407676,Assam,7,9,0,17,33,Pass
Aditya Reddy,03-07-2005,378520,Rajasthan,6,14,12,4,36,Pass
Krishna Chopra,27-10-2005,956382,Maharashtra,18,4,16,20,58,Pass
Aditya Mehta,14-09-2005,819664,Madhya Pradesh,18,13,24,4,59,Pass
Aryan D'Souza,30-08-2005,352892,Jharkhand,4,8,9,15,36,Pass
Aditya Sharma,24-11-2005,817176,Karnataka,22,4,7,4,37,Pass
Aryan Pillai,14-03-2005,336306,Assam,7,4,9,10,30,Pass
Kunal Fernandes,24-09-2005,624591,Delhi,23,16,10,2,51,Pass
Manpreet Verma,11-09-2005,701946,Madhya Pradesh,8,8,11,9,36,Pass
Ishaan Reddy,25-08-2005,543386,Odisha,15,8,2,5,30,Pass
Farhan Fernandes,06-01-2006,637699,Andhra Pradesh,2,14,8,22,46,Pass
Aryan Sharma,10-11-2005,857330,Tamil Nadu,12,19,10,17,58,Pass
Ishaan Pillai,23-12-2004,146535,Haryana,11,1,1,9,22,Pass
Peter Chopra,07-05-2005,430699,Telangana,5,11,23,13,52,Pass
Kunal Mehta,20-05-2005,633415,Gujarat,17,16,23,9,65,Pass
Harjeet Khan,22-01-2005,826119,Bihar,13,4,6,8,31,Pass
Rohan Fernandes,03-09-2005,537072,West Bengal,15,12,8,0,35,Pass
Krishna Reddy,29-04-2006,896466,Maharashtra,12,4,19,0,35,Pass
Aarav Verma,21-04-2006,779047,Uttar Pradesh,7,1,4,14,26,Pass
Raj Fernandes,04-09-2005,665977,Jharkhand,9,10,18,24,61,Pass
Yash Khan,19-03-2005,925519,Kerala,9,14,23,15,61,Pass
Raj Pillai,15-05-2005,509916,Maharashtra,17,4,14,24,59,Pass
Kunal Khan,27-05-2005,537103,Assam,11,7,11,9,38,Pass
Ishaan Singh,16-04-2006,698530,Punjab,2,3,5,17,27,Pass
Raj D'Souza,28-04-2005,485368,West Bengal,3,12,6,23,44,Pass
David Khan,17-12-2004,873094,Chhattisgarh,20,1,7,19,47,Pass
Kunal Mehta,21-04-2005,821715,West Bengal,3,18,19,13,53,Pass
Rohan Singh,29-11-2005,788930,Andhra Pradesh,8,3,1,12,24,Pass
Peter Singh,09-03-2006,316159,Tamil Nadu,14,21,9,10,54,Pass
Krishna D'Souza,03-04-2005,818411,West Bengal,3,22,23,17,65,Pass
David D'Souza,11-08-2005,563442,Chhattisgarh,14,19,0,21,54,Pass
John Verma,05-04-2006,891403,Maharashtra,5,21,6,15,47,Pass
Aarav Reddy,19-03-2005,831804,Maharashtra,7,18,2,3,30,Pass
Harjeet Verma,24-06-2005,920023,Rajasthan,24,4,18,20,66,Pass
Aryan Pillai,25-11-2004,915831,Madhya Pradesh,7,23,6,4,40,Pass
Sukhwinder Singh,27-10-2005,464313,Uttar Pradesh,24,1,11,6,42,Pass
Aarav Reddy,29-01-2006,438407,Andhra Pradesh,21,6,2,3,32,Pass
Yash Sharma,13-03-2006,198167,Uttar Pradesh,0,1,17,15,33,Pass
Balbir Singh,14-02-2006,159727,Chhattisgarh,20,0,3,14,37,Pass
Paul Reddy,16-12-2005,530490,Bihar,21,20,1,13,55,Pass
Zaid Sharma,17-03-2005,255084,Tamil Nadu,3,9,7,10,29,Pass
Rohan Khan,07-07-2005,402063,Tamil Nadu,14,18,10,16,58,Pass
Ishaan Singh,19-05-2005,628598,Manipur,13,1,1,15,30,Pass
Peter Verma,18-03-2006,369048,Jammu & Kashmir + Ladakh,1,16,9,21,47,Pass
John Mehta,18-11-2005,468194,Haryana,23,0,19,5,47,Pass
Balbir Fernandes,05-11-2005,878731,West Bengal,3,1,16,22,42,Pass
Aditya Chopra,11-02-2006,581623,Bihar,19,4,4,21,48,Pass
Raj Khan,07-05-2005,973311,Kerala,20,18,2,7,47,Pass
Krishna Reddy,22-03-2006,674811,Chhattisgarh,22,4,20,17,63,Pass
Aryan Pillai,09-02-2005,793425,Gujarat,8,16,17,0,41,Pass
Krishna Reddy,02-10-2005,310740,Madhya Pradesh,3,24,13,9,49,Pass
Vivaan Khan,06-12-2004,371648,Punjab,13,14,10,20,57,Pass
Rohan D'Souza,17-08-2005,294708,Tamil Nadu,19,3,4,10,36,Pass
Rohan Chopra,15-11-2004,838067,Punjab,2,3,22,23,50,Pass
Kunal Verma,13-01-2005,353675,Delhi,10,24,22,0,56,Pass
John Sharma,06-07-2005,915615,Uttarakhand,17,2,18,6,43,Pass
Yash Fernandes,30-05-2005,843757,Uttar Pradesh,6,1,2,4,13,Pass
Ishaan Pillai,16-11-2004,515980,Maharashtra,10,4,21,16,51,Pass
Aditya Fernandes,14-12-2004,362640,West Bengal,11,13,11,16,51,Pass
Aryan Sharma,24-11-2005,818539,Uttar Pradesh,1,1,10,19,31,Pass
Manpreet Chopra,02-05-2005,206770,Bihar,11,11,11,11,44,Pass
Yash Reddy,21-04-2005,314155,Punjab,11,23,18,9,61,Pass
Aarav Reddy,16-06-2005,302368,West Bengal,0,12,19,3,34,Pass
Aarav Khan,05-02-2006,995397,Andhra Pradesh,6,21,8,22,57,Pass
Ishaan Mehta,04-04-2006,216608,Tamil Nadu,18,2,19,24,63,Pass
Aryan Verma,08-08-2005,481205,Chhattisgarh,15,13,12,23,63,Pass
Krishna Chopra,17-06-2005,621789,Rajasthan,11,1,13,16,41,Pass
Yash Singh,28-01-2005,377918,Karnataka,1,14,3,15,33,Pass
Aarav Fernandes,22-10-2005,258957,Rajasthan,21,13,10,8,52,Pass
Sukhwinder Chopra,15-04-2006,956320,Punjab,21,3,24,16,64,Pass
Mathew Chopra,01-02-2006,227031,Bihar,5,4,22,0,31,Pass
Aryan Fernandes,10-11-2004,801799,Telangana,22,24,11,4,61,Pass
Vivaan D'Souza,22-03-2006,979712,Uttar Pradesh,21,1,19,0,41,Pass
Rohan Mehta,21-02-2006,525603,West Bengal,3,24,8,1,36,Pass
Vivaan Chopra,19-04-2006,350354,Uttar Pradesh,18,1,22,5,46,Pass
Sukhwinder Pillai,10-05-2005,170319,Uttar Pradesh,5,1,22,15,43,Pass
Krishna Reddy,03-12-2004,498788,Bihar,17,23,2,15,57,Pass
Peter D'Souza,16-05-2005,961138,Bihar,9,21,18,20,68,Pass
Vivaan Fernandes,02-02-2005,569411,West Bengal,0,24,11,2,37,Pass
Yash Singh,03-03-2005,106399,Haryana,6,3,23,13,45,Pass
Aarav Fernandes,03-10-2005,285885,Maharashtra,21,9,17,2,49,Pass
Raj Khan,06-07-2005,528241,Gujarat,23,1,0,10,34,Pass
Raj Singh,26-11-2005,725203,Punjab,7,24,18,9,58,Pass
Vivaan Sharma,28-03-2006,382572,Jharkhand,21,10,3,0,34,Pass
Rohan Reddy,18-01-2005,424416,Uttar Pradesh,10,1,12,6,29,Pass
Rohan Mehta,31-10-2005,735910,Jammu & Kashmir + Ladakh,6,19,7,6,38,Pass
Raj Singh,23-01-2005,827049,Tamil Nadu,18,9,8,9,44,Pass
Farhan D'Souza,07-07-2005,144824,Uttar Pradesh,4,1,11,22,38,Pass
Rohan Fernandes,21-02-2006,708653,Uttar Pradesh,3,1,24,17,45,Pass
Aditya Khan,12-05-2005,150236,Delhi,7,2,21,22,52,Pass
Rehan Verma,09-06-2005,398279,Punjab,19,18,16,21,74,Pass
Manpreet Verma,30-10-2005,486662,Bihar,18,16,2,21,57,Pass
Krishna Reddy,28-11-2004,703455,Madhya Pradesh,9,17,21,4,51,Pass
Krishna Chopra,11-03-2005,974167,Bihar,4,21,15,20,60,Pass
Rohan Fernandes,02-02-2005,719320,Andhra Pradesh,11,6,3,3,23,Pass
Kunal Singh,13-04-2006,177023,Haryana,6,9,0,9,24,Pass
Rohan Pillai,14-11-2005,827016,Telangana,2,2,12,4,20,Pass
Aarav Fernandes,12-06-2005,382312,Madhya Pradesh,21,20,18,4,63,Pass
Ishaan Chopra,21-10-2005,356484,West Bengal,4,19,13,5,41,Pass
Ishaan Fernandes,21-09-2005,634153,Odisha,24,3,13,21,61,Pass
Kunal Singh,23-10-2005,577875,Kerala,15,4,16,13,48,Pass
Kunal Fernandes,06-10-2005,667791,Maharashtra,3,18,21,3,45,Pass
Ishaan Reddy,29-04-2005,199202,Andhra Pradesh,8,6,0,8,22,Pass
John Khan,24-12-2005,967655,Odisha,4,17,7,13,41,Pass
Ayaan Reddy,22-12-2005,322161,Bihar,7,21,7,7,42,Pass
Sukhwinder Singh,13-08-2005,290120,Goa,6,16,9,1,32,Pass
Ishaan Chopra,31-07-2005,162265,Maharashtra,0,1,2,22,25,Pass
Manpreet D'Souza,14-08-2005,887074,Tamil Nadu,12,6,14,3,35,Pass
Manpreet Reddy,06-03-2006,510814,Uttar Pradesh,21,1,3,14,39,Pass
Yash Fernandes,02-12-2004,684254,Bihar,6,12,0,15,33,Pass
Ishaan Fernandes,08-05-2005,404140,Haryana,10,7,4,10,31,Pass
Aditya Chopra,01-02-2005,536123,Uttar Pradesh,21,1,22,10,54,Pass
Raj Mehta,29-03-2005,504275,Maharashtra,19,1,0,10,30,Pass
Aarav Pillai,29-07-2005,445204,Meghalaya,8,1,10,12,31,Pass
Aarav Mehta,10-10-2005,323653,Goa,8,9,11,4,32,Fail
Gurpreet Mehta,23-01-2005,955264,Jharkhand,2,12,14,1,29,Pass
Raj Chopra,11-01-2006,704480,Himachal Pradesh,13,2,15,11,41,Pass
Yash Sharma,28-02-2006,997529,West Bengal,3,16,14,9,42,Pass
Gurpreet Reddy,29-09-2005,663464,Bihar,4,11,9,2,26,Pass
Paul Reddy,22-02-2005,434294,Karnataka,19,22,9,12,62,Pass
Rohan Mehta,18-11-2005,184259,Kerala,11,2,14,15,42,Pass
Raj Pillai,12-10-2005,792170,West Bengal,18,20,1,11,50,Pass
Raj Fernandes,30-10-2005,783583,Madhya Pradesh,23,24,22,4,73,Pass
Paul Fernandes,29-05-2005,244500,Uttar Pradesh,16,1,7,5,29,Pass
Aditya Reddy,30-08-2005,390704,Bihar,8,2,3,23,36,Pass
Aryan Fernandes,06-07-2005,927812,Uttar Pradesh,5,1,11,9,26,Pass
David Pillai,11-01-2006,639966,Maharashtra,17,4,13,8,42,Pass
Imran Sharma,10-11-2005,278447,Chhattisgarh,7,13,13,1,34,Pass
Yash D'Souza,13-11-2005,948094,Uttar Pradesh,3,1,18,19,41,Pass
Rohan Pillai,21-09-2005,943129,Uttar Pradesh,0,1,2,22,25,Pass
Yash Verma,27-01-2006,898933,Bihar,23,17,10,12,62,Pass
Raj Verma,24-01-2005,846129,Kerala,12,17,7,24,60,Pass
Balbir Mehta,13-09-2005,317764,Karnataka,9,10,13,6,38,Pass
Aryan Verma,17-02-2005,388139,Odisha,5,11,19,10,45,Pass
Raj Mehta,26-04-2006,751146,Andhra Pradesh,19,24,12,12,67,Pass
Aarav Khan,28-01-2005,822424,Tamil Nadu,0,18,21,16,55,Pass
Sukhwinder D'Souza,14-11-2004,949793,Bihar,24,9,21,19,73,Pass
Vivaan Mehta,11-03-2006,213314,Maharashtra,11,1,24,7,43,Pass
Harjeet Reddy,01-11-2005,198103,West Bengal,18,5,15,5,43,Pass
Krishna Fernandes,03-02-2006,876162,Tamil Nadu,6,18,11,9,44,Pass
Aditya Pillai,25-11-2005,453262,Bihar,1,13,10,15,39,Pass
Kunal Reddy,08-09-2005,415414,Kerala,4,18,8,16,46,Pass
Rohan Singh,17-10-2005,327924,Andhra Pradesh,22,2,12,15,51,Pass
Yash Fernandes,02-08-2005,382730,Andhra Pradesh,1,18,6,10,35,Pass
Aditya Chopra,01-07-2005,620919,Telangana,13,4,13,6,36,Pass
Gurpreet Sharma,19-12-2005,450353,Maharashtra,24,0,1,15,40,Pass
Aryan Singh,29-01-2006,759979,Madhya Pradesh,23,22,14,4,63,Pass
Yash Singh,03-01-2006,902874,Assam,5,19,15,3,42,Pass
Mathew Pillai,09-02-2005,206719,West Bengal,3,9,18,13,43,Pass
Balbir Pillai,28-07-2005,643891,Mizoram,3,0,2,9,14,Pass
Gurpreet D'Souza,25-11-2005,698828,Madhya Pradesh,3,9,9,9,30,Pass
Balbir Verma,03-11-2005,908725,Uttarakhand,3,10,22,24,59,Pass
Vivaan Fernandes,06-12-2005,329207,Punjab,13,14,23,3,53,Pass
Harjeet Chopra,25-04-2006,175650,Uttar Pradesh,13,1,9,16,39,Pass
Vivaan Verma,27-03-2005,216170,Tamil Nadu,10,2,16,23,51,Pass
Raj Singh,14-09-2005,526520,West Bengal,4,15,11,8,38,Pass
Manpreet Fernandes,19-11-2005,909528,Uttar Pradesh,4,1,12,21,38,Pass
Raj Verma,13-03-2006,491289,Telangana,2,17,4,0,23,Pass
Rohan Pillai,02-12-2005,175172,Gujarat,21,0,9,1,31,Pass
Ishaan Chopra,07-11-2005,256273,Odisha,12,21,24,0,57,Pass
Paul D'Souza,14-03-2005,935758,Jharkhand,17,11,1,20,49,Pass
Aryan Pillai,07-12-2005,213144,Madhya Pradesh,8,23,5,4,40,Pass
Ayaan Khan,22-02-2005,437811,Madhya Pradesh,16,22,12,4,54,Pass
Yash Chopra,21-04-2006,672454,Uttar Pradesh,6,1,8,19,34,Pass
Mathew D'Souza,06-02-2005,108871,Karnataka,13,4,13,9,39,Pass
Aryan D'Souza,21-06-2005,954215,Madhya Pradesh,0,24,5,6,35,Pass
Sukhwinder Verma,04-12-2005,266978,Karnataka,13,18,9,16,56,Pass
Yash Reddy,26-12-2004,925334,Madhya Pradesh,19,21,6,4,50,Pass
Krishna Pillai,20-12-2004,880640,Karnataka,23,19,11,7,60,Pass
Aryan Verma,12-06-2005,763251,Kerala,19,23,10,3,55,Pass
Rohan Sharma,25-09-2005,377974,Chhattisgarh,12,5,14,6,37,Pass
Yash D'Souza,03-12-2005,351513,Bihar,13,4,15,7,39,Pass
Rohan D'Souza,10-09-2005,933354,Karnataka,23,10,16,1,50,Pass
Ishaan Verma,09-01-2005,878353,Rajasthan,16,2,6,24,48,Pass
Ishaan Chopra,26-04-2005,449826,Haryana,6,15,24,4,49,Pass
Rehan Singh,29-10-2005,812952,Himachal Pradesh,24,15,23,0,62,Pass
Gurpreet Pillai,06-09-2005,775809,Madhya Pradesh,1,0,7,5,13,Pass
Kunal Reddy,07-11-2005,347442,Andhra Pradesh,12,1,12,9,34,Pass
Gurpreet Pillai,24-06-2005,940257,Bihar,9,15,20,11,55,Pass
Harjeet Singh,30-03-2005,451365,Bihar,17,4,9,10,40,Pass
Rohan Khan,13-09-2005,633906,Bihar,9,9,0,6,24,Pass
Ishaan Chopra,02-11-2005,528166,West Bengal,3,20,13,11,47,Pass
Peter Reddy,22-04-2005,385476,Bihar,8,11,8,5,32,Pass
Aditya Reddy,09-04-2006,443930,Assam,12,14,17,14,57,Pass
Sukhwinder Chopra,23-04-2005,591713,Tamil Nadu,7,18,5,16,46,Pass
Sukhwinder Khan,13-01-2006,470548,Tamil Nadu,4,22,11,21,58,Pass
Aryan Fernandes,01-08-2005,593010,Madhya Pradesh,7,3,5,5,20,Pass
Raj Mehta,26-01-2006,204693,Bihar,2,9,11,8,30,Pass
Yash Reddy,22-06-2005,532181,West Bengal,1,9,17,10,37,Pass
Rohan Singh,24-11-2004,591673,Karnataka,7,2,5,13,27,Pass
Krishna Reddy,28-04-2006,767457,Bihar,17,0,23,10,50,Pass
Paul Chopra,22-03-2005,771847,Uttarakhand,3,18,7,18,46,Pass
Yash Khan,13-11-2004,525782,Uttar Pradesh,8,1,22,15,46,Pass
John Chopra,17-11-2005,185751,Maharashtra,14,0,11,18,43,Pass
Imran Reddy,15-02-2005,869222,Uttar Pradesh,3,1,21,19,44,Pass
Vivaan Chopra,17-05-2005,233046,Madhya Pradesh,22,16,5,4,47,Pass
Harjeet Verma,21-06-2005,711498,Haryana,23,22,10,15,70,Pass
Ishaan D'Souza,22-04-2006,262310,Uttarakhand,2,18,3,23,46,Pass
Vivaan Chopra,02-02-2005,845387,Rajasthan,1,13,16,23,53,Pass
Balbir Khan,01-09-2005,676258,Karnataka,15,22,1,10,48,Pass
Aarav Fernandes,09-11-2004,771670,Tamil Nadu,18,8,4,8,38,Pass
Aditya Sharma,21-02-2005,120557,Jammu & Kashmir + Ladakh,13,23,16,4,56,Pass
David Sharma,28-03-2006,859371,Uttar Pradesh,12,1,2,14,29,Pass
Aditya Khan,20-03-2005,808963,West Bengal,14,4,19,8,45,Pass
Gurpreet Fernandes,25-02-2006,881086,Maharashtra,11,10,3,6,30,Pass
David Khan,21-12-2004,219592,Tamil Nadu,3,24,1,17,45,Pass
Rohan Singh,24-02-2005,371868,West Bengal,3,16,24,9,52,Pass
Gurpreet Pillai,03-05-2005,709579,Rajasthan,11,13,3,18,45,Pass
Vivaan Mehta,24-10-2005,499191,Haryana,12,22,8,11,53,Pass
Rohan Mehta,28-05-2005,546384,West Bengal,24,18,8,3,53,Pass
Sukhwinder Fernandes,09-03-2005,658820,Karnataka,7,2,16,17,42,Pass
Kunal Singh,15-03-2005,843799,Rajasthan,17,14,1,10,42,Pass
Yash D'Souza,28-08-2005,342184,Karnataka,16,23,1,20,60,Pass
Sukhwinder Chopra,18-03-2005,909527,West Bengal,3,18,15,22,58,Pass
Gurpreet D'Souza,18-11-2004,989335,Punjab,16,18,12,19,65,Pass
Yash Reddy,22-12-2004,766663,Haryana,18,19,3,22,62,Pass
Aditya D'Souza,14-05-2005,910567,Haryana,22,15,5,4,46,Pass
Harjeet Mehta,22-08-2005,780398,Uttar Pradesh,1,1,18,18,38,Pass
Aditya Sharma,05-11-2005,921514,Kerala,7,8,7,8,30,Pass
Krishna Reddy,12-08-2005,944795,Uttar Pradesh,8,1,3,16,28,Pass
Sukhwinder Chopra,04-05-2006,592867,Haryana,5,18,3,1,27,Pass
Paul Fernandes,06-09-2005,372122,Chhattisgarh,21,15,19,23,78,Pass
Ishaan Pillai,15-02-2005,912990,Uttar Pradesh,17,1,10,24,52,Pass
Vivaan Sharma,21-11-2004,293097,Rajasthan,9,2,10,7,28,Pass
Kunal Pillai,11-11-2004,815215,Rajasthan,13,0,2,4,19,Pass
Balbir Mehta,26-04-2005,778673,Telangana,4,3,3,4,14,Pass
Manpreet Pillai,08-01-2005,732186,Uttar Pradesh,4,1,21,19,45,Pass
Rohan Fernandes,19-09-2005,297946,Chhattisgarh,2,5,2,21,30,Pass
Mathew Verma,30-01-2006,157888,Jharkhand,16,6,12,8,42,Pass
Yash Mehta,25-09-2005,158020,Rajasthan,11,5,19,0,35,Pass
Krishna Chopra,22-05-2005,282396,Uttar Pradesh,13,1,3,21,38,Pass
Harjeet D'Souza,08-02-2006,380649,Gujarat,19,5,11,15,50,Pass
Manpreet Chopra,24-07-2005,189561,Maharashtra,14,4,21,5,44,Pass
Aryan Pillai,23-11-2005,730695,Puducherry,15,5,6,16,42,Pass
Aryan Fernandes,16-10-2005,889941,Maharashtra,19,4,16,14,53,Pass
Aarav Chopra,16-02-2006,658870,Chhattisgarh,9,4,3,24,40,Pass
Gurpreet Khan,17-09-2005,926291,Bihar,23,11,21,5,60,Pass
Aarav Khan,28-03-2005,588096,Maharashtra,13,4,14,17,48,Pass
Aryan Verma,04-08-2005,903064,Bihar,22,3,16,17,58,Pass
Manpreet Sharma,12-05-2005,509683,Jammu & Kashmir + Ladakh,16,11,6,15,48,Pass
Zaid Sharma,09-05-2005,816601,Himachal Pradesh,2,6,13,4,25,Pass
Aditya Khan,23-03-2005,580864,Madhya Pradesh,22,7,9,12,50,Pass
John Singh,26-10-2005,680195,Puducherry,17,6,5,6,34,Pass
Ishaan Pillai,01-03-2005,946905,Tamil Nadu,1,22,17,8,48,Pass
Aditya Fernandes,21-02-2006,431876,Madhya Pradesh,22,0,12,4,38,Pass
Aditya D'Souza,29-03-2005,121995,Karnataka,11,5,2,22,40,Pass
Yash Verma,27-03-2006,227191,Karnataka,10,19,22,2,53,Pass
Yash Sharma,28-12-2005,488955,Kerala,5,14,20,13,52,Pass
Rohan Sharma,17-12-2004,958579,Uttar Pradesh,18,1,12,24,55,Pass
Aryan Verma,03-04-2006,203039,Gujarat,16,11,4,18,49,Pass
Aarav Chopra,24-11-2005,121698,West Bengal,2,14,5,22,43,Pass
Kunal Khan,25-02-2005,540479,Odisha,12,19,7,21,59,Pass
Aarav Sharma,18-08-2005,724343,Rajasthan,13,2,13,19,47,Pass
Farhan Reddy,11-07-2005,314003,Uttar Pradesh,15,1,20,11,47,Pass
Krishna Fernandes,20-12-2004,413786,Uttar Pradesh,14,1,15,1,31,Pass
Kunal Pillai,15-08-2005,721446,Bihar,12,8,20,4,44,Pass
Ishaan Khan,03-07-2005,949628,Tamil Nadu,17,15,12,19,63,Pass
Raj Chopra,21-03-2005,336803,Gujarat,4,17,8,8,37,Pass
Raj Khan,29-01-2005,643133,Punjab,10,18,13,9,50,Pass
Balbir Pillai,15-11-2004,561300,Uttar Pradesh,0,1,1,6,8,Pass
Paul Singh,10-11-2005,321714,Maharashtra,17,10,0,18,45,Pass
Aryan Verma,27-04-2006,521323,Bihar,18,20,9,6,53,Pass
Kunal Pillai,04-02-2005,751143,Madhya Pradesh,20,19,12,4,55,Pass
Yash Fernandes,18-12-2004,567583,Andhra Pradesh,22,16,1,12,51,Pass
Manpreet Chopra,24-03-2006,609336,Uttar Pradesh,19,1,13,21,54,Pass
Gurpreet Mehta,26-12-2005,683384,Uttar Pradesh,3,1,22,23,49,Pass
Aarav Pillai,28-08-2005,136472,Andhra Pradesh,5,7,8,14,34,Pass
Ishaan Singh,14-02-2006,405894,Assam,14,19,14,7,54,Pass
Ishaan D'Souza,13-02-2005,565583,Maharashtra,21,4,19,11,55,Pass
Yash Sharma,12-12-2005,494291,Haryana,18,2,23,4,47,Pass
Aryan Mehta,08-12-2004,953184,Rajasthan,20,23,6,20,69,Pass
Rohan Reddy,29-03-2006,284954,Uttar Pradesh,3,1,21,19,44,Pass
Kunal Sharma,06-02-2005,786353,Madhya Pradesh,1,11,1,4,17,Pass
Yash Khan,28-03-2005,208168,Rajasthan,1,3,4,13,21,Pass
Ayaan Mehta,18-11-2004,455564,Uttar Pradesh,5,1,22,1,29,Pass
Aditya D'Souza,13-03-2005,866652,Madhya Pradesh,10,3,2,17,32,Pass
Kunal Chopra,11-02-2005,499458,Rajasthan,3,6,10,23,42,Pass
Krishna Pillai,09-12-2004,429784,Bihar,14,7,20,4,45,Pass
Aditya Chopra,28-08-2005,480081,Uttar Pradesh,11,1,19,13,44,Pass
Krishna Chopra,09-12-2004,810880,Andhra Pradesh,16,0,19,24,59,Pass
Ishaan Reddy,14-01-2005,347500,Chhattisgarh,0,24,2,24,50,Pass
Kunal Khan,19-01-2005,143175,Madhya Pradesh,10,21,13,4,48,Pass
Krishna Verma,11-02-2006,151925,Tamil Nadu,15,22,3,14,54,Pass
David Sharma,14-12-2004,419868,Karnataka,18,3,24,7,52,Pass
Aditya Verma,12-11-2004,840459,Uttar Pradesh,20,1,21,11,53,Pass
Gurpreet Fernandes,28-04-2005,924963,Bihar,16,19,5,9,49,Pass
Kunal Khan,01-12-2005,428119,Punjab,3,17,7,0,27,Pass
Gurpreet Fernandes,20-04-2005,732260,Jharkhand,20,10,22,3,55,Pass
Mathew Pillai,08-09-2005,336413,Bihar,4,5,24,18,51,Pass
Aryan Sharma,20-11-2004,296320,Rajasthan,7,23,7,2,39,Pass
Raj Pillai,06-02-2006,226755,Uttar Pradesh,11,1,15,7,34,Pass
Kunal Sharma,13-09-2005,111063,Jharkhand,16,7,6,17,46,Pass
Aarav Chopra,09-02-2006,669137,Uttar Pradesh,12,1,0,15,28,Pass
Gurpreet Sharma,03-02-2005,846173,Uttar Pradesh,7,1,19,24,51,Pass
Kunal Chopra,01-04-2006,135626,Uttarakhand,14,17,14,3,48,Pass
Aryan Mehta,30-11-2005,524037,Telangana,1,11,24,19,55,Pass
Kunal Mehta,06-09-2005,885370,Telangana,0,11,5,8,24,Pass
Vivaan D'Souza,15-05-2005,423154,Bihar,19,2,2,23,46,Pass
Rohan Singh,08-01-2006,395361,Assam,5,19,0,11,35,Pass
Kunal D'Souza,19-02-2006,631089,Delhi,18,19,14,22,73,Pass
Raj Verma,05-04-2005,499247,Madhya Pradesh,0,5,13,11,29,Pass
Rohan Pillai,26-09-2005,902697,Rajasthan,16,20,11,16,63,Pass
David Khan,09-08-2005,300148,Bihar,10,10,10,3,33,Pass
Zaid Verma,15-02-2005,467472,Meghalaya,4,7,10,6,27,Pass
Raj Reddy,23-03-2006,239209,Jammu & Kashmir + Ladakh,23,13,23,3,62,Pass
Vivaan Reddy,05-04-2005,959181,Assam,5,18,23,0,46,Pass
Vivaan Singh,20-03-2005,363345,Delhi,16,10,23,11,60,Pass
Aarav Sharma,09-10-2005,351075,Andhra Pradesh,0,5,15,1,21,Pass
David Reddy,06-06-2005,510326,Telangana,12,10,14,15,51,Pass
Raj Fernandes,25-11-2004,667989,West Bengal,3,21,21,18,63,Pass
Krishna Fernandes,28-06-2005,181031,Bihar,11,11,22,17,61,Pass
Aditya Singh,22-03-2005,754484,Rajasthan,5,9,19,21,54,Pass
Rohan Sharma,13-02-2006,600910,Jammu & Kashmir + Ladakh,6,20,2,10,38,Pass
Yash Reddy,12-06-2005,740828,Uttar Pradesh,2,1,19,5,27,Pass
Raj D'Souza,26-08-2005,610664,Andhra Pradesh,8,5,14,9,36,Pass
Aditya Pillai,27-05-2005,126909,Himachal Pradesh,20,1,17,16,54,Pass
Kunal Fernandes,05-01-2005,787331,Maharashtra,23,4,8,19,54,Pass
Yash Chopra,02-08-2005,149929,Bihar,15,15,19,23,72,Pass
Paul Chopra,16-12-2004,188576,West Bengal,12,12,11,8,43,Pass
Ishaan D'Souza,18-10-2005,690310,Gujarat,21,15,16,1,53,Pass
David Khan,19-05-2005,965303,Haryana,8,21,17,8,54,Pass
Raj Verma,03-07-2005,509667,Maharashtra,17,4,9,7,37,Pass
Harjeet Chopra,18-01-2005,594885,Maharashtra,6,4,23,19,52,Pass
Yash Verma,08-08-2005,244526,Gujarat,20,14,15,22,71,Pass
Manpreet Mehta,24-04-2006,821617,Uttar Pradesh,3,1,22,19,45,Pass
Manpreet Verma,23-04-2006,652774,Uttarakhand,3,19,19,9,50,Pass
Kunal Fernandes,07-01-2005,920500,Punjab,9,0,2,14,25,Pass
Yash Verma,08-05-2006,202059,Andhra Pradesh,7,9,16,7,39,Pass
Vivaan Singh,17-03-2005,503622,Himachal Pradesh,9,15,0,23,47,Pass
Rohan Mehta,01-12-2004,299090,Haryana,20,20,17,22,79,Pass
David Singh,14-01-2005,885532,Tamil Nadu,8,4,22,19,53,Pass
Sukhwinder Pillai,29-08-2005,774563,Uttar Pradesh,8,1,18,22,49,Pass
Kunal Sharma,03-04-2005,389971,Uttar Pradesh,24,1,13,3,41,Pass
David Verma,25-05-2005,557931,Karnataka,11,18,23,9,61,Pass
Raj Khan,19-02-2006,665179,Uttar Pradesh,5,1,4,4,14,Pass
Mathew Sharma,16-03-2006,547440,Karnataka,5,3,0,0,8,Pass
Yash Fernandes,08-11-2005,879638,Uttar Pradesh,18,1,10,6,35,Pass
Raj Reddy,12-12-2004,772871,Karnataka,5,13,1,0,19,Pass
Mathew Fernandes,21-11-2004,444449,Bihar,18,23,6,18,65,Pass
Kunal D'Souza,06-12-2004,128398,Haryana,16,4,10,10,40,Pass
Aditya D'Souza,15-07-2005,401362,Rajasthan,4,11,17,13,45,Pass
Rehan Pillai,26-07-2005,434185,Uttar Pradesh,15,1,23,11,50,Pass
Aditya Reddy,05-01-2006,650893,Bihar,21,15,19,12,67,Pass
Gurpreet Mehta,15-01-2006,352258,Madhya Pradesh,8,16,22,4,50,Pass
Aditya Pillai,16-09-2005,880594,Bihar,11,13,18,18,60,Pass
Aryan Sharma,18-09-2005,935551,Madhya Pradesh,2,1,23,22,48,Pass
Aditya Chopra,22-12-2005,158126,Himachal Pradesh,6,16,13,1,36,Pass
Harjeet Khan,29-11-2004,117731,West Bengal,7,8,17,12,44,Pass
Sukhwinder D'Souza,28-11-2005,493490,Karnataka,6,5,9,8,28,Pass
Mathew Reddy,16-06-2005,589069,Bihar,0,12,3,8,23,Pass
Krishna Verma,06-06-2005,324608,West Bengal,5,8,18,20,51,Pass
Aryan Pillai,25-07-2005,562342,Uttar Pradesh,23,1,23,12,59,Pass
Rohan Verma,01-04-2005,292178,Madhya Pradesh,2,3,10,18,33,Pass
Krishna Chopra,18-10-2005,282395,Andhra Pradesh,17,15,8,1,41,Pass
Raj Sharma,07-11-2005,240709,West Bengal,2,8,6,16,32,Pass
Gurpreet Fernandes,05-07-2005,893461,Karnataka,14,24,5,11,54,Pass
Yash Fernandes,09-07-2005,592751,Kerala,16,19,15,0,50,Pass
Balbir Singh,22-09-2005,664786,Bihar,13,17,1,8,39,Pass
Sukhwinder Fernandes,09-04-2005,604138,Punjab,7,16,16,13,52,Pass
Rohan Chopra,27-10-2005,468191,West Bengal,3,14,18,18,53,Pass
Rohan D'Souza,12-10-2005,913926,Maharashtra,15,10,8,10,43,Pass
David Fernandes,05-10-2005,348978,Telangana,17,2,24,2,45,Pass
Harjeet Verma,23-09-2005,266322,Arunachal Pradesh,11,6,23,21,61,Pass
Ishaan Chopra,27-11-2005,827459,Delhi,18,16,15,7,56,Pass
Manpreet Mehta,06-03-2005,852315,Jammu & Kashmir + Ladakh,5,18,8,11,42,Pass
Raj Sharma,18-03-2006,589923,Rajasthan,1,6,18,8,33,Pass
Krishna Khan,15-04-2005,241780,Rajasthan,7,18,10,16,51,Pass
Gurpreet Singh,02-04-2006,118015,Uttarakhand,6,5,10,0,21,Pass
Aditya Singh,19-12-2005,432939,Maharashtra,1,21,21,0,43,Pass
Raj Singh,15-02-2006,690107,Punjab,14,6,15,18,53,Pass
Krishna Khan,10-09-2005,466677,Andhra Pradesh,16,18,8,10,52,Pass
Ishaan Verma,08-09-2005,172202,Maharashtra,9,4,23,9,45,Pass
Krishna Mehta,07-12-2004,533513,West Bengal,10,1,20,5,36,Pass
Gurpreet Mehta,19-11-2005,779379,Madhya Pradesh,0,18,6,21,45,Pass
Aryan Pillai,13-02-2005,917785,Karnataka,19,4,9,7,39,Pass
Aryan Verma,26-01-2006,892828,Jharkhand,11,8,4,12,35,Pass
Aditya Verma,17-01-2005,767059,Andhra Pradesh,7,4,20,2,33,Pass
Rohan Chopra,27-01-2006,646645,Rajasthan,10,8,16,7,41,Pass
Aditya D'Souza,06-01-2005,762350,West Bengal,3,1,20,17,41,Pass
Aarav Pillai,17-01-2005,840502,Tamil Nadu,0,21,18,5,44,Pass
Krishna D'Souza,03-05-2005,154122,Odisha,6,14,12,0,32,Pass
Aryan Reddy,09-07-2005,469952,Uttar Pradesh,14,1,19,4,38,Pass
Yash Fernandes,22-05-2005,442786,Tamil Nadu,12,10,4,13,39,Pass
Vivaan Mehta,28-12-2004,816011,Punjab,13,1,2,0,16,Pass
David Reddy,23-09-2005,938942,Odisha,6,5,4,4,19,Pass
David Reddy,07-04-2005,149252,Kerala,7,6,6,6,25,Pass
Raj Chopra,09-04-2005,821845,Punjab,13,15,15,22,65,Pass
Ishaan Sharma,23-07-2005,953330,Madhya Pradesh,21,6,22,4,53,Pass
Sukhwinder Sharma,10-09-2005,221133,Bihar,5,5,5,18,33,Pass
Ishaan Mehta,11-04-2005,938044,Odisha,6,15,15,6,42,Pass
Yash Mehta,21-07-2005,952667,Uttar Pradesh,16,1,21,5,43,Pass
Vivaan Sharma,27-10-2005,798779,Karnataka,4,14,20,21,59,Pass
Zaid D'Souza,24-02-2006,604605,Odisha,4,24,0,6,34,Pass
Kunal Chopra,24-05-2005,750655,Gujarat,5,14,7,24,50,Pass
Yash Chopra,30-12-2005,738799,Madhya Pradesh,21,11,1,17,50,Pass
Vivaan Verma,29-04-2006,305711,Bihar,18,7,9,0,34,Pass
John Sharma,20-12-2004,275237,Andhra Pradesh,1,0,21,6,28,Pass
Aarav D'Souza,19-12-2004,559685,Andhra Pradesh,4,5,0,7,16,Pass
Rohan Verma,21-05-2005,305011,Tamil Nadu,2,4,18,21,45,Pass
Rohan Fernandes,16-09-2005,407635,Uttar Pradesh,4,1,12,15,32,Pass
Mathew Mehta,19-02-2005,671916,Haryana,14,2,12,15,43,Pass
Yash Verma,17-11-2005,900229,West Bengal,2,1,11,12,26,Pass
Yash Sharma,29-10-2005,378740,Haryana,20,6,0,4,30,Pass
Kunal Pillai,13-04-2005,413764,Madhya Pradesh,8,13,6,20,47,Pass
Ishaan Sharma,10-11-2004,511427,Bihar,4,4,0,0,8,Pass
Aryan Verma,05-01-2005,802300,Telangana,17,7,12,22,58,Pass
Mathew Reddy,06-07-2005,516013,Meghalaya,1,7,7,15,30,Pass
Paul Khan,13-01-2005,887801,Punjab,1,0,7,18,26,Pass
Paul Mehta,23-07-2005,435323,Uttar Pradesh,11,1,19,13,44,Pass
Rohan Khan,14-12-2005,574141,West Bengal,16,3,10,1,30,Pass
Gurpreet Verma,10-03-2005,154592,Bihar,4,23,12,2,41,Pass
Harjeet Chopra,20-03-2005,586820,Madhya Pradesh,15,17,14,8,54,Pass
John D'Souza,09-06-2005,508978,Uttar Pradesh,12,1,9,18,40,Pass
Rohan Sharma,11-02-2006,926991,Uttar Pradesh,11,1,5,17,34,Pass
Aditya Singh,02-01-2005,748723,Bihar,14,21,10,5,50,Pass
Kunal D'Souza,19-01-2005,721619,West Bengal,3,13,20,22,58,Pass
Raj Chopra,24-12-2005,432642,Uttar Pradesh,6,1,12,0,19,Pass
Yash Fernandes,22-08-2005,433344,Jammu & Kashmir + Ladakh,8,16,19,6,49,Pass
Aarav Sharma,11-03-2006,219170,Meghalaya,4,20,23,2,49,Pass
Gurpreet Fernandes,13-08-2005,516217,Punjab,2,7,6,23,38,Pass
Aryan Chopra,25-12-2005,160322,Jharkhand,12,22,8,8,50,Pass
David Singh,11-10-2005,674524,Himachal Pradesh,3,4,24,18,49,Pass
Ishaan Chopra,27-03-2006,498604,Telangana,18,3,12,6,39,Pass
Ishaan Sharma,14-03-2006,479117,Andhra Pradesh,21,19,22,12,74,Pass
Mathew Singh,12-01-2005,260149,Tamil Nadu,7,6,7,6,26,Pass
Krishna D'Souza,14-01-2006,251268,Bihar,3,5,6,17,31,Pass
Vivaan Verma,20-03-2005,950367,Rajasthan,1,17,18,22,58,Pass
David D'Souza,18-02-2006,190978,Chhattisgarh,0,13,16,16,45,Pass
Aryan Verma,14-02-2005,545851,Punjab,6,17,16,16,55,Pass
Vivaan Fernandes,28-02-2005,208721,West Bengal,8,4,21,19,52,Pass
David Mehta,02-03-2006,483452,Uttarakhand,10,9,14,17,50,Pass
Aarav Verma,15-02-2006,311842,Bihar,13,9,16,17,55,Pass
Raj Singh,10-05-2005,137334,Madhya Pradesh,22,4,11,18,55,Pass
Yash Khan,05-10-2005,660308,Maharashtra,1,4,23,19,47,Pass
Ayaan Verma,29-04-2005,305693,Punjab,20,8,5,5,38,Pass
Manpreet Chopra,22-01-2006,189030,West Bengal,3,20,10,6,39,Pass
Aryan D'Souza,24-12-2005,751497,Telangana,3,17,23,16,59,Pass
Krishna Sharma,07-03-2005,730172,Uttar Pradesh,17,1,23,12,53,Pass
Krishna Mehta,21-09-2005,911762,Bihar,13,14,3,20,50,Pass
Yash Chopra,06-02-2006,614376,West Bengal,4,5,4,21,34,Pass
Yash Sharma,27-02-2005,455079,Uttar Pradesh,8,1,18,2,29,Pass
David Verma,18-12-2005,190713,Maharashtra,18,4,24,13,59,Pass
Aditya Mehta,18-04-2005,894426,Rajasthan,5,20,10,12,47,Pass
Rehan Mehta,12-09-2005,538192,Assam,8,12,3,23,46,Pass
Vivaan Chopra,21-02-2006,848678,Bihar,11,8,3,1,23,Pass
Raj Verma,04-04-2005,163148,Uttar Pradesh,7,1,24,5,37,Pass
David Reddy,03-07-2005,253339,Rajasthan,17,0,24,3,44,Pass
Raj Mehta,04-10-2005,287779,Haryana,6,15,4,3,28,Pass
Raj Reddy,12-09-2005,707762,Madhya Pradesh,18,21,2,12,53,Pass
Aditya Khan,12-01-2005,560498,Telangana,18,7,24,18,67,Pass
Mathew Reddy,25-03-2006,894756,West Bengal,8,0,10,18,36,Pass
Raj Mehta,20-03-2005,358521,Gujarat,21,13,14,8,56,Pass
Ishaan Mehta,16-11-2005,103188,Bihar,7,1,14,10,32,Pass
Aryan Pillai,03-11-2005,856243,Uttar Pradesh,17,1,17,0,35,Pass
Aditya Khan,06-08-2005,687956,Haryana,5,1,20,15,41,Pass
Balbir Mehta,23-08-2005,197211,Arunachal Pradesh,2,11,15,20,48,Pass
Vivaan Pillai,20-07-2005,743978,Kerala,24,13,11,13,61,Pass
John Mehta,06-12-2004,722390,Bihar,10,12,17,15,54,Pass
Peter Reddy,01-10-2005,876673,Jharkhand,16,11,18,12,57,Pass
John Sharma,02-08-2005,478183,Tamil Nadu,3,1,2,5,11,Pass
Aditya Khan,03-08-2005,360244,Puducherry,2,24,4,5,35,Pass
Mathew Reddy,07-02-2006,592139,West Bengal,3,2,16,23,44,Pass
Ishaan Reddy,03-03-2005,288678,Haryana,0,16,14,18,48,Pass
Aditya D'Souza,02-04-2005,705300,Maharashtra,3,21,18,5,47,Pass
Aarav Sharma,23-11-2004,141274,Bihar,0,17,5,13,35,Pass
Ishaan Khan,11-12-2004,567080,Rajasthan,19,3,15,22,59,Pass
Zaid D'Souza,31-07-2005,144668,Odisha,7,14,20,13,54,Pass
Vivaan Pillai,29-05-2005,833459,Haryana,3,11,1,22,37,Pass
Vivaan D'Souza,17-03-2005,193650,Karnataka,23,20,1,20,64,Pass
Ayaan Mehta,29-04-2005,504311,Haryana,18,13,23,12,66,Pass
Krishna Khan,04-05-2005,895139,Haryana,15,5,17,24,61,Pass
Yash Sharma,20-07-2005,349142,Rajasthan,24,4,6,0,34,Pass
Krishna Khan,21-08-2005,711485,Rajasthan,13,5,2,17,37,Pass
Aarav Mehta,17-12-2004,269344,Bihar,18,20,20,22,80,Pass
Vivaan Fernandes,25-12-2004,373436,Uttar Pradesh,22,1,21,4,48,Pass
Farhan Sharma,29-03-2005,359242,Andhra Pradesh,24,0,14,1,39,Pass
Ishaan Singh,03-02-2005,140248,Tamil Nadu,3,20,4,12,39,Pass
Imran Sharma,04-12-2005,791259,Maharashtra,15,4,16,14,49,Pass
Yash Pillai,04-04-2005,238396,Andhra Pradesh,2,9,6,9,26,Pass
Aditya Reddy,21-03-2005,182867,Uttar Pradesh,17,1,8,8,34,Pass
Sukhwinder Mehta,21-04-2006,637232,Rajasthan,10,22,0,14,46,Pass
Aarav Pillai,24-12-2004,330802,Telangana,11,23,14,14,62,Pass
Aditya Chopra,26-03-2006,738572,Maharashtra,2,20,0,22,44,Pass
Ishaan Chopra,02-09-2005,817250,Punjab,16,0,9,21,46,Pass
Harjeet Verma,23-02-2006,950658,Tamil Nadu,9,21,19,11,60,Pass
Rohan D'Souza,09-12-2005,931322,Bihar,12,24,21,4,61,Pass
Rohan Chopra,17-03-2006,923226,Rajasthan,1,19,23,5,48,Pass
Balbir Singh,06-05-2005,562036,Uttar Pradesh,7,1,2,12,22,Pass
Ishaan Reddy,22-12-2005,379195,Tamil Nadu,1,9,11,7,28,Pass
Rehan Sharma,14-03-2005,379048,Telangana,17,18,10,14,59,Pass
Rohan Singh,01-02-2005,200969,Uttar Pradesh,7,1,15,11,34,Pass
Raj Sharma,15-02-2005,665596,Tamil Nadu,2,4,8,8,22,Pass
Aditya Fernandes,14-11-2004,616490,Tamil Nadu,16,17,22,19,74,Pass
Manpreet Sharma,24-02-2005,673012,Madhya Pradesh,16,17,23,4,60,Pass
Ishaan Singh,07-12-2004,968281,Uttar Pradesh,23,1,18,0,42,Pass
Rohan Pillai,03-04-2006,600906,Tamil Nadu,4,5,24,13,46,Pass
David Pillai,14-07-2005,236339,Tamil Nadu,18,17,22,22,79,Pass
Kunal Khan,05-11-2005,610829,Uttar Pradesh,6,1,3,17,27,Pass
Ishaan Verma,22-12-2004,654772,Gujarat,18,6,17,14,55,Pass
Zaid Verma,10-01-2005,949426,Bihar,11,1,2,11,25,Pass
Raj Chopra,05-05-2005,490927,Manipur,4,20,19,19,62,Pass
Ishaan Sharma,06-12-2005,114729,Madhya Pradesh,20,8,22,4,54,Pass
Sukhwinder Sharma,31-01-2005,651578,Assam,7,17,3,13,40,Pass
Aryan Mehta,10-01-2005,723600,Karnataka,22,9,22,6,59,Pass
Rohan Sharma,23-08-2005,717803,Rajasthan,23,15,15,7,60,Pass
Balbir Khan,12-01-2005,138525,Punjab,15,2,17,16,50,Pass
Yash Khan,02-01-2005,579974,Maharashtra,20,11,7,0,38,Pass
Aryan Mehta,13-06-2005,163152,Uttar Pradesh,4,1,15,3,23,Pass
Aarav D'Souza,20-10-2005,351340,Bihar,20,12,24,18,74,Pass
Aarav D'Souza,25-02-2006,918483,Delhi,12,13,13,23,61,Pass
Aditya Chopra,06-01-2005,289902,Nagaland,5,15,19,0,39,Pass
Gurpreet Reddy,03-12-2004,952034,Bihar,10,2,9,15,36,Pass
David Verma,06-02-2006,492652,Madhya Pradesh,13,9,14,14,50,Pass
Rohan Reddy,14-12-2005,345032,Rajasthan,11,1,2,0,14,Pass
Kunal Sharma,07-02-2005,321148,Goa,8,6,23,7,44,Fail
Gurpreet Singh,13-12-2005,354433,Uttarakhand,13,14,14,9,50,Pass
Kunal Fernandes,11-07-2005,852069,Telangana,23,3,13,24,63,Pass
Rohan Pillai,12-04-2006,726937,Odisha,12,15,18,13,58,Pass
Aryan Singh,08-08-2005,187177,Bihar,7,22,12,4,45,Pass
Krishna Pillai,23-06-2005,686991,Bihar,6,3,13,11,33,Pass
Vivaan Pillai,31-03-2005,416183,Tamil Nadu,10,20,21,22,73,Pass
Aryan Fernandes,16-08-2005,857849,Punjab,4,17,8,17,46,Pass
Paul Fernandes,11-08-2005,784880,Jharkhand,4,10,12,5,31,Pass
Raj Fernandes,07-08-2005,297926,Bihar,15,1,3,0,19,Pass
Vivaan D'Souza,11-08-2005,274116,West Bengal,24,1,16,2,43,Pass
Ishaan Singh,27-06-2005,389867,Uttar Pradesh,12,1,12,20,45,Pass
Paul D'Souza,17-03-2005,265862,Andhra Pradesh,18,2,15,15,50,Pass
Manpreet Mehta,03-03-2005,179044,Haryana,13,6,10,1,30,Pass
Krishna Sharma,21-12-2004,426820,West Bengal,3,18,17,15,53,Pass
Vivaan Verma,30-11-2004,538807,Tamil Nadu,13,2,11,19,45,Pass
Mathew Sharma,29-01-2006,935865,Andhra Pradesh,12,8,9,6,35,Pass
Aditya Fernandes,02-03-2006,601138,Tamil Nadu,2,10,1,1,14,Pass
Vivaan Reddy,08-11-2005,947174,Uttar Pradesh,17,1,11,24,53,Pass
Manpreet Pillai,23-01-2006,281170,Andhra Pradesh,1,8,20,8,37,Pass
Vivaan Sharma,10-03-2006,314317,Rajasthan,3,17,2,3,25,Pass
Krishna Khan,30-11-2005,514813,Madhya Pradesh,2,21,19,2,44,Pass
Vivaan D'Souza,27-04-2006,373923,Andhra Pradesh,18,3,15,21,57,Pass
Paul Khan,08-09-2005,147019,Maharashtra,11,4,22,15,52,Pass
Aryan Pillai,01-01-2005,493180,Madhya Pradesh,10,22,6,4,42,Pass
Rohan Sharma,22-06-2005,622294,Uttar Pradesh,9,1,24,15,49,Pass
John Chopra,31-03-2006,211279,West Bengal,6,2,4,23,35,Pass
David Verma,18-10-2005,491952,Bihar,23,15,9,3,50,Pass
Rohan Verma,10-02-2006,934121,Rajasthan,16,5,0,8,29,Pass
Aditya Chopra,08-04-2005,352856,Assam,16,24,1,6,47,Pass
Aarav Verma,25-04-2005,746862,Maharashtra,19,4,3,8,34,Pass
Vivaan Mehta,07-12-2004,980597,Rajasthan,1,2,14,5,22,Pass
Raj Verma,15-03-2006,711510,Maharashtra,17,4,9,11,41,Pass
David D'Souza,06-11-2005,203588,Delhi,24,2,18,0,44,Pass
Rohan Reddy,29-03-2006,592634,Maharashtra,21,4,17,12,54,Pass
Aryan Reddy,27-04-2006,864471,West Bengal,5,13,7,20,45,Pass
Aryan Reddy,10-12-2005,836412,Maharashtra,15,4,15,15,49,Pass
Peter D'Souza,05-04-2005,113167,Rajasthan,16,12,6,22,56,Pass
Ishaan Sharma,07-11-2005,821599,Uttar Pradesh,22,1,11,10,44,Pass
Aditya Singh,22-04-2005,550106,Bihar,4,14,11,24,53,Pass
Vivaan Reddy,18-07-2005,746066,Uttar Pradesh,22,1,21,0,44,Pass
Vivaan Khan,02-12-2004,474214,Haryana,0,4,4,6,14,Pass
Kunal Verma,09-04-2005,362191,Uttar Pradesh,0,1,24,17,42,Pass
Raj D'Souza,22-01-2005,514114,Odisha,5,17,19,12,53,Pass
Rehan Verma,17-01-2005,267552,Uttar Pradesh,11,1,13,19,44,Pass
Aditya Reddy,29-06-2005,827993,Uttar Pradesh,15,1,5,23,44,Pass
Vivaan Fernandes,20-10-2005,798744,Rajasthan,8,12,17,6,43,Pass
Sukhwinder D'Souza,30-12-2004,843014,Rajasthan,21,15,15,13,64,Pass
Ishaan Pillai,21-04-2006,576745,West Bengal,1,10,18,16,45,Pass
Ishaan Singh,14-05-2005,803354,Assam,8,14,5,6,33,Pass
Raj Chopra,10-01-2006,788500,Uttar Pradesh,18,1,8,6,33,Pass
Aryan Chopra,14-01-2006,617764,Gujarat,4,17,6,11,38,Pass
Kunal Reddy,23-12-2004,399432,Andhra Pradesh,10,16,10,8,44,Pass
Sukhwinder Chopra,27-05-2005,229339,Tamil Nadu,21,19,23,24,87,Pass
Yash Mehta,09-10-2005,817122,Assam,5,3,5,6,19,Pass
Kunal Reddy,17-06-2005,129714,Karnataka,10,1,22,5,38,Pass
Harjeet Reddy,04-02-2006,160668,Haryana,14,20,5,14,53,Pass
Aryan Fernandes,07-02-2005,875848,Bihar,0,21,17,7,45,Pass
Rohan Singh,20-05-2005,466970,Bihar,20,8,2,7,37,Pass
Raj Fernandes,06-06-2005,926580,Andhra Pradesh,14,2,0,5,21,Pass
Raj Verma,04-10-2005,463324,Uttar Pradesh,0,1,8,10,19,Pass
Balbir Pillai,14-02-2005,202906,Bihar,7,8,9,14,38,Pass
Gurpreet Singh,08-10-2005,802980,Odisha,5,13,12,23,53,Pass
Aditya Pillai,07-01-2005,275054,Madhya Pradesh,24,19,8,4,55,Pass
Ishaan Pillai,17-09-2005,591198,Haryana,5,6,17,0,28,Pass
Vivaan D'Souza,15-06-2005,410371,Telangana,18,0,10,6,34,Pass
Aditya Fernandes,15-04-2005,749773,Tamil Nadu,17,24,18,22,81,Pass
Manpreet Khan,03-05-2006,282854,Tamil Nadu,17,23,5,16,61,Pass
Kunal Fernandes,20-12-2005,827607,Madhya Pradesh,17,24,10,4,55,Pass
Vivaan Verma,29-03-2006,907413,Bihar,11,6,13,15,45,Pass
Vivaan Mehta,10-11-2005,499383,West Bengal,1,5,5,7,18,Pass
Aryan Chopra,18-01-2006,664130,Nagaland,6,3,2,1,12,Pass
Vivaan D'Souza,02-04-2006,290131,West Bengal,24,5,4,9,42,Pass
Kunal Verma,15-12-2005,495622,Chhattisgarh,9,11,23,3,46,Pass
Peter Sharma,09-10-2005,827396,Haryana,4,7,14,10,35,Pass
Rohan Pillai,15-01-2005,787756,Odisha,18,5,3,7,33,Pass
Vivaan Singh,03-06-2005,936654,Rajasthan,12,8,8,7,35,Pass
Aarav D'Souza,25-03-2006,281124,Jharkhand,17,13,20,3,53,Pass
Kunal Mehta,27-04-2006,322708,Maharashtra,17,4,23,23,67,Pass
Peter Khan,19-08-2005,369812,Uttar Pradesh,18,1,13,15,47,Pass
Aarav Khan,13-10-2005,761449,Uttar Pradesh,22,1,15,4,42,Pass
Aarav Fernandes,26-05-2005,294029,Rajasthan,12,15,20,6,53,Pass
Krishna Verma,16-02-2006,481958,Delhi,14,10,19,3,46,Pass
Vivaan Fernandes,14-05-2005,586507,Gujarat,14,11,8,3,36,Pass
Aditya Sharma,20-12-2004,533798,Delhi,5,9,5,24,43,Pass
Krishna Mehta,16-12-2004,153461,Haryana,14,11,22,11,58,Pass
Raj Singh,10-02-2005,295744,Arunachal Pradesh,6,6,16,22,50,Pass
Raj Chopra,21-09-2005,917182,Manipur,4,9,13,8,34,Pass
Aditya Fernandes,10-07-2005,334443,Tamil Nadu,5,1,13,17,36,Pass
Yash Singh,16-08-2005,400140,Uttar Pradesh,5,1,23,24,53,Pass
Yash Pillai,03-04-2005,429167,Telangana,18,9,9,18,54,Pass
Vivaan Chopra,29-11-2005,102695,Rajasthan,2,12,12,2,28,Pass
Krishna D'Souza,03-03-2006,973870,Uttar Pradesh,23,1,2,14,40,Pass
Imran Khan,08-02-2005,375754,Madhya Pradesh,0,1,7,9,17,Pass
Sukhwinder D'Souza,29-01-2006,829088,Rajasthan,2,16,5,8,31,Pass
Raj Mehta,30-03-2006,997111,Andhra Pradesh,11,22,8,16,57,Pass
Kunal Fernandes,31-08-2005,152372,Rajasthan,22,4,4,12,42,Pass
Krishna Chopra,02-03-2005,682091,Delhi,11,8,2,19,40,Pass
Paul Verma,21-06-2005,406568,Gujarat,5,7,10,13,35,Pass
Balbir Reddy,19-04-2005,220418,Maharashtra,11,4,18,3,36,Pass
John Reddy,21-07-2005,461408,Uttar Pradesh,19,1,6,22,48,Pass
Gurpreet Mehta,17-04-2006,315839,Tamil Nadu,4,0,9,7,20,Pass
Yash Reddy,28-03-2006,601724,Rajasthan,16,6,6,23,51,Pass
Paul Verma,30-12-2004,685913,Kerala,24,23,0,19,66,Pass
Ishaan Singh,01-12-2005,624878,Chhattisgarh,11,3,19,19,52,Pass
Kunal Mehta,20-09-2005,741647,Andhra Pradesh,9,23,18,0,50,Pass
Vivaan Singh,08-01-2006,937558,West Bengal,19,18,9,7,53,Pass
Balbir D'Souza,26-10-2005,430615,Punjab,21,9,17,12,59,Pass
Kunal Singh,09-04-2006,171558,Uttar Pradesh,1,1,2,17,21,Pass
Aarav Verma,28-02-2005,301821,Karnataka,16,12,7,21,56,Pass
Yash Mehta,30-01-2005,122375,Bihar,4,20,23,22,69,Pass
Balbir Verma,02-02-2006,223552,Uttar Pradesh,3,1,2,14,20,Pass
Yash Verma,23-03-2005,597919,Rajasthan,14,24,6,4,48,Pass
Kunal Khan,14-07-2005,460758,Madhya Pradesh,15,5,9,13,42,Pass
Manpreet Pillai,22-02-2005,783890,Uttar Pradesh,4,1,8,1,14,Pass
Vivaan Sharma,26-01-2005,145550,West Bengal,1,21,24,0,46,Pass
Yash Pillai,17-03-2006,222266,Uttar Pradesh,15,1,12,8,36,Pass
Kunal Pillai,14-01-2005,345398,Maharashtra,6,16,7,19,48,Pass
Aryan Sharma,22-04-2006,800937,Assam,9,20,8,10,47,Pass
Yash Verma,21-07-2005,647931,Andhra Pradesh,24,11,12,6,53,Pass
Mathew Chopra,28-01-2006,388465,Uttar Pradesh,1,1,24,18,44,Pass
Aarav Reddy,04-01-2006,436836,Gujarat,6,10,1,17,34,Pass
Gurpreet Mehta,08-11-2004,316844,Uttarakhand,2,5,3,24,34,Pass
Kunal Verma,01-05-2006,747481,Uttar Pradesh,8,1,21,9,39,Pass
Aarav Khan,22-01-2006,713017,Uttar Pradesh,17,1,8,11,37,Pass
Ishaan Fernandes,22-07-2005,819157,Karnataka,5,13,8,10,36,Pass
Manpreet Fernandes,17-08-2005,977467,Karnataka,7,24,24,0,55,Pass
Raj Sharma,13-12-2005,165123,Gujarat,14,11,21,7,53,Pass
Gurpreet Reddy,17-04-2005,454249,Punjab,4,21,5,13,43,Pass
Sukhwinder Singh,12-01-2006,184323,Uttar Pradesh,24,1,18,15,58,Pass
Rohan D'Souza,28-10-2005,713966,Assam,2,23,14,2,41,Pass
David Verma,21-09-2005,592113,Uttar Pradesh,15,1,13,24,53,Pass
Aditya Reddy,31-08-2005,832709,Tamil Nadu,10,13,8,0,31,Pass
Aarav Singh,23-03-2005,611438,Haryana,24,3,21,13,61,Pass
Ishaan Fernandes,21-03-2006,745451,Assam,11,5,15,12,43,Pass
Raj Verma,10-07-2005,574077,Andhra Pradesh,4,13,10,18,45,Pass
Sukhwinder Verma,29-03-2005,129984,Jharkhand,16,13,9,13,51,Pass
Vivaan Khan,09-03-2006,930696,Bihar,15,23,22,15,75,Pass
Aarav Pillai,21-05-2005,867991,Telangana,16,13,23,3,55,Pass
Aarav Pillai,18-12-2004,242268,Uttarakhand,1,21,5,20,47,Pass
Krishna Singh,02-06-2005,374161,West Bengal,14,4,4,2,24,Pass
Aryan Verma,26-10-2005,324763,Uttar Pradesh,5,1,0,18,24,Pass
Balbir Verma,27-12-2004,440913,Bihar,8,6,17,11,42,Pass
Gurpreet Khan,07-05-2005,131198,Rajasthan,24,15,13,1,53,Pass
Vivaan Reddy,23-02-2006,281003,Uttar Pradesh,18,1,20,17,56,Pass
Kunal Fernandes,29-01-2005,858170,Bihar,16,10,20,13,59,Pass
Vivaan Pillai,28-12-2004,720185,Uttar Pradesh,4,1,16,22,43,Pass
Balbir Verma,24-01-2005,807102,Rajasthan,20,20,13,6,59,Pass
Krishna Chopra,14-01-2006,705109,Madhya Pradesh,21,19,8,4,52,Pass
Zaid Khan,03-03-2006,726195,Madhya Pradesh,19,20,2,10,51,Pass
Yash Reddy,12-11-2004,750669,Punjab,9,22,14,1,46,Pass
Rohan Verma,22-09-2005,198867,Tamil Nadu,11,8,23,20,62,Pass
Kunal Mehta,04-10-2005,655991,Bihar,6,17,2,6,31,Pass
Kunal D'Souza,08-10-2005,283534,Uttar Pradesh,9,1,16,10,36,Pass
Manpreet Singh,09-02-2006,369020,Telangana,6,6,13,9,34,Pass
Gurpreet D'Souza,21-01-2005,347507,Maharashtra,3,2,7,18,30,Pass
Rohan Reddy,23-10-2005,621578,Maharashtra,15,4,19,24,62,Pass
Aditya Verma,06-01-2005,159387,Uttar Pradesh,23,1,16,13,53,Pass
Aditya Chopra,20-02-2006,764183,West Bengal,1,0,24,18,43,Pass
Paul Verma,21-06-2005,505546,Chhattisgarh,12,7,10,17,46,Pass
Raj D'Souza,15-04-2006,442682,Haryana,18,2,7,23,50,Pass
Krishna Mehta,18-04-2005,625608,Karnataka,4,2,23,8,37,Pass
Yash Sharma,04-01-2005,235966,Bihar,16,23,4,21,64,Pass
Ayaan Mehta,31-01-2005,760439,Assam,6,5,18,13,42,Pass
Vivaan Fernandes,09-06-2005,540928,West Bengal,3,15,19,3,40,Pass
Kunal D'Souza,29-09-2005,336542,Punjab,1,0,11,4,16,Pass
Krishna Sharma,20-02-2006,868585,Madhya Pradesh,16,21,10,4,51,Pass
Ishaan Singh,18-04-2005,468152,Meghalaya,19,23,18,20,80,Pass
Aditya Chopra,05-05-2006,764476,Bihar,12,6,13,16,47,Pass
Raj Sharma,03-01-2005,235924,Maharashtra,20,4,20,9,53,Pass
Rohan Sharma,13-02-2006,142105,Uttar Pradesh,7,1,13,1,22,Pass
Vivaan Pillai,23-04-2005,157223,Jharkhand,11,18,16,21,66,Pass
Imran Singh,04-09-2005,658874,Tamil Nadu,8,18,15,7,48,Pass
Raj Mehta,20-01-2006,803314,Tamil Nadu,13,8,3,13,37,Pass
Aarav Verma,29-12-2005,379029,Uttar Pradesh,23,1,9,13,46,Pass
Ishaan Khan,17-02-2006,578968,Assam,7,22,6,14,49,Pass
John Fernandes,13-06-2005,141736,Andhra Pradesh,12,0,4,20,36,Pass
Balbir Verma,10-02-2006,369422,Tamil Nadu,15,3,19,14,51,Pass
Sukhwinder D'Souza,10-11-2004,963423,Puducherry,16,15,6,5,42,Pass
Sukhwinder Sharma,12-03-2005,663522,Bihar,17,4,7,1,29,Pass
Harjeet Verma,26-12-2004,694525,Uttar Pradesh,23,1,9,1,34,Pass
Aditya Mehta,16-01-2005,912740,Kerala,8,8,21,0,37,Pass
Krishna D'Souza,31-08-2005,155975,Tamil Nadu,14,8,23,13,58,Pass
Vivaan D'Souza,03-08-2005,786619,Bihar,23,3,21,13,60,Pass
Sukhwinder Khan,31-01-2005,711582,Jharkhand,11,6,6,6,29,Pass
David Mehta,10-08-2005,506102,Bihar,16,21,3,3,43,Pass
Yash Khan,12-07-2005,828889,Uttar Pradesh,3,1,13,15,32,Pass
Gurpreet Khan,07-03-2005,511859,Telangana,6,12,24,15,57,Pass
Vivaan Khan,03-07-2005,907852,Tamil Nadu,1,13,6,3,23,Pass
Aryan Fernandes,11-11-2004,875320,Gujarat,13,22,18,8,61,Pass
Balbir Reddy,24-02-2006,701589,Uttar Pradesh,24,1,5,11,41,Pass
Balbir Fernandes,17-04-2005,329757,Assam,2,10,12,18,42,Pass
Krishna Pillai,12-01-2006,265651,Bihar,23,11,10,12,56,Pass
Vivaan Chopra,16-11-2004,850114,Punjab,6,11,14,1,32,Pass
Aryan Reddy,06-05-2005,844695,Gujarat,19,19,7,6,51,Pass
Aryan Pillai,25-09-2005,895521,Tamil Nadu,24,23,22,12,81,Pass
Ishaan Sharma,17-07-2005,802840,Mizoram,2,4,8,7,21,Pass
Imran Pillai,08-01-2005,232146,Madhya Pradesh,0,12,16,9,37,Pass
Rohan Verma,30-09-2005,900612,Himachal Pradesh,6,1,13,1,21,Pass
Raj Pillai,20-02-2005,955762,Nagaland,8,17,7,8,40,Pass
Vivaan Pillai,13-01-2005,512168,Bihar,17,5,15,18,55,Pass
Rohan Pillai,17-09-2005,120848,Maharashtra,24,17,3,0,44,Pass
Vivaan Mehta,21-03-2006,931963,West Bengal,3,21,15,14,53,Pass
Farhan Singh,21-04-2005,846478,Uttar Pradesh,3,1,22,22,48,Pass
Aarav Mehta,09-02-2006,998843,Uttar Pradesh,11,1,0,20,32,Pass
Aditya Verma,08-02-2005,860338,Madhya Pradesh,0,0,17,20,37,Pass
Ishaan Pillai,04-09-2005,855373,Kerala,6,6,6,6,24,Pass
Krishna Reddy,11-03-2005,335151,Punjab,21,23,2,10,56,Pass
Rehan Fernandes,21-11-2005,714375,Gujarat,18,6,8,5,37,Pass
Peter Mehta,19-09-2005,349788,Bihar,11,4,2,23,40,Pass
Krishna Mehta,08-01-2005,976224,Uttarakhand,1,7,13,6,27,Pass
Harjeet Khan,26-04-2006,619643,Andhra Pradesh,23,0,22,15,60,Pass
Rohan Chopra,14-03-2005,969775,Uttarakhand,7,11,16,12,46,Pass
Yash Singh,09-12-2004,433322,Uttar Pradesh,14,1,9,7,31,Pass
Mathew Mehta,26-04-2005,104299,Uttarakhand,6,10,15,12,43,Pass
Peter Reddy,07-04-2006,763725,Uttar Pradesh,7,1,2,9,19,Pass
Aditya Fernandes,09-09-2005,882099,Punjab,2,9,13,0,24,Pass
Rohan Verma,20-02-2005,938052,Andhra Pradesh,3,20,7,12,42,Pass
Rohan Pillai,29-12-2004,291486,Bihar,11,1,21,14,47,Pass
Mathew Reddy,06-08-2005,686540,Madhya Pradesh,8,16,22,4,50,Pass
Raj Pillai,11-08-2005,125604,Bihar,4,11,11,11,37,Pass
Yash Pillai,01-02-2005,683615,Jharkhand,7,9,15,16,47,Pass
Aditya Verma,01-01-2005,637344,Bihar,15,5,13,9,42,Pass
Rohan Sharma,31-03-2005,912758,Uttar Pradesh,8,1,4,10,23,Pass
Raj Reddy,29-04-2005,545530,Andhra Pradesh,5,23,14,7,49,Pass
Ishaan D'Souza,12-11-2004,144096,Tamil Nadu,8,7,23,22,60,Pass
Ishaan Verma,01-03-2006,804089,Maharashtra,16,0,13,11,40,Pass
Aarav Mehta,02-11-2005,780677,Bihar,22,3,7,22,54,Pass
Rohan Singh,22-02-2006,191955,Uttar Pradesh,6,1,5,2,14,Pass
Manpreet Mehta,05-09-2005,984726,Madhya Pradesh,3,11,0,21,35,Pass
Aarav Sharma,17-01-2006,568304,West Bengal,23,16,5,4,48,Pass
Krishna Singh,11-11-2004,929909,Karnataka,15,13,3,14,45,Pass
Aryan Pillai,13-03-2005,524148,Rajasthan,20,7,8,17,52,Pass
Aryan Singh,18-04-2006,761057,Rajasthan,8,21,18,2,49,Pass
Vivaan Pillai,11-10-2005,237627,Uttar Pradesh,6,1,22,23,52,Pass
Harjeet Chopra,10-08-2005,749140,Tamil Nadu,0,5,2,15,22,Pass
Aditya Reddy,29-03-2005,462064,Rajasthan,21,10,7,1,39,Pass
Ishaan Pillai,15-03-2005,478981,Rajasthan,19,22,12,4,57,Pass
Farhan Chopra,15-01-2005,352307,Rajasthan,19,7,14,18,58,Pass
Aryan Mehta,13-10-2005,922111,Odisha,16,17,21,5,59,Pass
Krishna Khan,20-04-2006,984683,West Bengal,16,6,6,4,32,Pass
Mathew Pillai,15-04-2005,372966,Himachal Pradesh,12,17,0,17,46,Pass
Aarav Pillai,07-02-2005,500250,Bihar,22,11,13,7,53,Pass
Raj Sharma,30-06-2005,241249,Jharkhand,8,6,11,16,41,Pass
Aryan Fernandes,19-08-2005,257785,Madhya Pradesh,20,5,13,3,41,Pass
Harjeet Singh,15-11-2005,760109,Gujarat,7,6,6,3,22,Pass
Raj Verma,04-04-2006,418140,Andhra Pradesh,13,9,20,16,58,Pass
Aarav Singh,12-04-2006,772661,Uttarakhand,24,2,18,0,44,Pass
Aryan Fernandes,10-06-2005,686180,Madhya Pradesh,7,8,14,5,34,Pass
Vivaan Reddy,25-01-2005,168283,Tamil Nadu,24,12,14,21,71,Pass
Ishaan Fernandes,04-02-2006,728989,Tamil Nadu,18,24,21,5,68,Pass
Rohan Sharma,11-06-2005,525088,Haryana,18,0,0,6,24,Pass
Ishaan Pillai,26-04-2006,793987,Maharashtra,10,4,22,8,44,Pass
Aditya Chopra,21-03-2005,759889,Madhya Pradesh,13,6,17,8,44,Pass
John Singh,28-07-2005,126184,Odisha,19,14,9,7,49,Pass
Harjeet D'Souza,14-09-2005,707956,West Bengal,3,24,23,10,60,Pass
Raj Reddy,07-05-2006,472184,Punjab,20,8,12,7,47,Pass
Harjeet Chopra,19-06-2005,322189,Punjab,18,4,0,1,23,Pass
Rohan Mehta,04-03-2005,192979,Chhattisgarh,23,1,8,0,32,Pass
Ayaan D'Souza,17-12-2005,277162,Haryana,16,9,0,14,39,Pass
Raj Pillai,02-02-2005,910574,Rajasthan,11,0,9,6,26,Pass
Ishaan Mehta,23-11-2004,848022,Gujarat,4,22,1,15,42,Pass
Rohan Fernandes,21-04-2005,780622,Uttarakhand,5,3,5,13,26,Pass
Yash D'Souza,15-03-2006,911984,Maharashtra,19,5,0,11,35,Pass
Mathew Sharma,20-09-2005,148183,Karnataka,14,20,7,0,41,Pass
Rohan D'Souza,29-01-2006,843643,Bihar,23,21,20,18,82,Pass
Rohan Pillai,12-04-2005,926314,Daman & Diu / D&N Haveli,6,10,8,1,25,Pass
David Singh,11-06-2005,381260,Andhra Pradesh,21,17,20,3,61,Pass
Harjeet Verma,27-06-2005,124726,Bihar,1,21,23,5,50,Pass
Balbir D'Souza,03-05-2005,608540,Uttar Pradesh,12,1,6,15,34,Pass
Kunal Reddy,25-11-2005,858962,Uttar Pradesh,19,1,24,0,44,Pass
Manpreet D'Souza,20-10-2005,514321,Bihar,0,22,13,4,39,Pass
Mathew Khan,09-10-2005,993638,Punjab,12,16,4,6,38,Pass
Aditya Reddy,04-07-2005,950220,Madhya Pradesh,10,6,12,8,36,Pass
Rohan Fernandes,30-04-2005,776023,West Bengal,3,8,22,11,44,Pass
Ishaan Chopra,10-11-2005,497806,Bihar,7,21,6,3,37,Pass
Kunal Khan,14-11-2004,625182,Madhya Pradesh,14,5,10,5,34,Pass
Aditya Chopra,24-04-2005,417492,Andhra Pradesh,12,4,23,9,48,Pass
Kunal Pillai,29-04-2006,923280,Assam,6,0,14,0,20,Pass
Vivaan Khan,06-06-2005,910525,Bihar,0,4,11,10,25,Pass
Raj Mehta,14-06-2005,440102,Uttar Pradesh,24,1,17,9,51,Pass
Kunal Khan,25-02-2005,336405,Tamil Nadu,2,10,5,16,33,Pass
John Sharma,13-12-2005,573166,Assam,3,20,5,3,31,Pass
Gurpreet Khan,07-10-2005,771452,Haryana,17,17,11,9,54,Pass
Krishna Singh,20-06-2005,238692,Bihar,1,21,2,4,28,Pass
Aarav D'Souza,28-02-2005,460031,Uttar Pradesh,18,1,15,2,36,Pass
Yash Fernandes,09-01-2005,818667,Delhi,9,13,0,18,40,Pass
Ishaan Sharma,28-02-2005,223968,West Bengal,3,20,24,0,47,Pass
Aarav Reddy,23-10-2005,166828,Odisha,1,8,24,20,53,Pass
Paul Pillai,30-10-2005,435322,Bihar,16,9,22,11,58,Pass
Aditya Singh,26-05-2005,497571,Puducherry,5,6,5,5,21,Pass
Vivaan Sharma,14-03-2005,797673,West Bengal,17,13,7,4,41,Pass
Aditya Chopra,09-06-2005,187897,Manipur,4,23,20,0,47,Pass
Yash Pillai,20-09-2005,394833,Odisha,10,11,23,3,47,Pass
Aarav Pillai,05-05-2006,306889,Maharashtra,22,4,19,15,60,Pass
Kunal Mehta,16-02-2006,536699,Andhra Pradesh,2,3,3,7,15,Pass
Gurpreet Fernandes,27-12-2005,152224,Bihar,10,2,10,3,25,Pass
Rohan Pillai,22-06-2005,728905,Uttar Pradesh,23,1,14,1,39,Pass
Kunal Fernandes,15-04-2006,566373,Uttar Pradesh,10,1,3,23,37,Pass
Aditya Singh,23-08-2005,572627,Andhra Pradesh,7,21,21,8,57,Pass
Peter Sharma,12-02-2006,504779,Uttar Pradesh,18,1,0,7,26,Pass
Raj Chopra,04-02-2005,822698,West Bengal,9,11,6,17,43,Pass
Vivaan Singh,18-12-2004,790422,Punjab,9,4,16,1,30,Pass
Sukhwinder Verma,15-12-2004,475323,West Bengal,3,24,15,23,65,Pass
Aryan Verma,25-05-2005,106966,Assam,5,15,8,5,33,Pass
Raj Verma,28-10-2005,761133,Tamil Nadu,10,9,20,15,54,Pass
Yash Singh,27-04-2006,770549,Rajasthan,9,12,18,8,47,Pass
Vivaan Mehta,28-02-2005,886950,Maharashtra,13,4,21,11,49,Pass
Vivaan Fernandes,25-06-2005,998260,Tamil Nadu,20,2,14,2,38,Pass
Sukhwinder Verma,18-11-2004,480587,Punjab,10,8,16,17,51,Pass
Aryan Reddy,12-05-2005,511621,Tamil Nadu,16,24,6,16,62,Pass
Mathew Verma,03-08-2005,330139,Telangana,7,12,4,21,44,Pass
Rohan Fernandes,02-04-2006,900664,Bihar,0,14,14,4,32,Pass
Aryan Reddy,28-08-2005,650338,Andhra Pradesh,15,1,8,15,39,Pass
Kunal Singh,04-07-2005,587713,Haryana,4,15,7,9,35,Pass
Ishaan Khan,17-08-2005,857854,West Bengal,14,4,10,10,38,Pass
Rohan Sharma,17-03-2006,901208,Chhattisgarh,16,9,6,4,35,Pass
Aryan Singh,07-04-2006,956226,Telangana,23,18,10,14,65,Pass
Vivaan Khan,22-02-2006,604031,Bihar,11,11,4,15,41,Pass
Vivaan Chopra,21-06-2005,874933,Chhattisgarh,0,16,18,11,45,Pass
Aarav Sharma,06-09-2005,599393,West Bengal,5,13,22,13,53,Pass
Rohan D'Souza,25-03-2005,895058,Rajasthan,22,24,3,9,58,Pass
Paul Sharma,05-12-2004,713503,Rajasthan,13,4,5,19,41,Pass
Rohan D'Souza,05-10-2005,133580,Telangana,15,20,16,16,67,Pass
Aarav Mehta,02-10-2005,464083,Uttar Pradesh,4,1,2,6,13,Pass
Raj Pillai,19-12-2004,308091,Kerala,2,5,24,2,33,Pass
Aarav Pillai,11-10-2005,253524,Himachal Pradesh,5,1,20,1,27,Pass
Gurpreet Pillai,21-02-2006,758934,Tamil Nadu,18,22,19,14,73,Pass
Aditya Pillai,09-04-2006,248354,Rajasthan,8,14,18,3,43,Pass
Yash Chopra,29-05-2005,616868,Rajasthan,21,24,1,8,54,Pass
Aditya Fernandes,07-12-2005,669201,Rajasthan,3,3,17,11,34,Pass
Raj Khan,03-02-2006,919644,Jharkhand,4,16,0,2,22,Pass
Zaid Fernandes,12-02-2006,558476,Nagaland,7,17,0,15,39,Pass
Rohan Khan,27-07-2005,764119,Bihar,18,6,6,2,32,Pass
Krishna Pillai,20-02-2005,201139,Rajasthan,13,15,18,23,69,Pass
Krishna Sharma,10-08-2005,155053,Rajasthan,1,13,10,8,32,Pass
Krishna Sharma,21-03-2005,795312,West Bengal,12,16,22,2,52,Pass
Ayaan D'Souza,06-01-2005,247386,Rajasthan,23,5,1,13,42,Pass
Rohan Reddy,11-03-2006,806614,Jharkhand,10,19,8,0,37,Pass
Raj Pillai,24-04-2005,236331,Assam,5,3,13,13,34,Pass
Paul Verma,11-11-2004,311427,Maharashtra,11,4,5,21,41,Pass
Gurpreet Pillai,03-05-2005,750397,Tamil Nadu,13,9,19,7,48,Pass
Rohan Sharma,02-08-2005,151893,Rajasthan,17,17,18,16,68,Pass
Aarav Sharma,16-04-2006,473397,Rajasthan,19,8,2,23,52,Pass
Vivaan D'Souza,06-01-2006,532320,Rajasthan,16,16,6,11,49,Pass
Krishna Pillai,12-05-2005,431754,Mizoram,18,14,4,2,38,Pass
Yash Khan,21-11-2005,505962,Chhattisgarh,24,8,6,18,56,Pass
Aryan Chopra,16-11-2005,503866,Tamil Nadu,21,23,10,9,63,Pass
Aarav Verma,07-04-2005,406281,Uttar Pradesh,23,1,24,13,61,Pass
Gurpreet Verma,11-10-2005,879524,Uttarakhand,3,17,19,10,49,Pass
Gurpreet Verma,23-02-2005,628432,Jharkhand,14,16,6,21,57,Pass
Yash Chopra,26-12-2005,305898,Tamil Nadu,16,15,5,10,46,Pass
Ishaan Mehta,30-03-2006,123251,Gujarat,3,9,22,8,42,Pass
Gurpreet Singh,20-04-2005,787762,Uttarakhand,3,16,0,19,38,Pass
David Chopra,25-12-2004,366260,Maharashtra,5,6,13,10,34,Pass
Krishna Pillai,30-08-2005,161905,Uttar Pradesh,15,1,18,7,41,Pass
Gurpreet D'Souza,15-08-2005,899858,Gujarat,6,11,2,19,38,Pass
Peter Chopra,01-08-2005,828524,Tamil Nadu,21,23,3,15,62,Pass
Aryan Mehta,19-11-2005,938652,Uttar Pradesh,3,1,18,20,42,Pass
Yash Chopra,05-01-2005,922689,Odisha,0,24,7,11,42,Pass
Yash Pillai,26-06-2005,466406,Uttar Pradesh,24,1,2,22,49,Pass
Ishaan D'Souza,25-06-2005,956253,Chhattisgarh,1,14,18,1,34,Pass
Aryan Singh,18-12-2004,635600,Tamil Nadu,24,11,16,16,67,Pass
Sukhwinder D'Souza,05-11-2005,460851,Madhya Pradesh,18,3,21,4,46,Pass
Rohan Pillai,05-03-2006,401798,Punjab,10,23,0,2,35,Pass
Ishaan Pillai,30-07-2005,230049,Madhya Pradesh,6,20,11,4,41,Pass
Aarav D'Souza,28-02-2006,942603,Madhya Pradesh,19,12,11,9,51,Pass
Vivaan Reddy,30-05-2005,849017,West Bengal,10,19,2,5,36,Pass
Harjeet Reddy,17-10-2005,729475,Kerala,13,1,2,1,17,Pass
Raj Reddy,21-01-2005,519019,Bihar,9,20,11,9,49,Pass
Rohan Fernandes,05-07-2005,414229,West Bengal,24,5,15,9,53,Pass
Aryan Khan,11-11-2005,362757,Assam,7,9,13,7,36,Pass
Ishaan Sharma,16-11-2005,531813,Bihar,13,23,0,6,42,Pass
Aditya Fernandes,05-04-2005,418662,Assam,5,11,9,9,34,Pass
Rohan Chopra,06-04-2005,301885,Punjab,5,23,17,1,46,Pass
Aryan Chopra,09-02-2005,105454,Telangana,10,19,3,24,56,Pass
John Mehta,27-04-2006,468842,Assam,5,7,23,20,55,Pass
Yash Reddy,14-12-2005,891037,Uttar Pradesh,16,1,10,14,41,Pass
Vivaan D'Souza,29-04-2005,382066,Bihar,2,15,15,15,47,Pass
Raj Singh,21-09-2005,814108,Kerala,9,14,16,22,61,Pass
Aarav Pillai,13-05-2005,284288,Karnataka,14,18,16,12,60,Pass
Aditya Reddy,03-07-2005,940184,Maharashtra,19,4,17,4,44,Pass
Raj Reddy,15-08-2005,563152,Uttar Pradesh,6,1,7,15,29,Pass
Mathew Chopra,14-07-2005,129011,Haryana,12,21,19,5,57,Pass
Aditya Verma,02-10-2005,157707,Odisha,7,5,4,8,24,Pass
Rohan Sharma,23-05-2005,307592,Rajasthan,1,23,1,17,42,Pass
Krishna Fernandes,29-12-2005,165956,Andhra Pradesh,23,12,5,5,45,Pass
Kunal Mehta,09-11-2005,359745,Bihar,4,19,9,19,51,Pass
Aditya Sharma,09-02-2005,378430,Punjab,22,14,16,18,70,Pass
John Fernandes,22-11-2004,954744,Rajasthan,7,14,11,1,33,Pass
Harjeet Chopra,13-11-2005,823594,Uttar Pradesh,5,1,9,6,21,Pass
Krishna Fernandes,13-07-2005,546083,Maharashtra,20,4,11,24,59,Pass
Ishaan Chopra,24-03-2006,578316,Uttar Pradesh,11,1,2,22,36,Pass
Rehan Chopra,05-04-2006,148238,Chhattisgarh,19,0,11,13,43,Pass
Aditya Sharma,15-03-2005,129822,Odisha,1,2,13,21,37,Pass
Mathew Reddy,16-02-2006,920513,West Bengal,3,22,6,23,54,Pass
Yash Pillai,05-09-2005,852588,Assam,5,5,17,13,40,Pass
Gurpreet Pillai,27-06-2005,399331,Telangana,9,11,21,16,57,Pass
Kunal Fernandes,29-04-2005,981922,Gujarat,14,18,3,21,56,Pass
Aryan Chopra,24-11-2004,429147,Maharashtra,17,9,11,12,49,Pass
David Pillai,10-07-2005,629351,Gujarat,8,3,1,23,35,Pass
Aryan Fernandes,28-12-2005,933630,Tamil Nadu,7,24,18,5,54,Pass
Aarav Sharma,28-09-2005,867197,Uttar Pradesh,20,1,16,2,39,Pass
Gurpreet Mehta,05-11-2005,285939,Maharashtra,24,4,16,10,54,Pass
Krishna Khan,25-05-2005,661166,Maharashtra,1,21,0,13,35,Pass
Mathew Fernandes,26-10-2005,749913,Rajasthan,21,21,23,23,88,Pass
Aarav Reddy,13-12-2004,390106,Tamil Nadu,6,13,22,16,57,Pass
Aditya Singh,28-02-2005,255451,Assam,5,8,11,13,37,Pass
Vivaan Reddy,07-04-2005,163165,Uttar Pradesh,3,1,17,15,36,Pass
Aditya Chopra,03-08-2005,793826,Telangana,9,18,12,18,57,Pass
Yash Fernandes,04-03-2005,104942,Delhi,5,21,9,5,40,Pass
Raj Singh,02-07-2005,422188,Rajasthan,15,0,19,0,34,Pass
Aditya Khan,04-01-2006,188110,Jharkhand,13,6,14,12,45,Pass
Aditya Singh,05-12-2004,294232,Gujarat,14,0,6,8,28,Pass
Rohan Singh,28-01-2006,732192,Chhattisgarh,19,4,23,3,49,Pass
Krishna Chopra,25-04-2006,725066,West Bengal,3,23,1,15,42,Pass
Mathew Verma,20-06-2005,319754,West Bengal,3,9,18,21,51,Pass
Ishaan Mehta,06-11-2005,877142,Odisha,5,1,6,19,31,Pass
Krishna Chopra,09-08-2005,617662,Rajasthan,9,10,14,23,56,Pass
Ishaan Fernandes,12-02-2005,259635,Rajasthan,1,19,13,18,51,Pass
Balbir Sharma,09-06-2005,656250,Uttar Pradesh,20,1,9,0,30,Pass
Ishaan Fernandes,14-10-2005,525170,Assam,20,9,2,16,47,Pass
Vivaan Verma,26-04-2005,646044,Haryana,18,13,2,10,43,Pass
Rohan Pillai,08-09-2005,627858,Punjab,13,14,0,22,49,Pass
Balbir Fernandes,20-03-2006,911475,Gujarat,9,1,16,3,29,Pass
Raj Verma,20-12-2004,619986,Kerala,0,18,19,24,61,Pass
Aryan Chopra,29-08-2005,964794,Gujarat,6,3,20,0,29,Pass
Imran Sharma,05-05-2006,974434,Odisha,5,7,18,7,37,Pass
Rohan Sharma,24-04-2006,983125,West Bengal,3,21,10,11,45,Pass
Kunal Fernandes,27-05-2005,764118,Uttar Pradesh,0,1,0,19,20,Pass
Ishaan Fernandes,23-09-2005,850046,Odisha,11,4,14,11,40,Pass
Kunal Pillai,10-02-2005,651013,Uttarakhand,3,16,11,11,41,Pass
Vivaan Pillai,22-07-2005,857302,Kerala,5,5,5,5,20,Pass
Aarav Chopra,24-08-2005,196414,Tripura,23,10,18,3,54,Pass
Yash Chopra,02-08-2005,720265,Maharashtra,23,4,7,19,53,Pass
Kunal Khan,24-03-2005,298595,Haryana,23,7,5,20,55,Pass
Vivaan Verma,06-03-2006,180961,Bihar,3,5,20,22,50,Pass
Raj Mehta,04-02-2005,258416,Madhya Pradesh,19,10,14,5,48,Pass
Ishaan Mehta,12-11-2004,273054,Bihar,3,15,15,13,46,Pass
Aryan Mehta,03-02-2005,732448,Uttar Pradesh,14,1,16,0,31,Pass
Rehan Singh,02-01-2005,138245,Rajasthan,23,15,21,24,83,Pass
Aditya Fernandes,26-09-2005,546946,Tamil Nadu,24,24,1,17,66,Pass
Imran Reddy,26-09-2005,430058,Punjab,3,3,16,23,45,Pass
Vivaan Pillai,12-08-2005,220255,Madhya Pradesh,2,3,21,11,37,Pass
Kunal Singh,09-02-2005,173248,Uttarakhand,13,12,1,22,48,Pass
Kunal Chopra,25-06-2005,941434,Rajasthan,15,23,8,12,58,Pass
Rohan D'Souza,02-02-2006,346196,Tamil Nadu,11,7,10,24,52,Pass
David Verma,22-11-2005,387134,Andhra Pradesh,9,1,16,2,28,Pass
Raj Singh,24-08-2005,229724,West Bengal,16,0,23,13,52,Pass
Sukhwinder Mehta,01-12-2005,377164,Uttar Pradesh,14,1,10,18,43,Pass
Kunal Mehta,27-02-2006,783795,Jammu & Kashmir + Ladakh,15,11,18,8,52,Pass
Harjeet D'Souza,19-06-2005,222560,Andhra Pradesh,17,14,2,18,51,Pass
Aryan Sharma,04-09-2005,825650,Assam,1,6,8,18,33,Pass
Raj Mehta,16-11-2005,245528,Maharashtra,21,0,2,18,41,Pass
Rohan D'Souza,25-06-2005,220553,Mizoram,23,4,6,6,39,Pass
Aditya Pillai,30-04-2005,292007,Andhra Pradesh,7,24,1,8,40,Pass
Mathew Reddy,20-04-2005,787145,Uttar Pradesh,10,1,4,19,34,Pass
Rohan Singh,03-12-2004,634093,Uttar Pradesh,13,1,13,22,49,Pass
Aarav Fernandes,27-09-2005,821851,Bihar,20,11,23,1,55,Pass
Vivaan Sharma,18-02-2005,586003,Uttar Pradesh,10,1,9,3,23,Pass
John Fernandes,07-03-2005,477135,Gujarat,19,17,0,15,51,Pass
Raj Sharma,14-10-2005,381889,Maharashtra,23,4,11,11,49,Pass
Peter Pillai,12-10-2005,219114,Haryana,9,11,15,16,51,Pass
Kunal Reddy,05-09-2005,779374,Maharashtra,17,4,18,15,54,Pass
Krishna Chopra,09-02-2006,715973,Uttar Pradesh,11,1,22,16,50,Pass
Krishna Pillai,27-04-2005,961992,Karnataka,23,22,4,11,60,Pass
Kunal Khan,04-03-2006,757640,Rajasthan,15,22,19,15,71,Pass
Balbir Khan,23-03-2006,357039,Uttar Pradesh,11,1,18,8,38,Pass
Ishaan Pillai,20-10-2005,608444,Andhra Pradesh,3,13,16,20,52,Pass
John Sharma,13-11-2005,900273,Kerala,4,13,14,3,34,Pass
Aarav Verma,04-02-2005,630251,Bihar,20,4,4,5,33,Pass
Kunal Sharma,14-12-2004,288804,West Bengal,3,15,5,24,47,Pass
Aditya Fernandes,31-03-2006,919005,Rajasthan,21,13,16,17,67,Pass
Raj Chopra,08-03-2005,194115,Kerala,16,11,10,15,52,Pass
Yash D'Souza,04-05-2006,418270,Tamil Nadu,6,24,21,4,55,Pass
Raj D'Souza,03-11-2005,827194,Maharashtra,14,4,2,10,30,Pass
Imran Singh,09-04-2005,137960,Kerala,15,19,16,15,65,Pass
Krishna D'Souza,05-04-2006,316777,Bihar,20,4,12,23,59,Pass
Paul Singh,03-09-2005,434402,Gujarat,1,15,16,12,44,Pass
Ishaan D'Souza,09-07-2005,965735,Andhra Pradesh,4,8,16,3,31,Pass
Raj Reddy,26-07-2005,429838,West Bengal,16,9,1,23,49,Pass
Krishna Mehta,15-04-2005,868690,Chhattisgarh,14,7,10,21,52,Pass
Krishna Singh,12-03-2005,944904,Andhra Pradesh,20,4,14,13,51,Pass
Kunal Verma,07-04-2005,420025,Telangana,11,24,11,7,53,Pass
Aarav Fernandes,05-04-2005,259591,Gujarat,24,1,4,21,50,Pass
Imran Fernandes,04-02-2006,991208,Punjab,11,22,22,7,62,Pass
Aditya Reddy,31-07-2005,213095,Karnataka,10,8,2,18,38,Pass
Rohan Mehta,19-02-2005,812301,Uttar Pradesh,3,1,24,22,50,Pass
Balbir Pillai,17-05-2005,690855,Uttar Pradesh,19,1,9,21,50,Pass
Aditya Chopra,09-07-2005,206256,Punjab,18,2,15,20,55,Pass
Yash Chopra,04-11-2005,597300,Telangana,5,16,7,10,38,Pass
Rohan Singh,21-08-2005,521677,Andhra Pradesh,15,21,11,8,55,Pass
Vivaan Singh,07-02-2006,713611,Uttar Pradesh,13,1,4,2,20,Pass
Aryan Sharma,06-01-2005,746532,Maharashtra,7,7,17,5,36,Pass
Rehan Sharma,17-11-2005,966682,Uttar Pradesh,21,1,0,11,33,Pass
Ishaan Fernandes,25-02-2005,116986,Punjab,12,3,13,4,32,Pass
Kunal Singh,19-02-2006,641181,Karnataka,18,15,9,21,63,Pass
Krishna Khan,14-02-2005,182544,Himachal Pradesh,6,23,19,15,63,Pass
Kunal Khan,14-08-2005,196953,Bihar,19,8,1,17,45,Pass
Vivaan Khan,24-07-2005,268303,Gujarat,14,0,4,0,18,Pass
Raj D'Souza,25-02-2006,580432,Jharkhand,21,3,9,12,45,Pass
Kunal Mehta,26-12-2005,386339,Rajasthan,12,11,7,21,51,Pass
Kunal Chopra,09-03-2005,355708,Bihar,17,2,11,0,30,Pass
Ishaan Mehta,19-05-2005,371377,Daman & Diu / D&N Haveli,6,1,8,5,20,Pass
Manpreet Fernandes,12-12-2005,555949,Bihar,19,21,15,16,71,Pass
Aditya Fernandes,29-07-2005,751721,Tamil Nadu,9,5,13,1,28,Pass
Kunal Chopra,20-02-2005,403959,Uttar Pradesh,10,1,8,13,32,Pass
Rohan Chopra,01-12-2005,108586,Uttar Pradesh,4,1,20,17,42,Pass
Rehan Reddy,12-03-2006,681191,Himachal Pradesh,15,24,19,8,66,Pass
Aryan Mehta,04-11-2005,160776,Andhra Pradesh,16,9,13,0,38,Pass
Rohan Chopra,19-02-2006,818433,Madhya Pradesh,20,23,1,7,51,Pass
Krishna Sharma,18-01-2005,148038,Haryana,16,14,1,21,52,Pass
Farhan D'Souza,26-08-2005,332337,Jammu & Kashmir + Ladakh,21,4,15,11,51,Pass
Rohan Sharma,02-08-2005,697432,Chhattisgarh,9,9,4,16,38,Pass
Raj Verma,25-04-2005,979453,Haryana,6,3,24,9,42,Pass
David Mehta,08-08-2005,313391,Telangana,14,5,20,10,49,Pass
Vivaan Khan,06-11-2005,468619,Telangana,16,18,6,24,64,Pass
Vivaan Fernandes,29-12-2005,762869,Bihar,8,0,0,12,20,Pass
Aditya Khan,06-08-2005,943716,Haryana,12,22,14,20,68,Pass
Krishna Sharma,21-06-2005,389757,Tamil Nadu,9,7,5,21,42,Pass
Sukhwinder Verma,29-03-2006,695244,Madhya Pradesh,22,23,19,4,68,Pass
Imran Reddy,03-01-2005,999907,Punjab,23,12,22,12,69,Pass
John D'Souza,15-04-2005,792511,Uttar Pradesh,11,1,15,11,38,Pass
Kunal Sharma,14-08-2005,322511,Maharashtra,17,4,17,17,55,Pass
Paul Verma,09-05-2005,607444,Tamil Nadu,6,17,20,0,43,Pass
Aarav Pillai,15-03-2006,829641,Punjab,11,20,4,19,54,Pass
Aarav Pillai,15-06-2005,240655,Uttar Pradesh,15,1,17,24,57,Pass
Krishna Verma,17-04-2006,429377,Bihar,21,18,15,11,65,Pass
Yash Reddy,27-12-2004,377783,Bihar,0,20,0,4,24,Pass
Raj Khan,11-04-2005,941857,Tamil Nadu,3,7,13,10,33,Pass
Raj Reddy,12-11-2004,227602,Bihar,19,9,23,21,72,Pass
Ishaan Sharma,07-06-2005,721787,Madhya Pradesh,21,9,8,4,42,Pass
Rohan Sharma,20-08-2005,269652,Bihar,5,11,15,0,31,Pass
Kunal Verma,26-10-2005,704441,Delhi,3,17,0,3,23,Pass
Harjeet Singh,09-03-2006,438892,Punjab,19,12,12,21,64,Pass
Vivaan Singh,31-10-2005,268379,Punjab,0,22,22,6,50,Pass
Rohan Mehta,06-06-2005,472244,Punjab,20,21,13,13,67,Pass
Vivaan Chopra,21-11-2004,404921,Bihar,6,18,22,22,68,Pass
John Chopra,16-07-2005,117696,Kerala,5,12,23,1,41,Pass
Paul D'Souza,01-08-2005,929462,Maharashtra,20,22,4,2,48,Pass
Aryan Reddy,01-02-2006,400535,Madhya Pradesh,17,16,22,4,59,Pass
Vivaan Singh,22-05-2005,431999,Uttar Pradesh,2,1,14,17,34,Pass
Kunal Singh,18-05-2005,117359,Punjab,13,11,6,5,35,Pass
Kunal Singh,08-11-2004,514200,Uttar Pradesh,18,1,23,8,50,Pass
Sukhwinder Khan,14-06-2005,952272,Karnataka,7,3,9,13,32,Pass
Aditya Verma,10-02-2006,506024,Haryana,4,8,17,14,43,Pass
Aryan Verma,25-05-2005,294900,Meghalaya,20,20,4,8,52,Pass
Aryan Singh,29-10-2005,858125,Maharashtra,19,7,0,3,29,Pass
Yash Chopra,09-04-2005,596707,Gujarat,23,20,10,17,70,Pass
Raj Reddy,02-04-2005,524583,Rajasthan,13,4,2,3,22,Pass
Ishaan Singh,16-04-2005,902686,Kerala,21,10,5,17,53,Pass
Krishna Mehta,22-09-2005,924580,West Bengal,0,21,12,0,33,Pass
Yash Reddy,15-04-2006,482245,Bihar,16,14,12,8,50,Pass
Rohan Chopra,18-02-2005,670165,Chhattisgarh,2,9,24,13,48,Pass
Aryan Pillai,07-03-2005,348235,Uttar Pradesh,3,1,17,22,43,Pass
Aryan Singh,23-07-2005,905277,Maharashtra,24,4,16,21,65,Pass
Aarav Mehta,30-06-2005,338249,Haryana,0,20,4,16,40,Pass
Krishna D'Souza,29-06-2005,171099,Uttar Pradesh,9,1,24,20,54,Pass
Farhan Verma,07-11-2005,828493,Rajasthan,7,12,16,8,43,Pass
Aryan Sharma,31-03-2006,679241,Madhya Pradesh,16,8,21,4,49,Pass
Ishaan Pillai,20-11-2005,646274,Maharashtra,3,15,22,6,46,Pass
Zaid Sharma,10-01-2005,969797,Madhya Pradesh,5,2,21,0,28,Pass
Ishaan Reddy,17-02-2006,285854,Rajasthan,7,15,7,3,32,Pass
Aditya Chopra,18-12-2004,988419,Maharashtra,19,5,23,0,47,Pass
Yash D'Souza,13-03-2005,748231,Bihar,7,8,18,14,47,Pass
Aditya Sharma,11-11-2005,174468,Maharashtra,12,4,21,1,38,Pass
Harjeet Fernandes,29-11-2005,944663,Uttar Pradesh,24,1,19,4,48,Pass
Aditya Reddy,30-04-2006,358800,Rajasthan,5,24,7,3,39,Pass
Krishna Fernandes,10-11-2005,819693,Tamil Nadu,18,20,12,5,55,Pass
Ishaan D'Souza,05-02-2005,311733,Rajasthan,17,11,8,7,43,Pass
Aryan D'Souza,04-11-2005,871314,Punjab,1,23,23,20,67,Pass
Aarav Mehta,14-12-2004,923691,Assam,11,21,8,3,43,Pass
Rohan Mehta,14-02-2005,242067,Tamil Nadu,9,16,2,19,46,Pass
Balbir Chopra,23-02-2005,679866,Madhya Pradesh,19,15,4,4,42,Pass
Rohan Singh,17-03-2006,248418,Sikkim,5,12,2,15,34,Pass
Aditya D'Souza,22-11-2004,267868,Tamil Nadu,23,10,3,12,48,Pass
Vivaan Fernandes,15-06-2005,344678,West Bengal,12,12,7,12,43,Pass
Rohan Verma,06-03-2006,748828,Jharkhand,14,1,1,16,32,Pass
Ishaan Khan,21-06-2005,665867,Uttar Pradesh,8,1,19,6,34,Pass
Rohan Singh,18-02-2006,389683,Maharashtra,14,1,3,11,29,Pass
Aryan Verma,06-08-2005,593533,Jammu & Kashmir + Ladakh,19,11,20,2,52,Pass
Harjeet Pillai,29-09-2005,942190,Rajasthan,20,2,1,12,35,Pass
Kunal Khan,08-07-2005,166932,Bihar,15,19,5,7,46,Pass
Krishna Pillai,19-07-2005,381328,Bihar,23,14,11,2,50,Pass
Rohan Mehta,13-01-2006,473721,Andhra Pradesh,6,16,18,12,52,Pass
Kunal D'Souza,21-02-2005,268642,Haryana,2,20,6,11,39,Pass
Aditya Pillai,17-08-2005,925765,Telangana,10,21,3,2,36,Pass
Yash Singh,22-12-2004,191615,Andhra Pradesh,18,22,2,21,63,Pass
Aarav Sharma,13-02-2005,765606,Gujarat,23,22,14,3,62,Pass
Krishna Mehta,26-10-2005,376959,Gujarat,23,24,3,11,61,Pass
Balbir Verma,18-12-2005,636639,Haryana,9,9,18,8,44,Pass
Ishaan Chopra,13-01-2005,798081,Punjab,2,17,8,19,46,Pass
Krishna Khan,03-07-2005,157626,Chhattisgarh,13,1,10,7,31,Pass
Aditya Chopra,27-07-2005,722332,Tamil Nadu,24,15,2,10,51,Pass
Raj D'Souza,28-06-2005,780492,Madhya Pradesh,6,21,8,12,47,Pass
Ishaan Mehta,08-04-2006,776591,Maharashtra,7,16,10,16,49,Pass
Krishna Chopra,28-11-2005,728246,Uttar Pradesh,24,1,0,5,30,Pass
Aryan Mehta,06-11-2005,687761,Uttar Pradesh,20,1,24,5,50,Pass
Aarav Fernandes,04-04-2005,811968,Maharashtra,23,4,12,8,47,Pass
Zaid Sharma,25-03-2006,569132,Maharashtra,11,4,19,8,42,Pass
Raj Fernandes,26-03-2006,129417,Rajasthan,4,8,7,18,37,Pass
Sukhwinder Sharma,11-08-2005,277939,Andhra Pradesh,24,5,13,20,62,Pass
Harjeet D'Souza,03-03-2006,827790,Punjab,4,1,15,4,24,Pass
Ishaan Fernandes,10-12-2005,209939,Uttar Pradesh,13,1,23,11,48,Pass
John Verma,25-03-2006,707714,Uttar Pradesh,18,1,14,4,37,Pass
John Verma,23-03-2006,835185,Tamil Nadu,2,3,4,19,28,Pass
Ishaan Chopra,12-01-2005,501180,Madhya Pradesh,15,9,13,12,49,Pass
Vivaan Pillai,05-06-2005,304765,West Bengal,3,21,21,17,62,Pass
Gurpreet Khan,09-07-2005,927505,Bihar,17,9,9,12,47,Pass
Aryan Pillai,03-02-2006,156704,Karnataka,16,7,22,6,51,Pass
Aryan Fernandes,01-06-2005,386167,Bihar,6,8,18,2,34,Pass
Ishaan Verma,08-04-2005,623358,Bihar,14,17,15,18,64,Pass
Paul D'Souza,22-02-2006,191844,Delhi,9,4,16,22,51,Pass
Farhan Chopra,10-09-2005,653788,Madhya Pradesh,5,6,18,8,37,Pass
David Reddy,27-10-2005,153714,West Bengal,3,4,23,16,46,Pass
Kunal Mehta,08-11-2005,433082,Gujarat,18,15,12,12,57,Pass
John Chopra,14-11-2004,572471,Rajasthan,23,0,16,12,51,Pass
Krishna Sharma,18-03-2006,503778,Haryana,9,4,17,10,40,Pass
Kunal Pillai,15-02-2006,333201,Rajasthan,6,24,21,21,72,Pass
Vivaan Sharma,05-04-2006,680529,Assam,13,7,23,15,58,Pass
Krishna Reddy,19-09-2005,379379,Andhra Pradesh,21,20,16,17,74,Pass
Ishaan Verma,10-03-2006,962604,Haryana,1,11,2,8,22,Pass
Gurpreet Singh,23-11-2005,779629,Tamil Nadu,20,9,8,13,50,Pass
Aryan Verma,31-03-2006,934145,Tamil Nadu,5,11,3,17,36,Pass
Aditya Verma,14-03-2006,242343,Madhya Pradesh,7,10,18,0,35,Pass
Ishaan Mehta,09-02-2005,532527,Jammu & Kashmir + Ladakh,2,14,7,19,42,Pass
Ishaan Pillai,18-03-2005,531738,Chhattisgarh,22,17,9,9,57,Pass
Manpreet D'Souza,25-03-2006,987495,Assam,6,6,11,15,38,Pass
Paul Reddy,29-06-2005,556250,Jammu & Kashmir + Ladakh,5,3,18,12,38,Pass
Ishaan Mehta,31-08-2005,428699,Puducherry,12,9,2,8,31,Pass
David Reddy,20-09-2005,880262,Bihar,11,14,8,1,34,Pass
Aarav Chopra,01-06-2005,597511,Maharashtra,10,12,3,23,48,Pass
Krishna Fernandes,12-01-2006,350898,Karnataka,10,9,12,24,55,Pass
Peter Fernandes,27-02-2005,548665,Tamil Nadu,15,7,8,4,34,Pass
Ishaan Singh,20-11-2004,276487,Madhya Pradesh,17,2,20,11,50,Pass
Balbir D'Souza,17-01-2006,157447,Odisha,3,22,0,4,29,Pass
Yash Verma,21-11-2005,821980,Maharashtra,3,4,13,22,42,Pass
Aditya Sharma,10-12-2005,682161,Telangana,19,16,16,6,57,Pass
Harjeet Sharma,02-04-2005,539897,Chhattisgarh,14,13,15,7,49,Pass
Krishna Mehta,15-08-2005,585911,Gujarat,18,3,1,14,36,Pass
Yash Verma,19-05-2005,506814,Chhattisgarh,23,3,21,8,55,Pass
Vivaan Verma,26-04-2005,983310,Jharkhand,6,22,14,7,49,Pass
Paul Verma,15-09-2005,989836,Bihar,12,19,17,13,61,Pass
Krishna Chopra,20-04-2005,376458,Madhya Pradesh,4,14,20,10,48,Pass
Yash Khan,07-12-2004,526074,Bihar,9,16,12,15,52,Pass
Aarav Verma,17-09-2005,531102,Chhattisgarh,3,10,23,23,59,Pass
Sukhwinder Khan,07-12-2004,652960,Uttar Pradesh,15,1,18,9,43,Pass
Raj Singh,08-12-2005,633956,West Bengal,18,2,12,8,40,Pass
Aarav Singh,08-01-2005,172435,Bihar,18,6,17,1,42,Pass
Aditya Mehta,27-11-2005,466564,Telangana,12,7,6,9,34,Pass
Paul Fernandes,09-08-2005,277109,Jharkhand,3,19,0,18,40,Pass
Aditya Reddy,22-08-2005,536288,Madhya Pradesh,6,16,4,23,49,Pass
Krishna Khan,27-10-2005,442126,Rajasthan,19,14,16,24,73,Pass
Kunal Chopra,11-11-2004,402735,Uttar Pradesh,18,1,10,4,33,Pass
Aarav Fernandes,21-01-2005,314736,Madhya Pradesh,0,2,7,16,25,Pass
Aarav Chopra,16-11-2005,132563,Bihar,23,15,12,12,62,Pass
Rehan D'Souza,02-02-2006,717242,Bihar,9,3,21,6,39,Pass
Ishaan Fernandes,20-12-2005,748686,Bihar,14,20,11,17,62,Pass
Aarav Pillai,17-11-2005,799096,Odisha,6,12,5,12,35,Pass
Vivaan Singh,03-11-2005,718361,Maharashtra,24,4,15,21,64,Pass
Raj Mehta,15-02-2006,552449,Gujarat,0,23,21,14,58,Pass
Peter Mehta,17-01-2005,872572,Delhi,5,11,16,4,36,Pass
Manpreet Mehta,06-01-2005,347121,Bihar,2,6,6,24,38,Pass
Rehan Khan,15-01-2005,326611,Kerala,15,15,4,2,36,Pass
Gurpreet Mehta,09-01-2005,218736,Assam,6,22,3,4,35,Pass
Vivaan Pillai,03-08-2005,491845,Madhya Pradesh,17,7,7,16,47,Pass
Sukhwinder Verma,02-10-2005,574687,Himachal Pradesh,1,0,24,19,44,Pass
Aryan Sharma,09-04-2006,342752,Karnataka,16,3,15,14,48,Pass
Aditya Verma,13-02-2006,213774,Tamil Nadu,6,23,14,5,48,Pass
Aarav Verma,20-02-2006,150505,Bihar,19,0,4,7,30,Pass
Manpreet Fernandes,23-12-2005,353993,Madhya Pradesh,11,11,19,10,51,Pass
Peter Khan,30-10-2005,794268,Uttarakhand,3,10,24,23,60,Pass
Krishna Verma,01-01-2006,993823,Karnataka,12,10,7,16,45,Pass
Kunal Singh,08-11-2005,738400,Odisha,15,14,15,2,46,Pass
John Chopra,06-01-2005,369371,Karnataka,7,0,24,0,31,Pass
Balbir Reddy,10-12-2005,754387,Madhya Pradesh,24,5,11,4,44,Pass
Harjeet Khan,13-10-2005,594228,Uttar Pradesh,4,1,0,0,5,Pass
Aditya Sharma,25-02-2005,608295,Madhya Pradesh,10,9,18,8,45,Pass
Kunal Singh,29-01-2005,592217,Punjab,22,16,7,20,65,Pass
Vivaan Verma,25-11-2005,969240,Jharkhand,8,3,0,9,20,Pass
Peter Singh,27-09-2005,208640,Haryana,1,11,11,18,41,Pass
Aarav Chopra,30-06-2005,165352,Bihar,0,14,24,15,53,Pass
Rehan Khan,02-01-2006,198094,Andhra Pradesh,4,12,19,0,35,Pass
David Reddy,30-04-2006,934802,Odisha,5,22,12,16,55,Pass
Harjeet Reddy,02-05-2005,182675,Assam,14,1,6,15,36,Pass
Raj Fernandes,05-03-2006,975104,Himachal Pradesh,6,23,16,11,56,Pass
Harjeet Pillai,22-02-2006,676033,Andhra Pradesh,16,8,22,5,51,Pass
Rohan Reddy,23-05-2005,474716,Gujarat,20,10,22,15,67,Pass
Aarav D'Souza,21-08-2005,323659,Karnataka,10,17,8,7,42,Pass
Aryan Fernandes,21-07-2005,123932,Assam,8,0,17,20,45,Pass
Yash Mehta,01-05-2006,498812,Madhya Pradesh,1,14,10,13,38,Pass
Paul Pillai,14-11-2005,140847,Gujarat,15,8,9,12,44,Pass
Krishna Pillai,03-01-2005,183522,Madhya Pradesh,1,1,5,10,17,Pass
John Singh,05-01-2005,945125,Uttar Pradesh,3,1,2,9,15,Pass
Gurpreet Reddy,23-12-2004,968150,Bihar,15,23,5,23,66,Pass
Rohan Khan,23-12-2005,248508,Maharashtra,12,3,14,11,40,Pass
Aarav Reddy,02-11-2005,584688,Bihar,5,20,6,23,54,Pass
Balbir Chopra,29-09-2005,464039,Andhra Pradesh,13,15,16,8,52,Pass
Kunal Singh,17-07-2005,401909,Haryana,0,11,19,0,30,Pass
Ishaan Verma,02-05-2006,469913,Rajasthan,10,13,1,9,33,Pass
Manpreet Khan,31-03-2006,403681,Uttarakhand,3,24,6,19,52,Pass
Vivaan Sharma,30-11-2005,215582,Uttarakhand,10,19,8,5,42,Pass
Krishna Pillai,15-04-2005,246681,Uttarakhand,8,8,10,0,26,Pass
Vivaan Fernandes,21-09-2005,972629,West Bengal,4,2,15,12,33,Pass
Ishaan Verma,21-11-2004,868461,Uttar Pradesh,23,1,2,7,33,Pass
Kunal D'Souza,03-01-2006,746390,Uttar Pradesh,14,1,19,2,36,Pass
Rohan Sharma,03-03-2005,177973,Chhattisgarh,22,6,7,13,48,Pass
Harjeet Mehta,18-03-2006,838713,Uttar Pradesh,1,1,1,11,14,Pass
Rohan Chopra,23-11-2004,844883,Karnataka,23,10,14,12,59,Pass
Rohan D'Souza,20-02-2005,787387,Maharashtra,3,19,19,8,49,Pass
Aarav Chopra,07-02-2006,484192,Jammu & Kashmir + Ladakh,4,13,16,12,45,Pass
Aditya Chopra,22-09-2005,608424,Punjab,2,8,7,19,36,Pass
Krishna Fernandes,22-04-2005,593921,Odisha,24,0,5,17,46,Pass
Krishna Pillai,18-01-2006,986540,Madhya Pradesh,22,13,0,3,38,Pass
Kunal D'Souza,06-03-2006,176107,Punjab,19,0,12,8,39,Pass
Kunal Khan,11-08-2005,744914,Karnataka,12,10,16,13,51,Pass
Mathew Fernandes,05-12-2005,564791,Gujarat,8,11,5,23,47,Pass
Aditya Mehta,23-09-2005,397950,Maharashtra,18,10,2,7,37,Pass
Aryan Fernandes,07-03-2005,565802,Uttar Pradesh,2,1,6,14,23,Pass
Aditya Chopra,30-06-2005,732724,Bihar,8,0,18,16,42,Pass
Yash Chopra,12-06-2005,345108,Bihar,2,8,15,23,48,Pass
Imran Verma,24-07-2005,232915,Bihar,19,7,17,9,52,Pass
Gurpreet Pillai,12-04-2005,538332,Andhra Pradesh,11,2,7,12,32,Pass
Yash Chopra,12-01-2005,287996,Andhra Pradesh,24,19,17,18,78,Pass
Aarav Verma,14-01-2005,244276,Jammu & Kashmir + Ladakh,1,6,6,13,26,Pass
Manpreet Verma,25-11-2004,885998,Haryana,17,9,1,9,36,Pass
Peter Sharma,20-02-2005,407427,West Bengal,1,4,16,10,31,Pass
Aryan Sharma,27-04-2006,454676,West Bengal,14,18,3,1,36,Pass
Gurpreet Verma,27-02-2006,737917,Uttar Pradesh,21,1,1,19,42,Pass
Kunal Mehta,19-01-2006,791030,Maharashtra,0,23,7,6,36,Pass
Aditya Chopra,10-11-2004,868043,Bihar,13,15,8,0,36,Pass
David Pillai,11-12-2005,376758,Bihar,10,1,9,13,33,Pass
Kunal Mehta,30-01-2006,775127,Madhya Pradesh,19,20,9,1,49,Pass
Raj Verma,09-09-2005,155726,Bihar,0,22,16,3,41,Pass
John Khan,03-02-2006,802747,Telangana,8,4,17,9,38,Pass
Aditya Verma,13-04-2006,334817,Bihar,7,11,2,6,26,Pass
Peter Fernandes,13-02-2006,959146,Tripura,19,20,3,13,55,Pass
Aditya Singh,31-08-2005,327174,Telangana,17,17,3,6,43,Pass
Krishna Verma,15-06-2005,586110,Tamil Nadu,2,2,20,15,39,Pass
David Fernandes,19-11-2004,647553,Arunachal Pradesh,20,6,9,14,49,Pass
Aarav Singh,12-11-2004,926970,West Bengal,19,7,9,6,41,Pass
Rohan Pillai,11-11-2004,327415,Bihar,22,1,18,24,65,Pass
Mathew Mehta,08-04-2006,609457,Uttar Pradesh,3,1,6,2,12,Pass
Mathew Mehta,08-04-2005,666465,Nagaland,2,3,19,8,32,Pass
Aarav Pillai,28-10-2005,148623,West Bengal,1,21,21,6,49,Pass
Vivaan Mehta,27-11-2005,119893,Uttar Pradesh,13,1,11,14,39,Pass
Gurpreet Singh,06-01-2005,485447,Uttar Pradesh,10,1,7,19,37,Pass
Balbir Mehta,01-03-2006,562580,Madhya Pradesh,0,14,17,1,32,Pass
Aarav Verma,05-12-2004,964335,Meghalaya,7,19,9,23,58,Pass
Aditya D'Souza,01-09-2005,847711,Uttarakhand,3,24,15,23,65,Pass
Rohan Chopra,25-04-2006,945794,Telangana,9,22,16,10,57,Pass
Aarav Reddy,25-12-2004,109396,Delhi,8,19,6,8,41,Pass
Raj D'Souza,24-01-2005,159406,Telangana,20,5,8,17,50,Pass
Harjeet Chopra,12-07-2005,278099,Rajasthan,0,6,10,1,17,Pass
Mathew Fernandes,12-03-2005,617108,Andhra Pradesh,17,22,12,6,57,Pass
Raj Mehta,28-02-2006,185143,Uttar Pradesh,18,1,23,13,55,Pass
Raj Reddy,30-11-2005,936399,West Bengal,3,6,22,15,46,Pass
Imran Verma,18-04-2006,327813,Maharashtra,7,1,11,20,39,Pass
Kunal Mehta,01-05-2005,916588,Bihar,2,21,20,19,62,Pass
Sukhwinder Verma,27-12-2004,829479,Punjab,16,10,15,11,52,Pass
Manpreet Khan,09-04-2006,708611,Punjab,15,21,20,23,79,Pass
Vivaan D'Souza,10-12-2005,622012,Manipur,9,3,2,17,31,Pass
Paul Fernandes,21-01-2006,291500,Andhra Pradesh,19,1,11,11,42,Pass
Aditya D'Souza,06-12-2004,158978,Maharashtra,7,6,1,14,28,Pass
Peter Singh,04-05-2006,862829,Gujarat,16,18,18,22,74,Pass
Ayaan Reddy,06-09-2005,425380,Andhra Pradesh,21,6,0,18,45,Pass
Aditya Khan,27-05-2005,336560,Maharashtra,18,4,13,7,42,Pass
Raj Chopra,02-04-2005,487689,Jharkhand,3,12,23,16,54,Pass
Raj Pillai,23-09-2005,304110,Punjab,18,5,4,5,32,Pass
Raj Mehta,01-02-2006,123283,Uttar Pradesh,13,1,10,23,47,Pass
Raj Verma,26-06-2005,625859,Madhya Pradesh,5,23,7,11,46,Pass
Balbir Khan,31-08-2005,342754,Haryana,2,21,19,8,50,Pass
Yash Sharma,09-04-2005,402307,Bihar,10,8,13,19,50,Pass
Paul Pillai,01-03-2005,660339,Maharashtra,21,4,22,7,54,Pass
Raj Reddy,24-01-2006,989995,Punjab,18,4,2,21,45,Pass
Krishna Chopra,15-10-2005,909572,Maharashtra,24,4,21,19,68,Pass
Raj Singh,12-09-2005,516498,Bihar,6,3,13,6,28,Pass
Yash Fernandes,12-07-2005,473322,Maharashtra,9,19,14,4,46,Pass
Ishaan Mehta,12-09-2005,899124,Uttar Pradesh,8,1,2,6,17,Pass
Harjeet Verma,09-01-2006,546842,Punjab,13,13,19,5,50,Pass
Rohan Singh,26-08-2005,698275,Tamil Nadu,19,22,11,22,74,Pass
Aditya Singh,13-04-2005,227630,Tripura,11,19,15,9,54,Pass
Vivaan Fernandes,11-04-2005,924678,Madhya Pradesh,18,24,17,4,63,Pass
Rohan Fernandes,07-01-2005,158052,Punjab,23,12,0,18,53,Pass
Raj Reddy,30-03-2006,814049,Tamil Nadu,2,10,0,16,28,Pass
Aarav Khan,15-03-2006,156058,Telangana,3,12,24,18,57,Pass
Peter Verma,30-12-2005,415408,Gujarat,18,5,5,1,29,Pass
Aryan Pillai,20-08-2005,323392,Tamil Nadu,24,8,10,11,53,Pass
Balbir D'Souza,09-03-2005,135556,Telangana,13,15,14,20,62,Pass
Paul Reddy,10-05-2005,574900,Rajasthan,13,23,21,19,76,Pass
Yash Pillai,14-12-2005,151141,Haryana,0,5,5,17,27,Pass
Aarav D'Souza,22-11-2004,491487,Madhya Pradesh,3,1,1,3,8,Pass
Aditya Chopra,29-04-2006,911109,Himachal Pradesh,6,0,2,5,13,Pass
Kunal Khan,03-07-2005,250091,Rajasthan,2,18,17,18,55,Pass
Yash Singh,05-03-2005,385324,Uttarakhand,18,8,1,0,27,Pass
Yash Fernandes,24-04-2006,643401,Tripura,0,2,7,16,25,Pass
Aryan Sharma,21-12-2004,682137,Maharashtra,14,4,23,10,51,Pass
Balbir Chopra,01-05-2005,864168,Tamil Nadu,12,18,24,6,60,Pass
Rehan Reddy,04-02-2006,309107,Karnataka,1,16,1,15,33,Pass
Paul Khan,03-12-2004,148595,West Bengal,3,24,17,2,46,Pass
Rehan Mehta,05-01-2006,316636,Bihar,1,0,3,8,12,Pass
Gurpreet Khan,14-04-2005,824823,Rajasthan,24,18,13,17,72,Pass
Aditya Chopra,27-10-2005,279499,Karnataka,1,0,1,4,6,Pass
Aditya Sharma,16-02-2006,214195,Bihar,18,21,17,9,65,Pass
Harjeet Verma,28-01-2006,657413,Uttar Pradesh,4,1,3,12,20,Pass
Aryan Reddy,18-05-2005,924838,Rajasthan,5,6,14,10,35,Pass
Peter Fernandes,17-04-2005,460013,Assam,2,24,9,24,59,Pass
Yash Chopra,27-05-2005,316802,Gujarat,7,14,23,19,63,Pass
Sukhwinder Mehta,25-02-2006,941248,Uttar Pradesh,19,1,5,21,46,Pass
Raj Mehta,28-12-2005,484274,Tamil Nadu,22,0,4,1,27,Pass
Aarav Mehta,16-03-2006,373252,Kerala,19,18,9,17,63,Pass
Yash Verma,05-01-2006,428671,Maharashtra,20,4,20,16,60,Pass
Sukhwinder Chopra,19-09-2005,113915,Bihar,18,15,21,11,65,Pass
Aryan Chopra,15-01-2006,907093,Maharashtra,13,4,8,24,49,Pass
Ishaan Fernandes,24-01-2006,371488,Madhya Pradesh,19,14,19,4,56,Pass
Harjeet Singh,05-02-2006,698580,Andhra Pradesh,5,11,0,10,26,Pass
Aryan Sharma,26-11-2004,586072,Maharashtra,18,9,3,18,48,Pass
Balbir Singh,30-08-2005,419451,Maharashtra,11,4,11,12,38,Pass
Aryan D'Souza,01-04-2006,512460,Rajasthan,15,22,0,17,54,Pass
Mathew Chopra,03-02-2006,438140,Tamil Nadu,10,23,8,5,46,Pass
Raj Sharma,04-08-2005,447121,Uttar Pradesh,0,1,7,6,14,Pass
Raj Pillai,14-08-2005,216859,Madhya Pradesh,20,4,3,0,27,Pass
Gurpreet Mehta,06-07-2005,593024,Maharashtra,13,4,22,22,61,Pass
Mathew Singh,15-07-2005,108473,Rajasthan,6,23,4,1,34,Pass
Aditya Sharma,15-06-2005,642199,Himachal Pradesh,0,22,10,0,32,Pass
Rehan Fernandes,02-03-2005,354041,Rajasthan,6,10,23,15,54,Pass
Harjeet D'Souza,26-02-2005,184360,Kerala,2,7,18,12,39,Pass
Ayaan D'Souza,30-11-2004,299505,Telangana,5,19,2,24,50,Pass
Aditya Sharma,07-12-2004,395927,Gujarat,10,19,5,8,42,Pass
Aarav Singh,16-01-2006,489483,Maharashtra,15,12,3,16,46,Pass
Aryan Sharma,13-05-2005,960379,Haryana,1,10,19,13,43,Pass
Sukhwinder Reddy,12-07-2005,604824,Bihar,12,12,1,18,43,Pass
Kunal Fernandes,06-01-2006,648662,Madhya Pradesh,13,0,1,6,20,Pass
Ishaan Verma,09-10-2005,100086,Telangana,11,20,17,21,69,Pass
Peter Khan,30-04-2005,775830,Bihar,10,23,9,16,58,Pass
Yash D'Souza,27-10-2005,413913,Rajasthan,12,22,3,18,55,Pass
Vivaan Reddy,22-11-2005,637334,Chhattisgarh,3,3,1,13,20,Pass
Kunal Khan,21-04-2005,723955,Karnataka,10,16,12,9,47,Pass
Kunal Verma,09-05-2005,616808,Rajasthan,10,17,18,15,60,Pass
Aarav Reddy,07-12-2005,125308,Bihar,1,4,8,7,20,Pass
Rohan Khan,19-09-2005,233342,Rajasthan,3,17,6,7,33,Pass
Krishna Reddy,20-01-2005,199545,Assam,2,24,19,6,51,Pass
Harjeet Sharma,19-05-2005,761511,Madhya Pradesh,4,22,20,4,50,Pass
Aryan Mehta,17-03-2006,740010,Bihar,17,15,4,20,56,Pass
Aditya Verma,18-09-2005,459594,Haryana,7,8,24,1,40,Pass
Balbir Sharma,27-05-2005,470456,Punjab,1,15,22,15,53,Pass
Aditya Singh,01-01-2005,938819,Uttar Pradesh,0,1,19,15,35,Pass
Ishaan Mehta,24-03-2005,716751,Maharashtra,20,0,18,2,40,Pass
Kunal Mehta,09-05-2005,133607,Andhra Pradesh,7,24,2,20,53,Pass
Gurpreet Singh,26-01-2005,448846,Gujarat,14,13,14,17,58,Pass
Vivaan Mehta,09-12-2004,725750,Andhra Pradesh,0,23,0,10,33,Pass
Ishaan Fernandes,22-08-2005,346078,West Bengal,3,23,18,7,51,Pass
Kunal Sharma,25-07-2005,255983,Odisha,15,20,22,22,79,Pass
John Reddy,07-12-2004,407559,Jammu & Kashmir + Ladakh,15,15,0,18,48,Pass
Aarav Pillai,02-06-2005,146157,Maharashtra,12,4,22,24,62,Pass
Rohan Khan,17-04-2006,551652,Kerala,0,11,14,14,39,Pass
Peter Reddy,02-03-2006,809147,Maharashtra,15,4,14,4,37,Pass
Manpreet Sharma,08-04-2006,920060,Rajasthan,23,8,16,0,47,Pass
Aarav Mehta,08-01-2006,394210,West Bengal,12,7,23,0,42,Pass
Kunal Reddy,21-01-2005,308765,Odisha,18,17,14,24,73,Pass
Vivaan Sharma,21-10-2005,998674,Jharkhand,21,5,4,8,38,Pass
Rohan Mehta,14-02-2006,788081,Kerala,1,19,8,18,46,Pass
Vivaan Verma,22-07-2005,731680,Karnataka,19,1,10,20,50,Pass
Aditya Verma,19-02-2005,477384,Bihar,20,23,12,17,72,Pass
Aarav Sharma,01-12-2004,791155,Maharashtra,9,4,16,10,39,Pass
Aarav Pillai,02-09-2005,444837,Assam,22,9,18,0,49,Pass
Harjeet D'Souza,21-01-2006,613937,Uttar Pradesh,10,1,4,24,39,Pass
Krishna Fernandes,03-01-2005,531142,Punjab,17,6,12,10,45,Pass
Manpreet Chopra,16-03-2006,508110,West Bengal,3,10,17,9,39,Pass
Aryan Mehta,08-05-2005,314094,Haryana,12,8,8,12,40,Pass
Rohan Pillai,30-05-2005,455005,Karnataka,21,19,20,5,65,Pass
Rohan Sharma,30-10-2005,155673,Uttar Pradesh,6,1,9,13,29,Pass
Vivaan Verma,02-11-2005,397785,Bihar,20,22,22,21,85,Pass
Kunal D'Souza,11-08-2005,447716,Uttar Pradesh,24,1,5,1,31,Pass
Raj Pillai,14-01-2005,996816,Rajasthan,24,15,12,11,62,Pass
Rohan Mehta,27-12-2004,315208,Bihar,8,5,14,8,35,Pass
Raj Sharma,15-02-2005,210190,Rajasthan,17,12,17,24,70,Pass
Krishna Reddy,23-09-2005,629457,Uttar Pradesh,4,1,0,18,23,Pass
Balbir Fernandes,07-04-2005,162372,Karnataka,18,8,16,16,58,Pass
Raj D'Souza,09-07-2005,206928,Chhattisgarh,11,17,17,24,69,Pass
Aditya Chopra,30-11-2004,650705,Karnataka,2,13,18,2,35,Pass
Harjeet Chopra,02-03-2006,568226,Delhi,1,24,17,3,45,Pass
Aarav Khan,12-02-2005,710569,Gujarat,7,17,1,3,28,Pass
Kunal Mehta,24-05-2005,140653,Bihar,12,5,0,8,25,Pass
Yash Verma,03-01-2006,201871,Kerala,5,0,11,11,27,Pass
Aarav Mehta,05-02-2005,718791,Punjab,18,7,16,1,42,Pass
Aryan Pillai,28-02-2005,950948,Uttar Pradesh,22,1,18,4,45,Pass
Ishaan Sharma,26-11-2005,591627,Himachal Pradesh,7,13,7,4,31,Pass
Raj Khan,14-05-2005,280317,Odisha,5,16,22,7,50,Pass
Rohan Mehta,08-01-2005,278419,Bihar,2,24,24,22,72,Pass
Yash Reddy,08-09-2005,129214,Jharkhand,5,5,6,5,21,Pass
Raj Khan,01-08-2005,116812,Uttar Pradesh,20,1,18,16,55,Pass
Sukhwinder Reddy,15-04-2006,283270,Haryana,23,19,1,18,61,Pass
Aditya D'Souza,25-05-2005,470380,Chhattisgarh,8,12,22,15,57,Pass
Vivaan Pillai,30-04-2006,539289,Jharkhand,7,12,3,2,24,Pass
Krishna Verma,03-06-2005,154388,Tamil Nadu,13,3,9,5,30,Pass
Kunal Reddy,22-03-2006,445146,Punjab,18,19,11,14,62,Pass
Ishaan Khan,16-03-2006,394308,Jharkhand,23,1,5,0,29,Pass
Ishaan Mehta,20-01-2005,728567,Punjab,4,5,0,5,14,Pass
Paul Singh,31-01-2006,458041,Rajasthan,14,10,8,2,34,Pass
Kunal Khan,03-05-2005,516866,Nagaland,5,6,6,7,24,Pass
Ishaan Pillai,26-04-2006,255234,Telangana,4,1,20,13,38,Pass
Rohan Sharma,18-09-2005,218076,Gujarat,18,10,1,6,35,Pass
David Pillai,26-03-2006,785783,Tamil Nadu,3,3,15,19,40,Pass
Manpreet Khan,07-05-2006,772810,Rajasthan,19,13,6,5,43,Pass
Kunal D'Souza,12-09-2005,614613,Rajasthan,3,5,2,3,13,Pass
Raj D'Souza,24-03-2006,527466,Telangana,4,12,12,9,37,Pass
Aarav Singh,22-07-2005,777114,Assam,9,19,22,12,62,Pass
Kunal Reddy,09-01-2005,660021,Haryana,21,11,20,16,68,Pass
Yash Pillai,25-11-2004,900864,Uttar Pradesh,7,1,15,13,36,Pass
Balbir Singh,01-11-2005,241832,Madhya Pradesh,6,17,13,0,36,Pass
Rohan Sharma,07-06-2005,338636,Andhra Pradesh,5,7,5,21,38,Pass
Imran D'Souza,13-07-2005,301157,Maharashtra,5,4,10,19,38,Pass
Farhan Fernandes,19-11-2005,584172,Uttar Pradesh,6,1,1,6,14,Pass
Aditya Singh,14-12-2004,530249,Bihar,5,9,3,8,25,Pass
Imran Khan,15-12-2005,181906,Kerala,18,11,2,8,39,Pass
Kunal Pillai,11-11-2005,948416,Maharashtra,13,4,12,23,52,Pass
David Reddy,18-04-2005,756187,Gujarat,12,6,7,0,25,Pass
Aarav Mehta,13-01-2005,403537,Jharkhand,24,12,9,2,47,Pass
Aditya Singh,02-12-2004,502114,Uttarakhand,16,15,3,1,35,Pass
Aditya Pillai,16-09-2005,859911,Odisha,6,9,24,0,39,Pass
Yash Chopra,20-11-2004,337329,Karnataka,8,6,13,4,31,Pass
Aditya Pillai,23-01-2006,910907,Andhra Pradesh,6,3,7,23,39,Pass
Gurpreet D'Souza,19-04-2006,433448,Bihar,9,3,12,7,31,Pass
Raj D'Souza,10-06-2005,271084,Maharashtra,16,1,2,15,34,Pass
Kunal Verma,23-03-2006,610745,Madhya Pradesh,22,18,12,4,56,Pass
Peter Khan,22-04-2005,840627,Bihar,15,14,21,24,74,Pass
Farhan Reddy,01-11-2005,877347,Bihar,0,5,22,20,47,Pass
Aryan Chopra,09-05-2006,468232,Rajasthan,1,6,12,10,29,Pass
Ishaan Fernandes,26-09-2005,401817,Madhya Pradesh,22,17,9,4,52,Pass
Manpreet Sharma,18-02-2005,971528,Punjab,15,11,2,9,37,Pass
Peter Pillai,15-12-2005,299933,Bihar,0,14,24,6,44,Pass
Aditya Pillai,03-01-2006,801007,Assam,21,3,14,10,48,Pass
Raj Sharma,06-05-2006,740581,Uttar Pradesh,10,1,17,6,34,Pass
Yash Reddy,03-12-2005,851343,Gujarat,2,17,4,6,29,Pass
Rohan D'Souza,13-11-2004,286923,West Bengal,3,13,19,15,50,Pass
Aditya Reddy,24-10-2005,272943,Haryana,12,23,12,8,55,Pass
Raj Sharma,18-01-2005,743608,Rajasthan,4,13,2,6,25,Pass
Yash Fernandes,09-01-2006,638340,Uttar Pradesh,12,1,7,15,35,Pass
Balbir Fernandes,26-09-2005,118907,Jharkhand,14,12,12,16,54,Pass
Ishaan Mehta,07-05-2005,456522,Bihar,18,22,0,2,42,Pass
Yash Fernandes,24-01-2006,100787,Tamil Nadu,22,8,12,6,48,Pass
Aarav Pillai,07-10-2005,613275,Uttar Pradesh,15,1,15,19,50,Pass
Vivaan Sharma,09-03-2005,943338,Arunachal Pradesh,7,5,7,7,26,Pass
Raj Chopra,12-11-2004,978510,West Bengal,10,6,14,17,47,Pass
Yash Sharma,02-07-2005,582018,Delhi,3,2,7,19,31,Pass
Rohan Pillai,09-11-2004,247741,Bihar,17,7,7,17,48,Pass
Rehan Pillai,12-11-2005,789651,Uttar Pradesh,7,1,18,13,39,Pass
Paul Fernandes,31-01-2005,300081,Madhya Pradesh,12,1,18,5,36,Pass
Peter Mehta,07-07-2005,864870,Kerala,5,5,5,5,20,Pass
Raj Verma,28-04-2006,168690,Maharashtra,1,15,17,5,38,Pass
Rohan Singh,20-12-2005,797284,Bihar,17,11,9,8,45,Pass
Imran Reddy,16-04-2006,370212,Uttarakhand,3,8,15,18,44,Pass
Gurpreet Pillai,01-11-2005,252456,West Bengal,13,18,18,5,54,Pass
David Sharma,24-01-2005,423233,Rajasthan,0,23,5,14,42,Pass
Kunal Khan,22-12-2005,347488,Haryana,7,10,2,21,40,Pass
Paul Pillai,23-11-2004,861706,Punjab,5,17,17,15,54,Pass
Kunal Pillai,10-02-2005,888820,Uttar Pradesh,19,1,17,17,54,Pass
Krishna Khan,10-02-2006,186971,Rajasthan,20,8,7,18,53,Pass
Aarav Sharma,09-01-2006,453787,Haryana,15,5,5,16,41,Pass
Yash Chopra,29-07-2005,804201,Tamil Nadu,14,21,0,6,41,Pass
Peter Pillai,07-09-2005,819160,Gujarat,18,15,1,7,41,Pass
Kunal Singh,03-02-2005,475943,Andhra Pradesh,1,10,17,4,32,Pass
Yash Reddy,02-02-2005,408348,Uttarakhand,3,18,14,18,53,Pass
Vivaan Reddy,14-03-2006,624060,Chhattisgarh,21,17,4,6,48,Pass
David Mehta,20-01-2006,575205,Telangana,21,20,10,15,66,Pass
Vivaan D'Souza,28-11-2004,515693,Madhya Pradesh,15,7,13,6,41,Pass
Farhan Khan,09-10-2005,101791,Bihar,24,17,11,4,56,Pass
John Sharma,11-02-2005,988504,Delhi,24,14,9,1,48,Pass
Vivaan Chopra,29-10-2005,550845,Uttar Pradesh,15,1,21,7,44,Pass
Sukhwinder Khan,03-04-2005,898282,Punjab,10,24,20,23,77,Pass
Harjeet Singh,21-07-2005,336679,Himachal Pradesh,3,21,20,13,57,Pass
Vivaan Chopra,17-01-2005,656319,Delhi,0,7,9,14,30,Pass
David Verma,09-07-2005,835385,Uttar Pradesh,7,1,0,8,16,Pass
Ishaan Pillai,14-12-2004,432973,West Bengal,1,21,21,5,48,Pass
Aarav Khan,25-12-2004,696573,Rajasthan,11,18,16,9,54,Pass
Aryan Pillai,08-01-2006,529938,Maharashtra,13,4,23,17,57,Pass
Kunal Pillai,24-07-2005,894863,Madhya Pradesh,11,23,4,12,50,Pass
Aditya Chopra,11-11-2004,202365,Bihar,7,22,0,1,30,Pass
David Chopra,16-07-2005,186397,Odisha,19,9,18,2,48,Pass
Harjeet Mehta,30-05-2005,929677,Madhya Pradesh,13,5,18,20,56,Pass
Rehan Verma,14-10-2005,159719,West Bengal,18,11,2,18,49,Pass
Aryan Fernandes,05-02-2005,861950,Maharashtra,16,4,22,22,64,Pass
Aarav Khan,25-03-2005,701873,Madhya Pradesh,16,9,10,3,38,Pass
Yash D'Souza,29-07-2005,584487,Bihar,6,21,22,17,66,Pass
Rehan Verma,12-05-2005,103965,Tamil Nadu,23,13,0,8,44,Pass
Harjeet Pillai,10-07-2005,876194,Manipur,0,16,12,20,48,Pass
Zaid D'Souza,11-08-2005,786111,Haryana,20,11,20,20,71,Pass
Yash Khan,05-02-2006,837483,Maharashtra,9,8,15,3,35,Pass
Manpreet Pillai,06-06-2005,715154,Bihar,4,20,24,6,54,Pass
Kunal Sharma,09-07-2005,752723,Gujarat,7,1,20,24,52,Pass
Krishna Verma,21-12-2005,909030,Delhi,24,13,10,6,53,Pass
Yash Khan,04-03-2006,394979,Bihar,0,5,1,10,16,Pass
Vivaan Fernandes,14-02-2005,256470,Punjab,15,6,6,4,31,Pass
Raj Verma,11-08-2005,782791,Gujarat,4,20,0,5,29,Pass
Kunal Singh,16-11-2004,379588,Rajasthan,14,1,24,15,54,Pass
Harjeet Singh,16-05-2005,304922,Haryana,7,14,22,14,57,Pass
Sukhwinder Singh,15-12-2004,940199,Jharkhand,21,15,10,21,67,Pass
Raj Reddy,28-09-2005,631382,Karnataka,6,19,8,8,41,Pass
Ishaan Singh,03-01-2005,485070,Kerala,0,8,10,7,25,Pass
Rohan Pillai,15-06-2005,897340,Rajasthan,12,7,17,12,48,Pass
Krishna Fernandes,12-06-2005,879260,Andhra Pradesh,12,19,6,8,45,Pass
Gurpreet Chopra,17-07-2005,984689,Chhattisgarh,11,8,19,8,46,Pass
Harjeet Pillai,05-02-2006,838961,West Bengal,13,4,12,16,45,Pass
Manpreet Reddy,17-04-2005,881609,Maharashtra,4,5,3,22,34,Pass
John Chopra,17-12-2004,773347,Assam,8,9,4,3,24,Pass
Peter Mehta,24-03-2005,404462,Odisha,5,13,13,23,54,Pass
Raj Singh,13-11-2005,731707,Tamil Nadu,23,3,17,14,57,Pass
Raj D'Souza,21-01-2006,162987,Telangana,22,6,9,2,39,Pass
Manpreet Singh,12-07-2005,822229,Maharashtra,11,11,11,12,45,Pass
John Verma,04-01-2006,306671,West Bengal,16,6,10,20,52,Pass
Balbir Fernandes,20-12-2004,903730,Haryana,5,23,14,16,58,Pass
Paul Verma,01-12-2004,103356,Himachal Pradesh,10,21,1,21,53,Pass
Yash Reddy,01-02-2006,849747,Odisha,11,0,24,24,59,Pass
Raj Pillai,27-10-2005,867074,Rajasthan,3,5,24,4,36,Pass
Yash D'Souza,20-12-2005,522042,West Bengal,7,8,9,24,48,Pass
Gurpreet Mehta,09-04-2005,385973,Tripura,18,13,10,24,65,Pass
Yash Reddy,14-07-2005,531516,Madhya Pradesh,11,3,19,17,50,Pass
Yash D'Souza,06-04-2006,972887,Andhra Pradesh,17,21,7,9,54,Pass
Ishaan Singh,15-09-2005,951889,Rajasthan,14,7,22,19,62,Pass
Aarav Verma,26-07-2005,827047,Odisha,11,12,15,18,56,Pass
Gurpreet D'Souza,07-04-2006,967726,Andhra Pradesh,15,19,9,21,64,Pass
Ishaan D'Souza,25-01-2005,998212,Chhattisgarh,1,18,20,0,39,Pass
Rohan Chopra,19-07-2005,229720,Maharashtra,15,4,20,1,40,Pass
Aryan Reddy,06-12-2005,796153,Uttarakhand,4,14,15,11,44,Pass
Paul Chopra,02-08-2005,222049,Maharashtra,19,4,22,23,68,Pass
Ishaan Chopra,19-10-2005,404684,Gujarat,2,7,2,5,16,Pass
Aditya Fernandes,03-01-2005,450980,Maharashtra,24,4,8,12,48,Pass
Imran D'Souza,19-11-2005,346298,Rajasthan,14,1,2,7,24,Pass
Ishaan Reddy,30-03-2005,833994,Uttar Pradesh,23,1,20,8,52,Pass
Farhan Sharma,29-08-2005,951576,Rajasthan,2,4,14,23,43,Pass
Manpreet Khan,18-03-2006,585469,Rajasthan,9,8,5,21,43,Pass
John Fernandes,17-07-2005,349527,Rajasthan,24,0,17,1,42,Pass
Krishna Mehta,07-04-2005,422376,Bihar,7,4,11,12,34,Pass
Aditya D'Souza,12-12-2004,687480,Tripura,9,12,10,4,35,Pass
Ishaan Reddy,08-05-2006,495612,Uttar Pradesh,4,1,12,1,18,Pass
Raj D'Souza,18-07-2005,726245,Andhra Pradesh,0,7,14,8,29,Pass
John Khan,20-05-2005,495808,Madhya Pradesh,8,15,4,21,48,Pass
Aryan Khan,16-07-2005,705769,Uttar Pradesh,22,1,11,11,45,Pass
Vivaan Khan,08-11-2004,737576,Maharashtra,5,11,19,9,44,Pass
Aryan Fernandes,24-11-2004,986996,Telangana,13,21,1,16,51,Pass
Ishaan Verma,27-11-2005,658367,Madhya Pradesh,21,5,19,9,54,Pass
Kunal Verma,13-07-2005,922775,Jammu & Kashmir + Ladakh,20,1,11,4,36,Pass
Aryan Khan,28-05-2005,828709,Gujarat,2,1,3,11,17,Pass
Raj Verma,20-02-2006,770490,Andhra Pradesh,12,14,13,14,53,Pass
Aarav Sharma,11-12-2005,135779,Uttarakhand,9,2,15,19,45,Pass
Mathew Singh,29-07-2005,622232,West Bengal,20,11,16,3,50,Pass
Rohan Fernandes,20-04-2006,257416,Gujarat,16,14,23,8,61,Pass
Aarav Pillai,14-07-2005,950580,Maharashtra,5,4,21,23,53,Pass
Harjeet Singh,01-01-2006,888634,West Bengal,3,10,10,22,45,Pass
Imran Verma,03-07-2005,891171,Madhya Pradesh,12,1,23,10,46,Pass
Vivaan Khan,26-03-2005,306936,Uttar Pradesh,4,1,14,13,32,Pass
Vivaan Chopra,04-05-2006,705679,Gujarat,24,23,1,18,66,Pass
Raj Khan,16-06-2005,710397,Odisha,5,8,2,7,22,Pass
Aarav Mehta,28-02-2005,112605,Karnataka,0,11,21,5,37,Pass
Kunal D'Souza,26-12-2005,819361,Delhi,17,17,12,4,50,Pass
Vivaan Verma,30-03-2005,830108,Bihar,13,11,12,13,49,Pass
Krishna Mehta,02-06-2005,263777,Telangana,0,10,20,0,30,Pass
Ishaan Mehta,09-12-2004,980330,Uttar Pradesh,0,1,24,10,35,Pass
Sukhwinder Fernandes,20-12-2004,395549,Tamil Nadu,14,9,24,14,61,Pass
Peter Sharma,12-10-2005,939635,Tamil Nadu,1,6,20,11,38,Pass
Krishna Singh,12-12-2004,645143,Haryana,20,22,18,11,71,Pass
Ishaan Sharma,24-09-2005,852785,Bihar,11,21,6,24,62,Pass
Yash Mehta,28-07-2005,351765,Chhattisgarh,24,17,5,15,61,Pass
Kunal Verma,04-06-2005,646722,Delhi,8,17,14,15,54,Pass
Sukhwinder Verma,29-09-2005,994305,Rajasthan,4,12,24,15,55,Pass
Sukhwinder Chopra,09-01-2005,468387,Himachal Pradesh,13,22,17,24,76,Pass
Vivaan Singh,13-09-2005,182438,Kerala,2,18,0,23,43,Pass
Manpreet Sharma,05-12-2005,558411,Bihar,8,20,17,9,54,Pass
Sukhwinder Sharma,10-07-2005,500602,West Bengal,3,18,20,1,42,Pass
Yash Reddy,29-05-2005,267537,Andhra Pradesh,11,18,13,7,49,Pass
Kunal Khan,03-12-2005,570937,Andhra Pradesh,20,18,20,3,61,Pass
Raj Mehta,08-04-2006,406700,Uttar Pradesh,14,1,20,18,53,Pass
Aditya Mehta,15-01-2005,143687,Assam,5,3,7,15,30,Pass
Kunal Khan,26-06-2005,259148,Uttar Pradesh,6,1,9,10,26,Pass
Manpreet Singh,20-12-2004,193048,Bihar,14,3,10,16,43,Pass
John Singh,20-10-2005,192645,Madhya Pradesh,18,3,19,12,52,Pass
Ishaan D'Souza,10-10-2005,435701,Madhya Pradesh,3,8,11,15,37,Pass
Raj Fernandes,27-01-2006,775005,Delhi,19,2,14,14,49,Pass
Gurpreet D'Souza,02-01-2005,860145,Rajasthan,0,15,8,2,25,Pass
Peter Mehta,21-02-2005,562871,Maharashtra,10,4,10,15,39,Pass
Manpreet Sharma,28-11-2004,564415,Uttarakhand,2,0,6,22,30,Pass
Yash Khan,06-04-2005,638354,Tripura,20,12,19,1,52,Pass
Yash Fernandes,13-02-2005,449860,Bihar,0,0,3,20,23,Pass
Sukhwinder Pillai,17-11-2004,681957,Jharkhand,24,4,1,24,53,Pass
Peter Chopra,22-02-2006,580480,Uttar Pradesh,1,1,12,20,34,Pass
Kunal Verma,07-02-2005,434002,Telangana,17,17,18,7,59,Pass
Krishna Reddy,15-06-2005,562690,Bihar,2,2,13,17,34,Pass
Aditya Sharma,18-04-2005,471486,Uttar Pradesh,10,1,3,15,29,Pass
Sukhwinder Pillai,28-12-2004,309026,Bihar,16,13,0,21,50,Pass
Aryan Reddy,26-09-2005,676485,Uttar Pradesh,18,1,20,8,47,Pass
Aditya D'Souza,01-05-2005,181601,West Bengal,1,9,7,13,30,Pass
Vivaan Mehta,23-03-2005,427311,Tamil Nadu,8,16,3,12,39,Pass
Ishaan Reddy,23-04-2006,953341,West Bengal,2,23,5,17,47,Pass
Rohan Reddy,13-06-2005,395219,Bihar,0,4,6,4,14,Pass
Gurpreet Reddy,27-06-2005,335648,Karnataka,24,11,0,8,43,Pass
Ishaan Sharma,12-03-2005,583294,Bihar,21,6,10,17,54,Pass
Ishaan Sharma,16-09-2005,220146,Andhra Pradesh,7,16,21,19,63,Pass
Aryan Mehta,24-04-2005,132691,Jharkhand,18,17,20,12,67,Pass
Manpreet Reddy,06-08-2005,340300,Uttar Pradesh,22,1,16,19,58,Pass
Harjeet Reddy,04-06-2005,823976,Madhya Pradesh,16,1,9,4,30,Pass
Krishna Sharma,26-07-2005,726324,Bihar,8,1,0,15,24,Pass
David Khan,19-11-2004,462162,West Bengal,1,2,13,16,32,Pass
Gurpreet Sharma,24-10-2005,132197,Andhra Pradesh,6,24,3,19,52,Pass
Aryan Reddy,08-11-2004,970414,Maharashtra,0,10,7,8,25,Pass
John Singh,25-11-2004,390680,Assam,2,24,15,1,42,Pass
Vivaan Khan,30-12-2005,926173,Telangana,2,5,20,5,32,Pass
Aditya Pillai,22-01-2005,818868,Jharkhand,8,16,2,16,42,Pass
Ishaan D'Souza,17-12-2004,198530,Karnataka,23,9,23,8,63,Pass
Manpreet Verma,04-01-2005,589324,Jharkhand,1,10,7,24,42,Pass
Aryan Singh,20-08-2005,269378,Rajasthan,21,20,10,13,64,Pass
Krishna D'Souza,26-09-2005,724647,Himachal Pradesh,3,22,11,5,41,Pass
Yash Sharma,06-12-2004,972111,Madhya Pradesh,5,7,1,20,33,Pass
Mathew Sharma,09-12-2005,307627,Gujarat,14,23,2,11,50,Pass
Ishaan Verma,03-08-2005,887262,Jharkhand,6,0,13,20,39,Pass
Raj Khan,15-06-2005,517251,Madhya Pradesh,19,9,12,7,47,Pass
Harjeet Chopra,14-03-2006,232459,Gujarat,14,22,21,21,78,Pass
Peter Verma,16-03-2006,199176,West Bengal,3,5,10,23,41,Pass
Aryan Mehta,26-06-2005,588788,Tamil Nadu,11,20,18,14,63,Pass
Peter Singh,02-05-2005,111175,Andhra Pradesh,13,13,7,2,35,Pass
Aditya Khan,08-04-2005,443496,Uttar Pradesh,20,1,18,1,40,Pass
Paul Chopra,24-04-2005,869618,Tamil Nadu,20,0,5,8,33,Pass
Aditya Verma,17-02-2005,845793,Rajasthan,17,1,22,12,52,Pass
Krishna Pillai,03-04-2005,507212,Goa,5,8,15,1,29,Fail
Rehan Fernandes,13-12-2004,357219,Madhya Pradesh,19,22,14,4,59,Pass
Gurpreet D'Souza,12-11-2004,459268,Karnataka,0,4,9,4,17,Pass
Aryan Chopra,07-01-2006,723221,Telangana,6,21,24,3,54,Pass
Zaid Singh,15-11-2004,523860,Uttar Pradesh,3,1,22,22,48,Pass
Imran Khan,03-10-2005,204137,Andhra Pradesh,2,13,22,8,45,Pass
Ishaan D'Souza,08-10-2005,410201,Jammu & Kashmir + Ladakh,22,5,24,14,65,Pass
Aryan Chopra,14-07-2005,751822,Uttar Pradesh,11,1,24,2,38,Pass
Kunal Khan,12-07-2005,739833,Maharashtra,18,4,9,18,49,Pass
Raj Reddy,01-02-2006,486159,West Bengal,1,5,4,12,22,Pass
Raj Verma,19-03-2005,469627,Rajasthan,14,23,17,16,70,Pass
Aditya Fernandes,22-01-2005,268617,Gujarat,12,2,12,18,44,Pass
Vivaan Reddy,17-03-2006,464986,Madhya Pradesh,5,4,15,2,26,Pass
Aditya Sharma,11-03-2006,270608,Uttar Pradesh,12,1,6,18,37,Pass
Aryan Singh,27-03-2005,463397,Gujarat,5,2,9,1,17,Pass
Vivaan Reddy,09-08-2005,638467,Punjab,5,8,21,24,58,Pass
Paul Verma,06-11-2005,641945,West Bengal,0,11,19,10,40,Pass
Yash Reddy,11-03-2006,841989,Assam,16,2,19,21,58,Pass
Vivaan Sharma,21-07-2005,174998,Tamil Nadu,17,13,15,10,55,Pass
Aarav Sharma,28-10-2005,277852,Odisha,2,3,14,9,28,Pass
Kunal Khan,15-12-2004,904577,Bihar,17,1,10,17,45,Pass
Raj Fernandes,13-04-2006,961650,Telangana,9,0,24,14,47,Pass
Krishna Fernandes,27-02-2005,512431,Jharkhand,14,13,19,5,51,Pass
Aarav Reddy,20-11-2005,906586,West Bengal,5,24,8,3,40,Pass
Aarav Singh,18-11-2005,550225,Rajasthan,4,21,11,23,59,Pass
Raj Verma,09-12-2004,983714,Bihar,23,4,13,10,50,Pass
Aarav Pillai,24-02-2005,902335,Delhi,1,8,3,2,14,Pass
Krishna D'Souza,21-01-2006,724151,Uttar Pradesh,8,1,9,14,32,Pass
Aarav D'Souza,30-01-2005,388215,Tamil Nadu,20,19,7,20,66,Pass
Balbir D'Souza,22-10-2005,344230,Tamil Nadu,11,21,22,11,65,Pass
Raj Fernandes,28-11-2005,948653,Odisha,12,5,8,3,28,Pass
Ishaan Fernandes,01-05-2005,658221,Tripura,10,6,15,2,33,Pass
Raj Fernandes,04-10-2005,318037,Telangana,19,24,17,18,78,Pass
Aarav Pillai,18-02-2005,138422,Maharashtra,18,4,4,13,39,Pass
Aryan Sharma,02-06-2005,873221,Rajasthan,10,11,4,15,40,Pass
David Chopra,02-03-2006,597076,Haryana,15,18,24,1,58,Pass
Sukhwinder Mehta,15-08-2005,406762,Gujarat,14,0,9,23,46,Pass
Gurpreet Reddy,26-11-2005,220602,Haryana,4,17,14,3,38,Pass
Rohan D'Souza,25-12-2005,559708,Maharashtra,22,4,11,5,42,Pass
Ishaan Singh,19-01-2006,256671,Andhra Pradesh,16,4,4,2,26,Pass
Aryan Fernandes,14-09-2005,287377,Kerala,20,2,0,23,45,Pass
Sukhwinder Singh,25-10-2005,119871,Gujarat,2,3,1,17,23,Pass
Kunal Fernandes,12-12-2005,656788,Karnataka,0,23,23,13,59,Pass
Harjeet Pillai,30-01-2005,679668,West Bengal,8,5,18,15,46,Pass
Yash Reddy,22-05-2005,566670,Tamil Nadu,24,15,16,3,58,Pass
Yash Fernandes,26-08-2005,502483,Madhya Pradesh,19,18,9,4,50,Pass
Manpreet D'Souza,14-02-2006,884317,Punjab,21,10,13,15,59,Pass
Ishaan Reddy,20-09-2005,254368,Punjab,24,18,21,5,68,Pass
Harjeet Sharma,30-11-2004,296363,Haryana,23,2,6,9,40,Pass
Vivaan Singh,23-04-2006,910023,Uttar Pradesh,0,1,16,3,20,Pass
Aditya Mehta,10-07-2005,182943,Maharashtra,7,5,20,17,49,Pass
Gurpreet Chopra,20-02-2005,762919,Jharkhand,15,10,1,19,45,Pass
Harjeet Pillai,13-03-2006,484137,Andhra Pradesh,22,0,8,6,36,Pass
Ishaan Verma,06-06-2005,995859,Uttar Pradesh,21,1,17,7,46,Pass
Balbir Pillai,26-08-2005,476326,Madhya Pradesh,24,8,15,7,54,Pass
Yash Verma,02-04-2005,322759,Bihar,18,24,10,18,70,Pass
Yash Fernandes,13-04-2006,267309,Maharashtra,7,21,2,16,46,Pass
Yash Pillai,22-11-2005,981497,Bihar,15,21,23,11,70,Pass
John Mehta,28-01-2005,268590,Andhra Pradesh,24,5,15,19,63,Pass
Aarav Chopra,25-02-2006,600109,Tamil Nadu,13,17,15,16,61,Pass
Mathew Verma,30-10-2005,834055,Tamil Nadu,11,19,18,4,52,Pass
Paul Fernandes,23-06-2005,716248,Andhra Pradesh,10,18,12,0,40,Pass
Rohan Reddy,26-07-2005,859172,Rajasthan,19,1,0,20,40,Pass
Aryan Sharma,04-12-2005,276663,Uttar Pradesh,11,1,0,9,21,Pass
Kunal Reddy,21-05-2005,821260,Kerala,24,4,3,23,54,Pass
Peter Khan,13-01-2006,523555,West Bengal,3,17,21,23,64,Pass
Harjeet Verma,16-03-2006,864652,Rajasthan,4,17,18,14,53,Pass
Manpreet Mehta,11-12-2005,205411,West Bengal,3,14,23,13,53,Pass
Yash Singh,05-03-2006,456159,Chhattisgarh,9,17,6,8,40,Pass
Vivaan Mehta,09-04-2005,404571,Haryana,11,8,6,7,32,Pass
Aditya Khan,22-01-2006,661198,Telangana,1,18,20,17,56,Pass
David Reddy,13-06-2005,167380,Gujarat,13,24,9,13,59,Pass
Rohan Reddy,21-06-2005,952410,Kerala,11,4,1,5,21,Pass
Manpreet Sharma,01-11-2005,667061,Odisha,2,22,24,13,61,Pass
Manpreet D'Souza,29-12-2005,317147,Uttar Pradesh,3,1,19,23,46,Pass
Aryan Pillai,15-04-2006,652013,Maharashtra,11,3,9,15,38,Pass
Krishna Verma,08-09-2005,878296,Rajasthan,3,4,14,24,45,Pass
Yash D'Souza,09-11-2005,270324,Rajasthan,24,12,6,6,48,Pass
Rohan Singh,07-11-2005,683931,West Bengal,18,18,6,10,52,Pass
Paul Pillai,03-01-2005,927735,Bihar,21,4,18,2,45,Pass
Aarav Reddy,01-08-2005,236104,West Bengal,0,2,12,15,29,Pass
Aarav Khan,12-01-2005,146410,Odisha,15,24,8,24,71,Pass
Raj Khan,11-03-2005,381046,Tamil Nadu,12,10,16,23,61,Pass
Yash Fernandes,29-12-2004,949401,Kerala,4,7,15,9,35,Pass
David Verma,13-10-2005,756349,Rajasthan,12,16,17,2,47,Pass
Krishna D'Souza,17-05-2005,848582,Delhi,9,2,4,5,20,Pass
Krishna Pillai,03-06-2005,521894,Uttar Pradesh,24,1,3,5,33,Pass
Balbir Pillai,07-07-2005,507178,Jammu & Kashmir + Ladakh,19,7,12,4,42,Pass
Balbir Pillai,14-06-2005,741565,Haryana,7,15,22,3,47,Pass
Ishaan Sharma,22-04-2005,593489,Uttar Pradesh,3,1,16,22,42,Pass
Manpreet Mehta,01-04-2005,800162,Rajasthan,10,15,4,6,35,Pass
Krishna Chopra,28-03-2006,698252,Odisha,18,4,5,5,32,Pass
Krishna Reddy,11-12-2005,803202,Tamil Nadu,13,17,23,12,65,Pass
Peter Mehta,13-05-2005,927421,Andhra Pradesh,19,5,19,1,44,Pass
Raj Singh,06-04-2005,886786,Haryana,15,5,19,14,53,Pass
Aryan Fernandes,07-01-2005,283486,Punjab,14,6,0,14,34,Pass
Kunal Reddy,25-04-2005,384021,Meghalaya,7,22,14,7,50,Pass
Harjeet Pillai,01-04-2005,457053,Himachal Pradesh,4,15,1,13,33,Pass
Rohan Khan,30-12-2004,168849,Andhra Pradesh,9,4,3,13,29,Pass
Farhan Sharma,19-12-2005,253292,Uttar Pradesh,23,1,10,10,44,Pass
Aarav Pillai,27-08-2005,145441,Mizoram,7,2,7,10,26,Pass
Krishna Khan,31-12-2004,751351,Madhya Pradesh,23,23,14,4,64,Pass
Yash Reddy,01-01-2005,804858,Maharashtra,6,4,20,17,47,Pass
Yash Mehta,24-09-2005,957588,Uttar Pradesh,19,1,13,14,47,Pass
Kunal Khan,07-06-2005,259019,Rajasthan,17,17,12,19,65,Pass
Aryan Khan,10-06-2005,933761,Haryana,7,0,16,20,43,Pass
Vivaan Khan,10-03-2005,467235,Madhya Pradesh,13,1,20,4,38,Pass
Imran Fernandes,18-06-2005,748912,Madhya Pradesh,6,2,21,18,47,Pass
Farhan Sharma,08-11-2005,236288,Maharashtra,2,9,11,9,31,Pass
Harjeet Fernandes,29-03-2005,190972,Andhra Pradesh,1,11,20,12,44,Pass
Yash Pillai,04-10-2005,944047,Rajasthan,4,10,1,14,29,Pass
Aditya D'Souza,26-12-2005,574052,Gujarat,17,10,19,16,62,Pass
Aryan Reddy,19-07-2005,236031,Rajasthan,0,3,7,1,11,Pass
Balbir Chopra,10-04-2005,211393,Bihar,9,12,15,1,37,Pass
Harjeet Pillai,28-03-2006,783586,Rajasthan,10,20,18,3,51,Pass
Yash Verma,12-10-2005,804305,Andhra Pradesh,1,1,22,22,46,Pass
Raj Khan,01-04-2006,125230,Maharashtra,10,24,3,0,37,Pass
Aryan Reddy,18-12-2005,226833,Uttar Pradesh,12,1,0,21,34,Pass
Sukhwinder Pillai,15-01-2006,627947,Delhi,14,23,11,13,61,Pass
Manpreet Chopra,22-01-2006,933681,Tamil Nadu,8,0,2,5,15,Pass
Vivaan Reddy,07-06-2005,359602,Tamil Nadu,8,4,24,8,44,Pass
Vivaan D'Souza,26-04-2005,296921,Jharkhand,6,2,22,16,46,Pass
Mathew D'Souza,31-03-2006,444240,Bihar,17,16,18,10,61,Pass
Rohan Pillai,05-01-2006,155761,Bihar,15,11,23,1,50,Pass
Ishaan Pillai,16-12-2004,701933,Bihar,9,1,0,24,34,Pass
Aryan D'Souza,03-01-2006,310063,Gujarat,13,5,19,21,58,Pass
Mathew Fernandes,08-03-2006,609548,Rajasthan,9,9,17,22,57,Pass
Sukhwinder Chopra,05-05-2005,165819,Haryana,10,17,10,24,61,Pass
Ishaan Chopra,11-09-2005,965043,Andhra Pradesh,5,20,0,19,44,Pass
Kunal D'Souza,25-04-2006,322157,Jammu & Kashmir + Ladakh,20,1,18,14,53,Pass
Ishaan D'Souza,08-04-2006,995835,Telangana,23,15,18,13,69,Pass
Raj Sharma,02-02-2006,823010,Rajasthan,5,2,1,11,19,Pass
Balbir Reddy,08-01-2005,243075,Bihar,15,4,1,1,21,Pass
Krishna Khan,24-05-2005,741209,Rajasthan,23,16,15,19,73,Pass
Imran Singh,14-01-2006,732549,Bihar,6,2,0,15,23,Pass
Zaid Reddy,26-04-2006,258187,Punjab,15,3,6,6,30,Pass
Peter Mehta,09-10-2005,925651,Gujarat,22,20,9,16,67,Pass
Raj Verma,22-12-2005,754019,West Bengal,11,3,15,24,53,Pass
Vivaan Sharma,20-04-2005,388412,Rajasthan,18,23,8,23,72,Pass
Farhan Singh,10-08-2005,467140,Uttar Pradesh,17,1,7,16,41,Pass
Yash D'Souza,05-09-2005,442516,Maharashtra,22,1,3,16,42,Pass
Manpreet Khan,04-03-2006,950635,Rajasthan,10,19,2,14,45,Pass
Vivaan D'Souza,16-08-2005,250442,Uttarakhand,7,13,13,5,38,Pass
Gurpreet Reddy,19-07-2005,621454,Andhra Pradesh,2,23,24,0,49,Pass
Aditya Mehta,27-09-2005,287725,Tamil Nadu,24,9,9,10,52,Pass
Raj Verma,23-03-2006,125707,Karnataka,21,14,3,1,39,Pass
Aditya Reddy,09-01-2005,908831,Rajasthan,8,15,9,18,50,Pass
Ishaan Sharma,22-11-2004,380484,Maharashtra,14,4,16,23,57,Pass
Aryan Khan,19-01-2006,996492,Jharkhand,9,21,2,0,32,Pass
Ishaan Reddy,09-12-2005,968603,Haryana,7,24,6,5,42,Pass
Aarav Mehta,12-10-2005,607092,Gujarat,9,0,23,2,34,Pass
Aryan Pillai,22-01-2005,218237,Assam,3,4,21,23,51,Pass
Harjeet Khan,05-08-2005,435713,Haryana,10,12,19,5,46,Pass
Manpreet Chopra,22-03-2005,779519,Madhya Pradesh,8,0,11,7,26,Pass
Rohan Chopra,19-12-2005,686291,Madhya Pradesh,4,3,20,17,44,Pass
Ishaan Khan,23-05-2005,578389,Uttar Pradesh,5,1,5,23,34,Pass
Krishna Verma,04-04-2005,696998,Chhattisgarh,9,15,21,19,64,Pass
Aditya Chopra,15-11-2004,764283,Telangana,2,4,10,4,20,Pass
Kunal Khan,28-02-2006,955634,Tamil Nadu,11,0,10,0,21,Pass
Aditya Khan,20-03-2006,801546,Maharashtra,21,4,3,24,52,Pass
Ishaan Singh,18-07-2005,745141,Rajasthan,17,22,5,17,61,Pass
Yash Mehta,16-03-2006,308744,Haryana,3,17,15,22,57,Pass
Yash Singh,10-12-2005,992211,Jharkhand,9,1,6,16,32,Pass
Krishna Khan,01-08-2005,899254,West Bengal,3,5,17,21,46,Pass
Rehan Mehta,30-03-2005,998332,Bihar,15,1,1,10,27,Pass
Yash Fernandes,23-04-2006,991604,Chhattisgarh,14,2,21,10,47,Pass
Zaid Mehta,12-12-2005,906391,Andhra Pradesh,19,8,12,1,40,Pass
Aditya Mehta,27-12-2005,859252,Haryana,6,9,24,8,47,Pass
Aditya Singh,07-03-2006,644063,Kerala,2,10,11,9,32,Pass
Aryan Singh,29-06-2005,113737,Uttar Pradesh,2,1,24,1,28,Pass
David Chopra,10-06-2005,226123,Uttar Pradesh,1,1,21,10,33,Pass
Vivaan Mehta,25-02-2005,454252,Bihar,4,2,5,6,17,Pass
Vivaan Mehta,29-12-2005,724821,Bihar,3,19,20,13,55,Pass
Zaid Fernandes,04-04-2005,991698,Assam,7,8,5,7,27,Pass
David Reddy,03-03-2006,422910,Delhi,22,24,23,8,77,Pass
Ishaan Pillai,04-12-2004,407763,Chhattisgarh,1,1,13,5,20,Pass
Raj Verma,20-12-2005,455403,Uttar Pradesh,1,1,13,14,29,Pass
Aryan Pillai,03-03-2005,937686,Kerala,4,19,2,6,31,Pass
Balbir Fernandes,07-04-2005,842456,Telangana,6,11,10,1,28,Pass
Harjeet Singh,19-04-2005,217249,Gujarat,12,20,18,17,67,Pass
Kunal D'Souza,15-08-2005,277016,Bihar,24,22,9,10,65,Pass
Krishna Sharma,08-07-2005,645395,Chhattisgarh,10,21,16,10,57,Pass
Aditya Sharma,01-09-2005,675804,Rajasthan,17,14,22,9,62,Pass
Vivaan Mehta,07-12-2004,324809,Andhra Pradesh,21,17,18,10,66,Pass
Krishna Khan,17-05-2005,631224,West Bengal,3,22,24,13,62,Pass
Krishna Khan,10-05-2005,952945,Delhi,15,11,15,23,64,Pass
John D'Souza,16-02-2005,805078,Assam,0,5,0,7,12,Pass
Vivaan Reddy,18-10-2005,147489,Maharashtra,3,6,1,16,26,Pass
John Chopra,27-12-2005,240935,Madhya Pradesh,10,7,18,11,46,Pass
Aarav Mehta,15-06-2005,571578,Telangana,7,5,2,12,26,Pass
Yash Chopra,28-12-2005,520575,Gujarat,14,22,15,22,73,Pass
Krishna Sharma,08-05-2006,263070,Uttarakhand,19,8,1,4,32,Pass
Rohan Chopra,21-10-2005,668328,Haryana,9,0,17,20,46,Pass
Rohan Khan,08-09-2005,474984,Jharkhand,5,5,5,6,21,Pass
Aryan Singh,13-03-2005,838092,Rajasthan,3,17,8,19,47,Pass
Rohan Khan,06-04-2006,461379,Nagaland,4,7,6,17,34,Pass
Aryan Mehta,11-04-2006,589118,Tamil Nadu,19,14,12,2,47,Pass
Yash Sharma,18-01-2006,873776,Punjab,0,11,19,8,38,Pass
Aryan Khan,20-02-2006,888557,Gujarat,1,10,4,23,38,Pass
Balbir Khan,20-12-2004,246296,Rajasthan,3,14,24,19,60,Pass
Aditya Verma,15-12-2004,182472,Maharashtra,13,4,11,20,48,Pass
Rohan Khan,06-01-2006,514244,Maharashtra,23,4,18,12,57,Pass
Yash Mehta,27-03-2005,559600,Madhya Pradesh,5,23,1,14,43,Pass
Raj Chopra,04-04-2005,729266,Gujarat,11,18,22,16,67,Pass
Krishna Chopra,09-07-2005,548641,Bihar,14,15,2,14,45,Pass
Paul Pillai,18-04-2005,586879,Tamil Nadu,8,5,16,14,43,Pass
Aditya Chopra,06-05-2006,727773,Rajasthan,6,21,17,7,51,Pass
Rohan Singh,26-07-2005,761423,Punjab,8,19,8,9,44,Pass
Yash Khan,14-02-2005,452093,Madhya Pradesh,3,2,1,15,21,Pass
Vivaan Verma,27-12-2005,621162,Odisha,15,9,6,4,34,Pass
Aarav Chopra,13-04-2006,230822,Karnataka,24,17,14,11,66,Pass
Rohan Fernandes,11-07-2005,523101,Haryana,21,11,8,9,49,Pass
David Singh,27-06-2005,281109,Rajasthan,8,19,2,22,51,Pass
Yash Chopra,02-02-2006,107887,Assam,3,20,23,22,68,Pass
Rohan Fernandes,23-11-2005,736421,Andhra Pradesh,7,21,9,15,52,Pass
Paul Pillai,05-03-2005,113322,Rajasthan,13,7,2,6,28,Pass
Aditya Sharma,09-02-2006,307833,Rajasthan,21,6,17,1,45,Pass
David Verma,10-02-2005,328059,Maharashtra,14,10,3,10,37,Pass
Ishaan Khan,03-04-2006,210641,Rajasthan,19,20,12,19,70,Pass
Paul Pillai,27-05-2005,619738,Rajasthan,16,22,12,6,56,Pass
David Reddy,14-02-2006,286596,Madhya Pradesh,20,18,13,2,53,Pass
Kunal Fernandes,13-02-2006,222259,Bihar,6,12,8,12,38,Pass
Balbir Sharma,17-12-2004,832242,Odisha,19,18,4,22,63,Pass
Peter Sharma,22-02-2005,716770,Bihar,10,19,10,4,43,Pass
Sukhwinder Sharma,04-04-2005,843863,Tamil Nadu,15,8,18,22,63,Pass
Yash Singh,06-03-2006,389100,Haryana,0,13,19,12,44,Pass
Kunal Pillai,25-04-2006,874491,Madhya Pradesh,4,18,20,4,46,Pass
Vivaan Verma,31-05-2005,319692,Rajasthan,4,0,21,6,31,Pass
Vivaan Sharma,02-01-2005,236727,Rajasthan,2,2,12,20,36,Pass
Raj Mehta,26-03-2006,662315,Manipur,2,1,2,12,17,Pass
Aditya Singh,17-09-2005,922886,Rajasthan,9,19,5,12,45,Pass
Raj Pillai,29-04-2006,728313,Uttar Pradesh,18,1,2,22,43,Pass
Aditya Sharma,04-11-2005,373563,Uttar Pradesh,12,1,7,10,30,Pass
Kunal Khan,11-01-2005,365234,Uttar Pradesh,7,1,23,10,41,Pass
Aditya Mehta,20-12-2004,706649,Madhya Pradesh,3,21,15,12,51,Pass
Krishna Reddy,12-04-2006,810864,Punjab,1,5,1,7,14,Pass
Aditya D'Souza,06-07-2005,597017,Rajasthan,6,4,0,18,28,Pass
Kunal Fernandes,18-03-2006,814284,Rajasthan,24,22,7,2,55,Pass
Raj Mehta,23-01-2005,876790,Bihar,24,22,5,6,57,Pass
Krishna Verma,28-06-2005,347432,Uttar Pradesh,18,1,6,11,36,Pass
Aarav Chopra,10-12-2005,160828,Rajasthan,21,14,15,15,65,Pass
Aditya Sharma,23-01-2006,254978,Assam,3,22,5,16,46,Pass
Kunal Fernandes,04-01-2005,472652,Bihar,19,11,6,4,40,Pass
Balbir D'Souza,27-03-2005,717526,Andhra Pradesh,7,20,7,2,36,Pass
Harjeet Fernandes,07-05-2005,400498,Andaman & Nicobar,4,4,5,20,33,Fail
Krishna Chopra,29-01-2005,898508,Meghalaya,16,6,8,5,35,Pass
Sukhwinder Singh,30-05-2005,161919,Madhya Pradesh,17,6,20,1,44,Pass
Aarav Fernandes,20-07-2005,214199,Karnataka,8,8,13,20,49,Pass
David Verma,08-02-2006,106242,Rajasthan,7,23,23,10,63,Pass
Balbir Verma,04-03-2005,132925,Andhra Pradesh,23,16,7,3,49,Pass
Vivaan Sharma,07-02-2005,670680,Rajasthan,2,16,4,12,34,Pass
Ishaan Mehta,01-07-2005,500990,Haryana,10,9,1,4,24,Pass
Rohan Fernandes,02-03-2005,656125,Uttar Pradesh,18,1,18,0,37,Pass
John Fernandes,23-11-2005,371484,Madhya Pradesh,18,9,24,4,55,Pass
Krishna D'Souza,09-07-2005,151652,Uttarakhand,16,13,6,1,36,Pass
Manpreet Reddy,06-10-2005,295497,Madhya Pradesh,7,6,9,7,29,Pass
Vivaan Singh,04-11-2005,857245,Andhra Pradesh,18,9,6,2,35,Pass
Yash Verma,13-04-2005,544861,Haryana,17,12,2,5,36,Pass
Rohan Khan,27-03-2005,374585,Odisha,24,5,4,21,54,Pass
Harjeet D'Souza,20-05-2005,688315,Madhya Pradesh,2,15,0,5,22,Pass
Kunal Sharma,11-10-2005,129839,Himachal Pradesh,8,12,19,5,44,Pass
Sukhwinder Mehta,22-10-2005,654349,Uttar Pradesh,5,1,22,23,51,Pass
Aditya Chopra,15-09-2005,755200,Haryana,6,14,1,18,39,Pass
Krishna Chopra,05-02-2006,380564,Rajasthan,18,24,13,13,68,Pass
Krishna Khan,07-04-2006,335036,Rajasthan,6,19,21,21,67,Pass
Aryan Fernandes,16-08-2005,113551,Bihar,11,4,2,16,33,Pass
Aryan Sharma,26-09-2005,617534,Telangana,24,21,0,23,68,Pass
Aryan Fernandes,12-06-2005,554725,Rajasthan,14,24,13,7,58,Pass
Aryan Verma,12-09-2005,701758,Telangana,15,0,2,24,41,Pass
Aditya Sharma,17-06-2005,425989,Rajasthan,18,6,7,5,36,Pass
Ishaan Fernandes,23-05-2005,956526,Jharkhand,3,16,16,9,44,Pass
Vivaan Khan,02-09-2005,926380,Jharkhand,5,0,9,4,18,Pass
Vivaan Fernandes,13-03-2006,878386,Bihar,8,11,18,7,44,Pass
Rohan Khan,03-01-2005,212219,Haryana,4,23,23,13,63,Pass
Ishaan Reddy,26-01-2005,486621,Tamil Nadu,14,9,3,5,31,Pass
Aryan Chopra,19-12-2004,977908,Uttar Pradesh,22,1,24,3,50,Pass
Vivaan Reddy,07-10-2005,403593,Uttar Pradesh,12,1,15,12,40,Pass
Kunal Chopra,17-04-2006,180822,Odisha,8,13,1,21,43,Pass
Aryan Singh,10-09-2005,793133,Gujarat,19,9,4,15,47,Pass
Aarav Pillai,03-10-2005,135112,Haryana,15,2,3,17,37,Pass
John Mehta,14-02-2005,525241,Rajasthan,8,14,10,6,38,Pass
Mathew Pillai,31-05-2005,852367,Tamil Nadu,12,11,23,8,54,Pass
Aditya Verma,08-01-2006,457835,Gujarat,20,13,6,14,53,Pass
Aarav Khan,09-08-2005,686587,Telangana,12,22,3,20,57,Pass
Peter Khan,31-01-2005,297507,West Bengal,3,2,24,22,51,Pass
Yash Sharma,19-06-2005,496023,Tamil Nadu,12,8,3,22,45,Pass
Aditya Reddy,07-07-2005,702826,Bihar,7,9,12,4,32,Pass
Raj Singh,29-12-2004,758237,West Bengal,11,12,0,3,26,Pass
Aditya Sharma,01-09-2005,497127,Andhra Pradesh,0,9,0,19,28,Pass
Aryan Singh,31-07-2005,501757,Maharashtra,7,4,2,20,33,Pass
Raj Sharma,20-03-2005,542606,Andhra Pradesh,24,15,24,2,65,Pass
Yash Pillai,26-04-2005,933374,Bihar,0,23,12,9,44,Pass
Peter Sharma,08-09-2005,127532,Gujarat,6,1,20,5,32,Pass
Vivaan Reddy,12-04-2005,580987,Uttar Pradesh,18,1,4,18,41,Pass
Rohan Pillai,27-11-2004,824772,Chhattisgarh,4,19,4,22,49,Pass
Aditya Reddy,16-01-2006,369999,West Bengal,6,16,8,12,42,Pass
Harjeet Verma,19-03-2006,367361,Uttar Pradesh,3,1,3,8,15,Pass
Kunal Chopra,04-12-2004,349499,West Bengal,10,21,12,8,51,Pass
Rehan Singh,06-02-2006,548951,Bihar,10,3,6,9,28,Pass
Harjeet Mehta,31-01-2006,923891,Punjab,5,12,10,17,44,Pass
Raj Pillai,03-02-2005,434831,Uttar Pradesh,3,1,21,21,46,Pass
Sukhwinder Khan,11-12-2005,712542,Andhra Pradesh,9,14,14,17,54,Pass
Mathew Chopra,04-01-2006,335017,Madhya Pradesh,23,4,24,4,55,Pass
Aarav Mehta,24-10-2005,907259,Karnataka,0,7,23,0,30,Pass
Yash Pillai,17-01-2006,349508,Rajasthan,8,9,6,15,38,Pass
Sukhwinder Singh,15-02-2006,357007,Uttarakhand,23,3,4,19,49,Pass
Aarav D'Souza,29-01-2005,537619,Andhra Pradesh,9,15,12,6,42,Pass
Raj Khan,18-03-2006,745728,Jammu & Kashmir + Ladakh,7,2,24,4,37,Pass
Raj D'Souza,26-10-2005,198292,Maharashtra,24,4,8,5,41,Pass
Ishaan Chopra,04-11-2005,439522,Rajasthan,5,8,0,0,13,Pass
Kunal Sharma,05-03-2006,743200,Tamil Nadu,0,5,6,22,33,Pass
Raj Khan,09-04-2005,344965,Uttar Pradesh,19,1,0,17,37,Pass
Harjeet Singh,14-04-2005,706092,Chhattisgarh,13,16,23,24,76,Pass
Krishna Reddy,27-11-2004,229238,Jammu & Kashmir + Ladakh,6,6,8,1,21,Pass
Aryan Reddy,17-12-2005,172072,Uttar Pradesh,17,1,11,1,30,Pass
Yash Mehta,06-04-2006,652479,Uttar Pradesh,5,1,0,7,13,Pass
Rohan D'Souza,28-11-2004,369369,Uttar Pradesh,12,1,13,3,29,Pass
Farhan Verma,12-08-2005,809219,Mizoram,4,5,8,5,22,Pass
Krishna Mehta,23-02-2006,518288,West Bengal,11,13,1,14,39,Pass
Raj Chopra,01-02-2006,648300,West Bengal,3,11,23,20,57,Pass
Kunal D'Souza,07-04-2006,493405,Rajasthan,10,3,24,0,37,Pass
Aryan Verma,05-08-2005,826166,Tamil Nadu,3,10,8,10,31,Pass
Aarav Chopra,05-03-2006,859097,West Bengal,12,5,10,13,40,Pass
Krishna Verma,20-03-2005,506498,West Bengal,19,23,5,0,47,Pass
Raj Reddy,04-08-2005,624372,Karnataka,22,22,19,5,68,Pass
Balbir Pillai,20-10-2005,453346,Rajasthan,7,0,12,0,19,Pass
David Verma,09-10-2005,893950,Rajasthan,5,24,15,0,44,Pass
Raj Sharma,25-11-2005,821519,Maharashtra,22,0,14,8,44,Pass
Ishaan Fernandes,28-06-2005,869729,Uttar Pradesh,9,1,19,16,45,Pass
Ishaan Chopra,15-02-2005,714067,Uttar Pradesh,4,1,12,24,41,Pass
Aryan Mehta,19-05-2005,145275,Bihar,18,3,15,14,50,Pass
Imran Fernandes,19-02-2005,168607,Maharashtra,1,23,4,10,38,Pass
Paul Pillai,06-11-2005,465345,Assam,24,3,6,14,47,Pass
Yash Reddy,07-03-2006,561407,Bihar,19,10,22,24,75,Pass
John Pillai,15-05-2005,566062,Telangana,23,22,4,8,57,Pass
Krishna Reddy,18-09-2005,517779,Rajasthan,6,6,11,15,38,Pass
Ayaan D'Souza,12-06-2005,983595,Bihar,3,15,3,15,36,Pass
Rohan Singh,07-10-2005,892017,Bihar,17,14,10,11,52,Pass
Raj Singh,10-11-2004,248270,Haryana,11,17,20,19,67,Pass
Gurpreet Sharma,11-10-2005,999549,Bihar,1,7,12,5,25,Pass
Harjeet Verma,25-01-2006,617286,Gujarat,14,3,14,16,47,Pass
Vivaan Khan,14-01-2006,130251,Telangana,5,17,5,11,38,Pass
Vivaan D'Souza,17-03-2006,349784,Punjab,12,7,13,12,44,Pass
Kunal Sharma,14-04-2005,338850,Haryana,21,1,1,10,33,Pass
Aarav Fernandes,24-01-2005,349625,Jharkhand,1,8,6,5,20,Pass
Kunal D'Souza,29-01-2006,261451,Tamil Nadu,1,23,1,15,40,Pass
Raj Pillai,28-03-2005,806963,Jharkhand,24,23,14,5,66,Pass
Harjeet D'Souza,10-11-2004,224318,Madhya Pradesh,19,19,9,4,51,Pass
Vivaan Singh,22-12-2004,757604,Bihar,20,21,4,14,59,Pass
Ishaan Fernandes,29-03-2005,727339,Uttar Pradesh,17,1,1,9,28,Pass
Aarav Pillai,02-03-2005,633094,Bihar,3,8,0,15,26,Pass
Raj Mehta,10-01-2006,544734,Bihar,20,2,15,2,39,Pass
Kunal Fernandes,19-06-2005,963948,Haryana,17,20,21,17,75,Pass
Balbir Singh,20-10-2005,844955,Tamil Nadu,8,3,3,12,26,Pass
Kunal Chopra,28-08-2005,392089,Andhra Pradesh,3,23,11,11,48,Pass
Rohan Chopra,09-05-2005,736849,Maharashtra,13,4,11,6,34,Pass
Farhan Pillai,28-06-2005,851958,Kerala,2,20,19,9,50,Pass
Krishna Fernandes,15-07-2005,228353,Uttar Pradesh,12,1,3,1,17,Pass
Aditya Sharma,22-11-2005,900565,Telangana,13,14,20,20,67,Pass
Manpreet Mehta,11-02-2005,591500,Bihar,0,8,1,7,16,Pass
Aryan Khan,05-01-2005,661427,Maharashtra,13,4,15,20,52,Pass
Rohan Verma,17-10-2005,879878,Bihar,6,24,1,10,41,Pass
Yash Reddy,13-05-2005,988687,Madhya Pradesh,10,18,14,4,46,Pass
Peter Mehta,08-01-2006,534286,Rajasthan,10,2,21,0,33,Pass
Mathew Singh,04-04-2005,312312,Madhya Pradesh,8,18,4,14,44,Pass
Aditya Khan,25-07-2005,916023,Tamil Nadu,21,13,20,19,73,Pass
Krishna Reddy,16-04-2005,457357,Maharashtra,15,1,12,5,33,Pass
Rohan Chopra,22-12-2004,147759,Telangana,22,13,12,16,63,Pass
Ishaan Mehta,29-12-2005,460475,Manipur,4,11,18,17,50,Pass
Sukhwinder Singh,01-09-2005,605672,Odisha,23,8,15,10,56,Pass
David Fernandes,07-01-2006,778040,Punjab,3,7,20,13,43,Pass
Yash Verma,03-10-2005,512373,Delhi,22,12,5,17,56,Pass
Kunal Pillai,01-01-2006,286111,Uttar Pradesh,15,1,9,18,43,Pass
Rohan Verma,25-11-2004,276548,Andhra Pradesh,6,2,12,6,26,Pass
Manpreet Sharma,27-11-2004,531337,Uttar Pradesh,22,1,18,18,59,Pass
Paul Fernandes,10-02-2005,618085,Uttar Pradesh,10,1,24,24,59,Pass
Manpreet Verma,20-02-2005,841422,Uttar Pradesh,15,1,16,18,50,Pass
Kunal Singh,15-01-2006,355687,Madhya Pradesh,22,19,24,4,69,Pass
Raj Mehta,20-01-2006,676613,Uttar Pradesh,18,1,20,15,54,Pass
Ishaan Reddy,02-09-2005,182379,Rajasthan,14,15,15,17,61,Pass
Kunal Fernandes,27-08-2005,399469,Uttar Pradesh,24,1,6,11,42,Pass
Raj Singh,03-08-2005,588240,Punjab,16,20,17,17,70,Pass
Rohan Pillai,22-01-2006,230587,Haryana,23,23,13,21,80,Pass
Paul Pillai,06-12-2004,433553,Rajasthan,2,1,9,2,14,Pass
Peter D'Souza,25-02-2006,865539,Madhya Pradesh,17,16,15,4,52,Pass
Yash Singh,08-11-2004,408851,Delhi,10,12,14,22,58,Pass
Ishaan D'Souza,12-11-2005,415801,Rajasthan,6,20,12,5,43,Pass
Aditya Pillai,17-06-2005,214955,West Bengal,15,7,23,4,49,Pass
Harjeet Sharma,16-11-2005,763009,Madhya Pradesh,12,14,1,1,28,Pass
Aditya Fernandes,30-12-2004,835175,Uttar Pradesh,4,1,12,19,36,Pass
Aryan Reddy,08-01-2005,872465,Jharkhand,15,11,9,15,50,Pass
Rohan Sharma,07-01-2005,865611,Madhya Pradesh,9,7,21,8,45,Pass
Ayaan Chopra,03-03-2005,667228,Madhya Pradesh,7,19,9,7,42,Pass
Raj Fernandes,10-11-2005,204961,Rajasthan,1,21,9,4,35,Pass
Kunal Sharma,08-08-2005,510618,Jammu & Kashmir + Ladakh,6,4,10,14,34,Pass
David Pillai,27-01-2006,692738,Rajasthan,21,19,1,0,41,Pass
Raj Pillai,28-12-2004,901835,Andhra Pradesh,14,1,17,4,36,Pass
Kunal Singh,06-04-2005,132895,Madhya Pradesh,22,21,23,4,70,Pass
Yash Khan,14-07-2005,725863,Telangana,15,5,8,0,28,Pass
Raj Singh,09-01-2006,967223,Nagaland,6,5,4,7,22,Pass
Manpreet Reddy,06-11-2005,642285,Maharashtra,7,4,22,23,56,Pass
Paul Fernandes,07-11-2005,352921,Uttar Pradesh,10,1,1,16,28,Pass
Yash Fernandes,31-10-2005,329785,Meghalaya,6,20,0,5,31,Pass
Raj Fernandes,08-10-2005,898771,Telangana,19,17,16,2,54,Pass
Ishaan Fernandes,17-02-2005,135187,Uttar Pradesh,3,1,7,22,33,Pass
Krishna Fernandes,17-04-2006,914429,West Bengal,3,15,7,18,43,Pass
David Pillai,10-01-2005,297094,Uttar Pradesh,1,1,0,14,16,Pass
Raj Mehta,10-05-2005,667952,Uttar Pradesh,2,1,4,22,29,Pass
Ishaan Mehta,16-05-2005,596932,Bihar,10,10,11,10,41,Pass
Ishaan Khan,01-01-2006,387985,Tamil Nadu,10,19,17,4,50,Pass
Rohan Reddy,16-12-2004,474444,Chhattisgarh,18,20,23,18,79,Pass
Aryan Mehta,01-05-2005,101346,Bihar,18,20,2,14,54,Pass
Balbir Khan,21-05-2005,717470,Maharashtra,18,6,4,15,43,Pass
Mathew Fernandes,23-05-2005,216931,Madhya Pradesh,23,16,18,4,61,Pass
Mathew Pillai,27-04-2005,743792,Rajasthan,20,15,1,0,36,Pass
Aarav D'Souza,05-04-2005,964609,Telangana,16,3,17,24,60,Pass
Raj Reddy,22-06-2005,846234,Andaman & Nicobar,21,23,3,4,51,Fail
Ishaan Chopra,03-05-2006,338515,Bihar,2,22,2,0,26,Pass
Aarav Fernandes,08-01-2006,781438,Jharkhand,1,20,19,0,40,Pass
John D'Souza,25-12-2004,573691,Maharashtra,5,4,22,21,52,Pass
Yash Fernandes,29-12-2004,162395,West Bengal,11,16,19,7,53,Pass
Aarav Khan,14-12-2004,677151,Chhattisgarh,20,2,7,1,30,Pass
Aryan Fernandes,24-02-2006,832691,Maharashtra,23,4,23,16,66,Pass
Rohan Singh,07-12-2004,724073,Tamil Nadu,19,24,24,14,81,Pass
Krishna Sharma,21-02-2006,787486,Madhya Pradesh,24,6,9,4,43,Pass
Yash Sharma,12-03-2005,791533,Bihar,4,18,23,8,53,Pass
John Khan,05-02-2006,105933,Uttar Pradesh,0,1,8,21,30,Pass
Harjeet D'Souza,27-10-2005,874894,Odisha,22,7,24,20,73,Pass
Vivaan Mehta,01-11-2005,784330,Punjab,0,18,19,13,50,Pass
Aarav Khan,17-01-2005,659621,Uttar Pradesh,7,1,10,17,35,Pass
Balbir Mehta,14-04-2006,975113,Tamil Nadu,3,19,3,20,45,Pass
Ishaan Singh,11-12-2005,479853,Kerala,1,4,10,5,20,Pass
Ishaan D'Souza,11-06-2005,894271,Telangana,12,1,9,21,43,Pass
Aarav Khan,18-08-2005,641903,Jharkhand,7,13,2,24,46,Pass
Peter Sharma,08-09-2005,306862,Bihar,19,7,15,20,61,Pass
Farhan Fernandes,25-02-2006,509174,Tamil Nadu,14,4,1,4,23,Pass
Vivaan Chopra,13-01-2005,133610,West Bengal,19,7,0,9,35,Pass
Aarav Chopra,16-12-2004,866541,Maharashtra,22,4,20,24,70,Pass
Kunal Reddy,22-01-2006,767377,Maharashtra,20,4,17,17,58,Pass
Vivaan Fernandes,28-08-2005,206671,Punjab,4,6,6,22,38,Pass
Aryan Pillai,04-02-2006,459195,Rajasthan,10,19,9,18,56,Pass
Aditya Fernandes,26-02-2005,650141,Bihar,13,20,2,10,45,Pass
Ishaan Khan,21-11-2004,311268,Bihar,17,4,22,1,44,Pass
David Singh,22-04-2005,690087,Kerala,16,23,22,3,64,Pass
Aditya Fernandes,04-02-2005,139788,Bihar,10,19,21,4,54,Pass
John Verma,23-11-2005,111616,Odisha,5,12,22,5,44,Pass
Kunal Khan,14-04-2006,340267,Madhya Pradesh,16,2,11,11,40,Pass
Rohan Sharma,17-02-2005,762248,Bihar,13,4,5,6,28,Pass
Manpreet Fernandes,25-07-2005,780586,Rajasthan,4,18,14,20,56,Pass
Harjeet D'Souza,15-04-2005,281370,Assam,22,14,16,6,58,Pass
Rohan Reddy,15-09-2005,966268,Telangana,15,1,21,13,50,Pass
Aditya Khan,17-08-2005,660624,Maharashtra,5,17,12,3,37,Pass
Kunal D'Souza,05-02-2005,376968,West Bengal,3,23,21,8,55,Pass
Mathew Pillai,12-01-2006,233713,Rajasthan,10,19,2,19,50,Pass
Paul Reddy,18-11-2004,534377,Chhattisgarh,9,22,10,3,44,Pass
Kunal Khan,13-05-2005,733392,Maharashtra,11,4,23,12,50,Pass
Kunal D'Souza,24-08-2005,559325,Tamil Nadu,7,12,6,6,31,Pass
Rohan Fernandes,09-05-2005,142866,Haryana,11,3,1,6,21,Pass
David Fernandes,16-12-2004,649415,Bihar,22,4,15,13,54,Pass
Rohan Reddy,05-11-2005,662608,West Bengal,3,16,1,21,41,Pass
Kunal D'Souza,08-03-2005,893307,Punjab,2,17,2,19,40,Pass
Krishna Sharma,18-07-2005,905270,Delhi,2,4,12,13,31,Pass
Ishaan Fernandes,16-07-2005,299753,Uttar Pradesh,22,1,8,13,44,Pass
Mathew Reddy,14-06-2005,589121,Bihar,13,21,13,23,70,Pass
Yash Reddy,25-08-2005,335240,Madhya Pradesh,11,13,1,22,47,Pass
Aryan Chopra,05-12-2004,628428,Madhya Pradesh,6,5,2,12,25,Pass
Raj Khan,12-11-2005,563943,Andhra Pradesh,0,17,19,10,46,Pass
Raj Fernandes,22-03-2006,933634,Uttar Pradesh,21,1,16,11,49,Pass
Gurpreet Verma,05-07-2005,872821,Bihar,18,3,3,16,40,Pass
Rehan Fernandes,28-11-2004,714713,Gujarat,13,24,19,2,58,Pass
Rohan Sharma,30-04-2005,566772,Uttar Pradesh,12,1,11,6,30,Pass
Rohan Pillai,22-11-2004,612207,Telangana,24,7,3,18,52,Pass
Paul Sharma,18-06-2005,711002,Kerala,16,19,19,8,62,Pass
Aditya Singh,23-03-2006,626475,Manipur,7,15,16,8,46,Pass
Zaid Singh,28-05-2005,903130,West Bengal,3,13,22,19,57,Pass
Vivaan Pillai,14-10-2005,901576,Uttar Pradesh,18,1,4,18,41,Pass
Aditya Mehta,14-12-2005,331222,Madhya Pradesh,19,13,23,4,59,Pass
Krishna Chopra,26-06-2005,191756,Tamil Nadu,10,14,10,8,42,Pass
Aditya Mehta,04-05-2006,675627,Haryana,21,5,21,24,71,Pass
Mathew Chopra,13-02-2005,336372,Uttarakhand,1,11,10,15,37,Pass
Yash Pillai,25-11-2004,778250,Rajasthan,9,19,17,14,59,Pass
Yash D'Souza,07-09-2005,396892,Bihar,12,20,13,8,53,Pass
Gurpreet Reddy,01-08-2005,572542,Rajasthan,4,8,18,21,51,Pass
Aarav Verma,22-02-2005,625595,Madhya Pradesh,6,16,1,13,36,Pass
Krishna Singh,21-11-2004,835075,West Bengal,8,2,22,17,49,Pass
Vivaan Singh,08-08-2005,923078,Uttar Pradesh,20,1,6,16,43,Pass
Ayaan Singh,05-10-2005,368433,Punjab,9,9,14,23,55,Pass
Paul Mehta,04-04-2006,216501,Bihar,1,18,24,13,56,Pass
Aryan Sharma,08-06-2005,348336,Tamil Nadu,22,20,9,23,74,Pass
Sukhwinder Reddy,12-12-2004,943727,Nagaland,5,18,2,5,30,Pass
Balbir Chopra,24-04-2006,324337,Uttar Pradesh,4,1,1,20,26,Pass
Aarav D'Souza,21-02-2006,841736,Maharashtra,17,4,6,19,46,Pass
Yash Verma,17-04-2005,347825,Madhya Pradesh,18,10,2,11,41,Pass
Raj Sharma,11-04-2006,553278,Himachal Pradesh,24,12,17,0,53,Pass
Kunal D'Souza,23-03-2006,488907,Himachal Pradesh,4,10,3,17,34,Pass
Raj Khan,05-03-2006,403738,Uttar Pradesh,19,1,8,13,41,Pass
Aryan Singh,06-07-2005,631608,Maharashtra,14,11,9,12,46,Pass
Aditya Chopra,29-09-2005,771818,Andhra Pradesh,3,22,12,0,37,Pass
Yash Verma,01-04-2006,695919,West Bengal,16,22,7,1,46,Pass
Sukhwinder Verma,03-12-2005,858997,Haryana,4,22,9,12,47,Pass
Raj Pillai,18-04-2006,347213,Andhra Pradesh,0,12,15,8,35,Pass
Harjeet Sharma,03-06-2005,891947,Maharashtra,24,15,2,5,46,Pass
Kunal Pillai,20-12-2005,843081,Delhi,21,5,9,3,38,Pass
Krishna Khan,28-04-2006,340926,Madhya Pradesh,18,21,13,4,56,Pass
Peter Reddy,19-12-2004,768187,Mizoram,3,4,9,19,35,Pass
Kunal Chopra,05-02-2005,182162,Tamil Nadu,23,3,8,9,43,Pass
Rohan Fernandes,25-04-2006,709788,Bihar,3,16,24,1,44,Pass
Harjeet Verma,12-02-2005,197120,Haryana,12,3,15,0,30,Pass
Raj Sharma,01-01-2006,187159,Andhra Pradesh,0,5,0,24,29,Pass
Balbir Fernandes,22-08-2005,831390,Madhya Pradesh,3,19,7,13,42,Pass
Rohan Fernandes,11-05-2005,272192,Karnataka,20,23,11,5,59,Pass
Yash Chopra,30-10-2005,480504,Bihar,16,14,11,19,60,Pass
David Pillai,02-02-2005,909004,Punjab,5,22,24,1,52,Pass
Kunal Sharma,12-11-2005,182864,Chhattisgarh,19,1,9,12,41,Pass
Ishaan Pillai,08-12-2004,730932,Uttarakhand,15,3,2,22,42,Pass
Aarav D'Souza,11-07-2005,503196,Maharashtra,11,2,2,21,36,Pass
Aditya Reddy,05-04-2005,598587,Rajasthan,2,13,23,3,41,Pass
Aditya Chopra,09-10-2005,498383,Uttar Pradesh,3,1,22,24,50,Pass
Kunal Reddy,25-04-2006,315236,Andhra Pradesh,11,8,12,15,46,Pass
Peter Pillai,20-01-2005,651546,Punjab,18,18,13,5,54,Pass
Rohan D'Souza,08-03-2006,309563,Rajasthan,21,2,0,17,40,Pass
Imran Chopra,24-11-2004,839223,Himachal Pradesh,9,11,17,9,46,Pass
Yash Singh,05-06-2005,438837,Haryana,10,19,20,7,56,Pass
Aditya Chopra,15-11-2005,126011,Maharashtra,21,7,2,20,50,Pass
Farhan Pillai,03-09-2005,354629,Punjab,22,10,6,4,42,Pass
Ayaan Mehta,15-02-2005,469460,Andaman & Nicobar,10,24,13,19,66,Fail
Aarav Khan,18-04-2005,462184,Andhra Pradesh,9,11,3,21,44,Pass
Raj Chopra,30-07-2005,528769,Madhya Pradesh,11,15,20,7,53,Pass
Vivaan Mehta,26-02-2005,176355,Madhya Pradesh,8,14,22,7,51,Pass
Kunal Fernandes,30-09-2005,572583,Delhi,20,12,24,3,59,Pass
Aryan Fernandes,10-03-2006,985028,West Bengal,16,6,2,24,48,Pass
Gurpreet Mehta,22-06-2005,461336,Odisha,8,6,9,0,23,Pass
Vivaan Mehta,04-12-2005,857752,Telangana,17,22,7,22,68,Pass
Aryan Chopra,17-11-2005,493703,Bihar,24,12,16,23,75,Pass
Aryan D'Souza,01-01-2006,172646,Rajasthan,8,20,6,12,46,Pass
Aditya Sharma,26-03-2006,445973,Andaman & Nicobar,23,23,14,13,73,Fail
Harjeet Singh,10-07-2005,764786,Punjab,14,20,14,5,53,Pass
Manpreet Verma,24-01-2005,629236,Bihar,21,21,9,11,62,Pass
Aryan Fernandes,26-04-2005,286194,Assam,12,7,6,23,48,Pass
Rohan Mehta,21-12-2005,611672,Maharashtra,23,0,2,11,36,Pass
Kunal Chopra,10-06-2005,591781,Bihar,3,5,24,6,38,Pass
Vivaan D'Souza,25-02-2005,707653,Kerala,2,1,10,8,21,Pass
Paul Sharma,18-05-2005,208334,Jharkhand,3,12,3,24,42,Pass
Kunal Chopra,17-12-2005,354147,Maharashtra,12,12,2,24,50,Pass
Aditya Singh,18-08-2005,990979,Bihar,17,9,18,18,62,Pass
Yash Fernandes,25-05-2005,137802,Kerala,15,16,6,13,50,Pass
Mathew Pillai,23-04-2005,262319,Rajasthan,9,2,9,21,41,Pass
Yash Sharma,14-04-2005,919223,Telangana,7,10,16,11,44,Pass
Sukhwinder Khan,03-08-2005,366371,Uttar Pradesh,8,1,21,16,46,Pass
Manpreet Singh,08-03-2006,509905,Andhra Pradesh,4,23,6,14,47,Pass
Aryan Mehta,14-02-2006,584626,Delhi,22,11,8,12,53,Pass
Aryan Khan,27-03-2005,842216,Tamil Nadu,21,20,24,21,86,Pass
Gurpreet Sharma,27-05-2005,297223,Rajasthan,12,23,17,0,52,Pass
Yash Fernandes,16-12-2004,831053,Uttar Pradesh,3,1,22,14,40,Pass
John Verma,17-04-2006,127561,Odisha,22,8,12,22,64,Pass
Rohan Mehta,31-12-2005,260732,Chhattisgarh,16,16,0,12,44,Pass
Ishaan Mehta,12-05-2005,724497,Kerala,5,16,21,1,43,Pass
Rohan Fernandes,05-08-2005,753804,Madhya Pradesh,17,12,2,14,45,Pass
Vivaan Verma,17-10-2005,878095,Bihar,15,20,22,17,74,Pass
Aditya Pillai,05-12-2004,389744,Bihar,1,24,13,19,57,Pass
John Pillai,02-02-2005,844303,Gujarat,12,22,6,8,48,Pass
Sukhwinder Khan,10-10-2005,358253,Telangana,17,7,13,2,39,Pass
Aryan Reddy,28-10-2005,323414,Bihar,15,15,1,16,47,Pass
Harjeet Chopra,18-02-2005,426879,Rajasthan,24,19,16,17,76,Pass
Krishna Singh,28-11-2005,503498,Bihar,19,11,17,22,69,Pass
Zaid Singh,06-11-2005,735268,Punjab,20,5,20,7,52,Pass
Vivaan Singh,11-02-2005,390795,Uttar Pradesh,16,1,15,7,39,Pass
David Reddy,31-01-2005,334496,Punjab,1,11,18,5,35,Pass
Gurpreet Pillai,19-11-2005,997978,Jharkhand,19,8,7,9,43,Pass
Mathew Khan,25-04-2006,538048,Maharashtra,6,11,2,17,36,Pass
Aarav Reddy,10-01-2005,733092,Uttarakhand,3,22,20,22,67,Pass
Kunal Reddy,13-03-2006,998160,Maharashtra,20,6,13,10,49,Pass
Krishna Pillai,25-02-2006,114809,Bihar,0,11,9,8,28,Pass
Raj Verma,13-11-2005,820626,Uttar Pradesh,13,1,22,2,38,Pass
Krishna Fernandes,18-03-2006,119077,Andhra Pradesh,12,18,10,11,51,Pass
Paul Reddy,17-03-2006,129308,Tamil Nadu,8,2,18,9,37,Pass
Aryan Sharma,22-01-2005,152394,Maharashtra,0,12,6,14,32,Pass
Vivaan Chopra,15-02-2005,694327,Uttar Pradesh,14,1,20,9,44,Pass
Krishna Verma,07-01-2005,400541,Telangana,0,2,9,7,18,Pass
Aarav Reddy,03-08-2005,604230,Delhi,16,15,19,17,67,Pass
David Verma,08-09-2005,681084,Uttar Pradesh,18,1,14,21,54,Pass
Vivaan Khan,21-10-2005,747388,Uttar Pradesh,8,1,8,18,35,Pass
Kunal Chopra,07-10-2005,501293,Haryana,23,2,12,20,57,Pass
Raj Pillai,26-04-2005,452109,Uttar Pradesh,20,1,9,19,49,Pass
Mathew Verma,11-07-2005,799268,Maharashtra,18,21,1,4,44,Pass
Yash Chopra,22-04-2006,413067,Madhya Pradesh,11,9,12,12,44,Pass
Peter Chopra,15-02-2006,463475,Tamil Nadu,9,1,5,11,26,Pass
Aarav Verma,19-05-2005,878256,Karnataka,15,6,8,8,37,Pass
Raj Mehta,22-02-2005,903217,Karnataka,8,8,9,9,34,Pass
Rohan Fernandes,24-06-2005,167860,West Bengal,10,5,14,14,43,Pass
Manpreet Pillai,25-10-2005,911358,Karnataka,10,8,15,2,35,Pass
Paul Sharma,22-07-2005,733166,Odisha,18,24,24,14,80,Pass
Manpreet Sharma,28-12-2005,556509,Bihar,14,4,5,12,35,Pass
Aryan Mehta,05-03-2005,954148,Tamil Nadu,19,11,5,10,45,Pass
Vivaan Fernandes,28-02-2006,772818,Tamil Nadu,23,3,19,21,66,Pass
David D'Souza,06-07-2005,389835,Bihar,5,6,4,20,35,Pass
Raj Singh,19-05-2005,612193,Tamil Nadu,24,17,3,16,60,Pass
Aditya Chopra,25-07-2005,507728,Rajasthan,21,14,8,3,46,Pass
Kunal Khan,01-12-2005,337015,Meghalaya,7,1,15,2,25,Pass
Kunal Pillai,01-02-2005,357561,Uttar Pradesh,1,1,8,23,33,Pass
Vivaan Singh,14-04-2006,419976,Uttarakhand,8,0,1,5,14,Pass
Yash Fernandes,20-12-2004,146466,Uttar Pradesh,11,1,16,22,50,Pass
Vivaan Pillai,28-07-2005,942131,Andhra Pradesh,12,13,6,23,54,Pass
Manpreet D'Souza,19-12-2004,802552,Haryana,7,12,13,11,43,Pass
Aditya Sharma,15-02-2005,404633,Daman & Diu / D&N Haveli,9,11,9,4,33,Pass
Krishna Reddy,30-01-2006,329173,Gujarat,14,7,10,13,44,Pass
Peter Fernandes,29-11-2004,229555,Haryana,9,3,22,24,58,Pass
Rohan Singh,25-08-2005,860457,Uttar Pradesh,6,1,11,4,22,Pass
Vivaan Reddy,14-12-2005,810185,Uttar Pradesh,17,1,13,10,41,Pass
Aryan Khan,14-09-2005,601461,Madhya Pradesh,21,20,19,4,64,Pass
Aryan Reddy,16-01-2006,252965,Punjab,19,13,5,15,52,Pass
Aryan Chopra,17-11-2004,740095,Himachal Pradesh,3,9,0,4,16,Pass
Kunal Sharma,16-01-2005,105587,Uttar Pradesh,6,1,4,15,26,Pass
Aarav Pillai,18-04-2006,582863,Uttar Pradesh,10,1,1,6,18,Pass
Krishna Chopra,05-03-2006,871716,Tamil Nadu,13,20,12,20,65,Pass
Aarav Singh,10-11-2004,526999,Punjab,20,8,21,0,49,Pass
Sukhwinder Chopra,04-09-2005,368794,Rajasthan,2,9,8,1,20,Pass
Kunal Verma,19-05-2005,754303,Haryana,0,11,10,2,23,Pass
Kunal Fernandes,18-11-2005,782648,Assam,21,18,4,21,64,Pass
Rohan Verma,10-11-2004,321286,Andhra Pradesh,0,21,5,0,26,Pass
Rohan D'Souza,16-04-2005,170025,Kerala,7,1,17,2,27,Pass
Aarav Fernandes,13-07-2005,808862,Tamil Nadu,11,16,21,23,71,Pass
David Mehta,26-01-2006,903882,Rajasthan,10,17,14,13,54,Pass
Aarav Fernandes,03-11-2005,459458,Uttar Pradesh,14,1,9,17,41,Pass
Aditya Sharma,05-12-2005,417064,Uttar Pradesh,4,1,19,19,43,Pass
Ishaan Sharma,30-11-2004,380911,Bihar,23,21,17,19,80,Pass
Aryan Chopra,14-09-2005,935376,Andhra Pradesh,4,2,16,20,42,Pass
Krishna Pillai,12-03-2006,179334,Tamil Nadu,16,1,6,6,29,Pass
David Chopra,15-10-2005,837559,Maharashtra,5,23,2,10,40,Pass
Aarav Sharma,29-03-2006,559724,Maharashtra,20,0,8,0,28,Pass
Rohan Verma,13-03-2006,639290,Chhattisgarh,22,24,8,19,73,Pass
Imran Singh,29-04-2005,766995,Haryana,20,7,23,18,68,Pass
Paul Singh,07-04-2006,482404,Himachal Pradesh,3,19,9,9,40,Pass
Rohan Singh,12-08-2005,556990,Haryana,16,22,14,17,69,Pass
Sukhwinder Sharma,25-03-2005,275144,Madhya Pradesh,3,18,12,15,48,Pass
Rehan D'Souza,24-06-2005,608934,Jammu & Kashmir + Ladakh,19,5,6,9,39,Pass
Sukhwinder Singh,06-11-2005,216215,Rajasthan,4,7,5,6,22,Pass
Aarav Pillai,27-07-2005,206072,Uttar Pradesh,22,1,12,6,41,Pass
Farhan Sharma,19-09-2005,231230,Chhattisgarh,14,12,13,24,63,Pass
Ishaan Mehta,02-02-2005,210358,Rajasthan,1,18,3,22,44,Pass
Rohan Fernandes,08-12-2005,991539,Madhya Pradesh,1,12,1,7,21,Pass
Aryan Mehta,28-08-2005,839332,Maharashtra,23,16,2,6,47,Pass
Ishaan Sharma,13-01-2006,485445,Bihar,9,7,15,4,35,Pass
Manpreet Sharma,27-04-2006,893865,Odisha,1,4,1,9,15,Pass
Ishaan Reddy,04-05-2006,852480,West Bengal,3,6,21,22,52,Pass
Ishaan Verma,27-10-2005,990243,West Bengal,14,3,10,11,38,Pass
Raj Sharma,06-09-2005,133809,Jammu & Kashmir + Ladakh,6,13,8,1,28,Pass
Kunal Singh,05-12-2004,204301,Andhra Pradesh,0,10,5,2,17,Pass
Balbir D'Souza,05-02-2005,438877,Tamil Nadu,12,7,14,19,52,Pass
Aarav Verma,04-06-2005,101278,Madhya Pradesh,16,23,12,4,55,Pass
Aarav D'Souza,23-08-2005,398996,Rajasthan,3,9,18,4,34,Pass
Imran Fernandes,16-11-2005,759653,Jammu & Kashmir + Ladakh,3,9,4,7,23,Pass
Aryan Sharma,14-02-2005,490170,West Bengal,9,9,2,24,44,Pass
Kunal Khan,07-04-2006,631576,Delhi,6,10,0,1,17,Pass
Aditya Fernandes,06-06-2005,974396,Uttar Pradesh,2,1,3,20,26,Pass
Aryan Reddy,20-07-2005,975671,Rajasthan,23,16,1,13,53,Pass
Krishna Verma,04-06-2005,829965,Jammu & Kashmir + Ladakh,7,24,8,23,62,Pass
Kunal Khan,23-11-2005,211100,West Bengal,14,10,12,1,37,Pass
Gurpreet Verma,07-10-2005,492657,Karnataka,5,19,11,18,53,Pass
Krishna Khan,22-01-2005,190841,Uttar Pradesh,5,1,10,24,40,Pass
Zaid Verma,18-01-2006,213590,Rajasthan,21,3,3,18,45,Pass
Rohan Khan,16-12-2005,910491,Maharashtra,0,22,11,12,45,Pass
Paul Chopra,01-05-2006,865346,Gujarat,14,14,0,12,40,Pass
Manpreet Fernandes,29-11-2005,871221,Bihar,2,1,5,16,24,Pass
Balbir Sharma,06-02-2005,624950,Bihar,18,12,14,21,65,Pass
Mathew Pillai,30-09-2005,229134,Rajasthan,18,10,10,7,45,Pass
Krishna Verma,27-03-2006,471740,Tamil Nadu,18,17,20,12,67,Pass
Harjeet Khan,17-01-2006,960044,Punjab,12,10,11,8,41,Pass
Manpreet Mehta,21-03-2006,457077,Punjab,24,1,9,11,45,Pass
Krishna Reddy,08-09-2005,609851,Jharkhand,24,8,20,12,64,Pass
Ishaan Sharma,03-04-2005,815035,Telangana,1,0,2,16,19,Pass
Vivaan Verma,21-11-2005,805695,Uttar Pradesh,3,1,17,22,43,Pass
Aryan D'Souza,27-02-2005,879927,Chhattisgarh,24,1,0,18,43,Pass
Ishaan D'Souza,01-05-2006,199644,Bihar,15,18,8,2,43,Pass
Krishna Reddy,20-01-2005,324698,Maharashtra,10,22,2,13,47,Pass
Aryan Sharma,07-12-2004,121736,Tamil Nadu,17,19,22,19,77,Pass
Yash Verma,04-04-2005,620342,West Bengal,15,16,17,5,53,Pass
Krishna Pillai,27-04-2006,100813,Uttar Pradesh,3,1,16,21,41,Pass
Aditya Fernandes,18-04-2006,457751,Madhya Pradesh,14,21,3,23,61,Pass
Aryan Mehta,06-12-2005,139948,Andhra Pradesh,6,17,24,14,61,Pass
Aryan Pillai,02-05-2005,661884,Tamil Nadu,17,5,14,3,39,Pass
Sukhwinder Singh,23-07-2005,417643,Bihar,17,22,21,21,81,Pass
Aryan Sharma,12-04-2005,868004,Assam,10,10,22,12,54,Pass
Vivaan Verma,21-06-2005,667832,Tamil Nadu,21,5,9,0,35,Pass
Aryan D'Souza,21-01-2006,354615,Karnataka,5,23,10,4,42,Pass
Aditya Pillai,05-07-2005,853495,Maharashtra,9,0,2,20,31,Pass
Vivaan Verma,04-03-2006,621425,Rajasthan,19,10,1,18,48,Pass
Paul Chopra,24-02-2005,936141,Tamil Nadu,5,21,23,7,56,Pass
Aarav Fernandes,06-07-2005,411225,West Bengal,9,21,13,3,46,Pass
Balbir Fernandes,03-10-2005,445357,Bihar,15,22,2,7,46,Pass
Raj Pillai,17-05-2005,843262,Jammu & Kashmir + Ladakh,18,5,1,9,33,Pass
Vivaan Fernandes,17-11-2004,447171,Gujarat,5,1,23,7,36,Pass
Rohan Sharma,05-02-2005,144334,Kerala,9,4,9,17,39,Pass
Aditya D'Souza,07-07-2005,297842,Maharashtra,12,13,6,4,35,Pass
Vivaan Sharma,12-12-2005,658746,Uttar Pradesh,12,1,6,13,32,Pass
Vivaan Verma,22-02-2005,587256,Odisha,13,14,1,1,29,Pass
Balbir Verma,06-07-2005,732444,Chhattisgarh,12,23,0,4,39,Pass
Aryan Khan,23-04-2005,393344,Bihar,16,7,18,22,63,Pass
Rohan Singh,12-09-2005,350551,Madhya Pradesh,4,12,2,17,35,Pass
Zaid Sharma,06-02-2005,155744,Maharashtra,5,12,9,22,48,Pass
Raj Sharma,01-10-2005,132445,West Bengal,2,13,5,15,35,Pass
Aryan Sharma,21-04-2005,627568,Rajasthan,21,1,18,18,58,Pass
Ayaan Verma,19-07-2005,461758,Andhra Pradesh,15,10,7,7,39,Pass
Mathew Chopra,03-04-2005,924523,Telangana,20,9,22,11,62,Pass
Aryan D'Souza,18-03-2005,910842,Rajasthan,23,21,15,8,67,Pass
Aarav Reddy,24-03-2005,939329,Punjab,4,15,23,9,51,Pass
Aarav D'Souza,09-04-2005,131730,Bihar,15,3,22,18,58,Pass
Aarav Singh,25-09-2005,922944,Telangana,3,18,13,3,37,Pass
Yash Reddy,26-01-2006,670079,Delhi,10,16,16,1,43,Pass
Gurpreet Verma,15-06-2005,505706,Bihar,11,9,6,9,35,Pass
Yash Khan,22-05-2005,956523,Chhattisgarh,14,3,16,14,47,Pass
Peter Verma,22-11-2004,948080,Jammu & Kashmir + Ladakh,10,3,0,8,21,Pass
Gurpreet Pillai,19-01-2006,219313,Madhya Pradesh,5,1,22,22,50,Pass
Yash Verma,01-05-2005,843995,West Bengal,17,14,2,8,41,Pass
Aarav Fernandes,02-08-2005,668318,Maharashtra,3,11,3,19,36,Pass
Manpreet D'Souza,19-01-2006,575583,Himachal Pradesh,4,10,5,15,34,Pass
Ishaan Reddy,20-10-2005,537019,Haryana,7,6,24,23,60,Pass
Raj Khan,28-03-2005,839971,Odisha,17,14,21,10,62,Pass
Paul Mehta,18-03-2005,101236,Madhya Pradesh,11,15,11,9,46,Pass
Kunal Reddy,31-03-2006,594765,Maharashtra,15,14,3,4,36,Pass
Gurpreet Chopra,21-03-2006,564509,Uttar Pradesh,22,1,0,8,31,Pass
John Mehta,08-02-2005,610029,Jharkhand,23,2,4,22,51,Pass
Gurpreet Mehta,30-04-2005,135160,Uttar Pradesh,9,1,12,8,30,Pass
Kunal Chopra,17-06-2005,934631,Madhya Pradesh,21,14,3,23,61,Pass
Raj Reddy,04-07-2005,858947,Odisha,17,7,17,19,60,Pass
Aditya Verma,21-12-2004,175001,Haryana,2,23,0,8,33,Pass
Balbir Reddy,06-02-2006,123913,West Bengal,21,3,9,7,40,Pass
Rohan D'Souza,25-12-2004,987877,Karnataka,8,2,8,14,32,Pass
Krishna Chopra,04-10-2005,233740,Delhi,20,4,13,16,53,Pass
Manpreet Mehta,19-06-2005,523510,Jammu & Kashmir + Ladakh,9,11,5,8,33,Pass
Aarav Singh,07-01-2005,670447,Tamil Nadu,22,23,19,5,69,Pass
Aditya Pillai,14-10-2005,742808,Punjab,15,16,10,5,46,Pass
Kunal Fernandes,14-10-2005,485125,Rajasthan,12,15,19,10,56,Pass
Sukhwinder Fernandes,15-06-2005,221861,Karnataka,9,3,18,9,39,Pass
Harjeet Chopra,07-03-2006,950854,Bihar,9,10,21,11,51,Pass
Rohan Mehta,28-12-2004,785335,Punjab,20,5,16,14,55,Pass
Rehan Pillai,12-10-2005,825461,Karnataka,14,10,19,4,47,Pass
Harjeet Mehta,09-02-2005,353480,Uttar Pradesh,16,1,6,0,23,Pass
Harjeet Pillai,14-12-2004,365794,Maharashtra,0,4,6,10,20,Pass
Raj Chopra,13-02-2006,899396,Odisha,5,22,23,1,51,Pass
Rohan Fernandes,05-03-2005,918109,Assam,4,4,13,22,43,Pass
Raj Reddy,06-06-2005,814921,Chhattisgarh,2,7,5,9,23,Pass
Aditya Sharma,25-04-2005,707390,Uttar Pradesh,16,1,17,1,35,Pass
Aryan D'Souza,29-11-2005,977414,Assam,9,20,10,4,43,Pass
Vivaan Reddy,06-03-2005,393254,Madhya Pradesh,4,6,23,8,41,Pass
Yash Khan,30-04-2006,332429,Punjab,8,21,23,6,58,Pass
Balbir Sharma,04-08-2005,422500,Rajasthan,15,9,9,12,45,Pass
Aarav Sharma,12-04-2005,283915,Punjab,13,1,4,2,20,Pass
Kunal Pillai,22-06-2005,786779,Madhya Pradesh,7,2,21,8,38,Pass
Aarav Sharma,19-03-2005,478317,Uttarakhand,3,22,5,6,36,Pass
Gurpreet Pillai,12-09-2005,763232,Maharashtra,8,21,2,15,46,Pass
Ishaan Khan,28-04-2006,648681,Kerala,14,11,13,23,61,Pass
Aarav D'Souza,03-09-2005,506486,Maharashtra,8,15,2,23,48,Pass
John Fernandes,23-03-2006,589969,West Bengal,12,6,8,19,45,Pass
Kunal Pillai,14-04-2006,604844,Maharashtra,11,19,10,8,48,Pass
Vivaan Pillai,23-08-2005,801033,Madhya Pradesh,12,21,3,13,49,Pass
Rehan D'Souza,04-02-2006,702652,Madhya Pradesh,17,24,3,21,65,Pass
Aryan Verma,17-10-2005,618689,Bihar,14,16,0,19,49,Pass
Harjeet Singh,02-05-2006,261317,Bihar,17,9,19,6,51,Pass
Raj D'Souza,28-10-2005,608788,Andhra Pradesh,12,23,16,2,53,Pass
Paul Reddy,21-01-2005,364823,Rajasthan,6,0,11,0,17,Pass
Aditya Pillai,10-12-2004,538212,Gujarat,3,6,11,22,42,Pass
Aryan Pillai,29-01-2006,868903,Haryana,15,3,0,5,23,Pass
Krishna Khan,10-10-2005,956778,Telangana,17,8,13,21,59,Pass
Vivaan Pillai,16-03-2005,486449,Punjab,12,12,23,5,52,Pass
Aarav Mehta,11-10-2005,646867,Andhra Pradesh,6,9,7,10,32,Pass
Peter Singh,22-02-2006,359962,Madhya Pradesh,24,23,3,8,58,Pass
Aarav Singh,09-12-2005,328156,Chhattisgarh,17,18,18,24,77,Pass
Krishna Pillai,19-06-2005,541340,Kerala,3,19,8,4,34,Pass
Sukhwinder D'Souza,21-01-2005,627304,Manipur,2,15,23,7,47,Pass
Vivaan Mehta,27-04-2005,663450,Nagaland,8,4,5,16,33,Pass
Rohan Verma,30-12-2004,195660,Manipur,4,0,11,0,15,Pass
Kunal D'Souza,24-01-2005,947672,Uttar Pradesh,20,1,3,7,31,Pass
Aryan Singh,07-10-2005,224856,Kerala,11,11,3,5,30,Pass
Vivaan Fernandes,30-12-2004,780122,Madhya Pradesh,1,6,12,21,40,Pass
Krishna Fernandes,12-03-2005,910329,Tamil Nadu,0,15,21,5,41,Pass
Rohan Sharma,29-01-2005,979372,Punjab,14,15,9,15,53,Pass
Ayaan Singh,13-11-2005,271197,Punjab,0,2,14,22,38,Pass
Krishna Sharma,25-11-2005,994249,Telangana,1,0,23,5,29,Pass
David Fernandes,24-08-2005,387632,Rajasthan,21,20,5,21,67,Pass
Vivaan Khan,26-01-2006,803963,Assam,20,22,7,16,65,Pass
Krishna Chopra,21-02-2005,590060,Rajasthan,9,14,9,4,36,Pass
Krishna Mehta,11-06-2005,208494,Odisha,22,18,2,9,51,Pass
Yash D'Souza,03-10-2005,565913,Uttar Pradesh,14,1,18,9,42,Pass
Farhan D'Souza,15-12-2004,783694,Maharashtra,10,4,0,22,36,Pass
John Mehta,14-11-2005,722962,Bihar,22,15,6,24,67,Pass
Raj Verma,05-03-2005,389590,Delhi,7,21,20,0,48,Pass
Vivaan Verma,21-12-2005,103944,Punjab,5,12,19,16,52,Pass
Vivaan Khan,24-04-2006,786363,Karnataka,2,3,24,4,33,Pass
Aditya Fernandes,08-10-2005,366901,Karnataka,19,23,3,15,60,Pass
Aryan Reddy,29-01-2006,453429,Nagaland,4,0,23,18,45,Pass
Rohan Fernandes,20-01-2006,541422,Madhya Pradesh,5,14,8,1,28,Pass
Aditya Pillai,11-04-2005,457035,Bihar,7,4,0,22,33,Pass
Yash Verma,18-01-2005,665736,Uttar Pradesh,21,1,5,22,49,Pass
Rohan Pillai,31-12-2005,238136,Karnataka,19,0,10,24,53,Pass
Balbir Chopra,02-03-2005,462513,Bihar,13,6,20,22,61,Pass
Krishna Verma,15-04-2006,145990,Punjab,10,23,11,3,47,Pass
Kunal Sharma,20-11-2005,307958,Uttar Pradesh,23,1,4,21,49,Pass
Aditya Verma,21-07-2005,829161,Bihar,19,19,5,6,49,Pass
Paul Verma,15-12-2005,239317,Madhya Pradesh,11,9,2,22,44,Pass
Krishna Reddy,13-01-2005,599301,Madhya Pradesh,9,7,0,22,38,Pass
Rohan D'Souza,20-05-2005,413116,Tamil Nadu,21,1,3,24,49,Pass
Vivaan Fernandes,27-01-2005,307264,Andhra Pradesh,23,23,17,13,76,Pass
Vivaan Sharma,12-08-2005,259659,Rajasthan,22,11,11,23,67,Pass
Ishaan Pillai,18-07-2005,404699,Maharashtra,4,21,5,13,43,Pass
John Pillai,25-02-2005,664067,West Bengal,2,14,23,8,47,Pass
Aarav Sharma,09-08-2005,668450,Tamil Nadu,9,24,13,3,49,Pass
Peter Verma,20-12-2004,212159,Bihar,11,17,9,20,57,Pass
Ishaan Pillai,17-01-2006,992150,West Bengal,7,0,12,10,29,Pass
Ishaan Chopra,20-12-2004,874723,Tamil Nadu,23,4,8,9,44,Pass
Paul Verma,03-09-2005,704109,Nagaland,5,3,4,15,27,Pass
David Khan,13-12-2005,277243,Uttarakhand,3,20,16,9,48,Pass
Ishaan Verma,11-05-2005,669385,Rajasthan,23,7,11,21,62,Pass
Raj Fernandes,01-12-2005,776358,Karnataka,12,14,15,17,58,Pass
Ishaan Reddy,06-03-2005,194493,Madhya Pradesh,12,6,21,10,49,Pass
Ishaan Sharma,08-11-2004,231450,Manipur,17,1,1,10,29,Pass
Aditya D'Souza,13-04-2006,473471,Madhya Pradesh,3,16,6,2,27,Pass
Vivaan Mehta,11-09-2005,652240,Bihar,9,4,11,6,30,Pass
Yash Chopra,09-02-2005,181343,Uttar Pradesh,2,1,1,10,14,Pass
Kunal Sharma,30-01-2006,784957,Haryana,3,22,6,13,44,Pass
Paul Verma,19-10-2005,887902,Tamil Nadu,2,13,1,14,30,Pass
David Verma,20-01-2005,460999,Uttar Pradesh,2,1,20,3,26,Pass
Aryan Singh,14-01-2005,788719,Rajasthan,23,5,21,19,68,Pass
Rohan Reddy,01-04-2006,140007,Tamil Nadu,23,15,24,15,77,Pass
Aditya Sharma,04-06-2005,274660,Meghalaya,12,0,10,7,29,Pass
Krishna D'Souza,03-03-2005,698621,Maharashtra,15,4,1,10,30,Pass
Rohan Mehta,07-05-2006,809742,Tamil Nadu,20,20,10,13,63,Pass
Kunal Khan,28-04-2006,585596,Gujarat,8,8,18,19,53,Pass
Manpreet Chopra,26-01-2006,205765,Bihar,3,15,17,19,54,Pass
Yash Verma,11-12-2004,415530,Punjab,13,22,3,15,53,Pass
Ishaan D'Souza,13-02-2006,802984,Chhattisgarh,15,8,0,19,42,Pass
Vivaan Verma,08-03-2006,272133,Rajasthan,11,21,1,19,52,Pass
Vivaan Khan,29-01-2006,348620,West Bengal,3,13,17,24,57,Pass
Aditya Singh,27-02-2005,936589,Uttar Pradesh,16,1,19,14,50,Pass
Aditya Reddy,30-12-2005,162940,Madhya Pradesh,15,18,3,17,53,Pass
Yash Mehta,08-11-2004,793780,Uttar Pradesh,22,1,10,9,42,Pass
Kunal Verma,07-03-2006,149973,Haryana,14,3,12,12,41,Pass
Yash Verma,25-01-2005,882701,Maharashtra,18,8,8,8,42,Pass
Rohan Pillai,22-11-2005,525917,Odisha,6,6,17,16,45,Pass
Aryan Verma,19-03-2005,566518,Odisha,10,0,14,2,26,Pass
Yash Singh,14-04-2006,240081,Odisha,20,18,17,3,58,Pass
Balbir Pillai,06-02-2005,934788,Bihar,6,19,18,12,55,Pass
Aryan Singh,30-08-2005,147392,Andhra Pradesh,0,13,18,21,52,Pass
Harjeet D'Souza,14-03-2005,754179,Meghalaya,7,4,7,8,26,Pass
Krishna Reddy,01-02-2006,624681,Bihar,12,14,24,1,51,Pass
Ishaan Verma,03-07-2005,770589,Bihar,1,20,2,14,37,Pass
Kunal Reddy,03-12-2005,434567,Karnataka,12,13,9,21,55,Pass
Yash Singh,10-06-2005,241129,Madhya Pradesh,2,1,23,13,39,Pass
Rehan Pillai,17-12-2005,275003,Bihar,8,22,1,13,44,Pass
Harjeet Pillai,23-10-2005,793709,West Bengal,4,21,15,6,46,Pass
Farhan Khan,31-01-2006,109879,West Bengal,22,3,12,17,54,Pass
Aditya Reddy,09-04-2006,864286,Bihar,4,13,1,5,23,Pass
Aryan Chopra,13-11-2004,661379,Haryana,9,11,11,12,43,Pass
Ishaan Reddy,02-03-2006,205144,Uttarakhand,5,24,0,6,35,Pass
Aditya Sharma,06-12-2005,736532,Jammu & Kashmir + Ladakh,6,18,19,23,66,Pass
Aditya Fernandes,24-04-2005,327775,Madhya Pradesh,14,24,3,5,46,Pass
Raj D'Souza,06-03-2006,421183,Odisha,22,4,21,2,49,Pass
Vivaan Singh,09-12-2004,862476,West Bengal,3,20,16,1,40,Pass
Aryan Singh,11-02-2005,556707,Bihar,16,6,8,20,50,Pass
Harjeet Reddy,13-01-2005,527870,Maharashtra,12,2,8,0,22,Pass
Farhan D'Souza,07-07-2005,345614,Maharashtra,4,15,12,13,44,Pass
Aryan D'Souza,21-04-2005,839862,Gujarat,8,19,3,23,53,Pass
Raj Verma,25-12-2004,223247,Maharashtra,1,7,14,10,32,Pass
Mathew Fernandes,23-02-2006,628746,Rajasthan,4,21,21,5,51,Pass
Aditya Khan,26-09-2005,412063,Haryana,24,6,20,21,71,Pass
Aditya Mehta,01-10-2005,114286,Tamil Nadu,18,9,2,9,38,Pass
Krishna Verma,08-01-2006,708215,Uttar Pradesh,3,1,18,4,26,Pass
Aditya Fernandes,19-03-2005,302571,Punjab,5,20,10,14,49,Pass
Ishaan Fernandes,25-11-2004,947817,Andaman & Nicobar,4,4,5,4,17,Fail
Ishaan Mehta,27-02-2005,307710,Tamil Nadu,8,13,5,0,26,Pass
Zaid Singh,21-04-2005,893501,Madhya Pradesh,3,22,14,2,41,Pass
Gurpreet Chopra,01-05-2006,691527,Jharkhand,17,15,15,12,59,Pass
Balbir Mehta,21-01-2006,854456,Maharashtra,9,12,2,15,38,Pass
Krishna Reddy,13-01-2006,679860,Bihar,6,21,5,18,50,Pass
Ayaan Sharma,26-05-2005,495143,Bihar,7,0,15,0,22,Pass
Vivaan Pillai,04-01-2005,250332,Haryana,23,18,16,9,66,Pass
Kunal Sharma,27-01-2005,562666,Punjab,12,18,1,7,38,Pass
Kunal Chopra,24-01-2006,257060,Gujarat,14,1,3,10,28,Pass
Aryan Fernandes,09-11-2005,150368,West Bengal,21,6,3,19,49,Pass
Sukhwinder Chopra,25-08-2005,776081,Uttar Pradesh,18,1,11,3,33,Pass
Kunal Sharma,05-02-2005,624903,Andhra Pradesh,6,4,14,17,41,Pass
Kunal Fernandes,05-12-2005,745418,Jharkhand,3,5,16,19,43,Pass
Rohan Mehta,12-11-2005,767074,Himachal Pradesh,3,1,0,20,24,Pass
Kunal Khan,30-12-2005,174565,Manipur,6,5,2,6,19,Pass
Aryan Verma,09-04-2006,563533,Andhra Pradesh,3,23,18,12,56,Pass
Harjeet Pillai,20-03-2006,147695,West Bengal,2,5,6,22,35,Pass
Kunal Mehta,20-02-2006,323004,Bihar,12,7,14,8,41,Pass
Ishaan Sharma,02-08-2005,919020,Nagaland,8,10,5,12,35,Pass
Aryan Reddy,23-04-2005,380160,Bihar,7,10,20,7,44,Pass
Rohan Singh,21-07-2005,627856,Bihar,21,10,7,9,47,Pass
Kunal Verma,15-01-2006,117612,Odisha,0,21,5,19,45,Pass
Aryan Pillai,15-02-2006,333493,Rajasthan,2,5,14,24,45,Pass
Sukhwinder Verma,07-03-2006,470394,Assam,24,16,23,10,73,Pass
Aarav Singh,04-10-2005,832800,Rajasthan,6,8,17,2,33,Pass
Paul Singh,27-12-2005,753459,Karnataka,21,10,7,11,49,Pass
Raj D'Souza,17-11-2004,936048,Assam,11,19,0,7,37,Pass
Aditya Mehta,14-08-2005,608849,Puducherry,6,5,12,5,28,Pass
Aarav Fernandes,08-11-2004,141483,Maharashtra,12,16,2,23,53,Pass
Rohan Singh,06-03-2005,450144,Rajasthan,3,20,18,21,62,Pass
Yash Mehta,02-09-2005,160911,Madhya Pradesh,22,2,3,20,47,Pass
Mathew D'Souza,24-08-2005,347962,Delhi,5,24,10,10,49,Pass
Sukhwinder Pillai,21-01-2005,866631,West Bengal,2,2,22,7,33,Pass
Vivaan Singh,07-01-2005,402339,Chhattisgarh,22,12,20,0,54,Pass
Sukhwinder Verma,08-10-2005,547213,Maharashtra,1,22,14,4,41,Pass
Aryan Pillai,25-02-2005,430597,Haryana,18,20,17,16,71,Pass
Kunal Pillai,13-04-2006,418819,Meghalaya,16,5,6,5,32,Pass
Gurpreet D'Souza,27-10-2005,542780,Uttar Pradesh,13,1,4,7,25,Pass
David D'Souza,17-05-2005,515465,Chhattisgarh,15,13,20,19,67,Pass
Ishaan Chopra,04-04-2005,389824,Haryana,8,5,5,3,21,Pass
Paul Chopra,23-12-2005,757190,Jharkhand,13,24,2,11,50,Pass
Aditya Singh,31-01-2005,963365,Tamil Nadu,23,20,22,12,77,Pass
Imran Reddy,21-04-2006,657926,Karnataka,10,21,14,9,54,Pass
Krishna D'Souza,08-08-2005,194360,Karnataka,7,11,13,4,35,Pass
Aarav Sharma,02-05-2006,786738,Odisha,7,2,11,4,24,Pass
Aarav Fernandes,24-12-2004,894398,West Bengal,11,1,4,0,16,Pass
David D'Souza,20-04-2006,672717,Tamil Nadu,13,16,21,15,65,Pass
Krishna Pillai,27-08-2005,204412,Punjab,11,24,21,16,72,Pass
Farhan Singh,12-12-2005,930423,Gujarat,17,21,23,23,84,Pass
Manpreet Chopra,27-04-2006,743313,Punjab,5,16,18,7,46,Pass
Ishaan D'Souza,25-11-2004,509539,Rajasthan,5,21,0,6,32,Pass
Rohan Singh,10-03-2005,167094,Maharashtra,20,2,15,8,45,Pass
Aryan Reddy,25-03-2005,926769,Uttarakhand,3,13,6,24,46,Pass
Raj Singh,02-02-2005,837109,Maharashtra,1,14,2,14,31,Pass
Aarav Reddy,21-01-2006,162194,Bihar,11,11,14,0,36,Pass
Gurpreet Sharma,18-05-2005,693006,Tamil Nadu,5,3,11,16,35,Pass
Vivaan Verma,24-10-2005,468507,West Bengal,2,14,16,12,44,Pass
Aarav Verma,03-01-2005,561221,Odisha,3,9,3,13,28,Pass
Aditya Fernandes,07-12-2004,445412,Bihar,3,10,15,12,40,Pass
Ayaan Singh,15-09-2005,109211,Tamil Nadu,23,4,19,2,48,Pass
Ishaan Singh,26-02-2005,400591,Uttar Pradesh,4,1,8,12,25,Pass
Raj Sharma,11-02-2005,630881,Madhya Pradesh,4,10,3,19,36,Pass
Aditya Pillai,21-10-2005,314214,Maharashtra,18,22,2,22,64,Pass
David Khan,01-01-2005,183263,Bihar,11,16,2,18,47,Pass
Krishna Singh,20-08-2005,118756,West Bengal,3,3,18,21,45,Pass
Yash Verma,22-05-2005,648020,Rajasthan,9,5,17,17,48,Pass
Raj Pillai,13-02-2006,811966,Telangana,10,16,5,11,42,Pass
Paul Pillai,04-01-2006,916453,Punjab,6,4,0,12,22,Pass
Raj Khan,26-08-2005,384891,West Bengal,18,7,5,22,52,Pass
Aditya Reddy,02-03-2006,690117,Madhya Pradesh,16,14,6,0,36,Pass
Zaid Mehta,10-11-2005,969813,Kerala,15,22,5,10,52,Pass
Farhan Sharma,03-07-2005,400948,Odisha,20,16,21,16,73,Pass
Ishaan Verma,17-08-2005,199217,Himachal Pradesh,4,2,20,6,32,Pass
Rohan Verma,12-11-2004,168030,Tamil Nadu,6,14,15,20,55,Pass
Harjeet Singh,12-12-2005,559512,West Bengal,13,0,7,5,25,Pass
Farhan Pillai,04-12-2005,389062,Telangana,1,5,23,3,32,Pass
Yash Verma,22-06-2005,915595,Uttar Pradesh,24,1,23,4,52,Pass
Krishna Pillai,08-01-2006,120856,Tamil Nadu,1,0,5,16,22,Pass
Vivaan D'Souza,24-07-2005,259941,Bihar,18,21,12,3,54,Pass
Vivaan Reddy,03-03-2005,147241,Himachal Pradesh,17,6,18,16,57,Pass
Raj Singh,21-02-2006,905640,Bihar,23,15,17,24,79,Pass
David Verma,16-03-2005,846834,Odisha,5,18,4,24,51,Pass
Aarav D'Souza,26-02-2006,885509,Bihar,24,15,18,10,67,Pass
Vivaan Mehta,12-01-2006,449653,Rajasthan,10,13,20,21,64,Pass
Vivaan Singh,28-04-2005,927989,Jharkhand,6,0,8,19,33,Pass
Harjeet Verma,17-11-2004,522223,Bihar,10,24,7,23,64,Pass
Yash Sharma,15-08-2005,327209,Maharashtra,22,24,2,5,53,Pass
Harjeet Sharma,14-01-2006,342535,Bihar,6,3,17,21,47,Pass
Vivaan Pillai,30-04-2005,644884,Uttar Pradesh,16,1,24,15,56,Pass
Peter Verma,11-06-2005,665821,Uttar Pradesh,17,1,5,24,47,Pass
Gurpreet Pillai,30-12-2004,157094,Assam,9,5,22,23,59,Pass
Yash D'Souza,05-10-2005,591813,Gujarat,21,2,4,4,31,Pass
Raj Mehta,16-12-2004,803585,West Bengal,1,15,13,17,46,Pass
Kunal Reddy,04-11-2005,179408,Punjab,3,4,20,6,33,Pass
Krishna Chopra,03-09-2005,821525,Rajasthan,23,11,16,10,60,Pass
Rehan Sharma,09-03-2005,924441,Uttar Pradesh,15,1,3,12,31,Pass
Ayaan Pillai,01-12-2005,834964,Bihar,0,11,7,6,24,Pass
Aarav Reddy,05-01-2006,526868,Maharashtra,17,16,4,4,41,Pass
Krishna Fernandes,15-05-2005,853483,Rajasthan,16,12,13,7,48,Pass
Aryan D'Souza,22-01-2006,440565,Uttar Pradesh,1,1,21,16,39,Pass
Rohan Chopra,22-05-2005,613964,Tamil Nadu,15,5,19,17,56,Pass
Aditya Khan,07-05-2006,594926,Uttar Pradesh,19,1,10,9,39,Pass
Aditya Verma,05-11-2005,905465,Tamil Nadu,9,15,7,19,50,Pass
Aryan Verma,19-07-2005,534491,Kerala,16,8,11,0,35,Pass
Aryan D'Souza,08-10-2005,845272,Karnataka,7,13,6,16,42,Pass
Aditya Sharma,02-02-2006,485416,Maharashtra,19,19,2,5,45,Pass
Balbir Khan,23-12-2004,863071,Punjab,16,8,14,23,61,Pass
Aditya Pillai,14-09-2005,669160,Karnataka,12,14,6,19,51,Pass
Ishaan Verma,01-10-2005,403543,Uttar Pradesh,20,1,6,6,33,Pass
David Chopra,17-01-2005,614395,Kerala,3,12,1,5,21,Pass
Aryan Fernandes,08-09-2005,574974,Rajasthan,20,12,9,15,56,Pass
Mathew Fernandes,21-07-2005,544104,Karnataka,13,5,3,14,35,Pass
Ishaan Verma,06-12-2004,499061,Kerala,22,18,8,10,58,Pass
Ishaan Pillai,27-02-2005,958950,Telangana,3,15,16,20,54,Pass
Vivaan Verma,27-06-2005,380597,Tamil Nadu,22,18,0,18,58,Pass
Raj Sharma,15-03-2005,900369,Karnataka,3,20,20,9,52,Pass
Kunal D'Souza,16-03-2006,966798,Uttarakhand,3,20,18,16,57,Pass
Paul Khan,16-09-2005,206639,Chhattisgarh,13,0,13,23,49,Pass
Aryan Singh,09-02-2006,546197,Rajasthan,15,7,6,2,30,Pass
Rohan Khan,10-03-2005,943950,Uttar Pradesh,6,1,11,14,32,Pass
Vivaan Singh,16-05-2005,596436,Gujarat,5,8,17,22,52,Pass
Mathew Reddy,10-01-2005,871874,Bihar,12,13,23,6,54,Pass
Aditya Sharma,30-07-2005,329020,Madhya Pradesh,12,4,10,9,35,Pass
Peter Pillai,01-03-2006,186252,Bihar,12,20,6,16,54,Pass
Ishaan Khan,31-03-2006,454603,Odisha,3,2,15,11,31,Pass
Raj Fernandes,01-02-2006,543875,Maharashtra,1,7,20,6,34,Pass
Kunal D'Souza,23-12-2005,204290,Haryana,7,20,19,23,69,Pass
Aarav Singh,16-06-2005,854401,Gujarat,12,2,16,9,39,Pass
Raj Chopra,09-03-2006,956524,Bihar,4,17,20,19,60,Pass
Aryan Fernandes,22-03-2006,909117,Andhra Pradesh,2,3,1,24,30,Pass
Manpreet Singh,11-11-2004,653348,Maharashtra,16,21,2,21,60,Pass
Rohan Verma,10-11-2004,577056,Uttar Pradesh,3,1,22,22,48,Pass
Balbir Mehta,22-11-2004,533825,Tamil Nadu,10,18,19,11,58,Pass
Sukhwinder Fernandes,01-04-2006,575158,Rajasthan,3,7,17,16,43,Pass
Gurpreet Verma,17-05-2005,127598,Chhattisgarh,7,14,2,15,38,Pass
Vivaan Reddy,09-09-2005,665792,Gujarat,23,21,12,9,65,Pass
Aryan Chopra,10-11-2005,155446,Rajasthan,12,5,23,4,44,Pass
Krishna Pillai,11-04-2005,971854,Jammu & Kashmir + Ladakh,6,16,7,5,34,Pass
Aarav Verma,17-06-2005,295276,Haryana,10,1,13,23,47,Pass
Ishaan Fernandes,28-02-2006,124003,Rajasthan,17,4,5,2,28,Pass
Rohan Singh,10-01-2006,113538,Rajasthan,8,18,13,3,42,Pass
Kunal D'Souza,13-07-2005,929726,Madhya Pradesh,1,2,11,16,30,Pass
Rohan D'Souza,18-06-2005,351580,Uttar Pradesh,0,1,21,2,24,Pass
Peter Singh,10-11-2004,136935,West Bengal,3,22,9,22,56,Pass
Krishna Sharma,12-02-2006,137837,Bihar,22,8,3,24,57,Pass
Harjeet Pillai,16-10-2005,937475,Bihar,9,10,1,9,29,Pass
Raj Reddy,04-08-2005,857281,Andhra Pradesh,16,4,4,24,48,Pass
David Verma,04-11-2005,481674,Uttar Pradesh,19,1,2,20,42,Pass
Gurpreet Sharma,02-08-2005,407750,Punjab,8,7,12,2,29,Pass
Aditya Mehta,30-05-2005,403356,Tamil Nadu,21,8,16,11,56,Pass
Yash Sharma,08-02-2006,893050,Bihar,24,16,15,10,65,Pass
Aryan Sharma,04-05-2005,605751,Rajasthan,3,21,2,20,46,Pass
Aryan Reddy,21-11-2005,933425,Madhya Pradesh,20,19,7,4,50,Pass
Aditya Khan,07-03-2005,621445,Andhra Pradesh,2,18,13,16,49,Pass
Kunal Chopra,23-02-2005,331060,Uttar Pradesh,18,1,14,8,41,Pass
Yash Sharma,16-04-2006,344356,Punjab,18,24,6,4,52,Pass
Ishaan Sharma,14-07-2005,917619,Bihar,22,11,15,1,49,Pass
Gurpreet Sharma,15-12-2005,694094,Tripura,7,9,0,7,23,Pass
Sukhwinder Fernandes,18-04-2005,988530,Haryana,8,5,11,4,28,Pass
Raj Sharma,19-03-2006,197252,Haryana,13,6,5,20,44,Pass
Raj Singh,24-07-2005,908308,Gujarat,5,3,20,4,32,Pass
Aditya Reddy,18-02-2005,693859,Uttar Pradesh,4,1,0,21,26,Pass
Krishna Sharma,13-05-2005,660669,Chhattisgarh,13,6,6,15,40,Pass
Aditya Khan,23-09-2005,662151,Tamil Nadu,3,16,12,17,48,Pass
Aditya Verma,02-02-2006,636800,Bihar,4,13,1,20,38,Pass
Vivaan Pillai,06-08-2005,339783,Uttar Pradesh,18,1,3,15,37,Pass
Krishna Pillai,01-10-2005,177872,Rajasthan,18,24,9,24,75,Pass
David Khan,11-12-2005,155056,Punjab,10,1,14,11,36,Pass
Yash Khan,04-09-2005,890712,Arunachal Pradesh,22,14,10,1,47,Pass
David Verma,15-09-2005,319756,Tamil Nadu,7,0,10,9,26,Pass
Paul Verma,07-02-2005,987851,Madhya Pradesh,19,10,3,16,48,Pass
Aryan Sharma,04-10-2005,247541,Uttar Pradesh,1,1,24,24,50,Pass
Manpreet D'Souza,25-04-2005,201530,Uttar Pradesh,5,1,15,5,26,Pass
Kunal Chopra,23-01-2005,553357,Bihar,12,1,19,7,39,Pass
Aditya Chopra,12-01-2006,949022,West Bengal,4,11,0,14,29,Pass
Ishaan Fernandes,27-03-2006,763470,Himachal Pradesh,15,18,0,1,34,Pass
Aarav Singh,03-09-2005,994412,Gujarat,2,12,15,18,47,Pass
Aarav Sharma,26-02-2006,284289,Bihar,18,15,4,19,56,Pass
David Sharma,12-07-2005,503862,Himachal Pradesh,9,24,23,14,70,Pass
Aarav Singh,29-05-2005,566543,Madhya Pradesh,21,19,3,5,48,Pass
Ishaan Verma,20-09-2005,972456,Madhya Pradesh,16,7,10,7,40,Pass
Gurpreet D'Souza,14-08-2005,501319,Uttar Pradesh,24,1,7,7,39,Pass
Krishna Khan,04-06-2005,186906,Madhya Pradesh,17,7,24,6,54,Pass
Rohan Reddy,15-01-2006,407631,Himachal Pradesh,17,6,21,8,52,Pass
Gurpreet Sharma,25-02-2006,442390,Delhi,2,19,1,14,36,Pass
Yash Reddy,04-01-2006,667604,Bihar,4,6,8,9,27,Pass
Paul Fernandes,20-03-2006,213437,Uttar Pradesh,7,1,20,1,29,Pass
Ishaan Reddy,16-08-2005,234047,Jharkhand,12,18,1,15,46,Pass
Mathew Chopra,02-05-2005,469398,Chhattisgarh,6,11,0,23,40,Pass
Rohan Pillai,31-01-2005,196452,Rajasthan,24,2,6,11,43,Pass
Sukhwinder Verma,01-05-2005,814200,Tripura,18,1,3,23,45,Pass
Manpreet Sharma,04-06-2005,759891,Uttar Pradesh,20,1,19,17,57,Pass
Kunal Sharma,11-05-2005,490032,Kerala,11,6,1,2,20,Pass
Vivaan Singh,28-06-2005,486772,Rajasthan,21,9,23,4,57,Pass
Harjeet Chopra,12-11-2005,728448,Maharashtra,11,3,17,17,48,Pass
Vivaan D'Souza,23-08-2005,680586,Odisha,12,2,7,11,32,Pass
Aditya Fernandes,26-07-2005,395343,Chhattisgarh,5,5,6,21,37,Pass
Rehan Sharma,10-06-2005,988156,Bihar,7,9,8,11,35,Pass
Krishna Khan,18-01-2006,310300,Uttar Pradesh,4,1,11,12,28,Pass
Aditya Singh,17-05-2005,922193,Uttar Pradesh,16,13,10,8,47,Pass
Vivaan Reddy,20-01-2006,840065,Rajasthan,18,11,5,9,43,Pass
Gurpreet Fernandes,02-08-2005,349912,Tamil Nadu,13,22,21,5,61,Pass
Harjeet Fernandes,21-07-2005,901305,Gujarat,18,21,6,24,69,Pass
Manpreet Verma,20-02-2005,480615,Madhya Pradesh,20,9,3,22,54,Pass
Imran D'Souza,19-11-2005,332368,West Bengal,12,3,5,11,31,Pass
Aarav Singh,07-10-2005,530688,Uttar Pradesh,1,19,12,24,56,Pass
Harjeet Verma,07-03-2005,117303,Tamil Nadu,1,3,15,9,28,Pass
Kunal Mehta,02-12-2004,369157,Tamil Nadu,10,22,7,6,45,Pass
Krishna D'Souza,04-03-2006,842954,Haryana,21,24,6,18,69,Pass
Raj Chopra,18-09-2005,484197,Tamil Nadu,24,7,15,21,67,Pass
Ishaan Reddy,07-11-2005,173130,Maharashtra,10,20,2,19,51,Pass
Ishaan Reddy,29-05-2005,459550,West Bengal,7,12,8,17,44,Pass
Rehan Verma,16-12-2005,895263,Uttar Pradesh,14,12,11,11,48,Pass
Gurpreet Pillai,27-08-2005,585830,Odisha,18,16,21,15,70,Pass
Harjeet Khan,24-04-2006,182526,West Bengal,0,10,4,2,16,Pass
Aryan Reddy,03-03-2006,575109,West Bengal,14,10,8,21,53,Pass
Balbir Mehta,02-12-2005,258111,Chhattisgarh,19,14,4,15,52,Pass
Manpreet Mehta,11-02-2005,998511,Punjab,10,22,3,11,46,Pass
Harjeet Reddy,10-12-2005,672308,Kerala,16,12,19,16,63,Pass
Ayaan Khan,29-04-2005,555090,Odisha,24,9,1,5,39,Pass
Raj Khan,11-02-2005,350866,Rajasthan,7,11,21,2,41,Pass
Aryan Pillai,24-03-2005,344175,Bihar,23,2,4,20,49,Pass
Yash Verma,22-02-2005,935228,Bihar,18,22,16,1,57,Pass
Krishna Singh,29-12-2005,244048,Uttarakhand,15,19,5,0,39,Pass
Aryan D'Souza,27-03-2006,865691,Bihar,23,8,24,23,78,Pass
Ishaan Khan,26-08-2005,951746,Tamil Nadu,8,4,14,19,45,Pass
Rohan D'Souza,07-03-2005,896536,Delhi,10,22,22,7,61,Pass
David Khan,28-09-2005,289503,Maharashtra,2,12,2,18,34,Pass
Aarav Reddy,25-04-2005,512110,Bihar,8,7,11,20,46,Pass
Aditya Sharma,10-04-2006,781900,Punjab,12,13,18,4,47,Pass
Aarav Pillai,11-07-2005,661091,Uttar Pradesh,16,0,2,24,42,Pass
Kunal Mehta,13-07-2005,417491,Delhi,7,3,11,21,42,Pass
Mathew Pillai,14-09-2005,763921,Uttar Pradesh,23,20,7,20,70,Pass
Gurpreet Singh,15-03-2005,762331,Uttar Pradesh,15,10,2,12,39,Pass
Ishaan Mehta,05-07-2005,119876,Rajasthan,10,18,22,20,70,Pass
Aarav Fernandes,07-02-2006,173684,Uttar Pradesh,8,12,16,1,37,Pass
Yash Khan,31-03-2005,464877,Rajasthan,23,23,9,6,61,Pass
Vivaan Mehta,17-01-2006,749339,Haryana,11,5,14,11,41,Pass
Ayaan Pillai,15-11-2004,866437,Jammu & Kashmir + Ladakh,5,0,10,6,21,Pass
Kunal Verma,18-11-2004,373465,Assam,11,3,19,4,37,Pass
Ishaan Singh,27-04-2006,162365,Andhra Pradesh,7,8,18,2,35,Pass
Aryan Singh,24-10-2005,688138,West Bengal,3,20,13,19,55,Pass
Manpreet Chopra,01-05-2006,158321,Odisha,18,21,12,19,70,Pass
Aditya D'Souza,18-08-2005,447276,Assam,8,20,20,15,63,Pass
Peter Mehta,15-10-2005,703817,Rajasthan,13,14,6,0,33,Pass
Aditya Mehta,03-01-2006,380047,Maharashtra,4,2,11,10,27,Pass
Raj Khan,24-10-2005,387019,Bihar,11,0,5,12,28,Pass
Imran D'Souza,01-02-2005,479113,West Bengal,11,23,5,0,39,Pass
Ishaan Mehta,15-01-2005,733158,West Bengal,3,11,20,16,50,Pass
Rohan Chopra,07-08-2005,236807,Chhattisgarh,21,2,16,5,44,Pass
Mathew Sharma,21-01-2005,415502,Tamil Nadu,10,21,19,5,55,Pass
Zaid Reddy,06-01-2005,964027,Madhya Pradesh,20,14,11,5,50,Pass
Aryan Fernandes,03-07-2005,934178,Bihar,23,10,1,16,50,Pass
Rohan Sharma,24-12-2004,599595,Uttar Pradesh,9,4,2,4,19,Pass
Aditya Pillai,23-03-2006,931460,Uttar Pradesh,19,5,19,18,61,Pass
Aryan Mehta,30-12-2004,938754,Jharkhand,5,1,5,19,30,Pass
Kunal D'Souza,21-02-2005,737988,Andhra Pradesh,3,2,13,15,33,Pass
Krishna Fernandes,03-10-2005,413392,Uttar Pradesh,16,5,10,20,51,Pass
Aryan Singh,03-12-2005,580350,Chhattisgarh,24,13,14,22,73,Pass
Raj Chopra,02-06-2005,535101,Uttar Pradesh,18,1,23,22,64,Pass
Krishna Chopra,28-03-2005,482340,Gujarat,1,20,22,15,58,Pass
Balbir Reddy,02-03-2006,844770,Tamil Nadu,5,10,13,24,52,Pass
Vivaan Khan,04-07-2005,834991,Assam,12,19,13,24,68,Pass
Rohan Mehta,20-11-2004,852958,Rajasthan,7,2,19,10,38,Pass
Aryan Mehta,03-04-2005,600714,Gujarat,20,7,12,2,41,Pass
Peter Verma,21-04-2005,634992,West Bengal,11,2,6,7,26,Pass
Manpreet Chopra,19-08-2005,900654,Madhya Pradesh,10,1,3,24,38,Pass
Raj Singh,24-06-2005,879701,Haryana,7,5,16,21,49,Pass
Aarav Khan,25-11-2005,315847,Madhya Pradesh,3,14,24,9,50,Pass
Aarav Mehta,15-02-2005,909160,Delhi,9,5,5,12,31,Pass
Zaid Verma,13-01-2006,835045,Uttar Pradesh,11,12,22,19,64,Pass
Aditya Singh,30-01-2005,469805,Punjab,12,6,13,2,33,Pass
Aarav Khan,25-01-2006,426015,Maharashtra,23,5,2,24,54,Pass
Raj Reddy,20-11-2004,972663,Bihar,2,12,12,7,33,Pass
Gurpreet Singh,12-06-2005,584320,Madhya Pradesh,24,23,3,10,60,Pass
Vivaan D'Souza,01-08-2005,517407,Assam,16,18,15,13,62,Pass
Krishna Pillai,07-01-2005,213083,Rajasthan,18,9,2,13,42,Pass
David Verma,20-07-2005,796453,Tamil Nadu,5,0,11,15,31,Pass
David Chopra,23-08-2005,839553,Assam,4,11,8,6,29,Pass
Rohan Sharma,17-08-2005,244819,Jharkhand,11,4,9,9,33,Pass
Farhan Sharma,23-02-2006,881499,Maharashtra,23,6,2,23,54,Pass
Krishna Khan,02-10-2005,577830,Uttar Pradesh,15,6,18,6,45,Pass
Paul Singh,12-11-2005,736158,Telangana,23,3,16,15,57,Pass
Aarav Fernandes,29-06-2005,683218,Rajasthan,0,1,21,6,28,Pass
Raj Chopra,02-12-2005,877029,Punjab,24,23,8,18,73,Pass
Aryan Sharma,21-05-2005,148561,Bihar,6,15,7,12,40,Pass
Manpreet Fernandes,02-03-2006,652193,Uttar Pradesh,7,10,24,15,56,Pass
Aditya Singh,05-03-2006,863171,Telangana,6,23,8,22,59,Pass
Ishaan Pillai,01-02-2005,430495,Punjab,2,12,24,20,58,Pass
Kunal Verma,20-01-2005,685401,Assam,9,24,6,23,62,Pass
Balbir Verma,21-09-2005,202728,Jharkhand,21,18,17,4,60,Fail
Vivaan Pillai,15-12-2005,714519,Odisha,13,0,10,10,33,Pass
Ishaan Pillai,02-07-2005,550380,Tamil Nadu,9,11,10,24,54,Pass
Mathew Sharma,16-11-2005,737736,Rajasthan,24,7,1,17,49,Pass
David D'Souza,13-11-2005,912442,Punjab,17,8,14,8,47,Pass
Yash Reddy,23-06-2005,256075,Bihar,24,10,15,11,60,Pass
Kunal Sharma,22-09-2005,264559,Uttar Pradesh,24,19,3,19,65,Pass
Harjeet Sharma,01-05-2006,696620,Telangana,7,24,13,19,63,Pass
Mathew Sharma,05-02-2005,582274,Meghalaya,10,9,5,18,42,Pass
Rohan Singh,04-03-2006,587062,Gujarat,22,23,7,2,54,Pass
Yash Mehta,05-03-2005,395686,West Bengal,0,0,14,12,26,Pass
Rohan Singh,26-06-2005,977648,Bihar,15,7,3,13,38,Pass
Sukhwinder D'Souza,14-04-2006,517717,Manipur,10,14,3,23,50,Pass
Kunal Pillai,07-03-2005,559610,Manipur,4,22,17,9,52,Pass
Gurpreet Reddy,20-10-2005,121585,Rajasthan,14,23,15,9,61,Pass
Ishaan Singh,17-04-2006,597260,Punjab,1,19,14,4,38,Pass
John Fernandes,05-02-2005,337332,Rajasthan,1,7,19,22,49,Pass
David Mehta,28-06-2005,525380,West Bengal,6,13,18,1,38,Pass
Rohan Khan,30-03-2006,263106,Maharashtra,2,6,4,21,33,Pass
Mathew Mehta,18-05-2005,666123,Uttar Pradesh,5,11,11,21,48,Pass
Kunal Pillai,30-01-2006,217231,Uttar Pradesh,2,20,8,13,43,Pass
Manpreet Sharma,09-07-2005,279527,Uttar Pradesh,15,23,23,0,61,Pass
Gurpreet Khan,29-11-2005,112430,Rajasthan,21,8,24,0,53,Pass
Aditya Chopra,24-08-2005,860956,Goa,8,14,2,9,33,Fail
Raj D'Souza,20-01-2005,153554,Madhya Pradesh,22,23,3,23,71,Pass
Aryan D'Souza,25-10-2005,162434,Meghalaya,23,24,20,11,78,Pass
Yash Singh,08-01-2005,372491,Maharashtra,19,16,2,22,59,Pass
Krishna Chopra,14-10-2005,643743,Rajasthan,14,19,5,23,61,Pass
Raj Chopra,15-04-2006,318018,Uttar Pradesh,6,6,2,8,22,Pass
Paul Mehta,18-04-2006,615499,Andhra Pradesh,16,24,23,15,78,Pass
Aditya D'Souza,26-11-2005,935854,Uttar Pradesh,21,0,22,7,50,Pass
Imran Reddy,12-08-2005,475178,Maharashtra,9,0,5,13,27,Pass
Yash Reddy,01-05-2005,301623,Karnataka,5,23,20,9,57,Pass
Manpreet Singh,21-10-2005,447603,Karnataka,8,4,16,2,30,Pass
Imran Pillai,21-03-2005,587272,Delhi,3,9,14,7,33,Pass
Aditya Fernandes,21-12-2005,610060,Bihar,3,8,20,21,52,Pass
Krishna Singh,10-12-2005,471801,Rajasthan,23,11,23,3,60,Pass
John Pillai,21-07-2005,972786,Andhra Pradesh,0,18,11,9,38,Pass
Peter Fernandes,19-02-2006,670149,Telangana,1,8,19,9,37,Pass
David Singh,12-04-2006,192494,Bihar,2,15,7,4,28,Pass
Gurpreet Reddy,26-03-2005,613936,Uttar Pradesh,2,22,11,3,38,Pass
Kunal Mehta,08-03-2006,115453,Kerala,5,0,15,18,38,Pass
Yash Sharma,03-06-2005,576497,Bihar,9,4,6,5,24,Pass
Ishaan D'Souza,28-10-2005,634773,Arunachal Pradesh,19,11,0,3,33,Pass
Raj Khan,01-12-2005,879265,Uttar Pradesh,20,6,12,7,45,Pass
Aditya Pillai,05-05-2005,587151,Uttar Pradesh,6,10,21,6,43,Pass
Rohan Pillai,15-07-2005,385572,Bihar,21,5,20,23,69,Pass
Aryan Singh,12-12-2005,874592,Maharashtra,4,12,8,16,40,Pass
Kunal Khan,09-10-2005,183370,Uttar Pradesh,15,19,24,3,61,Pass
Harjeet Khan,01-10-2005,821550,Madhya Pradesh,0,0,14,3,17,Pass
Sukhwinder Reddy,09-09-2005,107516,Andhra Pradesh,4,12,11,17,44,Pass
Imran D'Souza,08-04-2005,908483,Madhya Pradesh,12,9,22,0,43,Pass
Aditya D'Souza,28-11-2005,867641,Odisha,24,3,10,18,55,Pass
Yash Khan,28-04-2006,482897,Gujarat,10,14,7,14,45,Pass
Harjeet D'Souza,29-03-2005,925577,Rajasthan,7,7,20,10,44,Pass
Aditya Mehta,17-02-2005,377345,Tamil Nadu,21,19,7,23,70,Pass
Yash Singh,29-11-2004,349792,Maharashtra,10,2,19,8,39,Pass
Manpreet Singh,28-04-2005,586740,Punjab,6,24,9,3,42,Pass
Peter Khan,20-09-2005,416387,Telangana,14,22,0,12,48,Pass
Aditya Khan,08-05-2005,320271,Jharkhand,8,20,24,13,65,Pass
Aditya Chopra,20-02-2006,566507,Jammu & Kashmir + Ladakh,1,8,24,9,42,Pass
John Pillai,08-01-2006,578536,Rajasthan,13,21,13,23,70,Pass
Raj Chopra,14-01-2006,921574,Telangana,5,10,9,24,48,Pass
Zaid Mehta,31-10-2005,645216,Maharashtra,13,23,2,6,44,Pass
Manpreet Reddy,13-12-2004,785569,Telangana,12,21,15,7,55,Pass
Krishna Reddy,22-03-2005,721005,Chhattisgarh,6,15,11,19,51,Pass
Gurpreet Singh,18-04-2005,390319,Rajasthan,14,20,19,5,58,Pass
Aditya Fernandes,13-10-2005,650749,Bihar,22,12,19,10,63,Pass
Harjeet Singh,12-01-2005,387523,Karnataka,2,20,15,3,40,Pass
Kunal Verma,02-01-2005,653887,Maharashtra,12,18,2,22,54,Pass
Harjeet Sharma,25-06-2005,443130,Jharkhand,5,24,2,8,39,Pass
Yash Verma,22-12-2005,356567,Tamil Nadu,7,2,13,4,26,Pass
Farhan Verma,09-12-2004,758742,Andhra Pradesh,1,6,10,14,31,Pass
Aditya Verma,27-12-2005,764874,Maharashtra,18,4,7,8,37,Pass
Paul Khan,22-02-2005,527340,Punjab,24,2,17,24,67,Pass
Ishaan Sharma,04-08-2005,604766,Haryana,0,15,15,22,52,Pass
Vivaan Verma,16-03-2005,378608,Jharkhand,18,4,6,0,28,Pass
Rohan Verma,25-12-2004,312906,Bihar,13,2,20,8,43,Pass
Ishaan Singh,11-01-2006,390050,Madhya Pradesh,5,21,7,19,52,Pass
Aryan D'Souza,16-01-2006,357720,Himachal Pradesh,7,17,17,11,52,Pass
Imran D'Souza,21-12-2004,545895,Daman & Diu / D&N Haveli,3,19,5,11,38,Pass
Raj Reddy,21-10-2005,628587,Karnataka,21,19,6,19,65,Pass
Aryan Singh,26-03-2006,855901,Tamil Nadu,5,11,2,10,28,Pass
Yash Reddy,08-05-2006,998106,Uttar Pradesh,14,18,13,18,63,Pass
Aarav Chopra,25-02-2005,103076,Delhi,11,6,11,1,29,Pass
Vivaan Khan,11-07-2005,353987,Andhra Pradesh,16,3,11,4,34,Pass
Peter Chopra,11-02-2005,739907,Punjab,9,5,14,11,39,Pass
Kunal Chopra,16-02-2006,972226,Delhi,21,24,20,11,76,Pass
Aditya Verma,03-03-2006,998923,Bihar,9,7,3,1,20,Pass
Manpreet D'Souza,18-03-2005,444850,Chhattisgarh,18,0,5,12,35,Pass
Rohan Pillai,31-07-2005,165374,West Bengal,9,10,16,17,52,Pass
Raj Chopra,09-03-2005,332865,Tamil Nadu,5,12,2,4,23,Pass
Harjeet Pillai,19-08-2005,920322,Madhya Pradesh,16,15,1,1,33,Pass
Rohan Pillai,03-02-2006,383134,Punjab,19,11,2,12,44,Pass
Ishaan Singh,23-01-2005,133094,Odisha,9,20,15,1,45,Pass
Balbir Reddy,15-12-2004,922437,Rajasthan,9,6,12,23,50,Pass
Kunal Fernandes,05-12-2004,718679,Haryana,16,3,8,18,45,Pass
Raj Chopra,01-04-2005,253786,Andaman & Nicobar,12,16,4,5,37,Fail
Yash Verma,01-06-2005,885204,Uttar Pradesh,19,5,6,5,35,Pass
Aryan Fernandes,15-12-2004,962616,Maharashtra,4,21,10,7,42,Pass
Kunal Pillai,30-07-2005,987773,Kerala,17,11,6,3,37,Pass
Peter Verma,14-02-2005,992118,Gujarat,13,22,8,14,57,Pass
Sukhwinder Pillai,29-04-2006,910536,Maharashtra,18,3,2,20,43,Pass
John D'Souza,14-03-2005,328408,Maharashtra,3,6,15,11,35,Pass
Rohan Verma,03-04-2005,479239,Uttar Pradesh,0,17,19,9,45,Pass
Aarav Verma,24-12-2004,230496,Andhra Pradesh,23,2,12,12,49,Pass
Ishaan Fernandes,20-03-2005,152616,Tamil Nadu,3,9,14,16,42,Pass
Balbir Verma,06-05-2006,691809,Haryana,15,8,7,23,53,Pass
Vivaan Singh,27-02-2006,162752,Haryana,4,9,19,15,47,Pass
Gurpreet Mehta,30-03-2005,560783,Punjab,20,11,15,13,59,Pass
Aarav Reddy,15-03-2005,973137,Punjab,1,4,8,17,30,Pass
Aarav Pillai,05-04-2005,362607,Uttar Pradesh,18,21,15,6,60,Pass
Raj Chopra,13-04-2005,401271,Maharashtra,24,17,2,16,59,Pass
Ishaan Chopra,21-03-2005,599351,Punjab,16,23,0,0,39,Pass
Aditya Khan,05-04-2006,785339,Odisha,10,12,14,2,38,Pass
Ishaan Chopra,25-07-2005,477833,Madhya Pradesh,2,16,2,15,35,Pass
Mathew Mehta,17-12-2004,606680,Madhya Pradesh,12,1,10,15,38,Pass
David Reddy,12-01-2005,830259,Rajasthan,19,6,22,15,62,Pass
Manpreet Pillai,16-03-2006,175094,Andhra Pradesh,14,13,24,15,66,Pass
Zaid Reddy,29-08-2005,715764,Rajasthan,16,15,19,7,57,Pass
Krishna Khan,03-12-2004,378871,Andhra Pradesh,9,9,8,24,50,Pass
Rohan Sharma,03-04-2005,219887,Arunachal Pradesh,3,20,18,23,64,Pass
Manpreet Sharma,16-07-2005,476180,Tamil Nadu,3,9,19,7,38,Pass
Ayaan Pillai,03-08-2005,929802,Bihar,15,7,9,24,55,Pass
Yash Khan,12-03-2006,962208,Kerala,18,0,2,22,42,Pass
Aryan Fernandes,11-04-2005,373089,Punjab,20,6,18,1,45,Pass
Rohan Mehta,28-10-2005,959528,Jammu & Kashmir + Ladakh,18,6,3,8,35,Pass
Yash Mehta,13-08-2005,722214,Uttarakhand,13,0,1,9,23,Pass
Yash Singh,09-02-2006,214736,Jammu & Kashmir + Ladakh,18,9,11,13,51,Pass
John Verma,01-08-2005,290080,Madhya Pradesh,22,2,10,11,45,Pass
Rohan Reddy,05-08-2005,411157,Uttar Pradesh,14,7,0,11,32,Pass
Harjeet Reddy,13-12-2004,368572,Punjab,24,17,22,13,76,Pass
Paul D'Souza,27-12-2005,101410,West Bengal,6,5,6,8,25,Pass
Ishaan Mehta,25-04-2006,715773,Madhya Pradesh,23,7,8,13,51,Pass
Yash Fernandes,19-10-2005,463880,Haryana,13,23,15,7,58,Pass
David Reddy,07-05-2006,845168,Punjab,23,11,3,22,59,Pass
Kunal Fernandes,28-09-2005,485350,Arunachal Pradesh,11,18,15,0,44,Pass
Kunal Fernandes,03-04-2006,172010,Bihar,13,14,7,2,36,Pass
Kunal Verma,05-11-2005,900329,Madhya Pradesh,2,5,17,11,35,Pass
Rohan Pillai,04-01-2005,693865,Tamil Nadu,21,6,19,0,46,Pass
Aarav Verma,17-11-2004,786008,Andhra Pradesh,8,18,16,4,46,Pass
Aryan Pillai,18-03-2006,878272,Rajasthan,4,5,16,10,35,Pass
Kunal Fernandes,20-08-2005,460575,Haryana,9,11,17,8,45,Pass
Aryan Reddy,07-04-2006,625904,Punjab,16,6,24,0,46,Pass
Aarav Verma,18-03-2005,721640,Bihar,0,13,9,0,22,Pass
Ishaan Reddy,19-07-2005,636964,Uttar Pradesh,24,19,11,1,55,Pass
Ishaan Verma,21-01-2005,251419,Madhya Pradesh,18,24,3,24,69,Pass
Ishaan Sharma,23-01-2005,908445,Maharashtra,10,21,7,11,49,Pass
David Sharma,27-01-2005,271928,Chhattisgarh,11,11,15,24,61,Pass
Aarav Khan,23-01-2005,351445,Odisha,19,4,5,17,45,Pass
Vivaan Khan,16-10-2005,748082,Rajasthan,10,9,4,20,43,Pass
Sukhwinder Verma,08-02-2005,696849,Himachal Pradesh,14,24,0,14,52,Pass
Kunal Verma,01-10-2005,477232,Jharkhand,8,19,5,0,32,Pass
David Mehta,09-06-2005,823821,Jharkhand,24,7,9,11,51,Pass
Aditya Pillai,23-01-2006,285312,Madhya Pradesh,3,12,13,7,35,Pass
Balbir Reddy,30-12-2005,490879,Rajasthan,13,18,18,16,65,Pass
Yash Fernandes,18-04-2005,245180,Assam,4,18,11,7,40,Pass
Balbir Sharma,06-05-2006,246100,Assam,7,2,24,19,52,Pass
Krishna Sharma,02-03-2005,618799,Rajasthan,23,6,24,16,69,Pass
Aryan Singh,06-06-2005,470399,Madhya Pradesh,20,2,24,9,55,Pass
Mathew Mehta,23-05-2005,202849,Maharashtra,21,15,3,1,40,Pass
Aryan Verma,07-05-2006,238957,Madhya Pradesh,23,3,2,16,44,Pass
Gurpreet Khan,11-04-2006,411192,Gujarat,14,2,11,9,36,Pass
Vivaan Sharma,11-12-2004,663059,Bihar,5,8,20,7,40,Pass
Yash Singh,07-06-2005,808452,Gujarat,2,0,7,11,20,Pass
Yash Verma,15-03-2006,838489,West Bengal,17,3,5,18,43,Pass
Aarav Singh,14-05-2005,395792,Bihar,7,10,5,21,43,Pass
Kunal Pillai,22-01-2006,553748,Bihar,14,11,2,15,42,Pass
Kunal Khan,19-12-2004,531875,Maharashtra,6,14,17,0,37,Pass
Aditya Chopra,19-03-2005,149635,Uttar Pradesh,3,22,14,18,57,Pass
Vivaan Verma,08-08-2005,427976,Assam,3,18,8,21,50,Pass
Aditya Singh,26-04-2006,364880,Gujarat,1,0,3,8,12,Pass
Krishna Mehta,22-03-2006,208786,Uttar Pradesh,11,22,7,21,61,Pass
Aryan Pillai,18-12-2005,212457,Bihar,17,13,23,0,53,Pass
Mathew Mehta,06-04-2006,741653,Rajasthan,6,2,3,12,23,Pass
Manpreet Fernandes,02-04-2005,544655,Kerala,19,22,19,24,84,Pass
Kunal Pillai,08-02-2006,430649,Maharashtra,15,5,10,16,46,Pass
Ishaan Mehta,25-12-2005,611745,Chhattisgarh,3,12,11,12,38,Pass
Raj Verma,22-01-2005,856126,Uttar Pradesh,13,5,23,20,61,Pass
Aarav Pillai,14-06-2005,118317,Andhra Pradesh,8,20,6,15,49,Pass
Ishaan Pillai,17-03-2006,570671,Maharashtra,13,13,6,12,44,Pass
Aryan Chopra,27-09-2005,539418,Assam,8,7,22,15,52,Pass
Aarav Khan,07-05-2006,281272,Tamil Nadu,0,2,19,3,24,Pass
Imran Singh,02-01-2005,527696,Kerala,3,0,13,6,22,Pass
Gurpreet Reddy,30-12-2005,206725,Bihar,1,18,9,1,29,Pass
Harjeet Mehta,27-06-2005,436809,Maharashtra,20,8,2,21,51,Pass
Harjeet Singh,19-12-2005,619887,West Bengal,3,2,18,24,47,Pass
Kunal Reddy,27-04-2005,445982,Bihar,9,2,14,19,44,Pass
Rohan Pillai,19-09-2005,339209,Bihar,4,19,12,18,53,Pass
Imran Reddy,06-12-2004,860153,Rajasthan,11,22,0,9,42,Pass
Rohan Verma,14-01-2005,256606,Madhya Pradesh,11,20,3,17,51,Pass
Rohan Reddy,27-07-2005,226128,Haryana,21,5,7,12,45,Pass
Farhan Singh,29-08-2005,475902,Tamil Nadu,12,22,15,24,73,Pass
Sukhwinder Fernandes,28-03-2006,159228,Jammu & Kashmir + Ladakh,11,5,20,24,60,Pass
Peter Chopra,18-11-2005,711586,Assam,6,21,3,18,48,Pass
Ishaan Mehta,20-05-2005,340027,Uttar Pradesh,7,1,15,9,32,Pass
Ishaan D'Souza,23-03-2005,341255,Chhattisgarh,5,0,15,23,43,Pass
Yash Verma,05-01-2006,704659,Bihar,22,6,21,15,64,Pass
Aryan Mehta,16-09-2005,280488,Punjab,7,9,11,24,51,Pass
Harjeet Pillai,17-04-2006,549682,Assam,14,2,19,20,55,Pass
Krishna Fernandes,27-12-2005,686668,Tamil Nadu,9,10,9,3,31,Pass
Vivaan D'Souza,13-04-2005,295092,Rajasthan,12,21,8,5,46,Pass
Raj Singh,26-06-2005,213807,Maharashtra,11,8,10,16,45,Pass
Aryan Pillai,02-05-2005,418921,Andhra Pradesh,22,4,1,10,37,Pass
Rohan D'Souza,05-02-2006,940799,Chhattisgarh,17,17,16,22,72,Pass
Krishna Reddy,15-12-2004,897995,Assam,1,9,1,17,28,Pass
Imran Pillai,12-04-2006,735001,Jammu & Kashmir + Ladakh,21,2,15,17,55,Pass
Gurpreet Verma,19-12-2005,952712,Uttar Pradesh,2,13,1,19,35,Pass
Ishaan Khan,04-09-2005,447226,Andhra Pradesh,9,11,10,2,32,Pass
Aryan Sharma,03-12-2004,276577,Maharashtra,16,5,2,12,35,Pass
Harjeet D'Souza,27-04-2005,682847,Himachal Pradesh,24,15,4,8,51,Pass
Aryan Fernandes,14-11-2005,945163,Bihar,18,5,17,17,57,Pass
Yash Singh,02-12-2004,842441,Rajasthan,8,0,8,8,24,Pass
Kunal Khan,25-09-2005,253619,Jharkhand,19,15,16,10,60,Pass
Paul Chopra,13-12-2005,504167,Maharashtra,2,12,24,2,40,Pass
Aryan Pillai,09-01-2005,679197,Maharashtra,1,13,8,21,43,Pass
Aditya Khan,20-05-2005,471243,Rajasthan,21,13,1,22,57,Pass
Ishaan Khan,01-02-2005,981069,Uttar Pradesh,8,15,23,5,51,Pass
Yash Verma,09-11-2004,492321,Telangana,8,21,15,0,44,Pass
Krishna Mehta,27-10-2005,552371,Bihar,10,0,9,16,35,Pass
Vivaan Khan,20-11-2005,633036,Rajasthan,2,3,15,21,41,Pass
Harjeet Mehta,31-05-2005,305224,Bihar,24,2,5,1,32,Pass
Raj Fernandes,23-01-2006,350082,Bihar,18,0,15,9,42,Pass
Peter Singh,25-06-2005,218439,Uttar Pradesh,23,6,15,21,65,Pass
Aditya Verma,13-12-2005,422264,Kerala,19,24,10,14,67,Pass
John Chopra,22-11-2005,717283,Tamil Nadu,23,16,0,17,56,Pass
Aarav D'Souza,20-03-2006,906558,Himachal Pradesh,14,7,4,21,46,Pass
David Khan,04-04-2006,445258,Uttar Pradesh,4,8,16,4,32,Pass
Rohan Reddy,23-11-2004,646907,Madhya Pradesh,9,0,20,24,53,Pass
Vivaan Pillai,27-10-2005,420239,Uttar Pradesh,3,22,9,10,44,Pass
Raj D'Souza,04-04-2006,100436,Manipur,2,14,3,11,30,Pass
Raj Sharma,07-10-2005,790306,Gujarat,14,3,16,23,56,Pass
Aditya Pillai,16-02-2006,317491,Andhra Pradesh,13,9,5,10,37,Pass
Aryan Khan,06-04-2005,602287,Tamil Nadu,0,19,8,7,34,Pass
Aditya D'Souza,21-11-2005,230859,West Bengal,8,3,22,20,53,Pass
Yash Khan,20-06-2005,387007,Uttar Pradesh,21,13,16,4,54,Pass
Aarav Singh,03-10-2005,783898,West Bengal,9,10,15,10,44,Pass
Ishaan Khan,14-06-2005,559743,Tripura,7,23,6,5,41,Pass
Peter Pillai,03-04-2006,778984,Bihar,14,7,6,4,31,Pass
Aryan Singh,26-11-2004,378489,Maharashtra,8,21,2,12,43,Pass
Vivaan Reddy,04-04-2006,746050,Jharkhand,14,12,12,11,49,Pass
Harjeet Fernandes,24-11-2004,874638,Maharashtra,24,3,2,13,42,Pass
Vivaan Verma,19-04-2005,303248,Tripura,13,3,12,6,34,Pass
Harjeet Verma,03-01-2005,597990,Punjab,3,2,16,9,30,Pass
Harjeet Pillai,07-02-2005,404204,Rajasthan,21,13,12,2,48,Pass
Manpreet Singh,01-11-2005,184078,Bihar,0,19,10,12,41,Pass
Paul Pillai,21-12-2005,144383,Rajasthan,6,9,16,19,50,Pass
Krishna Fernandes,02-12-2005,852000,Karnataka,21,19,13,3,56,Pass
Aarav D'Souza,02-11-2005,659265,Chhattisgarh,7,10,2,0,19,Pass
Harjeet Khan,09-08-2005,513790,Madhya Pradesh,19,8,6,11,44,Pass
Raj Chopra,24-12-2005,666996,West Bengal,3,20,18,9,50,Pass
Aditya Singh,12-05-2005,480637,Chhattisgarh,11,4,12,24,51,Pass
Paul Pillai,16-06-2005,754537,West Bengal,10,23,0,21,54,Pass
Ishaan Mehta,24-07-2005,386061,Maharashtra,12,17,2,16,47,Pass
Vivaan Reddy,09-06-2005,548589,Andhra Pradesh,19,1,14,15,49,Pass
Raj Pillai,12-10-2005,347538,Tamil Nadu,0,8,8,7,23,Pass
Kunal D'Souza,24-02-2005,471649,Andhra Pradesh,10,17,11,3,41,Pass
Rehan Verma,07-02-2006,581381,Telangana,16,13,13,20,62,Pass
Krishna Chopra,28-09-2005,947387,Punjab,7,19,16,15,57,Pass
Gurpreet Reddy,08-05-2005,710304,Gujarat,5,21,13,19,58,Pass
Ishaan Pillai,20-04-2006,533632,Kerala,18,5,17,8,48,Pass
Farhan Fernandes,25-01-2005,551934,Punjab,8,14,16,15,53,Pass
Manpreet Khan,15-11-2005,171539,Bihar,6,5,16,2,29,Pass
John Khan,04-01-2005,741753,Maharashtra,8,21,3,10,42,Pass
Aarav Fernandes,18-06-2005,771598,West Bengal,12,18,0,9,39,Pass
Rohan Verma,11-03-2005,305424,Andhra Pradesh,9,16,18,4,47,Pass
Vivaan Reddy,21-02-2006,759772,Uttar Pradesh,3,23,20,16,62,Pass
David Verma,31-03-2005,161438,Kerala,15,11,8,13,47,Pass
Manpreet Khan,13-04-2006,556073,Tamil Nadu,5,1,10,21,37,Pass
Vivaan Pillai,07-07-2005,956289,Jharkhand,11,13,8,1,33,Pass
Yash Pillai,30-09-2005,226291,Punjab,21,12,11,24,68,Pass
Harjeet Chopra,17-08-2005,296724,Rajasthan,14,17,9,9,49,Pass
Harjeet Fernandes,17-07-2005,995792,Himachal Pradesh,11,9,10,8,38,Pass
Yash Verma,02-07-2005,573995,Maharashtra,11,22,7,4,44,Pass
Ishaan Reddy,01-03-2006,770543,Uttar Pradesh,21,8,14,2,45,Pass
Balbir Sharma,12-12-2005,880520,Rajasthan,5,10,19,17,51,Pass
Aryan Sharma,19-09-2005,678306,Uttar Pradesh,15,3,7,17,42,Pass
Aarav Khan,29-01-2006,915601,Delhi,18,1,6,23,48,Pass
Aditya Fernandes,10-03-2006,237545,Uttar Pradesh,12,11,6,7,36,Pass
Krishna Fernandes,25-02-2006,870051,Uttar Pradesh,10,13,21,20,64,Pass
Yash Chopra,26-03-2006,822248,Madhya Pradesh,15,2,2,13,32,Pass
Krishna Pillai,31-01-2006,280885,Assam,9,17,4,13,43,Pass
Balbir D'Souza,28-03-2005,191766,West Bengal,3,9,5,21,38,Pass
Aditya Fernandes,26-05-2005,899097,Gujarat,18,1,2,22,43,Pass
Raj Reddy,29-03-2005,613490,Madhya Pradesh,8,11,17,9,45,Pass
John Singh,20-01-2006,991117,Uttar Pradesh,3,20,24,9,56,Pass
Kunal Singh,12-05-2005,251355,Madhya Pradesh,14,18,12,11,55,Pass
Zaid Pillai,18-11-2005,862646,Uttarakhand,3,11,20,3,37,Pass
Manpreet Verma,30-07-2005,554614,Uttarakhand,19,2,10,18,49,Pass
Aryan Sharma,15-06-2005,862226,Punjab,17,18,8,24,67,Pass
Kunal Reddy,13-10-2005,575673,Odisha,19,20,23,21,83,Pass
Kunal Verma,02-02-2006,455309,Uttar Pradesh,0,0,15,21,36,Pass
Rohan Khan,19-10-2005,453929,Goa,8,6,5,3,22,Fail
David Pillai,03-07-2005,879509,Andhra Pradesh,1,4,6,5,16,Pass
Mathew Pillai,09-01-2006,895798,Chhattisgarh,3,15,8,20,46,Pass
Rohan Sharma,15-06-2005,109395,Himachal Pradesh,8,24,17,8,57,Pass
Ishaan Pillai,25-04-2006,630626,Uttar Pradesh,7,8,6,9,30,Pass
Balbir Singh,11-09-2005,799650,Uttarakhand,9,0,9,2,20,Pass
Krishna Reddy,13-07-2005,559928,Madhya Pradesh,16,24,3,10,53,Pass
Harjeet Chopra,09-02-2006,356342,Maharashtra,4,11,2,19,36,Pass
Vivaan Reddy,07-12-2004,446828,Gujarat,24,20,23,5,72,Pass
Aarav D'Souza,13-11-2005,208853,Madhya Pradesh,22,7,14,9,52,Pass
Krishna Reddy,02-12-2004,257447,Kerala,8,6,19,6,39,Pass
Ishaan Chopra,17-08-2005,208016,Punjab,5,20,13,10,48,Pass
Aarav Pillai,26-02-2006,683733,Telangana,15,20,18,8,61,Pass
Peter Khan,18-03-2005,977586,Uttarakhand,7,6,23,10,46,Pass
Ishaan Reddy,07-05-2006,302966,Jharkhand,6,11,16,22,55,Pass
Kunal D'Souza,06-11-2005,203214,Tamil Nadu,14,19,17,11,61,Pass
Raj Chopra,10-03-2005,528259,Odisha,12,4,10,13,39,Pass
Farhan Chopra,03-05-2006,123494,Bihar,12,7,16,21,56,Pass
Raj Fernandes,21-06-2005,146797,Karnataka,16,24,1,6,47,Pass
Harjeet Reddy,10-05-2005,888292,Uttar Pradesh,5,6,19,8,38,Pass
Ishaan Sharma,06-05-2006,944786,Tripura,17,5,14,24,60,Pass
Manpreet Pillai,15-12-2004,412293,Gujarat,0,6,9,3,18,Pass
Raj Mehta,09-04-2005,528037,Maharashtra,7,8,13,12,40,Pass
Aditya Mehta,06-03-2005,637100,Rajasthan,21,10,12,1,44,Pass
Ishaan Pillai,16-02-2005,816914,Rajasthan,9,19,3,21,52,Pass
Aarav Mehta,14-11-2004,758826,Haryana,15,24,8,9,56,Pass
Aryan Fernandes,16-01-2006,101988,Rajasthan,24,11,23,0,58,Pass
David Chopra,15-03-2006,487387,Uttar Pradesh,3,13,14,5,35,Pass
Peter Reddy,25-12-2005,143920,West Bengal,1,12,0,9,22,Pass
Aarav Pillai,12-02-2006,184428,Punjab,24,13,14,2,53,Pass
Balbir D'Souza,17-01-2005,259748,Maharashtra,9,0,17,10,36,Pass
Sukhwinder Mehta,07-05-2006,586321,Rajasthan,12,8,20,11,51,Pass
Paul Fernandes,12-11-2004,505004,Karnataka,8,23,10,20,61,Pass
Aarav Singh,07-02-2006,133305,Uttar Pradesh,0,23,6,7,36,Pass
Aarav Fernandes,13-03-2006,279897,Haryana,24,23,4,10,61,Pass
Rohan Khan,11-01-2006,531303,Telangana,2,24,2,8,36,Pass
Ishaan Verma,20-01-2006,274037,Maharashtra,16,5,2,19,42,Pass
Aarav D'Souza,11-01-2006,350317,Tamil Nadu,6,18,17,24,65,Pass
John D'Souza,24-01-2005,616400,Haryana,5,13,2,4,24,Pass
Farhan Verma,15-01-2006,276251,Maharashtra,16,6,0,5,27,Pass
Harjeet Sharma,12-03-2005,805030,Kerala,3,11,15,4,33,Pass
Balbir Reddy,28-02-2006,121677,Rajasthan,15,13,12,9,49,Pass
Aarav Khan,12-11-2004,564837,Rajasthan,13,13,18,0,44,Pass
Yash Singh,05-01-2005,159059,Andhra Pradesh,19,11,13,6,49,Pass
Rohan Mehta,04-08-2005,536554,Rajasthan,18,1,1,24,44,Pass
Yash Chopra,25-05-2005,513808,Telangana,12,24,21,3,60,Pass
Krishna Pillai,18-11-2004,614349,Punjab,24,16,7,14,61,Pass
Rohan Sharma,07-08-2005,722182,Bihar,7,11,22,9,49,Pass
Mathew Singh,02-05-2005,666944,Bihar,24,23,11,4,62,Pass
Aditya Pillai,30-03-2005,328780,Maharashtra,16,23,2,13,54,Pass
Aryan Mehta,21-02-2006,745207,Telangana,13,4,14,24,55,Pass
Sukhwinder Sharma,01-08-2005,991684,Uttarakhand,24,7,3,10,44,Pass
Ishaan Verma,18-01-2006,922138,Tamil Nadu,24,5,18,17,64,Pass
Aryan Sharma,31-07-2005,725381,Gujarat,12,7,3,24,46,Pass
Peter Singh,06-07-2005,760676,Andhra Pradesh,20,0,8,15,43,Pass
Sukhwinder Verma,26-12-2005,211311,Bihar,7,22,19,9,57,Pass
Aditya Mehta,11-11-2005,797981,Uttar Pradesh,12,2,10,16,40,Pass
Raj Chopra,18-12-2004,395334,Maharashtra,18,5,3,19,45,Pass
Rohan Khan,27-11-2005,464936,Uttar Pradesh,19,23,10,18,70,Pass
Raj Chopra,21-12-2005,651387,West Bengal,1,23,6,21,51,Pass
Yash Reddy,08-11-2004,350897,Maharashtra,18,23,2,17,60,Pass
Aditya Reddy,18-09-2005,463346,Maharashtra,21,10,2,23,56,Pass
Raj Singh,23-03-2006,249078,Sikkim,17,5,14,8,44,Pass
David Singh,22-11-2005,797408,Andhra Pradesh,17,9,0,10,36,Pass
Balbir Pillai,26-11-2004,546331,Odisha,16,24,24,21,85,Pass
Krishna Singh,10-07-2005,234979,Haryana,6,11,17,2,36,Pass
Paul Singh,03-03-2005,849776,Gujarat,11,4,14,18,47,Pass
Aditya Mehta,16-03-2006,892808,Uttar Pradesh,20,19,8,17,64,Pass
Kunal Chopra,15-01-2005,699060,Bihar,9,21,1,10,41,Pass
Ishaan Pillai,03-04-2005,434572,Maharashtra,3,13,3,3,22,Pass
Yash D'Souza,04-05-2006,685047,Tamil Nadu,3,6,7,5,21,Pass
Raj Reddy,03-10-2005,523476,Rajasthan,11,2,3,22,38,Pass
Harjeet Mehta,23-12-2005,534978,Jharkhand,22,3,12,13,50,Pass
Rohan Sharma,28-03-2006,941869,Rajasthan,13,13,0,1,27,Pass
Aryan Reddy,31-05-2005,273567,Uttar Pradesh,6,13,18,15,52,Pass
Vivaan Singh,20-02-2006,742541,Madhya Pradesh,2,22,3,3,30,Pass
Vivaan Fernandes,17-12-2005,792195,Bihar,11,9,10,16,46,Pass
David Sharma,26-01-2005,186440,Bihar,9,10,23,5,47,Pass
Aditya D'Souza,14-03-2005,238339,West Bengal,22,0,13,7,42,Pass
Aditya Mehta,15-08-2005,835611,Bihar,20,0,15,23,58,Pass
Ishaan Chopra,02-10-2005,350102,Uttar Pradesh,0,11,17,23,51,Pass
Imran Verma,03-05-2006,736503,Madhya Pradesh,23,7,3,17,50,Pass
Ishaan Sharma,26-09-2005,753236,Odisha,6,8,21,12,47,Pass
Ishaan Khan,08-06-2005,273503,Punjab,12,2,16,7,37,Pass
Krishna D'Souza,26-04-2006,547319,Bihar,12,3,2,8,25,Pass
Aarav Singh,09-02-2005,670482,Rajasthan,19,10,19,7,55,Pass
Ayaan Reddy,16-04-2005,450165,West Bengal,3,21,18,15,57,Pass
Peter Mehta,05-10-2005,710012,Rajasthan,13,18,22,13,66,Pass
Raj Pillai,17-03-2005,175991,Telangana,20,2,1,22,45,Pass
Vivaan Pillai,18-12-2005,411319,Maharashtra,19,18,5,7,49,Pass
Vivaan Khan,21-05-2005,858312,Tamil Nadu,3,23,23,0,49,Pass
Krishna Pillai,17-11-2004,576628,Bihar,9,19,19,20,67,Pass
Sukhwinder Pillai,13-03-2005,949545,Maharashtra,17,9,2,15,43,Pass
Aarav Singh,09-02-2006,575231,Rajasthan,18,11,20,22,71,Pass
Raj Reddy,04-04-2005,278846,Uttar Pradesh,17,2,17,22,58,Pass
Imran Pillai,25-08-2005,598745,Telangana,6,6,22,4,38,Pass
Ayaan Chopra,25-03-2005,114703,Uttar Pradesh,2,8,9,1,20,Pass
Yash Reddy,21-06-2005,741811,Maharashtra,21,4,4,4,33,Pass
Krishna Fernandes,28-09-2005,863925,Gujarat,2,18,13,4,37,Pass
Sukhwinder Khan,23-02-2005,364681,Gujarat,15,21,24,5,65,Pass
Yash Fernandes,06-08-2005,311947,Haryana,5,8,4,4,21,Pass
Aarav Fernandes,08-04-2005,359305,West Bengal,22,7,4,19,52,Pass
John Mehta,11-07-2005,191374,Odisha,18,17,11,2,48,Pass
Kunal Pillai,21-12-2005,382760,Andhra Pradesh,2,13,7,8,30,Pass
Zaid Fernandes,18-07-2005,201004,Telangana,18,11,16,5,50,Pass
Yash Verma,19-11-2005,147710,Tamil Nadu,13,8,1,22,44,Pass
Harjeet Pillai,30-12-2004,659176,Andhra Pradesh,16,11,16,23,66,Pass
Raj Sharma,12-05-2005,519264,Uttar Pradesh,24,7,16,17,64,Pass
Krishna Khan,25-04-2005,895411,Punjab,8,11,10,11,40,Pass
Balbir D'Souza,13-07-2005,529163,Rajasthan,16,22,9,21,68,Pass
Paul Verma,20-10-2005,308763,Uttar Pradesh,19,19,7,22,67,Pass
Ishaan Chopra,07-02-2005,516569,Gujarat,9,1,18,4,32,Pass
Raj Verma,14-12-2004,604568,Kerala,9,17,12,9,47,Pass
Kunal Chopra,04-04-2006,607329,Gujarat,12,14,10,24,60,Pass
Vivaan D'Souza,09-12-2005,243001,Haryana,15,11,18,11,55,Pass
Balbir Pillai,12-12-2004,793692,Uttar Pradesh,5,22,19,10,56,Pass
Rohan Fernandes,30-05-2005,665698,Chhattisgarh,1,20,7,10,38,Pass
Rohan Mehta,27-09-2005,918642,Tamil Nadu,14,10,16,10,50,Pass
Balbir Singh,14-02-2006,498133,West Bengal,3,22,23,2,50,Pass
Balbir Verma,19-09-2005,139838,Madhya Pradesh,11,18,8,1,38,Pass
Aditya Mehta,14-04-2006,670960,Maharashtra,6,10,2,23,41,Pass
Krishna Singh,21-11-2005,941931,Tamil Nadu,6,7,9,4,26,Pass
Farhan Sharma,15-10-2005,868937,Rajasthan,6,1,4,21,32,Pass
Aryan Khan,01-05-2006,665960,Uttar Pradesh,1,0,10,18,29,Pass
Yash Reddy,18-03-2006,714090,Assam,6,3,19,14,42,Pass
Rohan Reddy,25-02-2006,408906,Chhattisgarh,5,11,17,2,35,Pass
Rohan Khan,24-12-2004,313539,West Bengal,3,7,23,18,51,Pass
Aryan Reddy,02-04-2005,499484,Tamil Nadu,12,17,18,1,48,Pass
Manpreet Fernandes,22-03-2005,552433,Rajasthan,21,17,11,6,55,Pass
Ishaan Pillai,21-05-2005,332846,Chhattisgarh,8,8,14,15,45,Pass
Vivaan Reddy,27-09-2005,863540,Rajasthan,2,14,15,16,47,Pass
Mathew Mehta,25-04-2005,207244,Uttar Pradesh,0,7,10,13,30,Pass
Raj D'Souza,26-03-2005,745113,Maharashtra,1,21,8,6,36,Pass
Gurpreet Verma,09-01-2005,186952,Haryana,6,17,12,3,38,Pass
Mathew D'Souza,11-02-2006,729934,Manipur,8,14,4,1,27,Pass
Raj Mehta,21-03-2006,786280,Gujarat,1,19,3,11,34,Pass
Harjeet Singh,09-11-2005,807671,Telangana,9,17,6,3,35,Pass
Krishna Sharma,12-02-2005,611317,Telangana,8,21,12,20,61,Pass
Gurpreet Fernandes,23-09-2005,786196,Uttar Pradesh,23,7,16,15,61,Pass
Raj Sharma,07-02-2006,606724,Punjab,22,0,12,11,45,Pass
Paul D'Souza,22-05-2005,113405,Himachal Pradesh,0,14,19,8,41,Pass
Raj Chopra,02-12-2005,758528,Uttarakhand,3,10,19,17,49,Pass
Manpreet Fernandes,25-01-2006,856497,Haryana,13,14,24,1,52,Pass
Vivaan Fernandes,29-09-2005,980399,Delhi,20,17,10,7,54,Pass
Krishna Mehta,11-07-2005,122116,Madhya Pradesh,10,21,3,9,43,Pass
Gurpreet Khan,29-11-2004,369656,Himachal Pradesh,4,5,4,15,28,Pass
Krishna Khan,15-07-2005,603751,Delhi,10,2,10,14,36,Pass
Gurpreet Reddy,30-12-2005,136949,Assam,3,22,11,17,53,Pass
Aarav Singh,18-03-2005,124765,Bihar,22,14,6,18,60,Pass
Krishna Fernandes,20-01-2006,145141,West Bengal,3,17,11,22,53,Pass
David Khan,13-12-2004,819507,Jharkhand,11,4,4,8,27,Pass
David Sharma,04-07-2005,881228,West Bengal,3,22,0,24,49,Pass
Aarav Sharma,08-12-2005,294063,Assam,19,0,20,23,62,Pass
Aryan Mehta,14-11-2004,687223,Maharashtra,17,16,2,24,59,Pass
Yash Fernandes,09-11-2005,838921,Rajasthan,24,21,18,18,81,Pass
Krishna D'Souza,03-11-2005,556857,Haryana,23,22,14,15,74,Pass
Aarav Mehta,27-02-2005,241531,Uttar Pradesh,24,2,20,16,62,Pass
Krishna Verma,30-12-2004,241576,Odisha,12,7,10,1,30,Pass
Aryan Fernandes,07-06-2005,133654,Haryana,15,24,1,24,64,Pass
Yash Fernandes,01-12-2004,394875,Bihar,18,1,20,3,42,Pass
Krishna Chopra,25-10-2005,199748,Haryana,12,6,0,8,26,Pass
Vivaan Chopra,04-02-2006,417163,Delhi,3,21,15,19,58,Pass
Yash Khan,14-12-2005,937983,Madhya Pradesh,0,4,11,23,38,Pass
Kunal Fernandes,06-06-2005,765596,Bihar,3,20,6,17,46,Pass
Aarav Chopra,16-11-2005,254468,Delhi,16,3,23,8,50,Pass
Sukhwinder Fernandes,20-01-2006,799806,Uttar Pradesh,4,8,16,12,40,Pass
Kunal Reddy,24-03-2006,377934,West Bengal,9,4,21,9,43,Pass
Aditya Singh,06-02-2006,920038,Chhattisgarh,10,14,14,2,40,Pass
Krishna Singh,30-10-2005,363623,Madhya Pradesh,20,6,3,18,47,Pass
Paul Sharma,17-11-2005,408726,Punjab,21,3,20,4,48,Pass
Krishna Khan,18-12-2005,503782,Chhattisgarh,20,21,7,2,50,Pass
Aarav D'Souza,01-10-2005,778472,Gujarat,21,9,13,13,56,Pass
Balbir Pillai,18-01-2005,108098,Tamil Nadu,24,21,7,23,75,Pass
Vivaan Mehta,06-10-2005,344305,Madhya Pradesh,4,17,14,17,52,Pass
Vivaan Chopra,04-11-2005,918912,Maharashtra,19,18,2,19,58,Pass
Vivaan D'Souza,01-05-2006,180120,Bihar,17,15,9,4,45,Pass
Peter Fernandes,14-02-2005,243321,Maharashtra,13,5,2,21,41,Pass
Raj Verma,21-11-2005,370339,Uttar Pradesh,19,2,2,10,33,Pass
Aarav Khan,19-02-2006,278978,Uttar Pradesh,6,14,6,3,29,Pass
Farhan Chopra,08-03-2005,126957,Rajasthan,15,15,6,9,45,Pass
Krishna Reddy,17-12-2004,916052,Rajasthan,24,0,18,10,52,Pass
Paul Reddy,19-02-2005,292533,Madhya Pradesh,18,3,13,11,45,Pass
Aryan Fernandes,13-10-2005,173496,Haryana,10,18,12,12,52,Pass
Manpreet D'Souza,28-04-2006,131826,Gujarat,0,17,13,22,52,Pass
Sukhwinder Sharma,29-12-2004,514885,Assam,3,24,13,12,52,Pass
Raj Sharma,20-11-2004,879988,Uttar Pradesh,12,5,11,14,42,Pass
Balbir Verma,20-05-2005,634365,Uttar Pradesh,7,15,7,8,37,Pass
Ishaan Singh,08-06-2005,802775,Tamil Nadu,24,17,21,1,63,Pass
Paul Verma,20-09-2005,659462,Uttar Pradesh,0,14,10,24,48,Pass
Rohan D'Souza,20-12-2004,325256,Rajasthan,6,4,20,22,52,Pass
David Mehta,02-12-2004,295851,Maharashtra,18,2,18,3,41,Pass
Balbir D'Souza,19-10-2005,395320,Punjab,6,17,2,12,37,Pass
Farhan Fernandes,24-04-2006,462794,Tamil Nadu,0,4,13,13,30,Pass
Manpreet Pillai,09-02-2005,902755,West Bengal,3,9,18,16,46,Pass
Krishna D'Souza,20-12-2004,427913,Madhya Pradesh,0,15,20,14,49,Pass
Kunal Chopra,26-12-2005,328354,Bihar,1,23,12,23,59,Pass
Rohan Pillai,27-01-2006,746045,West Bengal,3,9,22,20,54,Pass
Rohan Fernandes,02-04-2006,720872,Jharkhand,15,11,5,20,51,Pass
Aryan D'Souza,10-07-2005,679106,Haryana,24,6,13,0,43,Pass
Rohan Khan,10-05-2005,160936,Uttar Pradesh,3,15,22,22,62,Pass
Raj Sharma,09-10-2005,955442,Meghalaya,15,1,4,13,33,Pass
Yash Khan,25-11-2004,584416,Rajasthan,4,2,21,12,39,Pass
Raj D'Souza,08-11-2004,787605,Andhra Pradesh,20,11,11,7,49,Pass
Ishaan Pillai,18-12-2004,194070,Madhya Pradesh,4,1,10,11,26,Pass
Harjeet D'Souza,04-06-2005,863149,Tamil Nadu,4,0,17,14,35,Pass
Paul Khan,13-11-2004,182451,Bihar,17,8,14,4,43,Pass
Aryan Khan,14-03-2006,988374,Telangana,22,3,8,13,46,Pass
Rohan Sharma,25-04-2006,808174,Gujarat,10,4,4,0,18,Pass
Gurpreet Reddy,15-04-2006,725201,Odisha,11,3,24,2,40,Pass
Aarav Sharma,18-04-2006,954662,Punjab,17,4,1,16,38,Pass
Aarav Pillai,18-10-2005,259284,Uttar Pradesh,9,18,12,18,57,Pass
Vivaan Chopra,17-02-2006,255420,Haryana,20,16,4,20,60,Pass
Krishna Singh,18-02-2006,509038,Maharashtra,20,24,2,21,67,Pass
Harjeet Fernandes,05-11-2005,432531,Uttarakhand,3,1,19,16,39,Pass
Rohan Khan,09-11-2004,455468,Chhattisgarh,7,18,21,7,53,Pass
Vivaan Mehta,31-12-2004,219933,Tamil Nadu,5,22,13,10,50,Pass
Raj Sharma,31-10-2005,268480,Uttar Pradesh,6,17,11,14,48,Pass
Kunal Khan,13-08-2005,151415,Chhattisgarh,8,17,3,5,33,Pass
Aarav Singh,12-02-2006,108276,Uttar Pradesh,7,14,15,21,57,Pass
Kunal D'Souza,03-01-2005,374524,Meghalaya,1,12,0,19,32,Pass
Farhan Reddy,29-11-2005,817961,Rajasthan,23,10,5,19,57,Pass
Aarav Chopra,12-05-2005,479204,Uttar Pradesh,22,9,2,7,40,Pass
Manpreet D'Souza,11-09-2005,226713,Chhattisgarh,5,21,3,20,49,Pass
Farhan Khan,12-10-2005,488538,Punjab,14,0,2,6,22,Pass
Kunal Singh,18-05-2005,335505,Andhra Pradesh,10,0,3,12,25,Pass
Ayaan Verma,01-11-2005,787029,Uttar Pradesh,19,2,17,19,57,Pass
Aryan Chopra,03-02-2006,372121,Uttar Pradesh,20,8,20,4,52,Pass
Kunal Fernandes,29-12-2004,592415,West Bengal,0,6,9,19,34,Pass
Aarav Verma,12-02-2006,886905,Karnataka,6,9,0,10,25,Pass
Vivaan Singh,13-01-2006,998718,Rajasthan,14,24,2,13,53,Pass
Ishaan Khan,24-09-2005,860833,West Bengal,3,13,18,9,43,Pass
Raj Sharma,14-01-2006,154479,Uttar Pradesh,22,3,18,8,51,Pass
Aditya Pillai,15-04-2006,141171,Uttar Pradesh,22,23,19,5,69,Pass
Ishaan Pillai,25-02-2006,660050,West Bengal,3,7,19,19,48,Pass
Aryan Verma,30-04-2005,148958,Telangana,23,7,10,20,60,Pass
Krishna Mehta,13-10-2005,694680,Madhya Pradesh,22,3,20,5,50,Pass
Raj D'Souza,12-10-2005,653900,Rajasthan,24,18,21,12,75,Pass
Aditya Khan,21-06-2005,215672,Himachal Pradesh,19,18,2,14,53,Pass
Vivaan Khan,01-09-2005,661463,Assam,21,15,0,1,37,Pass
Yash Verma,30-07-2005,979526,Rajasthan,9,22,19,10,60,Pass
Yash Mehta,25-11-2005,276614,Tamil Nadu,1,23,6,16,46,Pass
Yash Verma,25-12-2005,329859,Punjab,13,23,12,24,72,Pass
Ishaan Mehta,30-06-2005,542175,Punjab,8,13,19,11,51,Pass
Aditya Sharma,16-10-2005,161592,Tamil Nadu,6,11,14,18,49,Pass
Sukhwinder Pillai,05-10-2005,289808,Uttarakhand,3,22,15,21,61,Pass
Manpreet Pillai,19-06-2005,474164,West Bengal,3,20,24,13,60,Pass
Rohan Khan,20-04-2005,961740,Rajasthan,2,6,3,9,20,Pass
Balbir Reddy,11-12-2004,892281,Chhattisgarh,16,7,1,15,39,Pass
Gurpreet D'Souza,05-05-2006,664897,Andhra Pradesh,5,10,15,20,50,Pass
Vivaan D'Souza,24-07-2005,847000,Assam,18,19,18,4,59,Pass
Gurpreet Reddy,18-06-2005,159751,Punjab,21,18,15,6,60,Pass
Ayaan Mehta,28-11-2005,695449,Telangana,6,15,24,15,60,Pass
Harjeet Sharma,19-05-2005,171485,West Bengal,8,18,2,15,43,Pass
Aryan Reddy,15-10-2005,756654,Rajasthan,21,12,22,24,79,Pass
Sukhwinder Reddy,15-01-2005,329687,Rajasthan,24,10,8,15,57,Pass
Kunal Mehta,11-12-2004,854868,Bihar,2,16,5,20,43,Pass
Manpreet Chopra,13-11-2004,268458,Maharashtra,12,16,2,22,52,Pass
Ishaan Verma,10-03-2006,657380,Uttar Pradesh,15,2,10,5,32,Pass
Ishaan Fernandes,11-03-2005,169150,Madhya Pradesh,5,20,3,12,40,Pass
Manpreet Pillai,13-04-2006,221509,Madhya Pradesh,4,10,15,2,31,Pass
Aryan Reddy,21-04-2006,445462,Haryana,22,19,15,16,72,Pass
Balbir Reddy,09-04-2005,243755,Tamil Nadu,7,11,17,13,48,Pass
John Pillai,02-01-2006,105857,Kerala,5,12,10,19,46,Pass
Vivaan Chopra,26-03-2005,922462,Bihar,9,12,20,5,46,Pass
Peter Reddy,01-04-2005,683625,Andaman & Nicobar,12,11,23,18,64,Fail
Peter Mehta,12-07-2005,964864,Meghalaya,8,14,10,3,35,Pass
Paul Singh,09-01-2005,370633,Arunachal Pradesh,20,8,5,6,39,Pass
Vivaan Singh,20-02-2006,443996,Haryana,15,24,16,23,78,Pass
Rohan Mehta,06-11-2005,986430,Chhattisgarh,13,16,17,14,60,Pass
Ishaan Reddy,17-05-2005,341633,Chhattisgarh,17,5,3,20,45,Pass
Ishaan Verma,14-08-2005,879788,Bihar,3,4,20,9,36,Pass
Raj Pillai,21-12-2004,906425,Kerala,3,2,10,7,22,Pass
Aditya Khan,22-11-2004,792709,Punjab,15,7,24,8,54,Pass
Krishna Singh,04-01-2005,215204,Gujarat,9,18,2,17,46,Pass
Aryan Sharma,13-01-2006,410327,Haryana,1,4,6,12,23,Pass
Krishna Reddy,26-03-2005,835481,West Bengal,1,20,23,3,47,Pass
Raj Chopra,30-08-2005,549152,Uttar Pradesh,11,0,2,3,16,Pass
Aarav Singh,19-10-2005,799690,Andhra Pradesh,7,13,5,13,38,Pass
Ishaan Pillai,16-03-2006,365262,Delhi,2,18,6,18,44,Pass
Aryan Chopra,23-05-2005,129705,Uttar Pradesh,16,23,7,0,46,Pass
Rehan Khan,06-05-2006,738549,Jammu & Kashmir + Ladakh,16,3,23,2,44,Pass
Ishaan Mehta,06-03-2005,820351,Bihar,19,13,21,5,58,Pass
Manpreet D'Souza,17-11-2004,930389,Punjab,18,11,21,23,73,Pass
Yash Chopra,09-06-2005,259919,Haryana,8,2,22,17,49,Pass
Sukhwinder Verma,15-04-2005,856294,Maharashtra,12,18,2,13,45,Pass
Peter Chopra,02-02-2006,545008,Bihar,12,10,8,22,52,Pass
Raj Reddy,27-03-2006,599555,Maharashtra,18,19,2,17,56,Pass
Yash Singh,20-03-2005,325581,Maharashtra,13,2,17,0,32,Pass
Paul Singh,14-05-2005,737483,Karnataka,13,9,18,24,64,Pass
Yash Khan,06-03-2006,153902,Uttar Pradesh,3,24,22,24,73,Pass
Manpreet Mehta,01-11-2005,294405,Maharashtra,10,1,23,0,34,Pass
Aarav Fernandes,13-12-2005,398109,Punjab,2,10,4,12,28,Pass
Balbir Sharma,28-06-2005,380931,Punjab,5,13,8,2,28,Pass
Vivaan Pillai,16-07-2005,760764,Haryana,9,4,0,21,34,Pass
Aditya Pillai,22-12-2005,541653,Uttar Pradesh,18,4,15,15,52,Pass
Krishna Reddy,09-12-2005,193628,Karnataka,23,16,0,3,42,Pass
Peter Verma,16-01-2006,955683,Rajasthan,22,14,24,22,82,Pass
Krishna Mehta,10-05-2005,144464,Uttar Pradesh,13,1,1,10,25,Pass
Yash Mehta,05-05-2006,365991,Rajasthan,7,1,14,20,42,Pass
John Reddy,08-02-2006,558781,Andhra Pradesh,20,23,5,5,53,Pass
Ishaan Singh,15-01-2005,975469,Odisha,20,18,5,6,49,Pass
Aryan D'Souza,08-11-2004,568557,Bihar,19,24,23,21,87,Pass
Ayaan Verma,29-01-2005,427384,Maharashtra,0,9,17,12,38,Pass
Harjeet Fernandes,27-12-2004,745001,Tamil Nadu,5,7,16,20,48,Pass
Krishna Singh,19-11-2005,740598,Uttar Pradesh,7,14,16,4,41,Pass
Vivaan Reddy,24-03-2005,111120,Karnataka,12,10,9,6,37,Pass
Ishaan Verma,24-07-2005,956353,Madhya Pradesh,6,4,2,23,35,Pass
Kunal Singh,24-09-2005,900827,Rajasthan,0,6,19,17,42,Pass
Aryan D'Souza,14-11-2005,783110,Assam,10,0,24,11,45,Pass
Harjeet Pillai,08-09-2005,499770,Assam,18,23,2,17,60,Pass
Harjeet Verma,26-04-2006,106609,West Bengal,3,22,16,23,64,Pass
Rohan D'Souza,02-12-2005,974085,Bihar,1,18,15,6,40,Pass
Yash Fernandes,01-09-2005,431318,Rajasthan,5,2,19,19,45,Pass
Aarav Sharma,08-04-2005,360965,Rajasthan,3,10,24,13,50,Pass
Harjeet Reddy,10-01-2006,591538,Bihar,6,24,20,11,61,Pass
Rohan D'Souza,13-07-2005,170292,Rajasthan,11,11,3,1,26,Pass
Farhan Chopra,09-11-2004,888828,Andhra Pradesh,24,18,20,10,72,Pass
Yash Verma,20-01-2005,442305,Chhattisgarh,18,9,17,10,54,Pass
Balbir Pillai,08-06-2005,246607,Madhya Pradesh,2,19,3,22,46,Pass
Ishaan Singh,08-07-2005,143197,Bihar,10,21,5,6,42,Pass
Aditya Sharma,26-04-2006,506755,West Bengal,13,5,22,12,52,Pass
Ishaan Verma,03-07-2005,154022,Gujarat,6,23,21,16,66,Pass
Peter Mehta,21-01-2005,720079,Punjab,24,23,11,14,72,Pass
Vivaan Reddy,12-11-2005,793555,Rajasthan,23,21,15,6,65,Pass
Vivaan Fernandes,16-07-2005,382640,Bihar,5,14,22,3,44,Pass
Aditya Pillai,16-10-2005,321697,Uttar Pradesh,9,24,5,9,47,Pass
Gurpreet Singh,03-12-2005,170078,Kerala,7,21,16,16,60,Pass
Raj Mehta,28-11-2005,301008,Bihar,17,12,6,3,38,Pass
Krishna D'Souza,02-03-2006,883251,Uttar Pradesh,22,5,2,1,30,Pass
Raj D'Souza,20-02-2005,662029,Andhra Pradesh,10,12,7,0,29,Pass
Paul Chopra,06-10-2005,812072,Madhya Pradesh,11,0,13,23,47,Pass
Gurpreet Sharma,27-07-2005,826116,Tamil Nadu,3,23,17,13,56,Pass
Harjeet Fernandes,05-04-2005,239021,Tamil Nadu,2,6,24,7,39,Pass
Ishaan Chopra,29-11-2004,972668,Haryana,3,18,22,17,60,Pass
Aryan Fernandes,17-01-2006,429529,Madhya Pradesh,16,0,24,7,47,Pass
Yash Mehta,22-09-2005,493563,Rajasthan,19,8,4,20,51,Pass
Aryan D'Souza,10-02-2005,439094,Haryana,10,14,15,1,40,Pass
Yash Singh,09-03-2005,483356,Karnataka,9,3,3,21,36,Pass
Vivaan Sharma,30-03-2006,534994,Uttarakhand,19,1,19,7,46,Pass
Gurpreet Fernandes,27-02-2006,515735,Punjab,11,21,11,0,43,Pass
Aarav Chopra,10-02-2006,234387,Punjab,9,6,21,15,51,Pass
Aryan Chopra,04-10-2005,453826,Uttar Pradesh,1,14,7,22,44,Pass
Imran Fernandes,26-10-2005,368826,Chhattisgarh,18,16,23,11,68,Pass
Kunal Verma,28-01-2006,782768,Punjab,11,19,24,2,56,Pass
Aarav Pillai,08-04-2005,544001,Bihar,14,19,13,8,54,Pass
Gurpreet Fernandes,12-06-2005,671631,Odisha,17,21,17,6,61,Pass
Kunal Chopra,24-11-2004,570160,Gujarat,21,17,9,4,51,Pass
Yash Singh,12-11-2005,204902,Haryana,7,1,20,15,43,Pass
Aarav Verma,07-02-2005,700824,Rajasthan,24,9,0,11,44,Pass
Yash Fernandes,23-03-2006,886875,Uttar Pradesh,21,21,10,20,72,Pass
Peter Fernandes,05-08-2005,962645,Gujarat,5,4,16,15,40,Pass
Peter Verma,05-08-2005,485303,Maharashtra,15,18,2,18,53,Pass
Aditya Mehta,05-04-2005,785246,Bihar,4,8,22,24,58,Pass
Krishna Sharma,11-01-2005,135193,Punjab,2,5,8,3,18,Pass
Vivaan Pillai,08-02-2006,767281,Telangana,9,4,21,19,53,Pass
Manpreet Reddy,03-01-2005,954823,Punjab,5,17,19,7,48,Pass
Peter Fernandes,06-02-2006,288775,Maharashtra,7,11,15,10,43,Pass
Ishaan Khan,04-03-2006,448635,Rajasthan,23,5,11,8,47,Pass
Krishna Chopra,30-03-2005,338500,Bihar,7,10,18,15,50,Pass
Rohan Reddy,27-12-2005,334860,Maharashtra,13,9,2,23,47,Pass
Ishaan Singh,26-12-2005,107760,Madhya Pradesh,2,4,13,12,31,Pass
Aryan Mehta,20-02-2006,144038,Maharashtra,15,24,2,9,50,Pass
Rohan Singh,24-01-2005,116248,Maharashtra,4,19,2,22,47,Pass
Kunal Reddy,11-11-2005,612551,Karnataka,2,9,13,7,31,Pass
Rohan Singh,27-08-2005,455738,Bihar,20,5,9,14,48,Pass
Sukhwinder Sharma,11-01-2005,851193,Uttar Pradesh,13,15,6,21,55,Pass
Raj Reddy,30-08-2005,157683,Karnataka,12,23,18,13,66,Pass
John Mehta,15-08-2005,377845,Jharkhand,21,12,4,13,50,Pass
Vivaan Sharma,29-12-2005,528142,Maharashtra,5,24,9,0,38,Pass
Harjeet Mehta,18-12-2005,492312,Odisha,4,0,5,21,30,Pass
Krishna Chopra,19-01-2006,993578,Andhra Pradesh,23,7,2,21,53,Pass
Rohan Reddy,07-03-2005,485064,Karnataka,5,18,7,6,36,Pass
Ishaan Fernandes,28-11-2005,114268,Uttar Pradesh,15,17,7,17,56,Pass
Vivaan Singh,13-12-2005,465916,Andhra Pradesh,5,8,23,1,37,Pass
Ishaan Fernandes,23-01-2005,248555,Tamil Nadu,9,14,1,15,39,Pass
Krishna Reddy,09-03-2006,848572,Punjab,10,11,19,17,57,Pass
Rohan Mehta,28-11-2004,652662,Rajasthan,5,13,19,9,46,Pass
Aarav Verma,30-12-2004,572260,Rajasthan,5,6,23,18,52,Pass
Rohan Chopra,28-02-2005,200263,Rajasthan,12,13,11,22,58,Pass
Balbir Pillai,22-01-2005,833514,Assam,8,17,6,1,32,Pass
Ishaan Pillai,13-07-2005,490986,Maharashtra,10,4,14,17,45,Pass
Aarav Singh,15-04-2005,485597,Gujarat,12,5,6,4,27,Pass
Harjeet Sharma,05-11-2005,937050,Odisha,14,10,11,12,47,Pass
Vivaan Verma,20-02-2005,136520,Maharashtra,24,11,2,2,39,Pass
Kunal Singh,22-12-2004,332943,Odisha,12,1,9,12,34,Pass
Aryan Singh,19-03-2005,366077,Uttar Pradesh,0,4,10,8,22,Pass
Rohan Sharma,04-12-2005,504856,Rajasthan,9,19,7,9,44,Pass
Manpreet D'Souza,03-03-2005,214369,Haryana,24,10,9,21,64,Pass
Vivaan Chopra,24-03-2006,317303,Andhra Pradesh,22,6,15,6,49,Pass
Kunal Verma,13-06-2005,506422,Uttar Pradesh,23,5,17,10,55,Pass
Krishna Khan,14-02-2005,515012,Haryana,0,11,6,11,28,Pass
Gurpreet Reddy,25-03-2006,188885,Tamil Nadu,23,15,24,20,82,Pass
Yash Singh,25-12-2004,973894,Haryana,8,1,13,19,41,Pass
Raj Mehta,26-10-2005,361674,Punjab,18,10,23,7,58,Pass
Aditya Mehta,25-04-2006,997960,Rajasthan,20,3,7,7,37,Pass
Krishna Verma,09-01-2006,447376,Gujarat,20,10,15,11,56,Pass
Vivaan Singh,21-10-2005,235401,Uttarakhand,12,5,13,4,34,Pass
Raj Mehta,10-07-2005,546955,Andhra Pradesh,7,16,13,22,58,Pass
Peter Khan,04-03-2005,289789,Tripura,23,21,3,20,67,Pass
Farhan Mehta,09-10-2005,776331,Rajasthan,10,17,16,1,44,Pass
Kunal Chopra,16-04-2006,357003,Telangana,17,20,9,4,50,Pass
Aryan Chopra,02-12-2004,275192,Maharashtra,9,10,2,15,36,Pass
Raj Khan,03-04-2005,300249,Manipur,4,21,22,11,58,Pass
Aarav Verma,11-01-2005,372739,Madhya Pradesh,6,9,3,23,41,Pass
Ishaan Singh,14-10-2005,883228,Odisha,2,15,5,9,31,Pass
Aryan Singh,17-04-2006,263078,Gujarat,22,21,2,11,56,Pass
Aditya Mehta,08-07-2005,139296,Kerala,20,6,17,20,63,Pass
Rohan Reddy,23-11-2004,572120,Gujarat,18,5,12,9,44,Pass
Raj Fernandes,03-07-2005,974565,Madhya Pradesh,13,9,1,6,29,Pass
Balbir Reddy,17-05-2005,370948,Karnataka,17,8,13,4,42,Pass
Ishaan Singh,02-05-2005,806555,Haryana,1,17,23,24,65,Pass
Rohan Fernandes,06-02-2005,902183,Bihar,23,5,16,15,59,Pass
Ishaan Fernandes,29-06-2005,539872,Bihar,3,3,6,6,18,Pass
Yash D'Souza,15-01-2006,127985,Punjab,21,2,4,20,47,Pass
Aarav D'Souza,27-03-2005,356443,Telangana,20,2,5,15,42,Pass
Ayaan D'Souza,16-09-2005,526648,Rajasthan,0,1,6,20,27,Pass
Vivaan Verma,14-06-2005,820172,West Bengal,13,6,4,2,25,Pass
Aarav Chopra,19-01-2006,791478,Maharashtra,24,19,2,21,66,Pass
Rehan Fernandes,14-08-2005,450855,Karnataka,3,20,18,7,48,Pass
Raj D'Souza,10-12-2004,159858,Andhra Pradesh,19,20,18,12,69,Pass
Aryan Khan,20-07-2005,149822,West Bengal,8,0,17,14,39,Pass
Ishaan Pillai,17-03-2005,595643,Punjab,23,0,5,13,41,Pass
Aditya Mehta,05-12-2004,905180,Rajasthan,0,17,15,21,53,Pass
Ishaan Mehta,24-03-2005,346975,Gujarat,22,13,10,3,48,Pass
Aditya Pillai,25-02-2006,952865,Andhra Pradesh,5,12,15,4,36,Pass
Gurpreet Chopra,02-09-2005,896124,Telangana,0,19,12,3,34,Pass
Yash Mehta,04-07-2005,113801,Uttar Pradesh,18,23,11,0,52,Pass
Kunal Reddy,04-05-2006,568242,Andhra Pradesh,10,3,24,10,47,Pass
Vivaan Chopra,06-09-2005,800094,Maharashtra,18,19,2,8,47,Pass
Aryan Chopra,09-05-2006,841136,Rajasthan,11,19,18,1,49,Pass
Vivaan Sharma,28-12-2004,808109,Gujarat,1,8,9,16,34,Pass
Krishna Fernandes,11-09-2005,818429,Bihar,16,20,12,13,61,Pass
Balbir Pillai,16-01-2005,416959,Punjab,15,12,0,3,30,Pass
Balbir Pillai,22-03-2006,442271,Madhya Pradesh,4,3,21,10,38,Pass
Harjeet D'Souza,23-12-2004,414345,Kerala,14,4,12,0,30,Pass
Raj Sharma,19-09-2005,218589,Andhra Pradesh,6,11,19,21,57,Pass
Rohan Pillai,05-01-2006,792831,Haryana,2,17,16,24,59,Pass
Ishaan D'Souza,19-04-2005,609739,Punjab,6,12,17,12,47,Pass
Kunal Sharma,30-06-2005,737848,Rajasthan,23,24,14,3,64,Pass
Manpreet Mehta,08-01-2006,694264,Bihar,7,17,1,15,40,Pass
Gurpreet D'Souza,12-11-2004,540208,Uttar Pradesh,11,18,14,2,45,Pass
Kunal Pillai,30-01-2006,575165,Assam,19,18,21,23,81,Pass
Vivaan Pillai,13-02-2006,113746,Rajasthan,21,5,1,22,49,Pass
Ishaan Sharma,16-04-2005,186143,Rajasthan,4,19,10,5,38,Pass
Vivaan Mehta,11-07-2005,649524,Rajasthan,11,2,0,6,19,Pass
Yash Mehta,30-09-2005,753310,Uttar Pradesh,16,21,23,7,67,Pass
Kunal Mehta,18-04-2006,873878,Kerala,11,15,1,20,47,Pass
Aryan Sharma,26-04-2006,612845,Maharashtra,0,23,2,8,33,Pass
Krishna Pillai,13-04-2006,145950,Madhya Pradesh,23,9,3,22,57,Pass
Rohan D'Souza,25-01-2005,961899,Punjab,23,15,9,16,63,Pass
Ishaan D'Souza,22-03-2005,220312,Kerala,12,10,23,3,48,Pass
Mathew Chopra,27-01-2005,196232,Gujarat,6,23,16,9,54,Pass
Aarav Singh,06-10-2005,720033,Bihar,9,8,16,11,44,Pass
Harjeet D'Souza,20-05-2005,128157,Tamil Nadu,12,22,23,11,68,Pass
Yash Reddy,20-02-2006,949378,Uttar Pradesh,16,6,11,19,52,Pass
Kunal D'Souza,27-12-2005,883708,Bihar,10,6,3,18,37,Pass
Imran Singh,06-08-2005,956895,Bihar,5,14,13,14,46,Pass
Vivaan Pillai,25-09-2005,820560,Andhra Pradesh,9,24,13,1,47,Pass
Aarav Fernandes,31-12-2004,887698,Gujarat,18,16,21,16,71,Pass
Yash Sharma,06-09-2005,292029,Odisha,16,7,4,1,28,Pass
Vivaan Verma,19-03-2006,126118,Odisha,17,3,23,1,44,Pass
Ishaan Khan,21-01-2005,569796,Andhra Pradesh,12,1,3,3,19,Pass
Aarav Reddy,13-11-2004,752038,Andhra Pradesh,2,0,1,16,19,Pass
Rohan Pillai,05-05-2006,828629,Telangana,22,21,8,8,59,Pass
Aryan Reddy,11-12-2005,436895,Odisha,24,4,6,18,52,Pass
Aarav Pillai,08-03-2005,532732,Haryana,7,8,5,17,37,Pass
Rehan Singh,01-05-2005,489163,Uttar Pradesh,1,9,1,4,15,Pass
Sukhwinder Reddy,04-12-2005,482176,Gujarat,6,11,7,11,35,Pass
Aryan Chopra,29-08-2005,835456,Delhi,11,24,8,13,56,Pass
Sukhwinder Sharma,25-05-2005,576424,Rajasthan,1,14,1,19,35,Pass
Yash Sharma,21-12-2004,227071,Uttarakhand,15,11,4,15,45,Pass
Aditya Chopra,12-02-2006,491639,Assam,16,19,5,18,58,Pass
Yash Sharma,16-03-2006,454965,Uttar Pradesh,6,3,24,17,50,Pass
Aditya Pillai,16-03-2005,169908,Gujarat,6,2,3,23,34,Pass
Raj Fernandes,30-06-2005,195022,Arunachal Pradesh,11,9,23,3,46,Pass
Raj Singh,23-02-2005,960225,West Bengal,3,19,16,23,61,Pass
Gurpreet Reddy,13-01-2005,920958,Odisha,5,19,13,21,58,Pass
Aryan Fernandes,09-06-2005,660452,Nagaland,13,5,4,15,37,Pass
Ishaan Chopra,14-06-2005,165344,Kerala,11,20,20,24,75,Fail
Aditya Pillai,24-02-2005,827410,Madhya Pradesh,12,17,5,17,51,Pass
Sukhwinder Khan,19-01-2005,874349,Jharkhand,4,22,20,22,68,Fail
Rohan Fernandes,25-02-2005,207560,Madhya Pradesh,11,15,14,1,41,Pass
Vivaan Fernandes,16-03-2006,930308,West Bengal,14,6,11,18,49,Pass
Aditya Verma,12-02-2005,158798,Madhya Pradesh,2,5,0,14,21,Pass
Kunal Verma,17-03-2006,398367,Maharashtra,14,1,17,3,35,Pass
Ishaan D'Souza,20-01-2006,969954,Uttar Pradesh,23,23,7,7,60,Pass
Aryan Reddy,16-01-2005,298543,West Bengal,17,22,3,1,43,Pass
Aarav Chopra,23-04-2005,584470,Mizoram,4,8,8,8,28,Pass
Rohan Reddy,28-04-2006,689769,Punjab,16,11,24,3,54,Pass
Rohan Pillai,14-03-2006,433042,Maharashtra,23,14,2,14,53,Pass
Kunal Mehta,13-03-2005,550448,Assam,16,10,20,16,62,Pass
Aditya Mehta,05-05-2006,620880,Tamil Nadu,0,20,18,7,45,Pass
Kunal Pillai,14-05-2005,777440,Uttarakhand,11,24,3,2,40,Pass
Aditya Verma,22-09-2005,525728,Madhya Pradesh,21,7,2,23,53,Pass
Manpreet Fernandes,15-12-2004,368130,Bihar,0,8,12,18,38,Pass
Vivaan Verma,03-08-2005,835069,Kerala,21,12,12,5,50,Pass
Kunal Verma,09-06-2005,914426,Maharashtra,8,10,2,22,42,Pass
Ishaan Sharma,07-02-2006,856305,Bihar,14,20,2,23,59,Pass
Yash Fernandes,12-12-2005,527128,Rajasthan,23,15,5,18,61,Pass
Rohan Chopra,04-07-2005,414440,Gujarat,7,8,11,15,41,Pass
Harjeet Sharma,11-04-2006,938539,Bihar,13,15,6,16,50,Pass
Paul Verma,15-03-2006,939970,Uttarakhand,6,11,11,21,49,Pass
Aditya D'Souza,08-05-2005,794216,Punjab,18,21,12,9,60,Pass
Krishna Pillai,12-04-2006,390539,Bihar,3,0,8,22,33,Pass
Peter Pillai,16-08-2005,356915,Odisha,14,1,20,16,51,Pass
Rohan Khan,12-04-2005,158099,Haryana,12,22,24,13,71,Pass
Aarav Verma,03-01-2005,511642,Telangana,4,20,10,13,47,Pass
Rohan Singh,27-02-2005,722892,Telangana,12,15,1,11,39,Pass
Aarav Khan,24-04-2005,198553,Haryana,19,0,23,14,56,Pass
Sukhwinder Singh,02-04-2006,756151,Rajasthan,15,7,22,6,50,Pass
Vivaan Khan,15-01-2006,200535,Maharashtra,22,16,2,18,58,Pass
Rohan Fernandes,15-06-2005,275139,Rajasthan,21,11,22,12,66,Pass
Aditya Fernandes,18-12-2005,367849,Maharashtra,12,9,5,5,31,Pass
Mathew Khan,10-02-2005,955024,Uttarakhand,12,16,20,0,48,Pass
Aarav Chopra,16-08-2005,299353,Uttar Pradesh,13,22,13,6,54,Pass
Rohan D'Souza,16-09-2005,784810,Madhya Pradesh,4,19,14,19,56,Pass
Aarav Fernandes,06-11-2005,818533,Himachal Pradesh,10,21,14,16,61,Pass
Gurpreet D'Souza,17-11-2004,595694,Tamil Nadu,17,17,7,23,64,Pass
Yash Chopra,17-12-2004,793185,Uttar Pradesh,3,0,10,10,23,Pass
Aditya Verma,21-01-2006,847174,Rajasthan,16,21,5,21,63,Pass
Peter Sharma,09-05-2005,574217,Arunachal Pradesh,4,22,0,17,43,Pass
Harjeet Pillai,21-01-2006,620995,Odisha,15,18,20,15,68,Pass
Aarav Mehta,17-03-2006,995175,Maharashtra,12,19,4,14,49,Pass
Rohan Fernandes,25-08-2005,190033,Andhra Pradesh,21,9,7,7,44,Pass
Balbir Reddy,06-10-2005,599921,Maharashtra,15,5,2,19,41,Pass
Rohan D'Souza,02-10-2005,120508,Gujarat,24,7,6,2,39,Pass
Peter Khan,11-04-2006,804365,Mizoram,0,15,13,14,42,Pass
Manpreet Fernandes,17-04-2006,675843,Madhya Pradesh,6,24,10,9,49,Pass
Yash D'Souza,30-09-2005,337091,Bihar,18,19,9,13,59,Pass
Zaid Khan,08-06-2005,281856,Rajasthan,19,8,9,13,49,Pass
Balbir Verma,31-03-2006,943820,Odisha,8,5,3,16,32,Pass
Yash Pillai,16-03-2005,252359,Andhra Pradesh,4,1,1,8,14,Pass
Aarav Singh,15-11-2005,730797,Haryana,4,12,17,11,44,Pass
Aryan Mehta,21-06-2005,640486,Maharashtra,0,19,17,8,44,Pass
Gurpreet Mehta,29-06-2005,322767,Tamil Nadu,18,5,24,23,70,Pass
Vivaan Chopra,14-02-2005,923839,Bihar,13,3,18,1,35,Pass
Vivaan D'Souza,18-09-2005,379325,Jharkhand,3,15,23,5,46,Pass
Manpreet Singh,11-08-2005,620213,West Bengal,3,22,12,16,53,Pass
Aryan Mehta,06-02-2005,805721,Rajasthan,21,9,5,12,47,Pass
Sukhwinder Chopra,23-10-2005,830620,Tamil Nadu,23,24,24,20,91,Pass
Peter Sharma,09-11-2005,411546,West Bengal,13,11,11,16,51,Pass
Paul Pillai,24-04-2005,652245,West Bengal,22,20,6,3,51,Pass
Raj Fernandes,08-02-2006,521537,Uttar Pradesh,9,14,3,11,37,Pass
Vivaan Reddy,29-04-2006,575313,Odisha,0,7,14,16,37,Pass
Aarav Fernandes,18-04-2005,153960,Gujarat,9,23,1,6,39,Pass
John Reddy,14-10-2005,684707,Punjab,15,4,4,19,42,Pass
Aryan Verma,01-02-2006,262184,Jammu & Kashmir + Ladakh,7,9,7,21,44,Pass
Peter Mehta,02-09-2005,298904,West Bengal,8,22,0,13,43,Pass
Gurpreet Mehta,06-03-2006,522298,West Bengal,11,12,21,4,48,Pass
Rohan Khan,08-05-2005,522025,Madhya Pradesh,14,18,1,20,53,Pass
Ishaan Chopra,28-07-2005,204257,Uttar Pradesh,7,5,19,19,50,Pass
Aryan Verma,23-06-2005,753677,Uttar Pradesh,15,8,11,8,42,Pass
Aryan Sharma,11-02-2006,130484,Haryana,5,24,0,20,49,Pass
David Mehta,02-10-2005,935273,Sikkim,4,19,11,12,46,Pass
Gurpreet Pillai,17-02-2006,930351,Andhra Pradesh,15,1,10,13,39,Pass
Aditya Singh,11-02-2006,165212,Maharashtra,12,22,9,5,48,Pass
Aryan Sharma,09-03-2005,861809,Bihar,10,2,23,6,41,Pass
Aryan Singh,14-02-2005,310654,Madhya Pradesh,6,9,12,8,35,Pass
Aryan D'Souza,25-06-2005,789238,Uttar Pradesh,10,11,7,3,31,Pass
Raj Reddy,10-01-2006,910568,Gujarat,11,7,23,10,51,Pass
Paul Sharma,16-05-2005,206438,Karnataka,9,15,13,2,39,Pass
Paul Fernandes,11-12-2004,315395,Bihar,7,15,11,11,44,Pass
Ishaan Pillai,08-11-2004,447783,Gujarat,14,6,21,19,60,Pass
Aryan D'Souza,21-07-2005,166719,Uttar Pradesh,3,19,21,22,65,Pass
Rohan Verma,01-11-2005,977863,Punjab,12,17,20,1,50,Pass
Krishna Chopra,23-07-2005,554534,Punjab,14,23,13,0,50,Pass
Paul Verma,20-11-2005,561074,Uttar Pradesh,9,23,13,10,55,Pass
Raj Sharma,06-09-2005,175736,West Bengal,2,7,8,7,24,Pass
Sukhwinder Singh,18-06-2005,753145,Rajasthan,22,13,8,4,47,Pass
John Khan,04-02-2006,372026,Uttar Pradesh,6,21,13,10,50,Pass
Aditya Fernandes,31-03-2006,583333,Bihar,18,17,17,18,70,Pass
Aryan Fernandes,21-06-2005,404147,Jharkhand,9,14,14,3,40,Pass
Rohan Mehta,22-05-2005,473824,Punjab,16,18,2,14,50,Pass
Harjeet Chopra,14-12-2004,856539,Maharashtra,24,0,14,7,45,Pass
Yash Chopra,05-04-2005,568641,Haryana,20,13,16,12,61,Pass
David Mehta,07-05-2005,586185,Maharashtra,7,24,2,4,37,Pass
Rohan Sharma,25-04-2006,351775,Rajasthan,5,5,24,20,54,Pass
Gurpreet Pillai,25-07-2005,703028,Bihar,11,9,4,5,29,Pass
Aryan Fernandes,06-09-2005,117400,Maharashtra,9,11,22,0,42,Pass
Rohan Reddy,13-02-2006,133692,Telangana,10,14,7,1,32,Pass
Krishna D'Souza,11-04-2005,531122,Rajasthan,10,11,21,13,55,Pass
Raj Singh,31-08-2005,330712,Uttar Pradesh,8,10,0,13,31,Pass
Krishna Mehta,13-06-2005,441188,Madhya Pradesh,18,20,3,23,64,Pass
Rohan Fernandes,12-04-2005,527495,Bihar,24,2,14,20,60,Pass
Kunal Khan,04-12-2005,270888,Uttar Pradesh,6,9,14,1,30,Pass
Raj Reddy,20-12-2004,994933,Rajasthan,16,9,18,2,45,Pass
Kunal Sharma,13-12-2005,745898,Himachal Pradesh,10,4,11,20,45,Pass
Imran Pillai,03-05-2006,737098,Punjab,17,4,18,23,62,Pass
Rohan D'Souza,15-09-2005,509617,Uttar Pradesh,7,12,23,13,55,Pass
Aarav Pillai,19-07-2005,852690,Maharashtra,20,3,2,20,45,Pass
Kunal Pillai,11-10-2005,755226,Rajasthan,17,8,6,16,47,Pass
Peter Singh,01-05-2006,213958,Jharkhand,13,2,23,1,39,Pass
John Singh,09-05-2006,702113,Haryana,4,5,22,10,41,Pass
Aarav Mehta,05-05-2005,651290,Haryana,20,15,1,7,43,Pass
Aryan Fernandes,04-12-2005,623825,Andhra Pradesh,4,18,11,3,36,Pass
Ishaan Singh,20-02-2005,826598,Maharashtra,12,7,0,10,29,Pass
Aryan D'Souza,07-04-2005,663132,Uttar Pradesh,24,9,8,23,64,Pass
Imran D'Souza,02-06-2005,380995,Andhra Pradesh,6,1,21,9,37,Pass
Kunal Singh,08-02-2006,608852,Himachal Pradesh,21,7,22,8,58,Pass
Aarav Khan,02-09-2005,655603,Maharashtra,7,8,5,7,27,Pass
Yash Pillai,07-02-2005,939175,Uttar Pradesh,7,5,13,17,42,Pass
Imran Sharma,26-05-2005,341357,Assam,20,21,17,1,59,Pass
David Verma,27-07-2005,774440,Rajasthan,12,4,19,18,53,Pass
Krishna Sharma,05-10-2005,592391,Uttar Pradesh,11,4,11,7,33,Pass
Yash Chopra,19-02-2005,964785,Odisha,5,4,6,11,26,Pass
Aryan Singh,29-09-2005,694780,Rajasthan,14,19,10,11,54,Pass
Kunal Pillai,30-01-2006,482232,Telangana,18,23,0,22,63,Pass
Yash Khan,22-01-2006,954855,Punjab,19,11,16,12,58,Pass
Krishna Singh,30-03-2005,153011,Jharkhand,24,23,4,12,63,Fail
Balbir Reddy,08-12-2004,279967,Madhya Pradesh,13,14,7,19,53,Pass
Aarav Sharma,11-01-2005,544004,Andhra Pradesh,9,6,8,21,44,Pass
Gurpreet D'Souza,03-12-2004,115371,Jharkhand,16,20,17,19,72,Fail
Aryan Pillai,10-10-2005,634230,Punjab,13,15,17,10,55,Pass
Ishaan Khan,10-05-2005,960154,Telangana,19,10,3,20,52,Pass
Aryan Khan,13-12-2004,489226,Maharashtra,15,1,8,2,26,Pass
Sukhwinder Pillai,03-11-2005,960253,Bihar,10,4,1,6,21,Pass
Krishna Sharma,25-03-2006,163821,Punjab,20,15,1,2,38,Pass
Kunal Reddy,02-03-2006,161115,Punjab,20,22,2,21,65,Pass
David Verma,17-04-2005,441568,Madhya Pradesh,23,24,3,15,65,Pass
Raj Singh,08-04-2005,574729,Uttarakhand,1,13,13,5,32,Pass
Vivaan Pillai,04-07-2005,701889,Kerala,9,17,20,6,52,Pass
Aarav D'Souza,13-06-2005,629956,Nagaland,10,4,6,18,38,Pass
Rohan Fernandes,11-03-2006,255792,Gujarat,6,0,24,5,35,Pass
Yash Sharma,31-01-2006,735774,Bihar,20,2,13,14,49,Pass
Peter Mehta,09-03-2006,483213,Tamil Nadu,18,8,6,23,55,Pass
Raj Sharma,30-08-2005,483259,West Bengal,24,6,7,11,48,Pass
Kunal Chopra,08-08-2005,930038,Andhra Pradesh,19,11,16,0,46,Pass
Aarav D'Souza,29-04-2006,721184,Madhya Pradesh,12,12,9,19,52,Pass
Ishaan D'Souza,25-03-2006,451226,Maharashtra,20,11,2,6,39,Pass
Manpreet Verma,22-12-2005,840741,Haryana,12,9,15,13,49,Pass
Aarav Mehta,20-03-2006,899981,Maharashtra,4,3,2,21,30,Pass
Gurpreet Singh,26-02-2005,100704,Gujarat,2,3,21,6,32,Pass
Raj Mehta,12-08-2005,656137,Andhra Pradesh,10,1,15,14,40,Pass
Rohan Singh,29-12-2005,622748,Chhattisgarh,6,21,1,19,47,Pass
Aarav Khan,20-11-2005,670400,Rajasthan,10,17,7,10,44,Pass
Kunal Mehta,17-09-2005,681464,Kerala,4,20,19,15,58,Pass
Farhan Fernandes,26-01-2006,551351,Madhya Pradesh,17,7,16,16,56,Pass
Ishaan Khan,15-04-2005,252845,Andhra Pradesh,8,3,1,12,24,Pass
Kunal Reddy,05-02-2006,420317,Andhra Pradesh,13,18,9,7,47,Pass
David D'Souza,17-08-2005,576512,Andhra Pradesh,5,22,11,13,51,Pass
Ishaan Khan,19-06-2005,489027,Madhya Pradesh,20,9,1,3,33,Pass
Aditya Sharma,01-12-2004,547934,Jammu & Kashmir + Ladakh,4,20,6,5,35,Pass
Krishna Verma,24-04-2005,300554,West Bengal,16,9,12,1,38,Pass
Vivaan Fernandes,28-01-2005,446036,West Bengal,2,4,11,20,37,Pass
Vivaan Fernandes,12-04-2006,973968,Bihar,16,2,7,14,39,Pass
Yash Sharma,24-11-2004,447885,Maharashtra,23,0,7,16,46,Pass
Aditya Khan,09-11-2004,315422,Punjab,23,18,2,21,64,Pass
Aditya Sharma,05-10-2005,548599,Andhra Pradesh,10,21,18,9,58,Pass
Gurpreet D'Souza,15-01-2005,871973,Bihar,4,24,22,2,52,Pass
Kunal Pillai,14-03-2006,376471,Tamil Nadu,10,23,10,5,48,Pass
John Fernandes,03-03-2005,384734,Tamil Nadu,9,10,15,18,52,Pass
Gurpreet Verma,17-07-2005,192731,Rajasthan,24,2,6,18,50,Pass
Aditya Khan,25-07-2005,617336,Maharashtra,16,3,14,11,44,Pass
Peter Fernandes,02-09-2005,684864,Bihar,23,0,20,5,48,Pass
Raj D'Souza,01-01-2006,452834,Madhya Pradesh,13,2,7,12,34,Pass
Manpreet Reddy,01-12-2004,961874,Himachal Pradesh,10,3,4,12,29,Pass
Aarav Fernandes,08-02-2005,710719,West Bengal,4,24,11,7,46,Pass
Aryan Chopra,08-04-2006,410282,Jharkhand,7,17,14,19,57,Pass
Aarav Khan,16-11-2004,927754,Uttar Pradesh,19,3,20,9,51,Pass
Rohan Verma,13-02-2005,877882,Delhi,12,19,12,12,55,Pass
Rehan Reddy,14-01-2006,513772,Uttar Pradesh,3,2,8,20,33,Pass
Aryan Khan,21-04-2005,654457,Madhya Pradesh,21,22,3,16,62,Pass
Vivaan Reddy,28-01-2006,297876,Jammu & Kashmir + Ladakh,7,22,8,18,55,Pass
Raj Fernandes,09-04-2006,141070,Maharashtra,10,8,2,21,41,Pass
Peter Verma,23-05-2005,552966,Bihar,4,11,2,24,41,Pass
Krishna Verma,28-03-2006,222359,West Bengal,3,22,24,21,70,Pass
Yash Pillai,26-07-2005,785524,Gujarat,7,6,10,6,29,Pass
Aarav Mehta,17-11-2004,377565,Uttar Pradesh,3,0,9,4,16,Pass
Ishaan D'Souza,22-06-2005,588856,Uttarakhand,8,2,3,22,35,Pass
Vivaan Sharma,30-03-2005,672008,Bihar,20,22,21,9,72,Pass
Kunal Khan,28-12-2004,855022,Uttar Pradesh,9,12,20,24,65,Pass
Mathew Verma,08-09-2005,693343,Bihar,9,8,20,0,37,Pass
Raj Sharma,23-05-2005,561697,West Bengal,3,4,17,19,43,Pass
Aarav Fernandes,28-02-2006,870348,Tripura,19,8,11,10,48,Pass
Aryan Chopra,19-04-2006,163836,Jharkhand,12,11,15,18,56,Pass
Aarav Verma,25-04-2005,202791,Uttar Pradesh,16,16,14,14,60,Pass
Kunal Fernandes,26-11-2005,948232,Chhattisgarh,23,9,8,8,48,Pass
Aditya Sharma,05-05-2005,747578,West Bengal,19,6,7,14,46,Pass
Balbir Chopra,08-12-2004,821360,Rajasthan,4,17,16,24,61,Pass
Manpreet Mehta,21-10-2005,524482,West Bengal,22,0,16,1,39,Pass
Balbir Singh,08-01-2005,375605,West Bengal,3,24,9,5,41,Pass
Krishna Sharma,11-09-2005,759273,Rajasthan,14,11,4,11,40,Pass
Ayaan Sharma,20-01-2006,633463,Telangana,2,11,10,4,27,Pass
Yash Pillai,29-03-2006,529792,Tamil Nadu,13,10,8,22,53,Pass
Peter Sharma,22-03-2006,856190,Uttar Pradesh,12,11,8,23,54,Pass
Ishaan Mehta,15-01-2006,800110,Bihar,19,0,3,8,30,Pass
Aarav Khan,10-04-2006,103317,Madhya Pradesh,2,2,11,14,29,Pass
Aarav Singh,22-01-2005,190911,Gujarat,15,12,1,14,42,Pass
Raj Mehta,16-03-2005,485413,Madhya Pradesh,5,12,8,5,30,Pass
Aditya Fernandes,16-01-2006,235276,Himachal Pradesh,11,19,3,23,56,Pass
Aarav Khan,02-03-2005,134728,Maharashtra,0,20,2,23,45,Pass
Balbir Mehta,07-12-2005,447961,Puducherry,11,6,3,7,27,Pass
Farhan D'Souza,26-08-2005,837660,Rajasthan,8,20,18,13,59,Pass
Farhan Fernandes,21-11-2004,593231,Gujarat,11,19,19,21,70,Pass
Ishaan Khan,03-04-2006,990962,Delhi,11,7,8,18,44,Pass
Kunal Sharma,05-01-2005,562505,Jharkhand,2,11,15,15,43,Pass
Zaid Mehta,10-06-2005,902959,Uttar Pradesh,15,16,20,8,59,Pass
Ishaan Singh,14-03-2005,713122,Rajasthan,7,9,1,6,23,Pass
Aarav Mehta,27-04-2005,287675,Bihar,1,2,24,22,49,Pass
Yash Reddy,16-08-2005,143211,Rajasthan,19,23,8,11,61,Pass
Ishaan Khan,14-01-2005,826390,Punjab,18,23,17,13,71,Pass
Mathew Mehta,26-10-2005,739596,Tamil Nadu,0,3,14,12,29,Pass
Peter Mehta,12-08-2005,976411,Uttar Pradesh,15,15,22,5,57,Pass
Aryan Pillai,07-12-2005,892924,Maharashtra,5,6,11,2,24,Pass
Mathew D'Souza,12-05-2005,591197,Bihar,16,11,0,8,35,Pass
Aditya Singh,07-02-2005,765119,Bihar,1,4,18,7,30,Pass
Aarav Mehta,23-05-2005,593490,Karnataka,9,20,8,9,46,Pass
Aarav Chopra,23-05-2005,890687,Odisha,4,5,19,15,43,Pass
Rohan Chopra,06-09-2005,362213,Rajasthan,1,21,20,19,61,Pass
Yash D'Souza,18-01-2005,645316,Odisha,5,22,3,8,38,Pass
Yash Mehta,26-06-2005,106078,Jammu & Kashmir + Ladakh,0,11,16,1,28,Pass
Rohan D'Souza,02-03-2005,302555,Bihar,4,16,13,13,46,Pass
Krishna Verma,02-01-2006,933606,Madhya Pradesh,9,19,3,18,49,Pass
Raj Sharma,14-12-2005,973801,Telangana,14,10,2,12,38,Pass
Vivaan D'Souza,08-05-2005,834284,Tamil Nadu,0,13,24,23,60,Pass
Rohan Sharma,23-08-2005,649016,Madhya Pradesh,18,9,1,5,33,Pass
Vivaan D'Souza,04-01-2006,845044,Madhya Pradesh,3,10,3,18,34,Pass
Krishna D'Souza,21-05-2005,706372,Haryana,2,0,1,22,25,Pass
Yash Singh,15-12-2004,215317,West Bengal,3,12,20,22,57,Pass
Vivaan Khan,28-01-2005,875209,Himachal Pradesh,7,5,4,21,37,Pass
Balbir Fernandes,26-01-2006,935531,Punjab,21,0,10,19,50,Pass
Harjeet D'Souza,30-08-2005,413338,Uttar Pradesh,0,16,22,23,61,Pass
Krishna Reddy,04-03-2005,266961,Tamil Nadu,14,8,5,12,39,Pass
Yash Verma,31-12-2004,356560,Madhya Pradesh,14,5,9,23,51,Pass
Sukhwinder Pillai,08-06-2005,291075,West Bengal,16,0,17,12,45,Pass
Paul Singh,18-03-2006,518227,Bihar,5,18,2,2,27,Pass
Ayaan Pillai,14-05-2005,237121,Uttar Pradesh,19,22,5,6,52,Pass
Peter D'Souza,22-03-2005,730701,Gujarat,11,21,5,17,54,Pass
Ishaan D'Souza,02-06-2005,848972,Bihar,20,14,23,14,71,Pass
Kunal Singh,12-01-2006,203949,Arunachal Pradesh,7,6,18,7,38,Pass
Gurpreet Verma,30-09-2005,202008,Chhattisgarh,11,14,15,9,49,Pass
Aryan Singh,01-07-2005,955331,Karnataka,20,24,12,5,61,Pass
Balbir Singh,18-04-2006,693315,Madhya Pradesh,4,10,18,14,46,Pass
Ishaan Singh,01-09-2005,374975,Punjab,3,4,8,3,18,Pass
Krishna Pillai,14-12-2005,782871,Odisha,8,3,22,1,34,Pass
Manpreet Singh,09-05-2005,299830,Punjab,2,4,6,5,17,Pass
Harjeet Khan,25-04-2006,782441,West Bengal,24,2,21,5,52,Pass
David Singh,12-06-2005,905615,Maharashtra,11,13,2,11,37,Pass
Gurpreet Reddy,16-12-2004,879794,Bihar,20,14,19,1,54,Pass
John Khan,07-12-2005,411024,Andhra Pradesh,15,12,11,13,51,Pass
Balbir Singh,14-04-2006,819265,Punjab,11,14,8,14,47,Pass
Aditya Mehta,03-04-2006,861756,Uttar Pradesh,23,12,10,11,56,Pass
Aryan Mehta,16-04-2006,581611,Maharashtra,15,22,2,21,60,Pass
Aryan Chopra,20-01-2005,802209,Uttar Pradesh,14,23,3,19,59,Pass
Farhan Sharma,17-08-2005,326425,Bihar,0,4,15,21,40,Pass
Aarav Fernandes,28-02-2006,496966,Andhra Pradesh,3,14,0,10,27,Pass
Aditya Sharma,19-07-2005,451241,Madhya Pradesh,16,19,3,23,61,Pass
Kunal Khan,19-11-2005,655876,Maharashtra,14,2,7,0,23,Pass
Aditya Singh,01-06-2005,407654,Rajasthan,20,11,20,13,64,Pass
Mathew Reddy,06-02-2006,314793,Haryana,23,5,21,17,66,Pass
Balbir Chopra,07-09-2005,408553,Maharashtra,5,20,2,20,47,Pass
Rohan Khan,21-10-2005,273671,Tamil Nadu,7,20,17,11,55,Pass
Harjeet Fernandes,20-12-2004,376675,Uttar Pradesh,23,13,16,14,66,Pass
Ishaan Singh,07-07-2005,605053,West Bengal,16,7,7,2,32,Pass
Aryan Singh,05-12-2005,328795,Karnataka,12,2,3,14,31,Pass
Peter Chopra,18-06-2005,740137,Himachal Pradesh,10,24,22,15,71,Pass
Yash Sharma,17-01-2005,137630,Delhi,3,15,19,12,49,Pass
Krishna Chopra,20-03-2005,406932,Rajasthan,8,2,2,3,15,Pass
Yash D'Souza,13-08-2005,113195,Uttar Pradesh,21,9,10,4,44,Pass
Aryan D'Souza,02-06-2005,992880,Uttar Pradesh,1,15,4,20,40,Pass
John Khan,09-10-2005,628312,Bihar,18,18,13,1,50,Pass
Ishaan Fernandes,07-09-2005,626793,Maharashtra,8,7,2,24,41,Pass
Balbir Mehta,06-01-2006,963555,Uttar Pradesh,11,22,16,8,57,Pass
Mathew Chopra,08-05-2006,620503,West Bengal,3,20,20,15,58,Pass
Aditya Reddy,24-04-2005,674803,Bihar,24,14,24,13,75,Pass
Harjeet Khan,22-05-2005,732751,Bihar,13,0,22,15,50,Pass
Vivaan Singh,14-01-2006,777022,West Bengal,3,16,10,16,45,Pass
Yash Pillai,20-01-2005,184961,Madhya Pradesh,8,8,0,3,19,Pass
Yash D'Souza,10-04-2005,490748,Tamil Nadu,4,18,16,23,61,Pass
Paul Verma,26-01-2006,698816,Maharashtra,20,3,2,23,48,Pass
Balbir Singh,16-04-2005,442165,Jharkhand,5,22,1,15,43,Pass
Aryan Sharma,01-05-2005,989126,West Bengal,3,19,1,10,33,Pass
Farhan Fernandes,27-10-2005,735030,Maharashtra,20,3,2,23,48,Pass
John D'Souza,29-05-2005,416416,Jammu & Kashmir + Ladakh,15,8,6,19,48,Pass
Aryan Pillai,26-12-2005,547056,Madhya Pradesh,14,2,19,11,46,Pass
Raj Fernandes,20-03-2006,104943,Uttar Pradesh,3,14,22,17,56,Pass
Krishna Khan,24-04-2006,281985,Uttar Pradesh,21,9,18,10,58,Pass
Vivaan Pillai,29-07-2005,218729,Maharashtra,24,9,2,8,43,Pass
Aryan Pillai,09-08-2005,106563,Andhra Pradesh,8,13,3,4,28,Pass
Vivaan D'Souza,23-02-2006,206073,Goa,1,5,2,22,30,Fail
Balbir Khan,16-12-2004,605168,Bihar,15,2,23,6,46,Pass
Kunal Sharma,23-11-2005,578091,Rajasthan,1,12,17,21,51,Pass
Raj Chopra,26-11-2004,273066,Uttar Pradesh,16,8,7,10,41,Pass
Raj Fernandes,22-02-2006,965430,Telangana,4,0,9,21,34,Pass
Aditya Khan,01-04-2006,936137,Uttar Pradesh,10,15,12,10,47,Pass
Ishaan Chopra,21-02-2005,652237,Uttarakhand,21,9,6,0,36,Pass
Aarav Fernandes,16-11-2005,752495,Rajasthan,0,16,4,13,33,Pass
Raj Chopra,15-04-2005,745608,Odisha,0,19,8,9,36,Pass
Peter Reddy,18-05-2005,886293,Andhra Pradesh,17,23,6,2,48,Pass
Kunal Singh,06-09-2005,432404,Assam,18,16,13,20,67,Pass
Kunal Sharma,29-07-2005,390176,West Bengal,3,10,23,2,38,Pass
David Mehta,15-08-2005,774581,West Bengal,8,7,13,6,34,Pass
Aarav Sharma,21-11-2005,377492,Bihar,16,22,4,21,63,Pass
Yash Khan,25-10-2005,483442,Maharashtra,16,2,0,23,41,Pass
Ishaan Singh,05-11-2005,747125,Gujarat,8,0,13,8,29,Pass
Vivaan Pillai,16-12-2004,594790,Odisha,24,1,2,22,49,Pass
Krishna Mehta,26-06-2005,361482,Uttar Pradesh,14,16,11,12,53,Pass
Imran Pillai,02-12-2004,869100,Rajasthan,9,9,11,18,47,Pass
John Chopra,25-02-2005,989162,Assam,9,4,0,20,33,Pass
Aditya Mehta,31-12-2004,973238,Gujarat,21,13,3,4,41,Pass
Ayaan Mehta,17-12-2004,850307,Rajasthan,13,9,12,21,55,Pass
Aarav Singh,09-07-2005,611162,Punjab,1,5,14,7,27,Pass
Farhan Sharma,23-01-2005,205838,Chhattisgarh,1,21,23,11,56,Pass
Kunal Mehta,15-03-2005,174482,Tripura,18,14,4,7,43,Pass
Sukhwinder Verma,13-10-2005,637724,Madhya Pradesh,24,16,3,7,50,Pass
Sukhwinder Khan,17-12-2005,411211,Telangana,14,16,4,24,58,Pass
Aarav Sharma,29-05-2005,456762,Jharkhand,15,5,22,1,43,Pass
Paul Verma,23-02-2005,715463,Haryana,3,13,19,21,56,Pass
David Singh,25-09-2005,982906,West Bengal,3,1,16,19,39,Pass
Aryan Sharma,05-11-2005,233077,Maharashtra,16,12,5,16,49,Pass
Krishna Singh,09-07-2005,940857,Uttar Pradesh,15,13,14,18,60,Pass
Aditya Fernandes,30-10-2005,858100,Rajasthan,3,8,19,7,37,Pass
Krishna Singh,28-04-2005,261939,Haryana,1,22,10,21,54,Pass
Yash Sharma,03-09-2005,594507,Andhra Pradesh,14,22,15,3,54,Pass
Gurpreet Singh,06-02-2006,747218,West Bengal,4,16,20,6,46,Pass
Manpreet Mehta,10-01-2005,540485,Andhra Pradesh,11,13,24,2,50,Pass
Aditya Chopra,27-02-2006,471893,Gujarat,12,7,3,13,35,Fail
Ishaan Pillai,11-02-2006,608690,Madhya Pradesh,3,6,19,10,38,Pass
Rohan Verma,21-03-2005,857973,Karnataka,19,6,8,5,38,Pass
Kunal D'Souza,16-11-2005,937675,Delhi,23,24,12,15,74,Pass
Kunal Verma,02-11-2005,348969,Gujarat,6,21,21,23,71,Fail
Harjeet Sharma,02-03-2005,634954,Madhya Pradesh,4,7,19,10,40,Pass
Gurpreet Sharma,20-07-2005,806809,Assam,3,2,20,21,46,Pass
Yash Mehta,04-01-2006,922860,Delhi,9,21,14,7,51,Pass
Rohan Sharma,04-03-2006,665356,Uttarakhand,17,5,3,22,47,Pass
Rohan Fernandes,24-11-2004,276919,Madhya Pradesh,9,10,3,2,24,Pass
Aditya Verma,22-09-2005,657249,Bihar,20,11,5,3,39,Pass
Yash D'Souza,11-03-2006,288223,Maharashtra,24,3,0,17,44,Pass
Rohan Chopra,05-05-2006,253884,Maharashtra,23,13,9,2,47,Pass
Aditya Singh,02-07-2005,169592,Chhattisgarh,21,9,5,4,39,Pass
Ishaan Singh,19-10-2005,729195,Uttar Pradesh,1,19,5,15,40,Pass
Harjeet Mehta,15-09-2005,193623,West Bengal,3,21,5,23,52,Pass
Paul D'Souza,12-03-2005,698199,Tripura,19,8,7,8,42,Pass
Aditya Fernandes,29-07-2005,994810,Uttar Pradesh,10,12,23,11,56,Pass
Kunal Singh,14-01-2006,975006,Uttar Pradesh,18,14,7,13,52,Pass
Gurpreet Singh,17-11-2004,632183,Bihar,11,16,10,2,39,Pass
Aryan Reddy,05-09-2005,906454,Odisha,24,12,22,3,61,Pass
Yash Reddy,21-02-2006,390443,Andhra Pradesh,0,3,1,0,4,Pass
Manpreet Sharma,12-08-2005,408005,Uttar Pradesh,12,22,0,20,54,Pass
Vivaan Fernandes,10-04-2006,559879,Gujarat,12,14,23,4,53,Fail
Rohan Mehta,30-06-2005,171706,Daman & Diu / D&N Haveli,0,11,8,7,26,Pass
David Reddy,15-04-2006,471537,Odisha,19,10,8,10,47,Pass
Raj Chopra,01-02-2005,237835,Bihar,22,24,19,20,85,Pass
Rohan Singh,17-08-2005,823774,Bihar,24,9,19,2,54,Pass
Imran D'Souza,24-05-2005,877183,West Bengal,6,3,4,10,23,Pass
Zaid D'Souza,06-08-2005,960302,Madhya Pradesh,6,6,21,23,56,Pass
Aditya D'Souza,09-10-2005,866002,Punjab,1,19,5,11,36,Pass
Aryan Pillai,11-12-2005,756309,Bihar,10,10,16,19,55,Pass
Aditya Sharma,13-06-2005,836157,Telangana,16,20,6,14,56,Pass
Ishaan Fernandes,12-12-2005,279034,Tamil Nadu,2,12,23,23,60,Pass
Harjeet D'Souza,20-11-2004,795346,Haryana,2,18,8,19,47,Pass
Krishna Fernandes,13-07-2005,613948,West Bengal,3,10,24,1,38,Pass
Gurpreet Verma,30-03-2006,455257,Maharashtra,8,3,23,10,44,Pass
Krishna Sharma,03-12-2004,607408,Maharashtra,15,16,2,13,46,Pass
Aarav Sharma,26-12-2004,111950,Rajasthan,18,1,10,2,31,Pass
David Singh,15-10-2005,931842,Uttarakhand,0,14,3,21,38,Pass
Aryan Chopra,09-04-2006,532748,Tamil Nadu,7,0,9,23,39,Pass
Aarav Fernandes,11-09-2005,411981,Kerala,8,24,23,13,68,Fail
Raj D'Souza,12-03-2006,507191,Tripura,22,11,15,6,54,Pass
Krishna Pillai,23-02-2005,282481,Andhra Pradesh,3,10,7,12,32,Pass
Krishna Singh,08-10-2005,136564,Madhya Pradesh,0,14,1,13,28,Pass
Sukhwinder Singh,30-11-2005,785705,Tamil Nadu,5,24,6,4,39,Pass
Ishaan Fernandes,24-11-2005,387116,Meghalaya,0,2,14,17,33,Pass
Aarav Chopra,24-12-2005,209648,Rajasthan,21,18,22,2,63,Pass
Vivaan Khan,20-06-2005,707536,Madhya Pradesh,11,19,3,10,43,Pass
Harjeet Fernandes,03-01-2006,779738,Chhattisgarh,0,14,5,0,19,Pass
Peter Sharma,29-11-2004,209455,Himachal Pradesh,15,3,4,16,38,Pass
Aarav Pillai,18-01-2005,355581,Bihar,19,7,6,0,32,Pass
Balbir Fernandes,29-11-2004,842255,Tamil Nadu,4,12,0,20,36,Pass
Aarav Fernandes,06-12-2005,428279,Madhya Pradesh,22,14,3,19,58,Pass
Ishaan D'Souza,25-04-2006,862534,Assam,16,5,2,20,43,Pass
Balbir Fernandes,26-12-2004,900962,Tamil Nadu,13,14,21,10,58,Pass
Manpreet Mehta,03-04-2005,490600,Haryana,7,5,5,13,30,Pass
Harjeet Reddy,07-12-2005,608292,Mizoram,4,10,4,9,27,Pass
Ishaan Mehta,24-02-2005,797563,Gujarat,13,8,17,22,60,Fail
Imran Singh,20-09-2005,412131,Karnataka,1,2,18,15,36,Pass
Zaid Khan,26-02-2006,661491,Andhra Pradesh,15,7,6,4,32,Pass
John D'Souza,25-06-2005,814639,Uttar Pradesh,2,15,12,18,47,Pass
Aarav Chopra,12-06-2005,597341,Assam,20,11,12,14,57,Pass
Aarav Fernandes,12-02-2005,166418,Punjab,19,13,5,8,45,Pass
Aryan Verma,21-01-2006,233193,Rajasthan,23,15,23,18,79,Pass
Krishna Reddy,31-01-2006,792041,Odisha,14,18,1,3,36,Pass
Ishaan Mehta,06-03-2005,979947,West Bengal,3,23,21,17,64,Pass
Aarav Singh,02-02-2005,205034,Jharkhand,4,9,3,19,35,Pass
Yash Verma,24-03-2005,834108,Tripura,22,11,18,2,53,Pass
Balbir Sharma,14-07-2005,610530,Bihar,20,1,19,13,53,Pass
Harjeet Pillai,29-11-2004,461463,Rajasthan,18,20,6,22,66,Pass
Aarav Verma,25-06-2005,265415,West Bengal,10,4,14,8,36,Pass
Krishna D'Souza,04-05-2005,678116,Bihar,17,7,4,12,40,Pass
Yash Chopra,04-05-2006,606010,Gujarat,1,17,22,10,50,Fail
Krishna Sharma,06-03-2005,123886,Maharashtra,24,24,2,10,60,Pass
Balbir Chopra,03-02-2006,780158,Haryana,16,1,19,13,49,Pass
Kunal Reddy,08-01-2005,206161,Madhya Pradesh,19,19,3,5,46,Pass
Imran Verma,04-09-2005,218748,Madhya Pradesh,9,24,6,10,49,Pass
Sukhwinder Fernandes,16-01-2006,804396,Punjab,13,2,24,1,40,Pass
David Khan,23-02-2006,876279,Uttar Pradesh,14,8,5,18,45,Pass
Mathew D'Souza,09-03-2005,489263,Madhya Pradesh,20,20,3,21,64,Pass
Paul Mehta,16-05-2005,399910,Rajasthan,7,17,18,6,48,Pass
Sukhwinder Mehta,31-01-2006,976429,Jharkhand,10,23,4,23,60,Pass
Aditya Khan,19-04-2005,419725,Madhya Pradesh,10,1,13,15,39,Pass
Yash Sharma,19-04-2006,176738,Karnataka,13,19,15,21,68,Fail
Kunal Singh,11-02-2006,904542,Madhya Pradesh,19,11,0,9,39,Pass
Ishaan Reddy,27-03-2005,899887,Chhattisgarh,12,12,3,8,35,Pass
Rohan Reddy,21-01-2005,933109,Bihar,11,12,18,20,61,Pass
Krishna Verma,06-02-2005,906780,Himachal Pradesh,15,23,10,8,56,Pass
Aarav Singh,23-12-2005,569846,Telangana,21,18,20,7,66,Pass
Aarav Verma,18-02-2005,273523,Odisha,5,3,3,5,16,Pass
Yash Khan,11-03-2005,554354,Andhra Pradesh,14,19,8,11,52,Pass
Aryan Pillai,12-05-2005,647215,Gujarat,10,23,20,24,77,Fail
David Pillai,04-09-2005,100808,Uttar Pradesh,24,19,4,22,69,Pass
Rohan Fernandes,20-08-2005,395716,Madhya Pradesh,3,2,15,12,32,Pass
Aditya Fernandes,12-05-2005,520661,Maharashtra,12,7,0,7,26,Pass
Yash Chopra,08-12-2004,774119,Bihar,5,16,10,4,35,Pass
Aditya Mehta,26-07-2005,822776,Rajasthan,10,15,24,14,63,Pass
Aarav Pillai,18-04-2006,424106,Rajasthan,13,23,14,6,56,Pass
Gurpreet Fernandes,08-04-2005,770762,Uttar Pradesh,0,10,11,13,34,Pass
Sukhwinder D'Souza,19-07-2005,346616,Andhra Pradesh,4,6,24,7,41,Pass
Aryan Fernandes,03-09-2005,229531,Gujarat,11,15,23,14,63,Fail
Yash Reddy,17-11-2004,838250,Haryana,20,17,1,8,46,Pass
Sukhwinder Sharma,12-06-2005,981682,Gujarat,4,9,15,2,30,Fail
John Verma,28-10-2005,639751,Andhra Pradesh,16,8,6,20,50,Pass
Aarav Khan,10-12-2005,830828,Rajasthan,20,24,20,22,86,Pass
Aarav Khan,18-04-2006,270687,Telangana,22,20,13,1,56,Pass
John Pillai,22-01-2005,758414,Maharashtra,20,3,6,5,34,Pass
Harjeet Mehta,23-11-2005,355339,Uttar Pradesh,5,3,8,23,39,Pass
Gurpreet Sharma,14-02-2005,388910,Goa,6,7,3,21,37,Fail
Krishna Singh,22-12-2005,364078,Kerala,10,17,15,4,46,Pass
Aditya Fernandes,11-07-2005,646330,Kerala,7,17,11,23,58,Pass
Yash Sharma,29-11-2005,266925,Jharkhand,2,16,6,11,35,Pass
Kunal Verma,14-06-2005,113944,Punjab,19,10,11,17,57,Pass
Aryan D'Souza,29-04-2005,732095,Rajasthan,1,19,24,5,49,Pass
Ishaan Mehta,11-12-2004,850234,Chhattisgarh,12,0,5,15,32,Pass
Raj Chopra,11-04-2005,663564,Madhya Pradesh,14,21,3,0,38,Pass
Aditya Mehta,07-03-2006,891406,Tamil Nadu,11,23,7,21,62,Pass
Aryan Verma,31-12-2004,437716,Tamil Nadu,3,9,7,3,22,Pass
Balbir Sharma,15-12-2005,674932,Uttar Pradesh,18,17,19,7,61,Pass
David Mehta,26-09-2005,954424,Tripura,18,7,18,15,58,Pass
Ishaan Khan,21-03-2005,629405,Odisha,15,3,24,12,54,Pass
Rohan Pillai,24-08-2005,439356,Uttar Pradesh,3,19,24,22,68,Pass
Vivaan Reddy,29-11-2004,833938,Karnataka,8,1,10,21,40,Pass
Aarav Khan,14-01-2005,869918,Haryana,21,22,8,8,59,Pass
Aryan Khan,13-03-2005,259537,Bihar,17,7,5,13,42,Pass
Yash Mehta,11-02-2006,393678,Gujarat,24,14,6,1,45,Fail
Aarav Pillai,20-02-2005,974620,Maharashtra,9,10,4,16,39,Pass
Peter Singh,18-10-2005,649090,Haryana,8,8,20,6,42,Pass
John Verma,01-02-2005,538144,Gujarat,15,14,20,19,68,Fail
Aditya Mehta,16-08-2005,184455,Himachal Pradesh,19,1,12,8,40,Pass
Krishna Sharma,29-12-2005,401743,Tamil Nadu,7,5,24,9,45,Pass
Rohan Khan,30-12-2005,470577,Uttarakhand,8,12,9,3,32,Pass
John Fernandes,27-11-2004,891266,Bihar,1,12,10,3,26,Pass
Raj Sharma,14-12-2004,226946,Madhya Pradesh,1,8,24,19,52,Pass
Krishna Fernandes,27-04-2005,687564,Andhra Pradesh,20,12,2,7,41,Pass
Kunal D'Souza,26-03-2005,365590,Assam,17,5,12,0,34,Pass
Raj Khan,01-01-2006,157437,West Bengal,22,11,9,6,48,Pass
Yash Sharma,30-08-2005,720618,Rajasthan,5,2,22,18,47,Pass
Rohan Singh,19-02-2005,660824,Uttar Pradesh,5,15,19,10,49,Pass
Rohan D'Souza,03-09-2005,818108,Uttar Pradesh,18,5,12,20,55,Pass
Raj Mehta,10-06-2005,869115,Chhattisgarh,0,0,8,23,31,Pass
Krishna Reddy,01-04-2005,708775,West Bengal,8,7,10,10,35,Pass
Aarav Khan,22-07-2005,456166,Maharashtra,6,4,7,17,34,Pass
Manpreet Khan,16-12-2005,940933,Uttar Pradesh,11,3,15,21,50,Pass
Kunal Fernandes,18-11-2004,137881,Uttar Pradesh,5,6,21,10,42,Pass
Kunal Mehta,29-01-2006,304673,Jharkhand,1,4,0,23,28,Pass
Rohan Pillai,15-06-2005,572798,Rajasthan,16,17,11,24,68,Pass
Raj Fernandes,27-12-2005,303910,Madhya Pradesh,4,6,17,5,32,Pass
Gurpreet D'Souza,11-04-2006,999638,Kerala,11,12,0,5,28,Pass
Harjeet Singh,03-06-2005,584024,Jharkhand,13,23,22,12,70,Fail
Ayaan Fernandes,26-10-2005,672929,Rajasthan,0,19,24,5,48,Pass
Krishna Mehta,25-03-2005,788444,Assam,10,23,11,15,59,Pass
Sukhwinder Sharma,26-11-2004,713675,Jammu & Kashmir + Ladakh,6,16,3,5,30,Pass
Ishaan Pillai,30-04-2006,435460,Madhya Pradesh,24,9,9,3,45,Pass
Yash Reddy,31-10-2005,707974,Karnataka,16,10,21,14,61,Pass
Rohan Fernandes,09-11-2004,685183,Tamil Nadu,2,7,6,13,28,Pass
Mathew D'Souza,23-01-2005,446687,Manipur,12,5,4,3,24,Pass
Krishna Fernandes,28-10-2005,215538,Tamil Nadu,23,23,22,13,81,Pass
Paul Pillai,01-03-2005,779339,Jharkhand,21,2,6,14,43,Pass
Gurpreet Pillai,23-12-2004,597102,Nagaland,9,5,6,7,27,Pass
Vivaan Verma,02-12-2005,821861,Haryana,24,8,12,23,67,Pass
Manpreet Verma,19-04-2006,429626,Kerala,12,1,20,21,54,Pass
Manpreet D'Souza,14-08-2005,907855,Maharashtra,24,19,2,15,60,Pass
Imran Sharma,04-11-2005,243021,Haryana,20,11,5,16,52,Pass
Sukhwinder Pillai,22-10-2005,646383,Haryana,17,24,11,13,65,Pass
Ishaan Khan,19-01-2006,138418,Tamil Nadu,5,19,12,0,36,Pass
Imran Khan,17-04-2005,916000,Uttar Pradesh,10,6,2,11,29,Pass
Aditya Singh,22-01-2005,369272,Jharkhand,4,1,13,14,32,Pass
Ishaan Fernandes,08-12-2005,893800,Madhya Pradesh,5,22,0,15,42,Pass
Ishaan Fernandes,24-01-2005,456362,Gujarat,20,19,1,11,51,Fail
Mathew Pillai,07-02-2005,873359,Uttar Pradesh,13,22,7,5,47,Pass
Ishaan Verma,20-03-2006,988776,Bihar,14,0,13,8,35,Pass
Peter Pillai,12-10-2005,242340,Jammu & Kashmir + Ladakh,0,4,17,8,29,Pass
Mathew Mehta,14-02-2006,882805,Uttar Pradesh,21,6,18,8,53,Pass
Aryan Mehta,15-02-2006,523503,Madhya Pradesh,2,13,10,19,44,Pass
Vivaan Verma,19-07-2005,557420,Maharashtra,0,17,5,16,38,Pass
Aditya Khan,28-11-2005,421225,Andhra Pradesh,14,12,5,16,47,Pass
Balbir D'Souza,06-05-2006,545915,Tamil Nadu,3,15,18,17,53,Pass
Aarav Khan,27-11-2005,841787,Jharkhand,10,6,6,5,27,Pass
Yash Singh,04-05-2006,435300,Tamil Nadu,9,7,19,13,48,Pass
Vivaan Chopra,28-05-2005,627160,Bihar,7,19,13,6,45,Pass
Ishaan D'Souza,22-04-2006,460832,Delhi,24,11,9,5,49,Pass
Sukhwinder Sharma,05-08-2005,241643,Tamil Nadu,1,10,18,2,31,Pass
Ishaan Khan,22-03-2006,608314,Haryana,9,18,12,21,60,Pass
Harjeet Khan,02-10-2005,752223,Madhya Pradesh,16,8,16,7,47,Pass
Aarav Mehta,18-05-2005,547390,Kerala,6,19,13,23,61,Pass
Balbir Verma,27-11-2005,436137,Madhya Pradesh,7,6,1,20,34,Pass
Krishna D'Souza,01-10-2005,981188,Maharashtra,8,1,2,24,35,Pass
Aarav Chopra,09-04-2005,181916,Gujarat,1,10,17,17,45,Fail
Aarav Chopra,07-03-2006,791996,Delhi,17,8,4,22,51,Pass
Krishna Reddy,10-09-2005,198600,Haryana,0,10,22,1,33,Pass
Raj Fernandes,03-11-2005,282870,Bihar,24,22,11,19,76,Pass
Aarav Khan,08-11-2005,278537,Karnataka,15,7,18,20,60,Pass
Ishaan Chopra,17-02-2006,393109,Maharashtra,3,17,8,17,45,Pass
Aarav Chopra,09-05-2005,375468,Odisha,6,8,0,7,21,Pass
Sukhwinder Sharma,12-12-2004,148325,Punjab,21,1,15,0,37,Pass
Rohan Chopra,12-03-2005,638684,Rajasthan,3,11,7,21,42,Pass
Kunal Pillai,15-05-2005,189051,Maharashtra,17,1,9,19,46,Pass
Rohan Reddy,16-02-2005,709911,Rajasthan,17,10,6,9,42,Pass
Krishna Mehta,19-02-2006,879162,Maharashtra,2,16,20,1,39,Pass
Aditya D'Souza,05-01-2006,604626,Maharashtra,2,5,12,5,24,Pass
Aarav Sharma,20-04-2006,517896,Rajasthan,12,5,14,20,51,Pass
Paul Reddy,25-01-2006,582865,Rajasthan,21,23,7,24,75,Pass
Raj Singh,03-04-2005,381882,Madhya Pradesh,3,2,18,19,42,Pass
Vivaan Fernandes,05-08-2005,451205,Haryana,4,13,12,11,40,Pass
Balbir Reddy,12-12-2005,985796,Uttar Pradesh,7,15,10,5,37,Pass
Yash Reddy,04-03-2005,467822,Rajasthan,4,4,6,23,37,Pass
Raj Verma,04-02-2006,508501,Uttar Pradesh,3,13,3,11,30,Pass
Yash Fernandes,22-11-2005,202247,Tamil Nadu,20,7,22,20,69,Pass
Aditya Chopra,13-04-2005,939877,Tamil Nadu,12,23,24,17,76,Pass
Manpreet Fernandes,25-08-2005,104086,Madhya Pradesh,2,14,13,2,31,Pass
Kunal Mehta,24-12-2004,971497,Karnataka,4,13,21,6,44,Pass
Harjeet Sharma,29-01-2006,571192,Bihar,19,24,6,19,68,Pass
Ishaan Sharma,19-02-2006,424317,Tamil Nadu,3,11,18,12,44,Pass
Vivaan Pillai,08-03-2006,772471,Madhya Pradesh,24,2,22,3,51,Pass
Vivaan Chopra,03-04-2005,724040,Andhra Pradesh,10,17,5,8,40,Pass
Aditya D'Souza,15-05-2005,570272,Gujarat,1,14,5,13,33,Fail
Peter Fernandes,18-11-2004,657255,Uttar Pradesh,5,3,23,2,33,Pass
Manpreet Khan,18-12-2005,632177,Odisha,2,8,21,12,43,Pass
Peter Pillai,23-11-2004,914673,West Bengal,3,4,16,13,36,Pass
Ishaan Reddy,06-07-2005,565883,Bihar,6,5,11,23,45,Pass
David Pillai,11-07-2005,652789,Assam,23,7,7,3,40,Pass
Aarav Chopra,14-04-2006,756918,Gujarat,5,4,16,19,44,Fail
Aditya Reddy,25-06-2005,988586,Rajasthan,6,11,4,3,24,Pass
Raj Reddy,10-02-2006,607461,Rajasthan,21,21,0,7,49,Pass
David Pillai,05-05-2006,370741,Odisha,5,4,23,13,45,Pass
Aryan Chopra,20-08-2005,911204,Tamil Nadu,19,20,8,17,64,Pass
Yash Singh,29-06-2005,555831,Tamil Nadu,3,12,14,7,36,Pass
Krishna Singh,05-02-2005,432750,Gujarat,15,17,16,5,53,Fail
Gurpreet Verma,15-04-2006,541085,Telangana,19,8,7,17,51,Pass
David D'Souza,30-07-2005,840227,Himachal Pradesh,6,11,13,7,37,Pass
Ishaan Khan,05-03-2005,320595,Haryana,14,4,23,8,49,Pass
Aditya Khan,17-03-2006,978255,Kerala,22,16,7,12,57,Pass
Zaid Fernandes,17-12-2004,518030,Telangana,22,7,16,6,51,Pass
Raj Khan,02-06-2005,160812,Rajasthan,7,17,5,2,31,Pass
Ishaan Singh,21-02-2006,983303,Maharashtra,9,24,2,19,54,Pass
Raj Mehta,01-06-2005,255727,Andhra Pradesh,20,2,15,7,44,Pass
Rohan Verma,31-03-2006,645156,Madhya Pradesh,20,4,12,19,55,Pass
John Mehta,19-03-2005,642710,Uttar Pradesh,3,12,23,17,55,Pass
Mathew Verma,25-09-2005,591112,Jharkhand,14,15,22,11,62,Pass
Aarav Chopra,05-05-2006,700247,Telangana,5,14,6,19,44,Pass
Gurpreet D'Souza,31-12-2005,193331,Bihar,22,10,24,6,62,Pass
Raj D'Souza,23-06-2005,548015,Haryana,0,14,10,11,35,Pass
Vivaan Reddy,10-06-2005,770825,Madhya Pradesh,4,18,3,22,47,Pass
Paul Verma,21-04-2005,693584,Tamil Nadu,22,19,18,20,79,Pass
Raj Khan,02-10-2005,397251,Rajasthan,11,15,21,22,69,Pass
Kunal Fernandes,05-11-2005,790744,Gujarat,21,20,18,17,76,Fail
Aryan Pillai,06-03-2005,486251,West Bengal,7,1,24,0,32,Pass
Yash Pillai,07-02-2006,580399,Uttar Pradesh,12,5,6,13,36,Pass
Gurpreet Verma,30-06-2005,957060,Rajasthan,11,1,16,5,33,Pass
Aryan Fernandes,29-03-2005,332546,Bihar,2,0,18,8,28,Pass
Raj Pillai,28-01-2006,932239,West Bengal,3,9,10,15,37,Pass
Rehan Singh,01-05-2006,736880,Madhya Pradesh,9,6,4,0,19,Pass
Ishaan Sharma,08-12-2004,614310,Bihar,9,16,19,17,61,Pass
Krishna Fernandes,28-11-2004,512814,Bihar,20,4,11,2,37,Pass
Aarav Singh,24-08-2005,653559,Haryana,6,17,17,18,58,Pass
Ishaan Sharma,06-06-2005,833360,Maharashtra,0,7,10,13,30,Pass
Aditya Reddy,02-01-2006,816621,Rajasthan,14,15,9,18,56,Pass
Mathew Verma,02-03-2005,678335,West Bengal,18,3,4,24,49,Pass
Mathew Sharma,03-10-2005,837500,Chhattisgarh,6,5,23,23,57,Pass
Kunal Fernandes,13-06-2005,967287,Andhra Pradesh,20,0,21,15,56,Pass
Kunal Pillai,24-01-2006,637623,Kerala,13,22,10,23,68,Fail
Balbir Mehta,23-02-2006,883833,Haryana,10,20,11,24,65,Pass
Balbir Chopra,18-06-2005,933523,West Bengal,4,4,5,19,32,Pass
Sukhwinder Khan,03-04-2006,400567,Uttar Pradesh,8,2,21,15,46,Pass
Ayaan Fernandes,29-05-2005,869306,West Bengal,5,12,19,4,40,Pass
Gurpreet Pillai,15-08-2005,369405,Madhya Pradesh,11,4,6,15,36,Pass
Peter Khan,29-07-2005,305525,Himachal Pradesh,5,24,12,3,44,Pass
Yash Fernandes,24-07-2005,651870,Bihar,5,4,23,7,39,Pass
Raj Khan,01-12-2005,417299,Madhya Pradesh,7,9,16,21,53,Pass
Yash Sharma,14-12-2005,814453,West Bengal,16,4,15,3,38,Pass
Yash Fernandes,28-10-2005,450322,Andhra Pradesh,18,4,13,1,36,Pass
Aditya Fernandes,24-09-2005,599269,Andhra Pradesh,2,23,13,6,44,Pass
Manpreet Reddy,24-12-2005,102267,Bihar,9,9,22,15,55,Pass
Aryan Mehta,20-07-2005,779621,Telangana,12,4,9,0,25,Pass
Manpreet Verma,29-09-2005,568752,Uttar Pradesh,4,1,23,15,43,Pass
Paul D'Souza,06-10-2005,296314,Manipur,4,21,22,15,62,Pass
Krishna Pillai,11-12-2005,983538,Manipur,4,17,24,13,58,Pass
Sukhwinder Pillai,03-02-2006,564446,Andhra Pradesh,5,13,0,12,30,Pass
Balbir D'Souza,28-04-2005,119254,Kerala,0,22,5,16,43,Pass
Kunal Mehta,06-03-2006,297387,Uttarakhand,6,15,16,11,48,Pass
Ishaan Reddy,30-03-2005,191676,Tamil Nadu,15,11,14,0,40,Pass
Aryan Fernandes,28-02-2005,866324,Bihar,20,14,12,18,64,Pass
Vivaan Sharma,30-05-2005,509935,Uttar Pradesh,9,19,22,0,50,Pass
Aarav Fernandes,25-07-2005,909249,Bihar,12,5,6,12,35,Pass
Gurpreet Chopra,03-10-2005,550158,Madhya Pradesh,18,19,3,9,49,Pass
Yash D'Souza,17-01-2005,961832,Bihar,17,20,20,13,70,Pass
Aryan D'Souza,06-12-2004,360325,Maharashtra,1,23,2,12,38,Pass
Yash Mehta,31-05-2005,843083,Madhya Pradesh,21,22,3,2,48,Pass
Paul Sharma,28-08-2005,928013,Gujarat,13,6,20,24,63,Fail
Yash Singh,21-01-2005,689946,Rajasthan,9,21,1,4,35,Pass
Krishna Fernandes,29-01-2005,843650,Madhya Pradesh,5,9,13,22,49,Pass
Manpreet D'Souza,12-02-2005,294801,Tamil Nadu,18,12,7,17,54,Pass
Yash Singh,25-11-2005,162788,Bihar,5,17,13,1,36,Pass
Vivaan Fernandes,04-07-2005,997556,Haryana,12,1,21,17,51,Pass
Ishaan Mehta,02-08-2005,194621,Odisha,11,5,23,15,54,Pass
Aryan Pillai,30-12-2005,898009,Uttar Pradesh,5,8,10,8,31,Pass
Ayaan Singh,27-10-2005,592049,West Bengal,2,5,9,22,38,Pass
Kunal Sharma,09-11-2005,822440,Chhattisgarh,2,8,20,11,41,Pass
Sukhwinder Chopra,12-11-2005,933620,Uttarakhand,16,7,2,8,33,Pass
Harjeet Fernandes,15-04-2006,588583,Andhra Pradesh,3,17,0,0,20,Pass
Aditya Khan,22-09-2005,105623,Maharashtra,14,9,10,16,49,Pass
John Reddy,09-12-2004,624408,Kerala,6,14,0,4,24,Pass
Paul Pillai,01-02-2006,473662,Tamil Nadu,22,11,24,21,78,Pass
Farhan Chopra,17-04-2005,358053,Rajasthan,8,9,15,23,55,Pass
Aryan Singh,20-10-2005,697218,West Bengal,6,8,10,22,46,Pass
Raj Reddy,28-05-2005,776680,Odisha,20,23,23,6,72,Pass
Gurpreet Reddy,19-01-2005,542258,Rajasthan,5,10,8,2,25,Pass
Aarav Chopra,15-05-2005,956499,West Bengal,1,9,0,5,15,Pass
Ishaan Pillai,24-01-2005,810731,Maharashtra,23,1,19,3,46,Pass
Raj D'Souza,23-12-2005,743825,Rajasthan,5,2,9,1,17,Pass
Aryan Mehta,06-05-2006,730383,Madhya Pradesh,3,6,20,1,30,Pass
Peter Verma,05-11-2005,278274,Jharkhand,4,12,23,22,61,Fail
Ishaan Chopra,24-11-2004,733146,Uttar Pradesh,21,17,2,13,53,Pass
Raj Mehta,10-03-2006,110990,Rajasthan,2,14,6,19,41,Pass
David D'Souza,28-04-2005,532872,Uttar Pradesh,19,1,7,17,44,Pass
Peter Chopra,26-11-2005,393247,West Bengal,19,5,12,11,47,Pass
Vivaan D'Souza,07-04-2006,928790,Gujarat,24,12,4,16,56,Fail
Sukhwinder Sharma,19-08-2005,434780,Rajasthan,15,12,11,14,52,Pass
Krishna D'Souza,18-01-2006,139588,West Bengal,21,15,8,1,45,Pass
Aarav Chopra,01-07-2005,993716,West Bengal,3,21,12,17,53,Pass
Vivaan Sharma,05-04-2005,414133,Gujarat,24,13,2,9,48,Fail
Kunal D'Souza,10-01-2005,752928,Odisha,21,10,14,9,54,Pass
Mathew Chopra,03-07-2005,577249,Maharashtra,2,20,18,2,42,Pass
Raj Mehta,18-03-2006,891491,Madhya Pradesh,23,18,6,9,56,Pass
Aditya Khan,08-04-2005,797156,Maharashtra,1,9,22,6,38,Pass
Aditya Sharma,15-11-2005,881741,Haryana,19,15,4,10,48,Pass
Krishna Verma,12-08-2005,109289,Odisha,1,3,12,6,22,Pass
Yash Verma,06-12-2005,961189,Madhya Pradesh,11,10,13,0,34,Pass
Sukhwinder Pillai,18-05-2005,121448,Uttar Pradesh,23,9,5,0,37,Pass
Rohan Singh,01-02-2005,344638,Himachal Pradesh,17,17,8,13,55,Pass
Ishaan Fernandes,29-04-2006,508975,Gujarat,9,8,21,10,48,Fail
Ishaan D'Souza,16-11-2005,581090,Bihar,14,7,20,7,48,Pass
David Chopra,27-04-2006,980151,Maharashtra,3,12,6,21,42,Pass
Aryan Singh,15-05-2005,467089,Delhi,14,9,8,21,52,Pass
Aryan Khan,01-03-2006,455048,Bihar,20,3,22,23,68,Pass
Rohan Khan,06-12-2005,733543,Delhi,21,15,1,15,52,Pass
Harjeet Khan,29-01-2006,601538,Maharashtra,24,18,0,5,47,Pass
Harjeet Reddy,19-04-2005,235416,Bihar,5,2,14,16,37,Pass
Sukhwinder D'Souza,22-10-2005,945799,Uttar Pradesh,13,20,18,0,51,Pass
Ishaan Pillai,05-08-2005,872255,Madhya Pradesh,7,4,17,13,41,Pass
Aditya D'Souza,27-10-2005,146722,Assam,0,17,0,10,27,Pass
Aryan Mehta,18-12-2004,127569,Tripura,5,5,6,2,18,Pass
Raj Sharma,21-07-2005,148443,Haryana,13,12,19,16,60,Pass
Aditya Khan,16-10-2005,280101,Uttarakhand,23,1,5,6,35,Pass
Mathew Mehta,30-03-2006,672353,Jharkhand,18,16,5,12,51,Pass
Balbir Verma,11-01-2006,711513,Jharkhand,24,17,22,1,64,Pass
Yash D'Souza,22-12-2005,640260,Punjab,7,17,7,11,42,Pass
Yash Fernandes,04-07-2005,686802,Assam,2,19,6,3,30,Pass
Rehan Sharma,02-05-2006,205659,Haryana,2,19,12,20,53,Pass
Yash Pillai,26-07-2005,217212,Telangana,5,5,4,22,36,Pass
Aditya D'Souza,06-02-2005,921297,Karnataka,7,19,17,6,49,Pass
Kunal Chopra,04-03-2006,275301,Rajasthan,14,18,7,12,51,Pass
Aarav Sharma,08-03-2005,643991,Bihar,1,19,15,1,36,Pass
Balbir Sharma,03-12-2004,715589,Maharashtra,7,18,2,20,47,Pass
Peter Sharma,09-01-2005,260966,Telangana,8,3,18,1,30,Pass
Rohan Verma,16-01-2005,660126,Telangana,0,24,4,19,47,Pass
Gurpreet Chopra,27-11-2004,933078,Bihar,15,18,17,11,61,Pass
Gurpreet Pillai,08-03-2005,671404,Telangana,0,18,19,16,53,Pass
Kunal Chopra,02-08-2005,655890,Andhra Pradesh,21,4,2,1,28,Pass
Aryan Pillai,20-01-2005,591819,Andhra Pradesh,23,0,22,5,50,Pass
Yash Fernandes,18-12-2005,296166,Uttar Pradesh,18,8,19,17,62,Pass
Sukhwinder Chopra,03-11-2005,932155,Haryana,14,17,11,8,50,Pass
Aryan Fernandes,31-10-2005,778161,Rajasthan,19,20,20,6,65,Pass
Aarav Reddy,23-04-2005,241248,Bihar,13,2,6,18,39,Pass
Sukhwinder Sharma,15-04-2005,749543,Kerala,6,19,1,20,46,Pass
Paul Sharma,31-08-2005,163603,West Bengal,19,7,9,1,36,Pass
Rohan Khan,15-09-2005,262510,Himachal Pradesh,6,12,23,10,51,Pass
Rohan Mehta,24-10-2005,662357,Odisha,2,8,18,1,29,Pass
Yash Reddy,25-04-2006,271437,Uttar Pradesh,8,0,12,20,40,Pass
Yash Fernandes,01-09-2005,533755,Uttar Pradesh,5,20,24,17,66,Pass
Mathew Reddy,22-08-2005,810499,Andhra Pradesh,15,18,15,7,55,Pass
Ishaan Chopra,28-12-2004,230519,Rajasthan,15,19,3,2,39,Pass
Yash Pillai,16-11-2005,915698,Odisha,24,24,1,23,72,Pass
Aarav Reddy,11-11-2004,727392,Maharashtra,6,5,15,0,26,Pass
Gurpreet Verma,03-01-2006,598841,Tamil Nadu,6,12,9,22,49,Pass
Krishna Sharma,20-10-2005,119833,Uttar Pradesh,11,12,11,1,35,Pass
Aditya Fernandes,26-04-2006,228443,Uttar Pradesh,5,18,16,13,52,Pass
Vivaan Fernandes,08-12-2004,912798,Punjab,20,6,19,15,60,Pass
David Singh,11-01-2006,583640,Haryana,19,8,12,17,56,Pass
Yash Fernandes,08-07-2005,425702,Tripura,24,4,3,17,48,Pass
John Singh,17-01-2006,529252,Bihar,12,3,17,24,56,Pass
Kunal Sharma,29-05-2005,891802,Gujarat,21,1,17,10,49,Fail
Krishna Sharma,13-10-2005,720604,Chhattisgarh,13,10,16,18,57,Pass
Paul Singh,03-01-2005,821702,Maharashtra,13,10,2,18,43,Pass
Vivaan Pillai,25-04-2005,121007,Madhya Pradesh,3,15,5,20,43,Pass
Rohan Mehta,21-04-2006,506159,Rajasthan,20,6,19,1,46,Pass
Rohan D'Souza,01-03-2006,589345,Uttar Pradesh,24,3,3,14,44,Pass
Vivaan Reddy,30-12-2005,764052,Maharashtra,7,17,2,0,26,Pass
Gurpreet Chopra,20-04-2005,209117,Madhya Pradesh,21,17,3,23,64,Pass
Aryan Verma,03-08-2005,217155,Andhra Pradesh,1,2,23,6,32,Pass
Ishaan Khan,14-02-2006,520819,Haryana,20,3,2,15,40,Pass
Peter Fernandes,06-11-2005,275212,Maharashtra,12,24,1,0,37,Pass
Aryan Khan,14-08-2005,794896,Gujarat,22,11,17,19,69,Fail
Aarav Fernandes,20-03-2005,174999,Punjab,10,19,0,0,29,Pass
Kunal Sharma,18-05-2005,805104,Andhra Pradesh,21,4,15,19,59,Pass
Ishaan Pillai,06-11-2005,113371,Maharashtra,23,0,7,12,42,Pass
Harjeet Fernandes,26-02-2005,989307,Tamil Nadu,11,0,1,18,30,Pass
Balbir Fernandes,13-12-2005,309912,Odisha,23,21,8,24,76,Pass
Aryan Verma,02-06-2005,833175,Jammu & Kashmir + Ladakh,13,13,4,23,53,Pass
Krishna Pillai,10-12-2005,557869,West Bengal,2,7,2,16,27,Pass
Raj Singh,10-07-2005,230120,Punjab,5,13,12,10,40,Pass
Raj Pillai,16-11-2004,611998,West Bengal,9,20,2,6,37,Pass
Rohan Fernandes,03-11-2005,169414,Rajasthan,7,13,1,20,41,Pass
John Pillai,03-10-2005,725577,Maharashtra,10,8,2,17,37,Pass
Rohan D'Souza,07-02-2006,505931,Assam,13,5,5,20,43,Pass
Aryan Mehta,18-04-2005,680854,Bihar,2,4,11,16,33,Pass
Aryan D'Souza,14-10-2005,146137,Karnataka,12,7,15,20,54,Pass
Mathew D'Souza,14-11-2004,608247,Haryana,21,17,24,12,74,Pass
Aditya Fernandes,14-12-2004,914737,Haryana,8,22,10,8,48,Pass
Yash D'Souza,30-12-2004,593416,Bihar,0,20,8,15,43,Pass
Balbir Reddy,16-01-2006,428201,Bihar,3,20,21,22,66,Pass
Raj Chopra,31-12-2004,889778,West Bengal,3,22,21,20,66,Pass
Manpreet D'Souza,13-02-2006,476713,Maharashtra,10,6,5,18,39,Pass
Aditya Khan,20-06-2005,902223,Uttar Pradesh,1,1,23,19,44,Pass
Kunal Khan,08-01-2005,824947,Madhya Pradesh,2,17,22,13,54,Pass
Yash D'Souza,09-08-2005,846142,Rajasthan,0,9,13,2,24,Pass
Aryan Singh,15-04-2006,229012,Punjab,19,14,9,24,66,Pass
Ishaan Verma,22-02-2005,815366,Rajasthan,14,9,15,5,43,Pass
Gurpreet Singh,01-10-2005,643860,Andhra Pradesh,1,9,23,16,49,Pass
Aryan Reddy,15-01-2006,277621,Kerala,16,16,17,12,61,Pass
Ishaan Singh,11-12-2005,162137,Andhra Pradesh,6,21,17,8,52,Pass
Manpreet Singh,25-03-2006,386075,Maharashtra,18,14,2,18,52,Pass
Ishaan Reddy,13-02-2005,621469,Bihar,17,12,18,1,48,Pass
John Mehta,09-12-2004,164833,Andhra Pradesh,4,21,7,6,38,Pass
Manpreet Reddy,15-01-2006,605979,Maharashtra,5,14,12,8,39,Pass
Aditya Pillai,23-04-2006,584434,Bihar,9,10,8,14,41,Pass
Rohan Reddy,26-07-2005,205425,Uttar Pradesh,21,1,2,16,40,Pass
Vivaan Sharma,28-05-2005,283082,Assam,24,2,6,3,35,Pass
Manpreet Pillai,20-11-2005,787094,Madhya Pradesh,14,5,19,13,51,Pass
Aryan Mehta,01-01-2006,693663,Gujarat,2,11,18,18,49,Fail
Aarav Fernandes,29-11-2004,888217,Rajasthan,6,11,0,17,34,Pass
Aarav Fernandes,20-07-2005,174105,Rajasthan,5,10,10,11,36,Pass
Gurpreet Reddy,02-07-2005,989664,Tamil Nadu,16,0,11,13,40,Pass
Kunal Chopra,25-06-2005,293308,West Bengal,3,8,17,18,46,Pass
Kunal Fernandes,15-09-2005,673063,Gujarat,24,19,11,7,61,Fail
Manpreet Mehta,08-01-2005,654631,Rajasthan,10,17,10,14,51,Pass
Vivaan D'Souza,12-12-2005,454109,Uttar Pradesh,24,11,0,11,46,Pass
Ayaan Mehta,09-01-2005,404117,Punjab,18,7,20,22,67,Pass
Sukhwinder Chopra,21-10-2005,911651,Rajasthan,17,22,16,9,64,Pass
Rohan Verma,25-06-2005,979041,Punjab,14,19,2,21,56,Pass
Rohan Reddy,13-04-2005,152898,Assam,8,20,6,24,58,Pass
Yash D'Souza,08-04-2005,305518,Gujarat,17,14,2,13,46,Fail
Aryan Khan,05-06-2005,587714,Bihar,7,24,15,4,50,Pass
Balbir Khan,08-02-2006,570440,Assam,12,0,14,23,49,Pass
Aarav Singh,29-08-2005,299181,Telangana,0,17,1,11,29,Pass
Yash Chopra,25-11-2005,528822,Kerala,6,23,4,17,50,Pass
Rohan Mehta,08-12-2005,795406,Rajasthan,3,24,16,24,67,Pass
Vivaan Fernandes,21-12-2005,740365,Uttar Pradesh,14,20,16,15,65,Pass
Krishna Sharma,16-03-2005,509566,Uttarakhand,0,17,11,1,29,Pass
Vivaan Singh,20-11-2004,913987,Madhya Pradesh,6,23,0,24,53,Pass
Raj Khan,11-12-2004,795425,Jharkhand,20,18,5,14,57,Pass
Kunal D'Souza,31-03-2006,842057,Karnataka,2,7,1,12,22,Pass
Aarav D'Souza,08-01-2006,883886,Maharashtra,7,20,2,6,35,Pass
Balbir Singh,03-04-2005,281019,Bihar,10,0,18,0,28,Pass
Aryan Singh,09-02-2006,819486,West Bengal,11,2,16,23,52,Pass
Vivaan Khan,05-01-2005,169220,Tripura,17,6,3,19,45,Pass
Imran Verma,18-05-2005,448127,Rajasthan,22,22,17,22,83,Pass
Aryan Fernandes,10-06-2005,537273,Uttar Pradesh,14,13,6,10,43,Pass
Aryan Fernandes,24-06-2005,601773,Andhra Pradesh,0,5,1,13,19,Pass
Raj Verma,21-01-2006,140514,Tamil Nadu,9,11,23,16,59,Pass
Rohan D'Souza,25-12-2004,869536,Bihar,4,2,9,3,18,Pass
Paul Verma,29-04-2006,964223,Uttar Pradesh,1,15,20,1,37,Pass
Aarav Mehta,08-03-2005,607263,Tamil Nadu,18,17,24,1,60,Pass
Yash Fernandes,03-04-2005,766896,Assam,6,23,3,5,37,Pass
Gurpreet D'Souza,16-10-2005,812640,Uttarakhand,16,3,2,24,45,Pass
Krishna Fernandes,25-06-2005,999628,Bihar,0,21,9,11,41,Pass
Yash Singh,03-12-2005,688245,Maharashtra,12,22,0,9,43,Pass
Krishna Sharma,21-05-2005,126857,Uttar Pradesh,10,14,4,19,47,Pass
Aryan Khan,04-02-2005,779669,Haryana,5,21,11,3,40,Pass
Kunal Chopra,11-03-2006,892246,Rajasthan,19,15,18,24,76,Pass
Yash D'Souza,09-01-2006,166091,Tamil Nadu,1,18,5,19,43,Pass
Yash Mehta,31-12-2004,449681,Telangana,3,21,23,21,68,Pass
Krishna Mehta,06-12-2004,125601,Rajasthan,3,6,12,7,28,Pass
Aditya D'Souza,24-11-2004,865947,Bihar,3,1,10,12,26,Pass
Ishaan D'Souza,20-03-2006,290538,Jharkhand,19,13,15,23,70,Fail
Gurpreet Khan,14-12-2005,141478,Chhattisgarh,4,7,12,1,24,Pass
Peter Reddy,20-03-2005,347137,Telangana,2,14,3,16,35,Pass
Yash Fernandes,08-08-2005,450701,Maharashtra,17,16,2,21,56,Pass
John Pillai,10-10-2005,803452,Telangana,13,24,24,5,66,Pass
Harjeet Singh,04-02-2005,987298,Karnataka,12,12,19,5,48,Pass
Aditya Fernandes,02-04-2005,220103,Uttar Pradesh,2,0,14,23,39,Pass
Harjeet Mehta,25-07-2005,162127,Maharashtra,15,8,19,7,49,Pass
Yash D'Souza,03-04-2006,159576,Haryana,18,4,4,2,28,Pass
Mathew Khan,22-03-2005,912061,Bihar,15,8,10,21,54,Pass
Yash Reddy,20-11-2005,279885,Jharkhand,17,21,1,0,39,Pass
Ishaan D'Souza,03-05-2005,263310,Uttarakhand,5,19,16,6,46,Pass
Krishna Khan,10-03-2006,345340,Haryana,10,21,4,4,39,Pass
Aarav Singh,28-04-2006,501176,Haryana,24,23,10,15,72,Pass
Rohan Khan,01-10-2005,535839,Rajasthan,18,0,0,9,27,Pass
Krishna Khan,22-11-2005,429876,Haryana,17,23,16,1,57,Pass
Raj D'Souza,28-04-2006,218877,Madhya Pradesh,14,14,1,24,53,Pass
Raj Pillai,12-04-2005,509553,Bihar,5,15,4,12,36,Pass
Vivaan Khan,06-06-2005,956607,Odisha,6,0,13,3,22,Pass
David Chopra,26-04-2006,842200,Rajasthan,7,6,15,23,51,Pass
Kunal Verma,01-05-2006,854960,Maharashtra,20,22,2,13,57,Pass
John Pillai,15-08-2005,463010,Tamil Nadu,5,13,0,3,21,Pass
Vivaan Fernandes,27-12-2005,702717,Uttarakhand,20,6,16,0,42,Pass
Rohan Verma,24-03-2006,527620,Jammu & Kashmir + Ladakh,16,15,10,19,60,Pass
Balbir Singh,18-04-2006,220195,Punjab,1,22,7,22,52,Pass
Aarav Verma,30-10-2005,865746,Punjab,0,13,14,0,27,Pass
Krishna Singh,22-01-2005,735326,Andhra Pradesh,15,7,5,22,49,Pass
Aryan Singh,22-04-2005,602376,Rajasthan,15,13,11,21,60,Pass
Balbir Mehta,30-11-2005,347502,Bihar,22,24,24,16,86,Pass
Aryan Reddy,09-10-2005,586424,Gujarat,23,20,7,16,66,Fail
Raj Reddy,03-11-2005,340158,Tamil Nadu,24,12,7,0,43,Pass
Krishna Reddy,04-03-2006,973227,Tamil Nadu,8,15,13,1,37,Pass
Raj Chopra,18-01-2006,557226,Uttar Pradesh,1,10,12,24,47,Pass
Kunal D'Souza,20-06-2005,124048,Bihar,19,19,20,2,60,Pass
Raj Khan,05-05-2005,590581,Haryana,14,13,22,24,73,Pass
Rohan Singh,23-12-2005,614871,Haryana,15,7,11,10,43,Pass
Kunal Pillai,24-02-2006,891804,Madhya Pradesh,20,0,12,9,41,Pass
Aryan Mehta,27-02-2006,611356,West Bengal,3,18,24,20,65,Pass
Mathew Reddy,06-12-2004,936440,Andhra Pradesh,22,20,9,11,62,Pass
Aarav Verma,02-12-2005,850349,Andhra Pradesh,10,0,21,3,34,Pass
Krishna Reddy,23-01-2005,627076,Uttarakhand,14,6,3,19,42,Pass
Ishaan Reddy,09-04-2005,986138,Madhya Pradesh,4,21,3,23,51,Pass
Rohan Chopra,22-02-2006,551298,Telangana,12,9,2,24,47,Pass
Gurpreet D'Souza,27-11-2004,889286,Jharkhand,2,10,24,5,41,Pass
Raj Sharma,27-11-2005,494044,Maharashtra,16,2,2,15,35,Pass
Krishna Chopra,16-04-2005,824228,Delhi,16,16,19,21,72,Pass
Raj D'Souza,15-01-2006,905755,Madhya Pradesh,21,3,17,1,42,Pass
Paul Khan,07-03-2006,213658,Haryana,0,13,16,12,41,Pass
Yash Sharma,27-11-2004,686339,Rajasthan,15,3,6,10,34,Pass
Krishna Sharma,26-03-2005,165462,Maharashtra,14,22,4,6,46,Pass
Ishaan Reddy,15-03-2006,455754,Jharkhand,19,4,9,13,45,Pass
Vivaan Khan,27-12-2005,357403,Andhra Pradesh,6,6,21,6,39,Pass
Kunal Mehta,18-02-2005,195294,Andhra Pradesh,1,8,5,9,23,Pass
Vivaan Khan,19-12-2004,687749,Telangana,19,0,8,6,33,Pass
Raj Chopra,16-03-2005,852603,Gujarat,18,4,16,16,54,Fail
Yash Singh,09-02-2006,808463,Manipur,4,16,11,10,41,Pass
Rohan Sharma,02-02-2005,864321,Haryana,11,10,10,11,42,Pass
Rohan Verma,25-07-2005,711487,Andhra Pradesh,21,1,12,9,43,Pass
Aditya Chopra,14-01-2005,904239,Tamil Nadu,11,17,7,12,47,Pass
Aarav Reddy,18-12-2005,739039,Uttarakhand,20,4,9,2,35,Pass
Rohan Pillai,20-04-2006,290702,Madhya Pradesh,14,24,3,19,60,Pass
Sukhwinder Pillai,12-08-2005,677138,Bihar,22,4,9,7,42,Pass
Ishaan D'Souza,04-01-2006,423855,Punjab,5,15,17,10,47,Pass
Ishaan Pillai,15-09-2005,217163,Rajasthan,5,19,18,14,56,Pass
Aditya Fernandes,22-03-2006,138313,Bihar,5,17,10,12,44,Pass
Manpreet Singh,17-03-2005,354107,Uttar Pradesh,1,3,9,9,22,Pass
Yash Pillai,06-10-2005,830391,Rajasthan,3,17,9,23,52,Pass
Ishaan Fernandes,25-12-2005,351405,Andhra Pradesh,9,12,4,20,45,Pass
Sukhwinder Singh,03-07-2005,229761,Rajasthan,4,24,22,1,51,Pass
Sukhwinder Verma,04-07-2005,244713,Andhra Pradesh,5,14,11,23,53,Pass
Vivaan Singh,10-01-2005,654131,Tamil Nadu,13,9,0,22,44,Pass
Balbir D'Souza,22-04-2005,984705,Rajasthan,20,7,6,0,33,Pass
Aryan Fernandes,02-11-2005,684668,Tamil Nadu,2,20,17,18,57,Pass
Rohan Pillai,04-11-2005,742154,Jharkhand,20,1,7,15,43,Pass
Vivaan Mehta,24-04-2006,349638,Jammu & Kashmir + Ladakh,10,1,10,7,28,Pass
Vivaan Mehta,10-08-2005,246038,Jharkhand,23,2,15,4,44,Pass
Kunal Mehta,29-06-2005,615387,Uttar Pradesh,18,19,17,12,66,Pass
Krishna Khan,22-04-2005,343082,Maharashtra,24,11,2,10,47,Pass
Raj Khan,28-11-2005,792490,Jharkhand,21,3,11,13,48,Pass
Aryan Chopra,02-02-2006,217604,Uttar Pradesh,10,15,15,18,58,Pass
Yash Fernandes,12-11-2004,224962,Maharashtra,14,22,0,5,41,Pass
Gurpreet Sharma,10-02-2006,519355,Bihar,12,11,10,1,34,Pass
Peter Verma,22-01-2005,676866,Rajasthan,20,10,17,21,68,Pass
Aryan Mehta,29-03-2005,466042,Bihar,14,16,10,5,45,Pass
Gurpreet Chopra,01-11-2005,856758,Tamil Nadu,8,19,22,12,61,Pass
Peter Sharma,02-09-2005,990707,Rajasthan,5,6,6,20,37,Pass
Yash Singh,11-11-2005,504109,Punjab,4,18,11,0,33,Pass
Aarav Sharma,24-04-2006,923490,Bihar,20,21,20,24,85,Pass
Aarav Khan,28-03-2005,348425,Tamil Nadu,16,10,11,1,38,Pass
Rohan Fernandes,24-02-2005,564351,Uttar Pradesh,17,15,19,13,64,Pass
Gurpreet Sharma,15-04-2005,815176,Rajasthan,2,7,2,0,11,Pass
Kunal Verma,26-05-2005,528423,West Bengal,13,10,4,19,46,Pass
Rohan Fernandes,24-03-2006,207593,Rajasthan,16,8,8,7,39,Pass
Aditya Verma,16-11-2004,535930,Bihar,2,0,16,6,24,Pass
Yash Reddy,16-03-2005,954324,Bihar,13,7,14,22,56,Pass
Aryan Chopra,01-02-2006,314594,Odisha,22,8,20,13,63,Pass
Gurpreet Sharma,23-05-2005,835152,Uttarakhand,14,24,3,3,44,Pass
Aryan Sharma,01-03-2006,260994,West Bengal,12,23,9,2,46,Pass
Ishaan Reddy,27-12-2005,258039,Himachal Pradesh,17,9,5,1,32,Pass
Vivaan D'Souza,15-11-2005,626680,Uttar Pradesh,21,15,11,21,68,Pass
Sukhwinder Sharma,21-12-2005,179504,Bihar,3,13,9,15,40,Pass
Aryan D'Souza,18-05-2005,466889,Maharashtra,4,4,22,17,47,Pass
Mathew Singh,27-05-2005,579788,Uttar Pradesh,2,0,24,11,37,Pass
Harjeet Mehta,05-04-2005,199986,Maharashtra,6,16,6,21,49,Pass
Raj Reddy,30-01-2006,422554,Punjab,7,23,24,9,63,Pass
Farhan Reddy,14-11-2005,991784,Rajasthan,15,20,1,18,54,Pass
Ishaan Fernandes,05-12-2004,902193,Gujarat,8,24,1,11,44,Fail
Aarav Pillai,13-03-2006,474686,Uttarakhand,19,9,5,6,39,Pass
Harjeet Singh,14-05-2005,505869,Rajasthan,11,20,11,9,51,Pass
Ishaan Fernandes,31-03-2006,319101,West Bengal,14,15,7,14,50,Pass
Kunal Verma,04-04-2006,822809,Uttar Pradesh,21,16,4,5,46,Pass
Manpreet Verma,01-11-2005,311068,Uttar Pradesh,16,21,20,7,64,Pass
Krishna Khan,12-11-2005,680715,Odisha,8,1,18,0,27,Pass
Rohan Verma,13-12-2004,158200,Uttar Pradesh,18,6,3,20,47,Pass
Mathew Verma,22-01-2005,508957,Haryana,6,13,15,4,38,Pass
Sukhwinder Mehta,21-05-2005,273518,Telangana,19,24,10,3,56,Pass
Rohan Sharma,09-11-2005,294189,Chhattisgarh,22,3,1,17,43,Pass
Kunal Khan,06-10-2005,334474,Rajasthan,21,6,0,7,34,Pass
Gurpreet Khan,24-07-2005,307895,Kerala,0,18,23,23,64,Pass
Yash Verma,13-08-2005,466933,Maharashtra,21,6,2,18,47,Pass
Raj D'Souza,10-02-2006,877609,West Bengal,13,10,3,23,49,Pass
Krishna Reddy,19-06-2005,516272,Andhra Pradesh,19,0,17,7,43,Pass
Raj Verma,29-04-2005,356661,Uttar Pradesh,8,14,14,0,36,Pass
Aarav Reddy,20-04-2006,752598,Uttarakhand,1,20,24,4,49,Pass
Kunal Sharma,22-02-2006,424788,Maharashtra,17,0,1,17,35,Pass
Aarav Chopra,15-09-2005,128071,Rajasthan,17,13,11,16,57,Pass
Yash Chopra,03-01-2005,589806,Chhattisgarh,12,6,19,0,37,Pass
Yash D'Souza,18-11-2004,863579,Odisha,22,3,22,22,69,Pass
Manpreet Khan,13-12-2005,614832,Madhya Pradesh,18,0,3,23,44,Pass
Yash Khan,21-02-2005,249553,Andhra Pradesh,20,9,5,17,51,Pass
Raj Verma,16-12-2005,905164,Madhya Pradesh,20,0,10,8,38,Pass
Harjeet Pillai,14-07-2005,850631,Arunachal Pradesh,9,2,21,20,52,Pass
Krishna Sharma,13-06-2005,213907,Telangana,6,8,9,22,45,Pass
Balbir Sharma,17-05-2005,527391,Uttar Pradesh,14,11,7,1,33,Pass
Ishaan D'Souza,08-11-2005,174199,Madhya Pradesh,12,13,2,12,39,Pass
Ishaan Fernandes,20-03-2006,962920,Tamil Nadu,24,13,4,17,58,Pass
Aarav Khan,05-01-2006,330993,Haryana,14,1,11,20,46,Pass
Vivaan Mehta,31-03-2006,961234,Uttar Pradesh,10,19,10,7,46,Pass
Krishna Reddy,03-03-2006,124204,Haryana,6,19,8,24,57,Pass
Ishaan Chopra,13-10-2005,883457,Uttar Pradesh,8,20,16,3,47,Pass
Rohan Singh,14-12-2005,452649,Gujarat,24,13,12,20,69,Fail
Aarav Fernandes,31-01-2006,824348,Rajasthan,14,4,13,2,33,Pass
Gurpreet D'Souza,23-10-2005,984481,Uttar Pradesh,15,18,6,24,63,Pass
Rohan Verma,08-05-2005,537217,Uttar Pradesh,7,11,0,5,23,Pass
Aryan Chopra,26-12-2005,886463,Telangana,4,13,9,10,36,Pass
Rohan Khan,04-11-2005,950834,West Bengal,11,9,14,7,41,Pass
Aryan Mehta,01-05-2006,133416,Uttar Pradesh,4,9,14,8,35,Pass
Kunal Fernandes,14-04-2006,321168,Madhya Pradesh,10,6,1,16,33,Pass
Kunal Sharma,22-02-2005,301010,Uttar Pradesh,19,0,6,18,43,Pass
Aryan Mehta,10-08-2005,444275,Rajasthan,15,2,18,0,35,Pass
Aryan Mehta,29-03-2005,484158,Haryana,4,0,18,8,30,Pass
Rohan Verma,09-04-2005,837069,Gujarat,15,8,8,7,38,Fail
Krishna Verma,04-11-2005,296465,Uttarakhand,21,21,3,1,46,Pass
Ishaan Reddy,13-06-2005,147091,Maharashtra,21,13,3,3,40,Pass
Balbir Khan,17-12-2005,204130,Jammu & Kashmir + Ladakh,4,9,0,20,33,Pass
Peter Khan,31-07-2005,413716,West Bengal,12,22,1,18,53,Pass
Aarav Pillai,02-05-2006,701348,Rajasthan,14,3,8,19,44,Pass
John Khan,06-02-2006,933999,Tamil Nadu,0,2,3,0,5,Pass
David Reddy,12-01-2006,586787,Uttar Pradesh,10,0,10,1,21,Pass
Krishna Singh,20-01-2006,107858,Tamil Nadu,19,15,13,8,55,Pass
Aditya Khan,30-04-2005,402046,Rajasthan,2,12,5,1,20,Pass
Kunal Reddy,15-06-2005,878356,Rajasthan,24,1,23,7,55,Pass
Manpreet Mehta,01-12-2005,653260,Maharashtra,7,13,8,8,36,Pass
Manpreet Fernandes,25-08-2005,241195,Assam,2,19,5,0,26,Pass
Rohan Fernandes,22-11-2005,899845,Karnataka,7,9,6,16,38,Pass
Raj D'Souza,09-05-2005,952961,Uttarakhand,14,18,2,10,44,Pass
Peter Pillai,06-01-2005,113923,Maharashtra,13,11,1,22,47,Pass
Aryan Mehta,19-09-2005,363214,Uttar Pradesh,23,21,7,5,56,Pass
Aditya Pillai,06-03-2005,241615,Rajasthan,0,21,7,5,33,Pass
Rohan Reddy,07-06-2005,208014,Andhra Pradesh,6,0,24,9,39,Pass
Kunal Reddy,22-03-2006,788640,Karnataka,0,10,20,4,34,Pass
Aditya Sharma,27-07-2005,526339,Chhattisgarh,19,9,8,19,55,Pass
Aarav Reddy,18-12-2005,195396,Haryana,16,19,7,22,64,Pass
Vivaan Mehta,26-07-2005,475248,Tamil Nadu,22,23,5,3,53,Pass
Mathew Pillai,05-04-2005,247064,Andhra Pradesh,9,20,10,3,42,Pass
Aditya Chopra,24-11-2005,913518,Uttar Pradesh,15,7,6,16,44,Pass
Paul Khan,28-04-2006,586848,Rajasthan,15,6,14,8,43,Pass
John Pillai,23-06-2005,845876,Madhya Pradesh,8,8,6,0,22,Pass
Kunal Singh,17-03-2006,174297,Assam,3,24,20,0,47,Pass
Vivaan Reddy,18-03-2006,660303,Jammu & Kashmir + Ladakh,3,3,5,14,25,Pass
Kunal Fernandes,10-08-2005,717566,Odisha,17,4,3,24,48,Pass
Sukhwinder Sharma,05-04-2005,909533,Karnataka,7,21,9,18,55,Pass
Ishaan Singh,06-01-2005,350937,Uttar Pradesh,19,17,10,23,69,Pass
Kunal Chopra,19-01-2005,288998,Bihar,19,20,18,6,63,Pass
Ayaan Pillai,21-12-2004,392292,Punjab,17,7,24,21,69,Pass
David Pillai,02-04-2005,332315,Kerala,23,4,1,15,43,Pass
Manpreet Chopra,04-05-2005,450553,Bihar,7,22,5,4,38,Pass
Vivaan Sharma,07-07-2005,257745,Odisha,24,22,18,9,73,Pass
Mathew Mehta,17-06-2005,453530,Rajasthan,5,5,13,2,25,Pass
Aryan Sharma,08-03-2006,790379,Bihar,18,16,20,19,73,Pass
Ishaan Mehta,25-01-2006,845002,Uttar Pradesh,4,0,10,6,20,Pass
Rohan Verma,16-03-2006,984870,West Bengal,10,15,9,8,42,Pass
Raj Sharma,05-02-2006,642435,Rajasthan,9,15,13,9,46,Pass
David Reddy,23-10-2005,528646,Haryana,19,10,15,9,53,Pass
Balbir Chopra,12-10-2005,979679,Andhra Pradesh,13,12,13,9,47,Pass
Ishaan Reddy,01-06-2005,951595,Punjab,9,10,6,20,45,Pass
Kunal Sharma,31-01-2005,240356,Karnataka,18,22,19,2,61,Pass
Krishna Singh,29-03-2005,718195,Bihar,2,20,22,13,57,Pass
Harjeet D'Souza,09-03-2005,456463,Kerala,13,24,10,11,58,Pass
Kunal Reddy,19-12-2004,476098,Rajasthan,10,19,7,4,40,Pass
Aarav Reddy,09-11-2004,637506,Punjab,10,5,3,19,37,Pass
Krishna D'Souza,27-02-2005,981551,Maharashtra,22,16,2,9,49,Pass
Aditya Sharma,12-02-2006,436452,Himachal Pradesh,12,24,2,17,55,Pass
Aryan Fernandes,23-02-2006,649505,West Bengal,23,3,2,2,30,Pass
Kunal Fernandes,03-11-2005,902891,Uttar Pradesh,5,23,22,21,71,Pass
Harjeet Fernandes,08-01-2005,452274,Uttarakhand,13,21,3,11,48,Pass
Aryan Khan,15-04-2006,851039,Tamil Nadu,20,20,20,3,63,Pass
Gurpreet Reddy,13-08-2005,646650,Delhi,12,14,21,19,66,Pass
Krishna Singh,02-06-2005,847367,Uttar Pradesh,18,22,7,11,58,Pass
Sukhwinder Sharma,26-11-2004,844981,Haryana,2,13,8,2,25,Pass
Yash Singh,06-11-2005,976472,Karnataka,2,12,16,18,48,Pass
Aditya Singh,10-04-2006,880659,Andhra Pradesh,24,4,1,21,50,Pass
Aditya D'Souza,23-09-2005,774517,Bihar,15,18,13,18,64,Pass
Aryan Chopra,27-01-2006,438428,Punjab,6,19,13,21,59,Pass
Farhan Reddy,27-12-2004,973977,Kerala,16,0,21,7,44,Pass
Rohan Singh,28-11-2004,684303,Punjab,4,21,19,12,56,Pass
Vivaan Sharma,01-05-2006,319913,Rajasthan,10,21,11,18,60,Pass
Kunal Reddy,15-07-2005,922914,Haryana,14,15,15,1,45,Pass
Raj Mehta,04-08-2005,707218,Jammu & Kashmir + Ladakh,13,23,12,13,61,Pass
Krishna Reddy,22-03-2005,957095,West Bengal,3,21,12,6,42,Pass
Rohan Pillai,21-04-2006,455660,Rajasthan,2,16,24,24,66,Pass
Kunal Khan,29-03-2005,472163,Uttar Pradesh,5,21,11,10,47,Pass
Balbir Fernandes,21-08-2005,939012,Himachal Pradesh,0,18,23,7,48,Pass
Krishna Reddy,17-12-2004,774812,Bihar,3,3,13,7,26,Pass
Aditya Sharma,11-02-2005,503233,Rajasthan,20,21,10,17,68,Pass
Aditya Reddy,26-08-2005,921084,Madhya Pradesh,5,11,3,21,40,Pass
Sukhwinder D'Souza,17-04-2006,832483,Uttar Pradesh,1,14,10,13,38,Pass
Aarav Sharma,30-05-2005,779581,Haryana,11,17,23,12,63,Pass
Aryan Chopra,20-04-2005,142411,Bihar,19,9,19,17,64,Pass
Paul Verma,23-11-2004,821030,Karnataka,24,17,16,10,67,Pass
Sukhwinder Verma,22-03-2005,723300,Karnataka,17,10,4,18,49,Pass
Yash Verma,09-08-2005,785550,Rajasthan,24,24,19,14,81,Pass
Kunal Fernandes,05-10-2005,555280,Madhya Pradesh,1,2,18,14,35,Pass
Farhan Khan,31-03-2006,711309,Jharkhand,20,15,13,10,58,Pass
Aryan Fernandes,18-06-2005,702609,Jharkhand,7,10,21,12,50,Pass
Aditya Verma,19-03-2006,508332,Meghalaya,10,18,6,9,43,Pass
Ishaan Singh,20-05-2005,539362,Telangana,2,6,21,24,53,Pass
Aryan Singh,29-05-2005,667949,Haryana,16,19,16,11,62,Pass
Manpreet Verma,23-03-2006,831656,Maharashtra,5,19,21,2,47,Pass
Gurpreet Mehta,02-05-2006,699711,Maharashtra,6,10,11,20,47,Pass
Aditya Chopra,01-08-2005,199983,Odisha,8,2,23,1,34,Pass
Aditya Fernandes,23-04-2005,327958,Maharashtra,0,20,10,10,40,Pass
Aryan Singh,13-12-2005,278502,Meghalaya,11,5,4,8,28,Pass
Rohan Pillai,03-03-2006,835147,Tamil Nadu,2,7,8,14,31,Pass
Balbir Verma,12-12-2005,133796,Uttar Pradesh,10,13,3,24,50,Pass
Raj Reddy,02-02-2006,926700,West Bengal,14,1,11,19,45,Pass
John Mehta,17-04-2005,701223,Chhattisgarh,16,18,9,5,48,Pass
Balbir Mehta,07-09-2005,246284,Uttar Pradesh,8,12,5,1,26,Pass
Ayaan Reddy,09-08-2005,768344,Bihar,1,1,24,15,41,Pass
Aryan Mehta,14-12-2005,665674,Bihar,4,13,10,12,39,Pass
Manpreet Fernandes,11-08-2005,712242,Madhya Pradesh,5,6,24,2,37,Pass
Rohan Khan,20-12-2005,538077,Haryana,19,12,16,12,59,Pass
Krishna Fernandes,20-01-2005,249485,Jammu & Kashmir + Ladakh,4,23,4,9,40,Pass
Rohan Verma,01-05-2006,246424,Bihar,24,18,20,16,78,Pass
Sukhwinder Reddy,19-05-2005,620421,Uttar Pradesh,12,3,22,23,60,Pass
Sukhwinder Khan,16-03-2006,559423,Bihar,0,18,6,17,41,Pass
Ishaan Reddy,19-08-2005,743401,Odisha,10,13,8,15,46,Pass
Raj Verma,16-12-2005,742820,Delhi,11,7,20,7,45,Pass
Rohan Reddy,30-07-2005,601036,Uttarakhand,4,18,5,9,36,Pass
Aarav Pillai,30-01-2006,179853,Bihar,22,14,21,0,57,Pass
Aarav Sharma,12-02-2005,922727,Uttar Pradesh,8,0,14,17,39,Pass
Raj Khan,14-02-2005,739309,Uttar Pradesh,21,3,17,14,55,Pass
Yash Verma,18-01-2006,115506,Telangana,20,0,20,22,62,Pass
Vivaan Pillai,11-09-2005,948189,Uttar Pradesh,15,19,17,15,66,Pass
Paul Pillai,22-12-2005,769541,Rajasthan,7,0,23,20,50,Pass
Krishna Reddy,16-08-2005,566836,Andhra Pradesh,19,8,14,8,49,Pass
Vivaan Mehta,07-09-2005,910300,Bihar,9,24,18,1,52,Pass
Harjeet Chopra,04-01-2006,685912,West Bengal,3,6,24,24,57,Pass
Vivaan D'Souza,30-11-2005,197550,Madhya Pradesh,20,18,14,1,53,Pass
Yash Khan,05-07-2005,362842,Karnataka,22,12,5,1,40,Pass
Rohan Reddy,18-09-2005,110322,Tamil Nadu,2,16,17,10,45,Pass
Farhan Mehta,01-07-2005,994765,Uttar Pradesh,10,21,3,14,48,Pass
Rohan D'Souza,30-06-2005,747123,Maharashtra,12,16,16,5,49,Pass
Ayaan Chopra,29-09-2005,328453,Jammu & Kashmir + Ladakh,4,6,10,17,37,Pass
Raj Singh,15-06-2005,479907,Haryana,16,23,5,0,44,Pass
Yash Khan,20-05-2005,633898,Rajasthan,20,18,9,24,71,Pass
Aarav Khan,30-06-2005,891259,Maharashtra,11,12,0,7,30,Pass
Rehan Khan,20-07-2005,377762,Chhattisgarh,10,0,21,20,51,Pass
Aarav Mehta,21-02-2006,698025,Maharashtra,7,4,21,0,32,Pass
Aditya Singh,27-04-2005,898593,Uttarakhand,14,15,3,24,56,Pass
Yash Pillai,31-08-2005,364416,West Bengal,0,10,7,1,18,Pass
Ishaan Sharma,23-02-2005,877319,Andhra Pradesh,9,7,3,20,39,Pass
Harjeet Reddy,21-10-2005,535402,Haryana,4,8,23,21,56,Pass
Aryan Reddy,23-03-2005,456618,Maharashtra,12,21,0,7,40,Pass
David Chopra,23-09-2005,326783,Bihar,14,5,17,23,59,Pass
Mathew Verma,02-07-2005,475259,West Bengal,1,2,24,17,44,Pass
Vivaan Verma,08-07-2005,566681,Karnataka,14,8,24,16,62,Pass
Aditya Mehta,17-02-2005,174727,Telangana,9,9,11,19,48,Pass
Yash Chopra,24-12-2004,470360,Odisha,14,0,5,2,21,Pass
Rohan Pillai,16-05-2005,510422,Tamil Nadu,0,13,11,8,32,Pass
Harjeet Pillai,11-02-2006,923220,Bihar,3,17,1,10,31,Pass
Raj Reddy,30-09-2005,161445,Maharashtra,5,23,9,3,40,Pass
Rohan Chopra,14-03-2005,895661,Telangana,20,10,3,23,56,Pass
Mathew Pillai,28-02-2006,121127,Uttar Pradesh,9,16,8,18,51,Pass
Aryan Chopra,02-02-2005,968363,Rajasthan,0,23,0,4,27,Pass
Harjeet Mehta,24-01-2006,745463,Daman & Diu / D&N Haveli,3,3,5,7,18,Pass
Gurpreet Khan,08-09-2005,650351,Jharkhand,14,7,4,12,37,Pass
Rohan Mehta,12-02-2006,469036,Bihar,21,21,9,22,73,Pass
Sukhwinder Fernandes,03-02-2006,938998,Jharkhand,15,7,13,8,43,Pass
Krishna Reddy,02-05-2006,562137,Uttar Pradesh,13,17,11,22,63,Pass
Raj Reddy,09-09-2005,907061,Assam,7,23,16,0,46,Pass
Rohan Singh,15-08-2005,111025,Andhra Pradesh,7,23,9,9,48,Pass
Krishna Sharma,22-11-2005,772489,Uttar Pradesh,12,21,5,0,38,Pass
Raj Verma,05-12-2005,939307,Bihar,22,16,6,19,63,Pass
Yash Sharma,31-05-2005,286845,Uttar Pradesh,11,9,2,21,43,Pass
Aditya Reddy,26-11-2004,818177,Chhattisgarh,14,16,9,5,44,Pass
Kunal Khan,18-04-2005,872750,Haryana,8,1,7,18,34,Pass
Manpreet Pillai,02-01-2005,808305,Assam,0,3,20,6,29,Pass
Ishaan Pillai,19-10-2005,704950,Madhya Pradesh,2,15,20,5,42,Pass
Rohan Sharma,18-03-2005,532121,Punjab,4,0,5,12,21,Pass
Rohan Mehta,05-02-2005,694806,West Bengal,12,8,6,19,45,Pass
Aryan Mehta,02-03-2006,651811,Karnataka,2,11,0,3,16,Pass
Peter Pillai,08-03-2006,783355,Rajasthan,2,12,2,9,25,Pass
Balbir D'Souza,13-05-2005,783899,West Bengal,3,15,14,24,56,Pass
Aditya Sharma,12-02-2006,800630,Delhi,3,12,6,15,36,Pass
Aarav Chopra,27-11-2005,246348,Bihar,9,18,4,3,34,Pass
Aryan Singh,22-03-2005,750100,Bihar,0,2,24,22,48,Pass
Mathew Khan,18-07-2005,447622,Assam,2,0,11,4,17,Pass
Rohan Singh,08-06-2005,327355,Karnataka,20,7,13,21,61,Pass
Krishna Fernandes,05-09-2005,814431,Andhra Pradesh,23,6,7,5,41,Pass
Vivaan Chopra,07-10-2005,689043,Kerala,9,18,20,13,60,Pass
Yash Verma,31-05-2005,777042,Punjab,0,15,8,18,41,Pass
Harjeet D'Souza,11-09-2005,880278,Rajasthan,23,17,0,9,49,Pass
Yash Verma,02-06-2005,857977,Uttar Pradesh,18,0,6,3,27,Pass
Yash Pillai,02-02-2005,299459,West Bengal,0,0,4,9,13,Pass
Rohan Sharma,26-03-2005,310563,Nagaland,19,24,21,23,87,Pass
Imran Mehta,26-06-2005,187466,Haryana,0,5,0,19,24,Pass
Raj Khan,14-01-2006,867730,Madhya Pradesh,23,21,3,21,68,Pass
Yash Mehta,04-02-2006,929188,Bihar,24,22,4,12,62,Pass
Aditya Verma,28-12-2004,521954,Madhya Pradesh,19,6,10,20,55,Pass
Raj Reddy,19-12-2005,707446,Andhra Pradesh,11,17,16,3,47,Pass
Manpreet Verma,21-05-2005,817350,Odisha,5,13,13,8,39,Pass
Vivaan Khan,08-02-2005,198590,Andhra Pradesh,14,20,11,3,48,Pass
Harjeet Singh,25-10-2005,771010,Punjab,0,3,20,14,37,Pass
Kunal Sharma,07-03-2005,466478,Punjab,9,9,16,23,57,Pass
Gurpreet Verma,15-11-2004,447941,Bihar,22,7,19,15,63,Pass
Paul Fernandes,24-04-2006,260604,Himachal Pradesh,9,15,2,24,50,Pass
Ishaan Reddy,18-12-2004,585041,Assam,15,21,18,12,66,Pass
Kunal Khan,06-12-2005,348960,Gujarat,16,5,19,15,55,Fail
Aryan Khan,05-01-2005,982904,Himachal Pradesh,16,5,11,6,38,Pass
Kunal Singh,06-02-2005,628348,Uttarakhand,1,14,15,2,32,Pass
Aditya Fernandes,08-09-2005,903237,Tamil Nadu,6,23,24,5,58,Pass
John D'Souza,30-11-2004,935847,Daman & Diu / D&N Haveli,8,9,9,7,33,Pass
Yash Pillai,26-03-2006,720077,Assam,5,0,1,23,29,Pass
Yash Chopra,24-06-2005,908009,Rajasthan,23,7,23,23,76,Pass
Aditya Verma,13-03-2006,678719,Assam,22,3,15,18,58,Pass
Yash Chopra,17-04-2005,971730,Bihar,3,1,13,11,28,Pass
Raj Khan,31-03-2005,494702,Uttar Pradesh,13,5,22,20,60,Pass
Krishna Sharma,26-05-2005,970157,Bihar,9,14,16,5,44,Pass
Harjeet Pillai,07-11-2004,554222,Andhra Pradesh,7,24,17,13,61,Pass
Gurpreet Mehta,18-02-2005,632772,Uttar Pradesh,11,3,24,1,39,Pass
Ishaan Chopra,04-07-2005,863674,Chhattisgarh,21,10,9,3,43,Pass
Kunal Singh,22-02-2006,796157,Jammu & Kashmir + Ladakh,9,6,8,6,29,Pass
Aarav Verma,27-08-2005,100180,Tamil Nadu,23,0,4,1,28,Pass
Rohan Sharma,07-02-2006,831426,Kerala,13,3,5,4,25,Pass
Kunal Chopra,08-08-2005,429365,Maharashtra,5,18,20,1,44,Pass
Aditya Fernandes,03-06-2005,123603,Madhya Pradesh,0,5,22,8,35,Pass
Aarav Singh,22-04-2006,566091,Karnataka,23,22,19,17,81,Fail
Kunal Pillai,02-02-2006,197287,Uttarakhand,2,21,13,8,44,Pass
Rohan Fernandes,01-03-2005,822377,Andhra Pradesh,9,9,8,7,33,Pass
Rohan Mehta,03-12-2004,908003,Rajasthan,14,19,8,17,58,Pass
David Pillai,27-04-2006,399569,Madhya Pradesh,18,21,3,3,45,Pass
Krishna D'Souza,06-06-2005,432769,Uttar Pradesh,10,15,7,15,47,Pass
Aryan Fernandes,14-02-2006,354712,Bihar,14,17,4,4,39,Pass
Kunal Fernandes,25-08-2005,437419,Uttar Pradesh,14,6,10,22,52,Pass
Krishna Chopra,13-04-2006,463595,Maharashtra,7,17,3,7,34,Pass
Ishaan Pillai,19-04-2006,901638,Delhi,17,18,11,9,55,Pass
Mathew Fernandes,24-04-2006,827079,Bihar,0,14,15,20,49,Pass
Farhan Reddy,30-03-2005,272854,Himachal Pradesh,0,16,22,5,43,Pass
Raj D'Souza,20-03-2006,158657,Andhra Pradesh,15,8,4,18,45,Pass
Gurpreet D'Souza,30-01-2006,849434,Jharkhand,10,5,0,4,19,Pass
Manpreet Singh,12-12-2004,431444,Tripura,23,12,22,0,57,Pass
Manpreet Sharma,11-04-2006,998115,Punjab,6,4,1,19,30,Pass
Vivaan Fernandes,27-03-2006,502345,Jammu & Kashmir + Ladakh,7,8,15,21,51,Pass
Ishaan Chopra,17-03-2006,301096,Bihar,0,19,22,4,45,Pass
Rohan Mehta,20-04-2005,407080,Uttar Pradesh,3,4,19,17,43,Pass
Raj Singh,11-12-2004,843884,Uttar Pradesh,23,3,16,17,59,Pass
Kunal Sharma,14-03-2006,440768,Kerala,16,15,10,6,47,Pass
Yash Sharma,25-04-2006,581620,Punjab,19,12,2,13,46,Pass
Aarav Verma,19-09-2005,516250,Uttar Pradesh,14,9,10,12,45,Pass
David Sharma,21-11-2005,152052,Himachal Pradesh,24,6,5,13,48,Pass
Aarav D'Souza,21-12-2005,630140,Punjab,11,5,13,12,41,Pass
Krishna D'Souza,31-07-2005,735157,Telangana,2,8,11,18,39,Pass
Aditya Sharma,16-04-2005,940600,Uttar Pradesh,4,21,13,24,62,Pass
Aryan Pillai,17-01-2005,960025,Uttar Pradesh,17,19,17,1,54,Pass
Ishaan Singh,12-05-2005,858469,Assam,0,3,20,17,40,Pass
Imran Chopra,25-02-2005,471840,Meghalaya,8,4,21,8,41,Pass
Aarav Pillai,11-06-2005,161237,Assam,19,24,0,18,61,Pass
Kunal D'Souza,29-05-2005,337781,Gujarat,7,19,2,22,50,Fail
Rehan Khan,01-12-2004,447460,Maharashtra,6,21,8,10,45,Pass
Aditya Verma,06-12-2004,687898,Tamil Nadu,3,8,23,24,58,Pass
Vivaan D'Souza,09-11-2004,185411,Uttar Pradesh,2,19,15,23,59,Pass
Aarav Fernandes,11-01-2006,302990,Bihar,4,13,13,1,31,Pass
Harjeet Pillai,19-01-2005,172833,Andhra Pradesh,0,22,4,24,50,Pass
Gurpreet Sharma,28-11-2004,709901,Gujarat,4,8,14,14,40,Fail
Krishna Sharma,08-01-2005,271451,Tamil Nadu,17,8,5,4,34,Pass
Aarav Verma,06-10-2005,496897,Punjab,15,11,3,22,51,Pass
Harjeet Khan,03-08-2005,760182,Himachal Pradesh,11,10,19,17,57,Pass
Aryan Pillai,20-05-2005,365288,Haryana,17,0,9,22,48,Pass
Aditya Singh,14-07-2005,920916,Bihar,17,2,13,7,39,Pass
Aditya Sharma,11-11-2005,668418,Telangana,12,5,0,11,28,Pass
Raj Singh,25-03-2005,562178,West Bengal,3,14,8,24,49,Pass
Yash Sharma,02-01-2006,100033,Bihar,20,21,18,3,62,Pass
Raj Fernandes,24-07-2005,680732,Rajasthan,8,11,24,4,47,Pass
Peter Chopra,05-09-2005,577661,Rajasthan,22,16,23,20,81,Pass
Manpreet Singh,10-01-2006,499792,Himachal Pradesh,1,1,13,22,37,Pass
David Fernandes,07-03-2006,448419,Jammu & Kashmir + Ladakh,20,8,6,18,52,Pass
Raj Pillai,21-11-2005,263154,Rajasthan,16,14,21,17,68,Pass
Aarav Verma,21-12-2005,308808,Telangana,13,23,0,10,46,Pass
Mathew Chopra,24-04-2005,725128,Karnataka,17,5,23,24,69,Fail
Rohan Singh,04-04-2005,537034,Haryana,22,14,4,20,60,Pass
Vivaan Fernandes,11-03-2005,116594,Maharashtra,2,15,10,14,41,Pass
Zaid Singh,16-05-2005,378850,Uttar Pradesh,9,24,10,0,43,Pass
Vivaan D'Souza,25-11-2004,578878,Karnataka,20,18,24,24,86,Fail
Yash Pillai,12-02-2005,456155,Odisha,15,15,23,9,62,Pass
Balbir Singh,26-06-2005,227544,Bihar,14,0,5,22,41,Pass
Aditya Singh,23-03-2005,833675,Andhra Pradesh,21,5,0,16,42,Pass
Kunal Verma,18-10-2005,311716,Goa,5,18,3,7,33,Fail
Peter Fernandes,29-04-2005,504525,Chhattisgarh,6,6,3,15,30,Pass
Aditya Khan,15-04-2005,162761,West Bengal,18,0,1,17,36,Pass
Aryan Sharma,03-10-2005,490641,Jharkhand,16,18,7,22,63,Pass
Vivaan Verma,26-10-2005,458288,Haryana,23,12,12,15,62,Pass
Aditya D'Souza,26-09-2005,103424,Rajasthan,1,12,24,5,42,Pass
Yash D'Souza,05-02-2006,980730,Assam,13,2,24,4,43,Pass
Aryan D'Souza,21-07-2005,718315,Madhya Pradesh,24,24,3,16,67,Pass
Aarav Pillai,28-12-2004,815505,West Bengal,3,2,2,13,20,Pass
Krishna Chopra,08-06-2005,188936,Karnataka,9,19,14,23,65,Pass
Ishaan Chopra,18-12-2005,585423,Rajasthan,9,8,18,21,56,Pass
Vivaan Verma,02-05-2005,164513,Maharashtra,9,5,24,6,44,Pass
Krishna Fernandes,30-06-2005,286997,Bihar,5,18,2,23,48,Pass
Sukhwinder Chopra,13-08-2005,298079,Bihar,15,9,21,9,54,Pass
Ayaan Fernandes,25-11-2004,369661,Uttar Pradesh,19,17,1,22,59,Pass
Aarav Verma,30-05-2005,849186,Rajasthan,10,11,5,2,28,Pass
Raj Chopra,04-04-2006,532703,Bihar,21,7,17,6,51,Pass
Aryan Chopra,25-12-2004,866859,Gujarat,22,12,15,1,50,Fail
Manpreet Singh,22-10-2005,636221,Rajasthan,23,11,23,11,68,Pass
Vivaan Pillai,13-03-2005,896680,West Bengal,2,6,11,16,35,Pass
Aarav Reddy,17-02-2005,585037,Rajasthan,24,16,6,2,48,Pass
Yash Reddy,07-12-2005,388857,Madhya Pradesh,6,20,6,1,33,Pass
Aditya Singh,01-06-2005,813247,Bihar,15,8,23,22,68,Pass
Paul Reddy,18-07-2005,389874,Uttar Pradesh,22,6,9,6,43,Pass
Zaid Fernandes,27-02-2005,232455,Uttar Pradesh,23,0,7,8,38,Pass
Raj Singh,13-03-2006,290867,Uttar Pradesh,19,15,8,22,64,Pass
Raj Mehta,09-03-2005,727690,Tamil Nadu,23,13,21,18,75,Pass
Imran Fernandes,19-01-2006,659819,Maharashtra,11,13,18,0,42,Pass
David Singh,16-01-2005,786158,Jammu & Kashmir + Ladakh,8,7,6,6,27,Pass
Kunal Pillai,29-05-2005,877957,Telangana,21,3,24,4,52,Pass
Raj Mehta,10-02-2005,774631,Telangana,4,10,20,4,38,Pass
Aryan Sharma,29-11-2005,785665,Andhra Pradesh,15,17,4,9,45,Pass
Ishaan Sharma,16-02-2006,202785,Bihar,6,11,14,17,48,Pass
David D'Souza,04-02-2006,634046,Odisha,4,8,11,12,35,Pass
Rohan Fernandes,16-09-2005,620588,Maharashtra,16,3,3,3,25,Pass
Ishaan D'Souza,12-12-2005,238592,West Bengal,7,0,5,0,12,Pass
Kunal Verma,04-04-2005,881659,Rajasthan,10,21,11,7,49,Pass
Krishna Sharma,06-02-2006,145221,Rajasthan,17,18,4,1,40,Pass
Yash Khan,27-07-2005,200580,Gujarat,0,15,9,18,42,Fail
Kunal Pillai,21-02-2006,745562,Haryana,19,15,11,4,49,Pass
Yash Pillai,17-01-2005,894046,Himachal Pradesh,10,3,1,21,35,Pass
Rohan Pillai,03-05-2005,290249,Delhi,16,14,23,7,60,Pass
Aarav Pillai,18-06-2005,338242,Madhya Pradesh,11,5,14,10,40,Pass
Aarav Singh,24-02-2005,445862,Maharashtra,6,2,5,13,26,Pass
Aryan Fernandes,29-04-2006,281316,Uttar Pradesh,14,3,4,13,34,Pass
Gurpreet Pillai,22-08-2005,774561,Gujarat,5,19,7,13,44,Fail
Kunal Verma,13-11-2004,181938,Chhattisgarh,21,9,18,3,51,Pass
Vivaan Verma,27-11-2004,883302,Jharkhand,1,3,23,16,43,Pass
Aditya Reddy,15-11-2005,136939,Uttar Pradesh,23,14,20,14,71,Pass
Aditya Sharma,17-06-2005,192290,Rajasthan,24,24,11,13,72,Pass
Aryan Chopra,05-05-2006,451610,Rajasthan,8,10,0,24,42,Pass
Yash D'Souza,03-05-2005,187574,Rajasthan,7,20,3,24,54,Pass
Krishna Fernandes,03-12-2004,310072,Tamil Nadu,12,10,22,15,59,Pass
Krishna Chopra,02-11-2005,842515,Haryana,0,8,2,8,18,Pass
Krishna Fernandes,24-02-2005,686083,Gujarat,2,19,0,10,31,Fail
Ishaan Reddy,29-11-2004,666512,Andhra Pradesh,4,10,12,21,47,Pass
Aryan Khan,13-12-2004,813255,Karnataka,18,0,2,20,40,Pass
Aryan Mehta,01-07-2005,373172,Bihar,18,13,24,14,69,Pass
Gurpreet Mehta,09-05-2005,599663,Karnataka,11,9,7,0,27,Pass
Raj Singh,02-01-2006,201752,Rajasthan,19,1,17,10,47,Pass
Raj Reddy,05-07-2005,991852,Uttar Pradesh,0,10,1,18,29,Pass
Manpreet Chopra,29-11-2004,445901,Uttar Pradesh,7,17,5,10,39,Pass
Aarav Verma,18-03-2006,606775,Uttar Pradesh,2,14,3,13,32,Pass
Kunal Singh,22-02-2006,389641,Haryana,23,11,20,19,73,Pass
John Mehta,23-04-2006,848235,Maharashtra,5,5,24,7,41,Pass
Harjeet Fernandes,16-10-2005,757981,Uttar Pradesh,14,6,18,16,54,Pass
Sukhwinder Chopra,04-06-2005,679472,Haryana,3,8,3,18,32,Pass
Farhan Reddy,16-04-2005,295388,Bihar,0,24,6,16,46,Pass
Rohan Reddy,20-04-2006,697624,Tamil Nadu,20,16,14,20,70,Pass
Aryan D'Souza,03-06-2005,315805,Uttar Pradesh,20,2,11,10,43,Pass
Peter D'Souza,10-01-2006,103068,Gujarat,1,12,24,23,60,Fail
Ishaan Chopra,17-11-2004,334796,Odisha,22,16,13,3,54,Pass
John Mehta,10-07-2005,580015,West Bengal,3,14,12,24,53,Pass
Harjeet Mehta,12-01-2005,947645,Telangana,4,13,24,3,44,Pass
Gurpreet Pillai,19-05-2005,610805,Uttar Pradesh,9,16,20,17,62,Pass
Rohan Verma,03-12-2005,921597,Rajasthan,13,21,23,15,72,Pass
Aryan Sharma,04-12-2004,990743,Bihar,23,11,1,20,55,Pass
Paul Chopra,17-11-2004,986681,Uttar Pradesh,17,0,23,21,61,Pass
Balbir D'Souza,26-03-2006,944735,Haryana,19,8,5,15,47,Pass
Vivaan Sharma,26-07-2005,738998,Madhya Pradesh,22,23,3,2,50,Pass
Vivaan D'Souza,23-09-2005,381895,Rajasthan,4,13,20,20,57,Pass
Krishna Singh,09-01-2005,667816,Karnataka,19,9,3,15,46,Pass
Aarav Mehta,15-06-2005,810603,Karnataka,1,20,21,1,43,Pass
Aditya Pillai,28-11-2004,704809,Rajasthan,22,9,15,10,56,Pass
Ishaan Singh,07-09-2005,989713,Assam,23,20,9,2,54,Pass
Vivaan Fernandes,14-02-2005,380190,West Bengal,3,2,20,21,46,Pass
Kunal Fernandes,04-02-2006,975878,Jharkhand,16,9,6,14,45,Pass
Aryan Mehta,07-03-2005,393182,West Bengal,3,19,12,23,57,Pass
Aryan Sharma,06-12-2004,372052,Uttar Pradesh,12,14,14,20,60,Pass
Yash Singh,22-01-2005,920169,Andhra Pradesh,2,15,17,19,53,Pass
Krishna Singh,12-11-2004,465895,Arunachal Pradesh,8,6,15,9,38,Pass
Rehan Pillai,09-07-2005,240717,Punjab,14,1,9,0,24,Pass
Harjeet Fernandes,17-04-2006,809296,Karnataka,3,14,0,5,22,Pass
Manpreet Khan,14-12-2005,532603,Andhra Pradesh,1,13,21,15,50,Pass
Ishaan Mehta,18-01-2006,950144,West Bengal,13,18,7,2,40,Pass
Aryan Khan,04-12-2004,420277,Uttar Pradesh,14,1,18,8,41,Pass
Raj Sharma,08-09-2005,479576,Nagaland,0,8,7,17,32,Pass
Rohan D'Souza,21-06-2005,239376,Uttar Pradesh,18,8,10,1,37,Pass
Vivaan Fernandes,04-12-2005,222552,Punjab,13,18,10,3,44,Pass
Raj Fernandes,14-02-2005,542898,Bihar,5,17,12,22,56,Pass
Aarav Mehta,01-12-2005,717517,Haryana,6,6,22,4,38,Pass
Farhan Sharma,13-09-2005,197542,Uttar Pradesh,22,3,22,18,65,Pass
Raj Sharma,15-03-2005,215911,Gujarat,8,19,0,2,29,Fail
Krishna Fernandes,15-11-2005,475405,Madhya Pradesh,19,13,7,14,53,Pass
Rohan Verma,04-02-2006,793466,Rajasthan,19,0,22,20,61,Pass
Aryan Pillai,21-01-2006,645810,Punjab,4,1,17,5,27,Pass
David Chopra,09-04-2005,105907,West Bengal,3,22,8,21,54,Pass
Vivaan Pillai,02-01-2005,200538,West Bengal,9,23,9,12,53,Pass
Kunal Fernandes,05-10-2005,551193,Karnataka,0,20,8,1,29,Pass
Aditya Sharma,09-11-2005,528358,Daman & Diu / D&N Haveli,12,7,3,4,26,Pass
Kunal D'Souza,26-02-2005,849727,Andhra Pradesh,13,9,14,16,52,Pass
Yash Sharma,10-11-2004,511698,Karnataka,16,2,20,0,38,Pass
Aryan Chopra,09-07-2005,405789,West Bengal,3,23,16,17,59,Pass
Krishna D'Souza,09-04-2005,611262,Andhra Pradesh,14,11,2,19,46,Pass
Paul Khan,10-11-2004,254174,Madhya Pradesh,0,24,21,5,50,Pass
Sukhwinder Reddy,06-03-2005,452778,Karnataka,6,7,12,11,36,Pass
Raj Singh,19-09-2005,797833,Gujarat,5,2,2,13,22,Fail
Aryan D'Souza,19-04-2006,194315,Haryana,4,19,16,16,55,Pass
Sukhwinder Khan,26-02-2005,541338,Assam,9,7,18,24,58,Pass
Yash Mehta,17-06-2005,900666,Odisha,2,3,19,21,45,Pass
Aditya Verma,28-03-2006,967604,Jammu & Kashmir + Ladakh,22,1,12,21,56,Pass
Ishaan Reddy,12-03-2005,896108,Telangana,12,23,1,22,58,Pass
Aditya Khan,23-01-2005,445665,Assam,8,6,12,4,30,Pass
Aditya Chopra,25-04-2005,713950,Uttar Pradesh,4,8,19,11,42,Pass
Yash Singh,02-03-2006,436894,Bihar,16,13,16,6,51,Pass
Peter Singh,08-01-2005,248689,Andhra Pradesh,2,3,12,18,35,Pass
Ishaan Chopra,10-03-2006,294793,Tamil Nadu,12,17,4,12,45,Pass
Rohan D'Souza,13-06-2005,747383,Rajasthan,21,4,0,8,33,Pass
Kunal D'Souza,22-03-2005,657764,West Bengal,3,18,24,12,57,Pass
Aryan Chopra,16-02-2006,161145,Uttar Pradesh,14,12,12,24,62,Pass
Rohan Fernandes,26-10-2005,432686,Andhra Pradesh,17,17,16,21,71,Pass
Imran Singh,14-04-2006,869203,Haryana,8,15,0,16,39,Pass
Aarav Chopra,27-04-2005,893485,Punjab,24,4,22,11,61,Pass
Aarav Singh,28-01-2005,737015,Karnataka,24,22,13,1,60,Pass
Mathew Singh,04-05-2005,189564,Chhattisgarh,11,15,0,6,32,Pass
Yash Khan,26-03-2005,366165,Rajasthan,5,6,23,10,44,Pass
Aryan Chopra,25-11-2005,359011,Maharashtra,13,3,2,17,35,Pass
Aarav Fernandes,13-12-2005,128493,Telangana,12,12,7,6,37,Pass
Rohan Mehta,03-07-2005,264472,Jharkhand,14,23,19,19,75,Fail
Aditya Chopra,22-03-2005,804963,Uttar Pradesh,9,3,3,18,33,Pass
Manpreet D'Souza,16-09-2005,255821,Jammu & Kashmir + Ladakh,6,4,21,4,35,Pass
Raj Singh,26-03-2006,616360,Madhya Pradesh,1,5,6,19,31,Pass
Balbir D'Souza,01-09-2005,255761,Karnataka,19,4,6,17,46,Pass
Aryan Sharma,16-07-2005,892676,Himachal Pradesh,12,20,10,15,57,Pass
Aryan D'Souza,02-08-2005,948108,Bihar,1,3,17,20,41,Pass
Krishna D'Souza,08-11-2004,486550,Rajasthan,23,22,15,21,81,Pass
Krishna Khan,21-08-2005,692227,Andhra Pradesh,15,9,15,0,39,Pass
Ishaan Mehta,31-05-2005,515228,Madhya Pradesh,2,14,22,0,38,Pass
Aditya Khan,15-06-2005,595066,Madhya Pradesh,23,9,3,22,57,Pass
Harjeet Mehta,11-12-2005,425778,Maharashtra,22,11,3,2,38,Pass
Ishaan Singh,04-04-2005,517512,Madhya Pradesh,1,12,21,17,51,Pass
Rohan D'Souza,17-04-2006,337569,Rajasthan,4,20,12,5,41,Pass
Vivaan Sharma,25-12-2005,298533,Jammu & Kashmir + Ladakh,8,7,6,7,28,Pass
Aditya Sharma,12-03-2005,800792,Karnataka,6,6,22,24,58,Pass
Raj Verma,12-05-2005,322401,Himachal Pradesh,9,14,13,3,39,Pass
Aditya D'Souza,11-11-2005,368914,Haryana,2,9,22,16,49,Pass
Peter D'Souza,04-03-2006,461724,Telangana,14,19,23,11,67,Pass
Harjeet Mehta,07-02-2006,443145,Madhya Pradesh,13,3,24,12,52,Pass
Aryan Pillai,12-09-2005,800639,Rajasthan,8,14,23,2,47,Pass
Gurpreet Sharma,27-03-2006,825840,Assam,14,4,21,17,56,Pass
Raj Pillai,07-05-2005,546525,Maharashtra,2,21,2,7,32,Pass
Aryan Reddy,24-07-2005,824091,Maharashtra,16,5,11,6,38,Pass
Aarav Khan,18-12-2005,176405,Karnataka,21,23,16,2,62,Pass
Krishna Verma,17-12-2004,697452,Uttar Pradesh,17,5,24,24,70,Pass
Gurpreet Verma,10-03-2006,857186,Assam,4,1,1,7,13,Pass
Aditya Sharma,25-12-2005,700246,Jammu & Kashmir + Ladakh,15,21,22,4,62,Pass
David Chopra,25-09-2005,460994,Rajasthan,15,16,8,3,42,Pass
Rohan Fernandes,18-11-2004,961509,Madhya Pradesh,7,18,4,3,32,Pass
Aryan Chopra,08-11-2005,253462,Madhya Pradesh,0,23,9,22,54,Pass
Aryan Singh,09-03-2006,707445,Bihar,10,0,8,16,34,Pass
Ishaan Sharma,17-09-2005,837503,Haryana,21,17,23,14,75,Pass
Gurpreet Mehta,10-08-2005,396552,Uttarakhand,10,8,7,2,27,Pass
Aditya Singh,28-01-2006,305364,Rajasthan,15,14,0,5,34,Pass
Sukhwinder Pillai,19-02-2006,231640,Bihar,13,20,1,0,34,Pass
Yash Fernandes,08-05-2005,211521,Uttarakhand,12,20,3,5,40,Pass
Rohan D'Souza,30-09-2005,177025,Bihar,1,4,24,22,51,Pass
Kunal Reddy,20-10-2005,598904,Tamil Nadu,8,20,16,16,60,Pass
Aditya Mehta,04-12-2005,501968,Punjab,0,20,21,22,63,Pass
Kunal Khan,07-08-2005,606351,Jharkhand,15,14,3,8,40,Pass
Aarav Verma,26-01-2006,476369,Uttar Pradesh,4,9,21,6,40,Pass
Rohan Fernandes,17-01-2006,651076,West Bengal,13,6,7,0,26,Pass
Raj Verma,02-03-2005,373357,Tripura,15,24,3,16,58,Pass
Krishna D'Souza,20-11-2004,913323,Uttar Pradesh,15,19,24,14,72,Pass
Balbir Singh,14-03-2006,881542,Gujarat,1,11,0,2,14,Fail
Aryan Khan,19-07-2005,957924,Andhra Pradesh,19,13,1,0,33,Pass
David Mehta,08-02-2006,152698,Uttar Pradesh,11,14,2,7,34,Pass
Balbir Singh,24-08-2005,151930,Bihar,8,16,11,21,56,Pass
Krishna Singh,28-05-2005,328733,Chhattisgarh,6,24,23,9,62,Pass
Raj Reddy,16-11-2005,126147,Uttar Pradesh,22,3,13,23,61,Pass
Aryan Khan,03-01-2005,530214,Rajasthan,9,1,21,0,31,Pass
David Sharma,07-11-2004,601878,Rajasthan,3,1,14,19,37,Pass
Vivaan Reddy,28-03-2006,598348,Uttar Pradesh,6,12,6,10,34,Pass
Ishaan Reddy,03-02-2005,609344,Madhya Pradesh,3,16,18,3,40,Pass
Ishaan D'Souza,26-02-2006,134152,Andaman & Nicobar,16,3,4,14,37,Pass
Mathew Fernandes,14-01-2006,157887,Bihar,22,3,24,16,65,Pass
Mathew Verma,04-09-2005,157575,Telangana,12,7,8,20,47,Pass
Vivaan D'Souza,04-11-2005,911575,Telangana,1,15,11,13,40,Pass
Aditya Pillai,14-09-2005,714576,West Bengal,3,21,12,17,53,Pass
Vivaan Fernandes,16-03-2006,253059,Gujarat,19,8,1,19,47,Fail
Manpreet D'Souza,06-03-2006,224360,Maharashtra,5,0,1,12,18,Pass
Paul Mehta,08-03-2005,823089,Odisha,22,10,11,12,55,Pass
Yash D'Souza,17-01-2005,457487,Delhi,11,10,0,21,42,Pass
Manpreet Khan,08-03-2005,498498,Bihar,6,16,14,19,55,Pass
Aditya Singh,07-02-2006,490559,Maharashtra,7,13,2,22,44,Pass
Yash Sharma,09-07-2005,320054,Uttar Pradesh,11,0,17,14,42,Pass
Kunal Fernandes,16-02-2005,947431,Karnataka,22,20,13,24,79,Fail
Ishaan Pillai,30-09-2005,262424,Rajasthan,2,8,13,14,37,Pass
Aditya Singh,29-08-2005,430551,Jharkhand,10,12,22,7,51,Pass
Aarav Fernandes,24-12-2004,760923,Assam,9,17,19,7,52,Pass
Imran Mehta,10-03-2005,143032,Madhya Pradesh,6,20,19,7,52,Pass
Manpreet Fernandes,05-02-2005,721801,Uttar Pradesh,9,21,9,3,42,Pass
Kunal D'Souza,25-06-2005,700193,Uttar Pradesh,23,3,24,20,70,Pass
Mathew Chopra,15-10-2005,391711,Chhattisgarh,8,18,17,18,61,Pass
Rohan Pillai,26-04-2006,858712,Madhya Pradesh,15,4,3,24,46,Pass
Krishna Singh,16-01-2006,951548,Rajasthan,13,22,24,17,76,Pass
Ayaan Pillai,23-01-2005,880051,Assam,20,4,19,14,57,Pass
John Pillai,12-12-2005,501403,Maharashtra,22,15,2,0,39,Pass
Krishna D'Souza,29-03-2005,303073,Maharashtra,24,12,2,12,50,Pass
John Reddy,08-05-2006,528928,Karnataka,16,10,12,22,60,Pass
Kunal Khan,01-12-2005,649430,Kerala,11,10,2,0,23,Pass
Aryan Singh,26-11-2004,681300,Punjab,14,17,16,16,63,Pass
Gurpreet Sharma,01-12-2004,457214,Uttar Pradesh,19,10,10,3,42,Pass
Gurpreet Fernandes,25-08-2005,500930,Uttar Pradesh,6,18,4,24,52,Pass
Vivaan Fernandes,26-03-2005,396279,Maharashtra,9,4,13,19,45,Pass
Sukhwinder Mehta,21-08-2005,255864,Rajasthan,7,2,11,17,37,Pass
Raj Fernandes,28-02-2006,509742,West Bengal,1,24,20,9,54,Pass
Imran D'Souza,21-12-2004,489522,Andhra Pradesh,0,12,8,6,26,Pass
Vivaan Fernandes,09-09-2005,523522,Punjab,14,17,12,20,63,Pass
Krishna Sharma,10-07-2005,208621,Punjab,8,7,19,0,34,Pass
Zaid Fernandes,14-11-2004,641272,Bihar,24,16,9,23,72,Pass
Ishaan D'Souza,08-05-2005,468225,Uttar Pradesh,2,1,4,16,23,Pass
Balbir D'Souza,01-02-2005,515665,Punjab,16,17,18,11,62,Pass
Rohan Reddy,17-02-2006,493699,Haryana,12,11,10,19,52,Pass
Aarav Singh,31-07-2005,365807,Tamil Nadu,3,22,6,3,34,Pass
Kunal Singh,02-01-2006,345190,Madhya Pradesh,4,21,10,0,35,Pass
Rohan Pillai,23-09-2005,850041,Uttar Pradesh,19,5,14,0,38,Pass
Aryan Sharma,12-12-2005,440806,Jammu & Kashmir + Ladakh,24,8,2,1,35,Pass
Sukhwinder Pillai,15-01-2006,573966,Andhra Pradesh,14,6,6,10,36,Pass
Ayaan Singh,01-10-2005,449733,Tamil Nadu,23,16,22,18,79,Pass
Ayaan Singh,23-11-2004,488813,Jharkhand,19,2,20,21,62,Pass
Aditya Mehta,22-05-2005,114190,Rajasthan,3,9,24,4,40,Pass
Rohan Pillai,16-12-2004,934543,Haryana,2,5,9,24,40,Pass
Ishaan Fernandes,14-03-2005,680275,Uttar Pradesh,9,0,2,6,17,Pass
John Verma,25-07-2005,343209,Uttar Pradesh,24,10,18,13,65,Pass
Yash D'Souza,15-02-2006,418879,Kerala,15,17,0,7,39,Pass
Rohan Pillai,03-02-2006,780606,Uttarakhand,23,18,3,7,51,Pass
Sukhwinder Chopra,04-11-2005,458448,West Bengal,3,24,16,15,58,Pass
Yash Pillai,07-12-2005,725038,Bihar,5,17,16,10,48,Pass
Krishna Sharma,11-10-2005,564794,Gujarat,14,14,21,5,54,Fail
Aarav Chopra,17-01-2005,470139,Bihar,22,2,24,1,49,Pass
Yash Fernandes,04-01-2006,823597,Punjab,16,2,8,3,29,Pass
Ishaan Sharma,25-12-2005,878653,Bihar,3,8,8,14,33,Pass
Gurpreet Mehta,05-04-2005,536846,Tamil Nadu,20,21,18,8,67,Pass
Rohan Fernandes,02-03-2005,972579,Rajasthan,19,18,14,7,58,Pass
Paul Sharma,09-08-2005,269824,Jharkhand,20,8,13,23,64,Pass
Harjeet Sharma,05-03-2005,165847,Uttar Pradesh,1,11,21,11,44,Pass
John Pillai,25-08-2005,842696,Gujarat,21,14,21,10,66,Fail
Manpreet Mehta,24-11-2004,833105,Rajasthan,21,1,23,2,47,Pass
Yash Mehta,28-08-2005,969060,Tripura,6,17,10,15,48,Pass
Vivaan Pillai,03-02-2005,696075,Haryana,0,12,8,12,32,Pass
Mathew Chopra,23-10-2005,370686,Jharkhand,17,19,15,6,57,Pass
Aditya Sharma,23-07-2005,610653,Rajasthan,8,3,9,23,43,Pass
Aditya Mehta,28-12-2004,725305,Madhya Pradesh,15,12,21,1,49,Pass
Gurpreet Fernandes,14-06-2005,952313,Chhattisgarh,16,20,20,5,61,Pass
Kunal Khan,21-04-2005,773977,Tamil Nadu,3,4,3,13,23,Pass
Kunal Singh,29-04-2005,166622,Bihar,13,12,9,10,44,Pass
Kunal Mehta,04-11-2005,835056,Uttar Pradesh,17,12,0,4,33,Pass
Balbir Reddy,01-03-2005,998859,Rajasthan,24,22,13,3,62,Pass
Yash Pillai,02-12-2005,960756,Uttar Pradesh,3,13,4,17,37,Pass
Vivaan Reddy,01-04-2006,476696,Maharashtra,8,14,19,0,41,Pass
Krishna Mehta,11-03-2005,346931,Rajasthan,9,4,5,11,29,Pass
Ishaan Singh,06-09-2005,794139,Tamil Nadu,7,6,21,5,39,Pass
Harjeet Fernandes,18-09-2005,681844,Rajasthan,7,11,11,0,29,Pass
Krishna Fernandes,26-10-2005,472689,Uttarakhand,6,9,20,9,44,Pass
Aditya Reddy,26-02-2005,698851,Bihar,3,7,7,17,34,Pass
Harjeet Mehta,25-01-2006,698433,Haryana,8,15,11,3,37,Pass
Aryan Fernandes,14-04-2005,419635,Gujarat,14,0,11,20,45,Fail
Aarav Chopra,05-11-2005,637575,Uttar Pradesh,5,8,8,19,40,Pass
Peter Sharma,19-09-2005,402651,Tamil Nadu,20,0,18,16,54,Pass
Krishna Fernandes,19-09-2005,940782,Tamil Nadu,9,15,22,4,50,Pass
Manpreet Chopra,16-07-2005,756338,Madhya Pradesh,12,12,13,6,43,Pass
Krishna D'Souza,29-11-2004,718454,Andhra Pradesh,8,12,10,0,30,Pass
Rohan Verma,15-11-2004,347150,Tamil Nadu,7,7,16,24,54,Pass
Gurpreet Khan,06-05-2005,257325,Gujarat,21,14,24,8,67,Fail
Manpreet Pillai,12-12-2004,248890,Uttar Pradesh,4,13,0,11,28,Pass
Ishaan Mehta,15-07-2005,959833,Uttar Pradesh,16,13,12,7,48,Pass
Ishaan Singh,11-02-2005,943386,Assam,22,16,12,4,54,Pass
Harjeet Pillai,22-12-2004,703512,Chhattisgarh,23,14,8,5,50,Pass
Ishaan Khan,24-03-2006,934142,Karnataka,13,20,8,9,50,Pass
Sukhwinder Fernandes,08-03-2006,567787,West Bengal,3,16,15,16,50,Pass
Kunal D'Souza,06-03-2005,551373,Arunachal Pradesh,1,9,17,12,39,Pass
Aryan Pillai,18-01-2006,854468,Rajasthan,8,5,0,14,27,Pass
Kunal Reddy,09-10-2005,283733,Uttar Pradesh,21,10,17,14,62,Pass
Aryan Chopra,12-01-2006,571960,Madhya Pradesh,16,18,3,11,48,Pass
Vivaan Mehta,26-02-2005,967053,Rajasthan,18,10,4,3,35,Pass
Gurpreet Mehta,15-01-2006,821788,Rajasthan,6,8,7,0,21,Pass
Krishna Mehta,17-09-2005,843771,Gujarat,17,13,4,16,50,Fail
Manpreet Khan,29-07-2005,853071,Maharashtra,19,11,2,18,50,Pass
Paul Khan,24-02-2006,864344,West Bengal,1,20,1,16,38,Pass
Yash Khan,21-07-2005,153789,Madhya Pradesh,0,14,10,20,44,Pass
Raj Sharma,18-06-2005,187712,Bihar,6,8,17,10,41,Pass
Kunal Singh,30-04-2006,170272,Maharashtra,17,7,11,11,46,Pass
Raj Chopra,23-02-2006,125599,Jharkhand,21,17,5,22,65,Pass
Kunal Mehta,28-01-2005,855613,Gujarat,9,17,9,12,47,Fail
Aarav Reddy,01-02-2006,338677,Rajasthan,7,12,15,9,43,Pass
Balbir Sharma,10-08-2005,879985,Odisha,22,18,4,16,60,Pass
Aditya Fernandes,21-09-2005,236979,Bihar,1,6,3,23,33,Pass
Rohan Verma,21-07-2005,537577,Bihar,14,0,15,9,38,Pass
Raj Pillai,09-12-2004,749554,Jammu & Kashmir + Ladakh,8,8,14,14,44,Pass
Rohan Khan,01-06-2005,699076,Jammu & Kashmir + Ladakh,24,19,13,7,63,Pass
Peter Mehta,04-02-2005,146236,Bihar,23,2,11,3,39,Pass
Rohan Singh,25-12-2004,400308,Haryana,22,6,17,5,50,Pass
Ishaan Verma,23-04-2005,449437,Telangana,11,12,16,0,39,Pass
Imran Fernandes,13-11-2004,648365,Bihar,21,16,22,22,81,Pass
Harjeet Verma,17-12-2005,712948,Punjab,9,4,24,14,51,Pass
Manpreet Sharma,19-06-2005,738014,Andhra Pradesh,0,19,5,0,24,Pass
Aryan Pillai,05-02-2006,710084,Rajasthan,12,8,23,21,64,Pass
Rohan Pillai,21-03-2005,818852,Maharashtra,5,0,16,5,26,Pass
Rohan Singh,04-06-2005,644968,Rajasthan,0,14,18,17,49,Pass
Vivaan D'Souza,23-10-2005,263594,Rajasthan,18,14,24,18,74,Pass
Krishna Pillai,07-02-2006,169800,Rajasthan,8,17,12,10,47,Pass
Sukhwinder Chopra,07-05-2005,647715,Rajasthan,5,16,10,19,50,Pass
Kunal Mehta,13-12-2004,136748,Rajasthan,7,3,13,7,30,Pass
Vivaan Mehta,17-11-2004,303686,Bihar,13,20,16,17,66,Pass
Ishaan Sharma,08-06-2005,741148,Delhi,11,14,3,18,46,Pass
Kunal D'Souza,16-04-2006,692190,Tamil Nadu,10,21,9,16,56,Pass
Aryan Singh,02-11-2005,403330,Tamil Nadu,14,11,13,15,53,Pass
Aditya Reddy,16-02-2005,623612,Maharashtra,13,17,1,14,45,Pass
John Chopra,10-01-2005,201203,Karnataka,12,5,2,16,35,Pass
Yash Khan,30-09-2005,688018,Madhya Pradesh,14,6,1,9,30,Pass
Vivaan Reddy,02-01-2005,455410,Odisha,14,6,6,22,48,Pass
Rehan Pillai,29-10-2005,227626,Maharashtra,13,3,7,14,37,Pass
Ayaan D'Souza,21-12-2005,302836,Tamil Nadu,8,23,23,5,59,Pass
Kunal Singh,10-01-2005,596397,Rajasthan,21,24,16,3,64,Pass
Manpreet Khan,22-11-2005,612449,Punjab,21,11,0,11,43,Pass
Sukhwinder Singh,18-05-2005,756034,Bihar,17,0,11,13,41,Pass
Aryan Chopra,20-04-2006,258459,Madhya Pradesh,18,2,19,13,52,Pass
Kunal Singh,22-05-2005,933901,Tamil Nadu,22,19,17,22,80,Pass
Ishaan Mehta,25-09-2005,910926,Uttar Pradesh,15,9,9,12,45,Pass
Vivaan Pillai,13-03-2006,835110,Uttar Pradesh,11,3,12,20,46,Pass
Aarav Singh,16-06-2005,835589,Meghalaya,6,14,7,5,32,Pass
Vivaan Singh,19-01-2005,705994,Andhra Pradesh,21,10,11,22,64,Pass
Zaid Chopra,16-10-2005,580420,Punjab,21,23,18,6,68,Pass
Sukhwinder Verma,14-02-2005,611196,Punjab,17,23,18,14,72,Pass
Gurpreet D'Souza,11-11-2005,911048,Odisha,7,17,11,22,57,Pass
Aarav Pillai,27-02-2005,489946,Uttarakhand,24,6,3,22,55,Pass
Gurpreet Chopra,05-04-2006,183955,Uttar Pradesh,14,18,22,5,59,Pass
Ishaan Fernandes,16-02-2006,655387,Uttar Pradesh,23,15,11,18,67,Pass
Yash Pillai,29-11-2004,275027,Telangana,20,6,15,6,47,Pass
Vivaan Mehta,30-03-2005,596399,Andhra Pradesh,23,6,14,16,59,Pass
Paul Chopra,11-04-2005,447643,Andhra Pradesh,11,8,11,19,49,Pass
Harjeet Sharma,04-04-2006,338888,Chhattisgarh,24,4,4,13,45,Pass
Ishaan Verma,29-06-2005,245295,Manipur,4,6,21,10,41,Pass
Kunal Fernandes,29-08-2005,777897,Jammu & Kashmir + Ladakh,19,11,7,12,49,Pass
Kunal Singh,20-09-2005,207567,Assam,17,14,9,15,55,Pass
Aarav Chopra,02-04-2006,137622,Kerala,3,8,19,9,39,Pass
Raj Sharma,02-01-2005,372320,Bihar,17,22,9,11,59,Pass
Aarav Sharma,23-01-2005,668401,Gujarat,22,22,19,15,78,Fail
Krishna Mehta,25-01-2005,364542,Rajasthan,4,15,4,5,28,Pass
Mathew Sharma,14-02-2005,944151,Telangana,13,9,9,20,51,Pass
Aryan Verma,11-06-2005,138907,Haryana,6,9,19,11,45,Pass
Imran Chopra,18-02-2005,617132,Rajasthan,7,0,13,9,29,Pass
Aarav Fernandes,06-10-2005,889035,Andhra Pradesh,12,5,8,15,40,Pass
Raj Verma,17-01-2006,675490,Telangana,6,6,2,15,29,Pass
Peter Reddy,07-02-2005,512936,Himachal Pradesh,3,9,13,15,40,Pass
Ayaan Reddy,29-01-2006,190699,Karnataka,8,8,15,18,49,Pass
Vivaan Singh,12-12-2005,788376,Uttarakhand,15,0,7,13,35,Pass
Raj Singh,10-12-2005,662829,Maharashtra,5,9,2,17,33,Pass
Kunal D'Souza,21-07-2005,744383,Rajasthan,13,12,4,12,41,Pass
Farhan Sharma,28-01-2005,154619,Gujarat,16,18,5,10,49,Fail
Aditya Chopra,20-02-2006,914828,Bihar,9,21,21,1,52,Pass
Mathew Chopra,26-04-2005,488245,Maharashtra,5,15,18,1,39,Pass
Krishna Verma,28-09-2005,867646,Telangana,18,18,6,7,49,Pass
Manpreet Fernandes,19-01-2006,581607,Madhya Pradesh,6,21,6,7,40,Pass
Peter Mehta,01-12-2004,204450,Uttar Pradesh,8,8,0,11,27,Pass
Aryan Reddy,02-08-2005,570232,Madhya Pradesh,20,11,4,9,44,Pass
Imran Fernandes,06-02-2006,132486,Kerala,14,14,16,23,67,Pass
Raj Mehta,04-12-2004,836548,Tamil Nadu,23,12,4,10,49,Pass
Harjeet Singh,05-06-2005,699430,Bihar,2,4,14,7,27,Pass
Raj Pillai,26-12-2004,900054,Karnataka,1,7,20,10,38,Pass
Raj Verma,07-03-2005,711704,Tamil Nadu,18,1,15,1,35,Pass
Aarav Sharma,25-02-2005,827603,Gujarat,4,4,4,22,34,Fail
David Khan,18-02-2005,488530,Gujarat,7,7,18,16,48,Fail
Aditya Khan,22-01-2005,248238,Uttar Pradesh,2,5,1,24,32,Pass
Raj Chopra,17-11-2004,766257,Andhra Pradesh,17,10,22,5,54,Pass
Aarav Verma,30-07-2005,816593,Jharkhand,6,12,4,20,42,Pass
Peter Singh,09-02-2005,399106,Bihar,1,17,6,15,39,Pass
Manpreet Chopra,21-06-2005,199272,Andhra Pradesh,1,6,4,9,20,Pass
Aryan D'Souza,01-04-2005,525903,Goa,10,17,24,22,73,Fail
Ishaan Sharma,08-03-2006,651593,Andhra Pradesh,17,6,8,16,47,Pass
Sukhwinder D'Souza,04-09-2005,801834,Uttarakhand,24,18,1,4,47,Pass
Kunal D'Souza,25-04-2005,888960,Rajasthan,10,6,4,14,34,Pass
Rohan Mehta,23-09-2005,931374,West Bengal,3,23,24,16,66,Pass
Kunal Khan,21-01-2006,553788,Andhra Pradesh,22,9,8,7,46,Pass
Sukhwinder Mehta,06-05-2006,997712,Madhya Pradesh,24,11,2,8,45,Pass
Vivaan D'Souza,10-12-2005,965451,Gujarat,2,20,12,1,35,Fail
Krishna Pillai,19-01-2005,310086,Uttar Pradesh,4,8,16,15,43,Pass
Krishna Reddy,13-04-2005,481164,Telangana,9,9,21,5,44,Pass
Raj Fernandes,25-09-2005,946073,Andhra Pradesh,17,21,15,13,66,Pass
John Pillai,23-10-2005,726027,Telangana,10,23,24,6,63,Pass
Krishna Chopra,07-04-2006,631933,Maharashtra,22,6,4,5,37,Pass
Raj D'Souza,07-01-2005,536591,Rajasthan,6,2,18,22,48,Pass
Vivaan Khan,14-03-2005,767333,Andhra Pradesh,10,2,17,23,52,Pass
Rohan Mehta,05-01-2006,822837,Karnataka,14,15,6,5,40,Pass
Krishna Singh,05-01-2005,136420,Rajasthan,14,7,1,0,22,Pass
Ishaan Singh,13-02-2006,659120,Maharashtra,1,21,2,21,45,Pass
Ishaan Sharma,16-07-2005,534663,Tamil Nadu,2,15,22,2,41,Pass
Krishna Fernandes,16-04-2005,413970,Bihar,17,4,18,21,60,Pass
Aditya Khan,18-02-2006,644719,Himachal Pradesh,5,10,5,5,25,Pass
Vivaan Singh,25-01-2006,572964,Kerala,11,4,3,11,29,Pass
Yash Pillai,28-05-2005,714249,Gujarat,22,4,13,13,52,Fail
Yash D'Souza,08-01-2005,744931,Bihar,3,14,3,20,40,Pass
Aarav Mehta,22-04-2006,546692,Madhya Pradesh,5,9,24,14,52,Pass
Yash Singh,02-04-2006,270318,Bihar,9,5,19,1,34,Pass
Peter Mehta,09-12-2005,775509,Madhya Pradesh,24,20,3,9,56,Pass
Zaid Mehta,02-12-2005,631318,Gujarat,7,4,9,19,39,Fail
Paul Chopra,23-11-2005,456205,Rajasthan,14,20,12,9,55,Pass
Krishna Fernandes,08-04-2005,541028,Madhya Pradesh,3,11,2,1,17,Pass
Ishaan Mehta,24-05-2005,207918,Maharashtra,11,10,9,5,35,Pass
Sukhwinder Mehta,07-06-2005,232873,Bihar,24,10,22,24,80,Pass
Rohan Reddy,26-04-2006,810186,Andhra Pradesh,8,8,24,1,41,Pass
Rehan Sharma,26-11-2005,110273,Andhra Pradesh,13,10,2,17,42,Pass
Yash Singh,28-11-2005,732078,Uttar Pradesh,18,5,0,1,24,Pass
Harjeet Fernandes,13-10-2005,837404,Madhya Pradesh,0,19,6,8,33,Pass
Aryan Chopra,01-04-2005,515018,Uttar Pradesh,8,3,7,19,37,Pass
Aarav Pillai,27-12-2005,887084,Haryana,1,4,15,1,21,Pass
Ishaan Verma,23-08-2005,639795,Assam,23,14,6,0,43,Pass
Ishaan Khan,02-11-2005,608544,Bihar,23,24,2,19,68,Pass
Yash Fernandes,29-04-2006,896103,Andhra Pradesh,23,10,17,13,63,Pass
Raj Fernandes,09-07-2005,480392,Uttar Pradesh,0,7,20,8,35,Pass
Rohan Pillai,21-02-2006,367053,Tamil Nadu,15,4,6,4,29,Pass
Manpreet Sharma,24-12-2004,524153,Haryana,13,0,3,23,39,Pass
Yash Reddy,08-02-2005,183057,West Bengal,3,4,24,13,44,Pass
Aditya Pillai,19-02-2005,771014,Uttar Pradesh,10,17,3,16,46,Pass
John Chopra,20-05-2005,527752,Bihar,18,4,17,2,41,Pass
Aditya Mehta,17-09-2005,322702,Gujarat,22,9,13,2,46,Fail
Kunal Verma,07-03-2005,947262,Punjab,14,4,10,14,42,Pass
Aditya D'Souza,19-10-2005,389688,Delhi,1,9,15,21,46,Pass
Peter Sharma,20-01-2005,134232,Telangana,17,22,16,7,62,Pass
Aditya D'Souza,08-09-2005,464950,West Bengal,9,8,14,22,53,Pass
Aditya Mehta,31-01-2005,731752,Delhi,11,0,22,8,41,Pass
Rohan Khan,20-02-2006,766196,Bihar,16,8,2,8,34,Pass
Aryan Pillai,05-02-2005,836599,Haryana,22,11,20,24,77,Pass
Balbir Verma,24-10-2005,209312,West Bengal,13,6,13,12,44,Pass
Manpreet Sharma,29-04-2006,252440,Gujarat,24,8,10,0,42,Fail
Gurpreet Verma,05-02-2005,120434,Maharashtra,15,4,9,17,45,Pass
Sukhwinder Singh,06-02-2005,723229,Himachal Pradesh,21,10,17,15,63,Pass
Aditya Fernandes,29-12-2004,415304,Maharashtra,24,21,2,24,71,Pass
Krishna Pillai,12-11-2005,279257,Punjab,11,21,12,24,68,Pass
Aryan Singh,08-12-2004,401992,Rajasthan,20,18,18,9,65,Pass
Ishaan Sharma,09-09-2005,688607,West Bengal,20,0,20,6,46,Pass
Kunal Reddy,04-10-2005,216495,Delhi,13,17,2,10,42,Pass
David Sharma,05-02-2005,391299,Madhya Pradesh,2,16,14,18,50,Pass
Balbir Chopra,26-02-2006,397904,West Bengal,8,1,18,4,31,Pass
Aditya Khan,28-09-2005,838638,Uttar Pradesh,16,5,13,20,54,Pass
Gurpreet Singh,30-12-2004,487499,Maharashtra,7,9,10,12,38,Pass
Krishna Reddy,24-08-2005,607030,Gujarat,5,14,0,2,21,Fail
Manpreet Verma,25-09-2005,773716,West Bengal,2,17,7,6,32,Pass
Harjeet D'Souza,14-11-2005,595267,Puducherry,4,5,6,6,21,Pass
Yash D'Souza,12-04-2006,767334,Himachal Pradesh,5,8,6,16,35,Pass
Kunal Reddy,08-12-2004,651713,Uttar Pradesh,2,13,9,21,45,Pass
Peter Mehta,07-07-2005,836520,Haryana,8,24,7,23,62,Pass
Kunal D'Souza,12-07-2005,750830,Madhya Pradesh,22,5,3,21,51,Pass
Aarav Singh,17-12-2004,403781,Punjab,6,9,12,20,47,Pass
Balbir Sharma,22-02-2005,906552,Tamil Nadu,24,2,1,0,27,Pass
Vivaan D'Souza,26-07-2005,354049,Rajasthan,3,2,19,4,28,Pass
Krishna D'Souza,07-01-2006,811245,Andhra Pradesh,3,3,16,23,45,Pass
Raj Khan,30-04-2006,879308,Andhra Pradesh,8,5,11,17,41,Pass
Paul Verma,01-03-2005,871829,West Bengal,16,1,3,11,31,Pass
Aarav Fernandes,10-12-2004,569033,Karnataka,23,17,18,11,69,Fail
Aarav Pillai,20-03-2006,558799,Chhattisgarh,4,21,11,20,56,Pass
Vivaan Reddy,03-02-2006,801875,Uttar Pradesh,15,4,8,0,27,Pass
Ishaan Sharma,15-08-2005,995540,Uttarakhand,16,17,1,10,44,Pass
Kunal Khan,08-11-2004,936480,Maharashtra,12,21,2,18,53,Pass
Raj Fernandes,17-12-2004,443121,Uttar Pradesh,1,10,24,23,58,Pass
Kunal Chopra,26-06-2005,417129,Assam,14,20,22,12,68,Pass
Farhan Verma,24-03-2006,758279,Uttar Pradesh,9,21,13,17,60,Pass
Peter Sharma,22-07-2005,812945,Odisha,6,7,3,3,19,Pass
Ishaan Reddy,21-11-2004,265059,West Bengal,2,21,2,7,32,Pass
Ishaan Fernandes,10-08-2005,231744,Gujarat,20,5,12,11,48,Fail
Vivaan Fernandes,16-03-2006,395586,Bihar,24,16,13,14,67,Pass
Ishaan Pillai,01-04-2005,316182,Andhra Pradesh,15,6,24,12,57,Pass
Harjeet Sharma,03-06-2005,347585,Chhattisgarh,16,0,0,15,31,Pass
Harjeet Pillai,17-07-2005,789930,Maharashtra,0,6,14,24,44,Pass
Ishaan Khan,07-06-2005,473259,Uttar Pradesh,16,3,24,18,61,Pass
Rohan Khan,22-04-2005,266528,Maharashtra,21,8,11,7,47,Pass
Yash Sharma,23-04-2006,589607,Uttar Pradesh,4,13,20,9,46,Pass
Krishna Fernandes,27-11-2005,383982,Andhra Pradesh,4,12,8,20,44,Pass
Sukhwinder Singh,12-06-2005,861846,Maharashtra,12,16,2,11,41,Pass
Rohan Fernandes,17-03-2006,211375,Punjab,23,13,18,1,55,Pass
Krishna Chopra,04-09-2005,151437,Bihar,0,22,1,10,33,Pass
Manpreet Mehta,15-08-2005,653167,West Bengal,11,9,5,14,39,Pass
John Singh,19-08-2005,693307,Uttar Pradesh,19,8,0,22,49,Pass
John D'Souza,01-12-2004,211228,Madhya Pradesh,11,7,9,22,49,Pass
Raj Reddy,15-08-2005,262351,Bihar,20,13,20,6,59,Pass
Mathew Singh,08-03-2006,549375,Punjab,19,9,9,9,46,Pass
Kunal D'Souza,11-07-2005,429492,Tamil Nadu,15,12,5,9,41,Pass
Paul Reddy,20-02-2005,615181,Karnataka,23,1,17,6,47,Pass
Manpreet Verma,26-02-2005,326997,Uttar Pradesh,18,20,11,6,55,Pass
Gurpreet Chopra,10-06-2005,645818,West Bengal,2,24,21,0,47,Pass
Yash Reddy,10-04-2005,886439,Madhya Pradesh,18,0,3,18,39,Pass
Aryan Singh,20-02-2006,987923,Odisha,10,6,4,9,29,Pass
Kunal Sharma,25-09-2005,370910,Puducherry,7,6,9,6,28,Pass
Raj Singh,02-02-2005,685259,Haryana,13,6,0,20,39,Pass
Raj Mehta,26-12-2004,102226,Maharashtra,11,0,20,2,33,Pass
Raj Chopra,18-06-2005,421346,Assam,15,12,2,3,32,Pass
Aryan Verma,14-03-2005,362527,Rajasthan,3,18,9,9,39,Pass
Kunal Chopra,23-10-2005,560658,Rajasthan,19,23,6,17,65,Pass
Sukhwinder D'Souza,05-12-2005,785298,Maharashtra,6,21,2,2,31,Pass
Aditya Khan,01-03-2005,259861,Uttar Pradesh,19,2,5,2,28,Pass
Mathew Singh,15-12-2004,194009,Rajasthan,2,20,17,18,57,Pass
Kunal D'Souza,30-01-2006,741971,Bihar,15,9,10,20,54,Pass
Aryan Reddy,12-12-2004,703458,Jammu & Kashmir + Ladakh,13,23,4,23,63,Pass
Aditya Sharma,07-03-2005,664676,Maharashtra,20,8,2,16,46,Pass
Raj Mehta,14-08-2005,272794,Odisha,5,3,14,1,23,Pass
Ishaan Fernandes,12-08-2005,969973,Karnataka,21,17,18,14,70,Fail
Raj Mehta,21-02-2006,929653,Uttar Pradesh,14,22,3,17,56,Pass
Aditya Pillai,04-02-2006,637835,Bihar,20,9,10,15,54,Pass
Balbir Fernandes,22-11-2004,261979,Haryana,7,0,23,0,30,Pass
Imran Sharma,10-11-2004,407649,Odisha,23,15,9,0,47,Pass
Vivaan Sharma,24-10-2005,410783,Maharashtra,17,22,2,1,42,Pass
Kunal Reddy,30-04-2006,286999,Jharkhand,12,12,6,12,42,Pass
Aryan D'Souza,30-09-2005,521288,Manipur,6,0,2,6,14,Pass
Harjeet Sharma,25-06-2005,362128,Uttar Pradesh,14,10,20,9,53,Pass
Ishaan Mehta,23-04-2006,304461,Tamil Nadu,9,21,8,21,59,Pass
Kunal Khan,13-03-2006,523229,Jammu & Kashmir + Ladakh,24,8,19,3,54,Pass
Imran Chopra,18-07-2005,724503,Kerala,22,4,0,20,46,Pass
Rohan D'Souza,30-11-2004,865359,Bihar,5,18,21,13,57,Pass
Aditya Verma,04-12-2005,459503,Haryana,24,4,23,19,70,Pass
Manpreet Chopra,25-11-2005,667291,Gujarat,19,2,4,11,36,Fail
Farhan Sharma,09-10-2005,732152,Uttar Pradesh,16,8,24,6,54,Pass
Ayaan Sharma,31-07-2005,552688,Haryana,17,16,3,0,36,Pass
Kunal D'Souza,29-10-2005,977049,Haryana,20,12,3,9,44,Pass
Yash D'Souza,24-02-2006,246548,Gujarat,11,9,12,19,51,Fail
Aditya Pillai,24-06-2005,569572,Jharkhand,5,17,21,16,59,Pass
Aditya Reddy,14-04-2006,276265,Delhi,15,12,19,22,68,Pass
Kunal Singh,19-12-2005,904569,Telangana,1,19,12,4,36,Pass
John Mehta,23-03-2005,834908,Rajasthan,9,6,13,21,49,Pass
Raj Sharma,25-06-2005,947099,Uttarakhand,21,3,3,22,49,Pass
Yash Singh,22-03-2005,839222,Tamil Nadu,15,13,0,2,30,Pass
Sukhwinder Verma,07-12-2005,609098,Bihar,16,21,19,5,61,Pass
Balbir Khan,26-01-2005,225430,West Bengal,3,10,11,20,44,Pass
Aditya Sharma,20-02-2005,931315,Bihar,20,2,8,8,38,Pass
Vivaan D'Souza,05-04-2006,584651,Maharashtra,19,21,4,1,45,Pass
Raj Reddy,15-01-2005,432839,Jammu & Kashmir + Ladakh,10,16,11,23,60,Pass
Aryan Sharma,25-12-2004,235534,Odisha,12,8,10,4,34,Pass
Aarav Khan,25-04-2006,410192,Gujarat,23,16,0,14,53,Fail
Aarav Mehta,03-02-2006,168868,Odisha,19,0,6,18,43,Pass
Ishaan D'Souza,09-11-2004,425412,Chhattisgarh,1,19,6,4,30,Pass
Raj Sharma,03-11-2005,449808,Punjab,14,22,24,8,68,Pass
Aryan Singh,27-11-2004,190941,Bihar,10,7,8,24,49,Pass
Kunal Singh,06-02-2006,196914,Maharashtra,13,9,2,14,38,Pass
Kunal Sharma,02-03-2005,453524,Gujarat,6,0,7,10,23,Fail
Peter Verma,05-06-2005,568384,Maharashtra,13,22,9,2,46,Pass
Balbir Chopra,02-10-2005,913086,Mizoram,7,8,9,8,32,Pass
Gurpreet D'Souza,09-03-2005,639739,Maharashtra,12,19,2,1,34,Pass
Manpreet D'Souza,31-12-2005,326524,Tamil Nadu,8,2,7,21,38,Pass
Aryan Khan,04-06-2005,515002,Rajasthan,4,22,4,13,43,Pass
Manpreet Sharma,15-03-2006,302499,Tamil Nadu,12,7,13,22,54,Pass
Ishaan Verma,08-05-2006,378045,Gujarat,14,16,12,10,52,Fail
Balbir D'Souza,03-06-2005,573408,Maharashtra,20,3,2,22,47,Pass
Gurpreet Verma,26-11-2004,385365,Punjab,11,13,12,9,45,Pass
Rohan Sharma,11-04-2005,656580,Uttar Pradesh,23,2,11,13,49,Pass
Ishaan D'Souza,18-02-2006,856913,Madhya Pradesh,5,16,10,8,39,Pass
Manpreet D'Souza,07-08-2005,414943,Jharkhand,4,2,13,19,38,Pass
Kunal D'Souza,10-03-2005,874848,West Bengal,8,18,3,17,46,Pass
John Sharma,29-04-2005,558301,Jharkhand,0,2,2,21,25,Pass
Yash D'Souza,23-02-2005,436922,Chhattisgarh,19,0,16,12,47,Pass
Aryan D'Souza,14-06-2005,419506,Rajasthan,6,13,23,2,44,Pass
Yash Mehta,11-03-2006,980790,Maharashtra,24,4,5,16,49,Pass
Imran Pillai,08-07-2005,195556,Himachal Pradesh,6,14,22,15,57,Pass
Raj Verma,22-06-2005,606353,Bihar,19,24,20,1,64,Pass
Aditya Mehta,13-01-2005,851103,West Bengal,19,17,1,16,53,Pass
Vivaan Reddy,08-01-2005,904244,Haryana,21,14,3,7,45,Pass
Manpreet Mehta,22-05-2005,491892,Telangana,6,20,21,5,52,Pass
Paul Pillai,02-05-2006,304327,Punjab,23,0,17,10,50,Pass
Krishna Reddy,10-11-2004,967237,Uttar Pradesh,11,9,10,2,32,Pass
Rohan Reddy,15-02-2005,582697,Rajasthan,11,22,2,16,51,Pass
Aditya Pillai,16-04-2005,869081,Assam,7,21,2,0,30,Pass
Yash Reddy,04-08-2005,257440,Maharashtra,18,7,2,18,45,Pass
Ishaan Chopra,02-12-2005,443643,Bihar,8,0,2,21,31,Pass
Yash Pillai,09-02-2006,937135,Telangana,11,11,16,23,61,Pass
Aryan Singh,11-04-2005,273524,Telangana,9,14,0,6,29,Pass
Aryan Khan,24-04-2006,183455,Madhya Pradesh,13,9,19,8,49,Pass
Harjeet Fernandes,14-06-2005,736540,Andhra Pradesh,5,8,19,20,52,Pass
Paul Reddy,18-11-2004,599184,Rajasthan,22,14,24,6,66,Pass
Aryan Khan,22-03-2006,513751,Karnataka,9,10,9,14,42,Pass
Zaid Chopra,21-01-2006,662837,Madhya Pradesh,17,23,3,14,57,Pass
David Reddy,27-03-2006,988851,Bihar,17,19,5,13,54,Pass
Ishaan Sharma,29-03-2005,547711,Mizoram,15,5,12,5,37,Pass
Raj Reddy,08-02-2006,158193,Bihar,14,8,8,8,38,Pass
Ishaan Fernandes,15-12-2004,712120,Karnataka,0,9,0,11,20,Pass
Yash Khan,19-06-2005,876601,Maharashtra,19,13,2,15,49,Pass
Yash Pillai,28-12-2004,291187,Uttar Pradesh,3,6,10,2,21,Pass
Aditya Mehta,18-10-2005,594310,Jammu & Kashmir + Ladakh,19,24,19,21,83,Pass
Balbir Khan,30-11-2004,847287,Uttar Pradesh,17,7,7,3,34,Pass
Sukhwinder Singh,25-04-2005,195667,Bihar,14,4,13,11,42,Pass
Kunal Verma,13-11-2004,631668,Uttar Pradesh,1,9,17,0,27,Pass
Manpreet Sharma,11-03-2006,135215,Andhra Pradesh,13,23,10,8,54,Pass
Harjeet Sharma,25-05-2005,639595,Jharkhand,4,2,12,20,38,Pass
Krishna Mehta,11-02-2006,567375,Mizoram,18,3,10,13,44,Pass
Harjeet D'Souza,08-12-2005,146230,Telangana,5,22,1,6,34,Pass
Gurpreet Reddy,19-05-2005,546130,Rajasthan,6,12,23,20,61,Pass
Krishna D'Souza,26-01-2006,132153,Himachal Pradesh,17,2,13,18,50,Pass
Krishna Singh,13-03-2005,211831,Uttar Pradesh,7,23,20,13,63,Pass
Aarav Khan,18-06-2005,160411,Madhya Pradesh,6,18,4,0,28,Pass
Ishaan Reddy,19-04-2005,289568,Odisha,8,6,18,12,44,Pass
Gurpreet Singh,27-08-2005,300377,Tamil Nadu,7,13,23,22,65,Pass
Vivaan Sharma,19-01-2006,797743,Madhya Pradesh,2,16,16,3,37,Pass
Raj Mehta,26-04-2005,814662,Telangana,11,18,21,16,66,Pass
Krishna Verma,21-06-2005,757241,West Bengal,6,10,14,8,38,Pass
Raj Singh,14-02-2005,841435,Bihar,18,10,20,9,57,Pass
Krishna Verma,28-02-2005,716310,Rajasthan,18,5,14,2,39,Pass
Raj Khan,01-02-2005,257954,Telangana,17,3,6,15,41,Pass
Kunal Fernandes,01-04-2005,736791,Madhya Pradesh,18,21,6,8,53,Pass
Imran Pillai,27-04-2005,170840,Tamil Nadu,16,12,19,7,54,Pass
Krishna Sharma,16-08-2005,142961,Maharashtra,19,24,2,24,69,Pass
Yash D'Souza,23-03-2006,344888,Odisha,8,13,6,9,36,Pass
Kunal D'Souza,11-08-2005,375530,West Bengal,7,5,13,3,28,Pass
Gurpreet Sharma,24-01-2005,265985,Jammu & Kashmir + Ladakh,12,13,0,5,30,Pass
Rohan Chopra,03-03-2005,901575,Uttar Pradesh,21,10,24,10,65,Pass
Manpreet Verma,18-05-2005,492888,Gujarat,13,9,2,11,35,Fail
David Verma,06-12-2005,268753,Uttar Pradesh,15,0,19,4,38,Pass
Yash Singh,12-04-2006,725639,Uttar Pradesh,12,1,11,23,47,Pass
Kunal Sharma,26-11-2004,619892,Andhra Pradesh,2,14,9,6,31,Pass
Kunal Pillai,30-07-2005,178465,Jharkhand,13,14,9,23,59,Pass
Harjeet Sharma,05-08-2005,289360,Haryana,14,5,16,15,50,Pass
Yash Pillai,26-06-2005,906533,Rajasthan,19,19,23,17,78,Pass
David D'Souza,07-12-2005,357521,Gujarat,2,20,15,23,60,Fail
David Khan,11-02-2005,953190,Madhya Pradesh,16,5,17,7,45,Pass
Ishaan Sharma,12-08-2005,392959,Gujarat,16,13,11,11,51,Fail
Gurpreet Sharma,31-01-2006,239124,Telangana,20,11,7,8,46,Pass
Gurpreet Fernandes,07-01-2006,530901,Kerala,24,12,18,4,58,Pass
Rohan Pillai,22-04-2006,266607,Maharashtra,19,9,2,23,53,Pass
Yash Singh,09-02-2005,700447,Haryana,2,12,24,9,47,Pass
Aarav Mehta,02-05-2006,169305,West Bengal,3,6,14,10,33,Pass
Raj Verma,23-06-2005,810257,Gujarat,9,9,0,17,35,Fail
Peter Chopra,15-12-2005,692233,Himachal Pradesh,6,5,23,6,40,Pass
Yash Singh,31-10-2005,524956,Uttar Pradesh,3,9,7,10,29,Pass
Harjeet Khan,01-01-2005,656596,Madhya Pradesh,18,17,3,2,40,Pass
Raj Mehta,03-01-2006,408548,Kerala,4,12,20,12,48,Pass
Yash Mehta,27-09-2005,573998,Andhra Pradesh,10,3,12,19,44,Pass
Sukhwinder D'Souza,21-02-2006,794082,Odisha,10,4,16,16,46,Pass
Aarav Reddy,08-12-2005,674604,West Bengal,3,21,15,6,45,Pass
Vivaan Reddy,02-07-2005,168351,Uttar Pradesh,11,2,0,20,33,Pass
Ishaan Verma,28-06-2005,991782,Tamil Nadu,6,20,23,17,66,Pass
Krishna Mehta,07-01-2005,328970,Bihar,8,16,0,19,43,Pass
Ishaan Chopra,30-05-2005,750627,Haryana,10,1,6,0,17,Pass
Zaid Reddy,21-04-2006,201716,Himachal Pradesh,23,0,21,8,52,Pass
Aditya Chopra,04-02-2005,232125,Maharashtra,22,12,2,20,56,Pass
Aditya Fernandes,09-03-2006,148527,Uttar Pradesh,22,5,20,23,70,Pass
Aditya Reddy,28-08-2005,448590,Meghalaya,6,16,5,6,33,Pass
Aarav Fernandes,06-04-2006,371212,West Bengal,3,22,14,17,56,Pass
Raj Chopra,04-09-2005,562730,Rajasthan,19,15,13,8,55,Pass
Rohan Singh,01-10-2005,947952,Tamil Nadu,14,15,21,24,74,Pass
Vivaan Fernandes,09-06-2005,712398,Uttar Pradesh,4,14,7,21,46,Pass
Vivaan Fernandes,14-05-2005,672339,Rajasthan,6,18,12,3,39,Pass
Rohan Pillai,23-04-2006,379297,Rajasthan,3,0,8,6,17,Pass
Manpreet Khan,20-01-2006,871371,Rajasthan,8,22,13,2,45,Pass
Harjeet Pillai,30-03-2006,971348,Maharashtra,15,15,2,3,35,Pass
Gurpreet Reddy,10-12-2004,682005,Uttar Pradesh,14,12,21,6,53,Pass
Aryan Reddy,04-02-2006,618603,Bihar,16,14,17,10,57,Pass
Kunal Mehta,23-06-2005,921452,Tamil Nadu,22,7,20,5,54,Pass
Aryan Verma,30-11-2004,754830,Uttar Pradesh,5,6,9,12,32,Pass
Gurpreet Sharma,06-09-2005,878108,Chhattisgarh,21,7,7,12,47,Pass
Vivaan Verma,06-04-2005,902574,Rajasthan,2,9,9,8,28,Pass
Gurpreet Reddy,22-03-2005,197755,Punjab,1,7,0,20,28,Pass
Vivaan Mehta,25-11-2004,587299,Uttarakhand,22,18,7,0,47,Pass
Aryan Fernandes,10-05-2005,629250,Madhya Pradesh,22,6,3,7,38,Pass
Paul Khan,07-11-2005,167391,Karnataka,24,18,13,19,74,Fail
Ishaan Reddy,26-02-2006,207770,Bihar,0,6,2,12,20,Pass
Manpreet Fernandes,09-01-2005,804583,Bihar,19,2,12,1,34,Pass
Raj Verma,29-11-2004,854515,Haryana,3,12,23,21,59,Pass
Manpreet Pillai,21-01-2006,559643,Jharkhand,13,22,10,20,65,Pass
Farhan Verma,12-06-2005,847451,Jharkhand,6,21,5,17,49,Pass
Rohan Fernandes,16-12-2004,633948,Madhya Pradesh,10,8,14,9,41,Pass
Aarav D'Souza,27-04-2006,889396,Tamil Nadu,5,2,3,18,28,Pass
Aryan Mehta,08-10-2005,784794,Rajasthan,22,8,15,5,50,Pass
Yash D'Souza,21-07-2005,397854,Telangana,0,20,20,12,52,Pass
Rohan Reddy,29-11-2004,101587,Madhya Pradesh,22,5,3,8,38,Pass
David Khan,28-04-2005,232173,Uttar Pradesh,11,13,18,11,53,Pass
Aarav Fernandes,31-03-2006,497610,Uttarakhand,5,24,3,13,45,Pass
Krishna Khan,12-07-2005,110613,Rajasthan,5,1,23,5,34,Pass
Sukhwinder Reddy,30-08-2005,394100,Assam,4,3,19,21,47,Pass
Kunal Singh,31-05-2005,484527,Tripura,14,24,22,3,63,Pass
Gurpreet Mehta,16-11-2005,467759,Haryana,12,14,10,18,54,Pass
Ishaan Chopra,09-07-2005,726688,West Bengal,3,12,23,4,42,Pass
Paul Chopra,03-10-2005,113454,Haryana,14,17,2,11,44,Pass
Rohan Sharma,16-10-2005,211959,Maharashtra,8,23,11,4,46,Pass
Ishaan Verma,08-11-2004,125844,Haryana,23,14,7,24,68,Pass
Ishaan Reddy,23-01-2006,419099,Tamil Nadu,12,4,8,9,33,Pass
Aryan Singh,09-04-2005,484815,Andhra Pradesh,14,12,9,16,51,Pass
Krishna Khan,25-01-2005,592006,Chhattisgarh,5,19,2,23,49,Pass
Harjeet Sharma,17-02-2005,611238,Himachal Pradesh,10,3,1,19,33,Pass
Yash Fernandes,25-07-2005,872019,Jharkhand,15,7,3,22,47,Pass
Krishna Pillai,30-04-2005,629945,Rajasthan,15,15,7,16,53,Pass
Rohan Mehta,17-03-2006,463206,Tamil Nadu,0,17,14,16,47,Pass
Aditya Singh,31-03-2005,820458,Rajasthan,12,4,14,21,51,Pass
Ishaan Sharma,04-03-2005,455294,Punjab,24,3,1,20,48,Pass
Ishaan Mehta,21-12-2004,749053,Uttar Pradesh,1,20,14,19,54,Pass
Aryan Fernandes,23-12-2004,162892,Rajasthan,8,7,18,24,57,Pass
Raj Chopra,16-06-2005,926133,Jharkhand,4,4,11,2,21,Pass
Yash Reddy,30-10-2005,890425,Delhi,1,19,1,14,35,Pass
Yash Reddy,05-04-2006,210166,Jharkhand,21,14,10,6,51,Pass
Vivaan Mehta,13-04-2005,612916,Punjab,11,21,12,23,67,Pass
Ishaan Verma,02-02-2006,112132,Kerala,20,17,9,20,66,Pass
Manpreet Singh,06-02-2005,119194,Jharkhand,13,19,21,14,67,Pass
Raj Reddy,02-03-2005,836428,Bihar,3,15,6,18,42,Pass
Peter Fernandes,30-11-2005,562801,Maharashtra,0,1,1,5,7,Pass
Raj Verma,17-06-2005,409962,Uttar Pradesh,12,5,4,2,23,Pass
Aditya D'Souza,31-12-2004,476340,Maharashtra,16,14,2,22,54,Pass
Mathew Sharma,20-09-2005,525193,Bihar,5,16,10,16,47,Pass
Kunal Singh,23-12-2005,539491,Chhattisgarh,2,5,17,20,44,Pass
Ishaan Chopra,10-11-2005,901121,Madhya Pradesh,22,13,3,23,61,Pass
David D'Souza,06-07-2005,183711,Gujarat,0,8,12,11,31,Fail
John Pillai,06-05-2006,827731,Jammu & Kashmir + Ladakh,13,14,5,1,33,Pass
Vivaan D'Souza,21-03-2006,734814,Uttar Pradesh,12,9,17,4,42,Pass
Yash Verma,06-03-2005,408793,Chhattisgarh,7,11,23,6,47,Pass
Vivaan Verma,24-11-2005,461962,Bihar,13,3,18,18,52,Pass
Kunal Singh,22-07-2005,927831,Madhya Pradesh,17,6,15,7,45,Pass
Yash D'Souza,18-07-2005,853272,Madhya Pradesh,16,3,3,21,43,Pass
Rohan Sharma,30-12-2005,853957,Jammu & Kashmir + Ladakh,13,2,8,24,47,Pass
Krishna D'Souza,12-08-2005,852113,Odisha,14,5,0,15,34,Pass
Krishna Mehta,27-01-2006,414775,Rajasthan,17,9,23,11,60,Pass
Rohan Verma,18-05-2005,685975,Tamil Nadu,2,4,21,7,34,Pass
Paul Khan,24-08-2005,972757,Uttar Pradesh,14,9,14,22,59,Pass
Aditya Reddy,23-10-2005,973831,West Bengal,7,0,6,7,20,Pass
Yash D'Souza,14-12-2004,591594,Madhya Pradesh,23,18,11,0,52,Pass
Peter D'Souza,01-02-2006,328591,Maharashtra,8,7,3,13,31,Pass
Sukhwinder Verma,11-07-2005,628569,Kerala,2,12,1,0,15,Pass
Balbir Singh,23-01-2006,813425,Maharashtra,4,20,2,11,37,Pass
Aryan Chopra,29-07-2005,436783,Madhya Pradesh,17,15,16,3,51,Pass
Mathew Mehta,08-05-2006,491766,West Bengal,3,21,7,23,54,Pass
Vivaan Sharma,06-04-2005,620125,Bihar,15,22,9,4,50,Pass
Balbir Verma,17-03-2006,860738,Punjab,10,20,20,0,50,Pass
Vivaan Mehta,28-08-2005,671829,Puducherry,19,5,2,3,29,Pass
Yash Fernandes,07-05-2005,584954,Madhya Pradesh,18,15,3,16,52,Pass
Rohan Verma,20-12-2005,964917,Bihar,13,1,24,15,53,Pass
Krishna Chopra,01-06-2005,603614,Andhra Pradesh,13,20,18,9,60,Pass
Farhan Khan,09-03-2005,502722,Bihar,20,2,11,10,43,Pass
Balbir Verma,13-12-2004,772659,Maharashtra,16,12,5,12,45,Pass
Aditya Mehta,01-11-2005,545275,Uttar Pradesh,12,21,0,20,53,Pass
Aarav Verma,25-11-2005,435075,Uttar Pradesh,11,16,14,16,57,Pass
Aarav Verma,27-05-2005,812830,Madhya Pradesh,5,12,13,6,36,Pass
Harjeet Singh,04-08-2005,196529,Goa,6,18,7,19,50,Fail
Krishna Sharma,04-01-2006,197712,Odisha,9,24,19,16,68,Pass
Aditya Sharma,24-12-2005,700074,Jammu & Kashmir + Ladakh,0,6,16,4,26,Pass
Vivaan Fernandes,18-02-2006,846293,Bihar,9,10,3,8,30,Pass
Raj Verma,15-03-2005,940762,Jharkhand,4,20,17,19,60,Fail
Ishaan Fernandes,21-09-2005,415357,Maharashtra,1,18,2,11,32,Pass
Ishaan Khan,20-11-2004,982396,Rajasthan,18,5,17,3,43,Pass
Aditya D'Souza,15-05-2005,161941,Bihar,23,13,2,10,48,Pass
Ishaan Mehta,24-04-2005,472790,Assam,22,23,13,7,65,Pass
Peter Khan,14-11-2004,272716,Uttar Pradesh,7,9,12,12,40,Pass
Raj Fernandes,03-07-2005,405115,Assam,7,3,21,1,32,Pass
Imran Sharma,07-09-2005,379193,Maharashtra,7,14,2,24,47,Pass
Farhan Fernandes,21-04-2005,864318,Jharkhand,4,12,1,8,25,Pass
Vivaan Pillai,13-07-2005,370979,Uttarakhand,21,15,3,16,55,Pass
Kunal Sharma,19-12-2005,539211,Punjab,9,15,16,5,45,Pass
Vivaan D'Souza,11-05-2005,417502,Himachal Pradesh,1,19,15,23,58,Pass
Raj Mehta,22-05-2005,792413,Kerala,17,8,5,12,42,Pass
Mathew Fernandes,17-04-2006,543255,Uttarakhand,13,21,3,1,38,Pass
Raj Verma,29-11-2004,270198,Bihar,18,15,12,22,67,Pass
Imran Khan,28-12-2004,973730,Rajasthan,11,4,23,15,53,Pass
Ishaan Fernandes,05-01-2005,825808,Uttar Pradesh,16,20,15,8,59,Pass
Yash Singh,10-06-2005,159121,Bihar,0,7,19,14,40,Pass
John Fernandes,06-02-2005,145464,Assam,20,1,14,11,46,Pass
Mathew Khan,05-04-2005,842932,Madhya Pradesh,9,19,3,21,52,Pass
John Reddy,04-05-2006,278571,West Bengal,18,0,3,13,34,Pass
Aditya Singh,18-10-2005,734925,Uttar Pradesh,10,2,14,12,38,Pass
Krishna D'Souza,22-09-2005,956464,Madhya Pradesh,15,5,8,21,49,Pass
Peter Chopra,11-05-2005,786702,Bihar,9,7,17,9,42,Pass
Kunal Reddy,23-03-2006,655024,Maharashtra,7,8,4,19,38,Pass
Farhan Pillai,02-06-2005,990782,Andhra Pradesh,13,12,21,1,47,Pass
Ishaan Pillai,18-10-2005,686274,West Bengal,11,13,14,10,48,Pass
Sukhwinder D'Souza,14-03-2005,960451,West Bengal,3,7,11,23,44,Pass
Aarav Verma,01-01-2005,585961,Himachal Pradesh,2,24,7,20,53,Pass
Yash Pillai,18-12-2004,111125,Andhra Pradesh,20,3,24,16,63,Pass
Yash Pillai,27-04-2006,423225,Madhya Pradesh,12,14,10,8,44,Pass
John Pillai,03-01-2006,134623,Uttar Pradesh,5,6,18,23,52,Pass
John Verma,24-06-2005,743423,Rajasthan,8,1,16,1,26,Pass
Yash Chopra,21-11-2005,354727,Madhya Pradesh,0,16,19,2,37,Pass
Raj D'Souza,29-11-2004,880786,Bihar,24,20,12,10,66,Pass
Kunal Reddy,11-02-2006,531046,Uttarakhand,14,16,3,10,43,Pass
David Mehta,20-04-2005,753291,Uttar Pradesh,13,9,24,0,46,Pass
Kunal Chopra,29-11-2004,539625,Bihar,23,13,11,4,51,Pass
Aarav Mehta,20-07-2005,621328,Kerala,4,1,11,1,17,Pass
Vivaan Fernandes,19-05-2005,811364,Haryana,1,18,7,7,33,Pass
Aarav D'Souza,17-01-2006,530421,Maharashtra,18,24,2,6,50,Pass
Balbir Sharma,17-06-2005,537887,Uttar Pradesh,11,2,13,18,44,Pass
Yash Sharma,06-03-2006,360517,Jharkhand,14,20,2,7,43,Pass
Yash Khan,14-02-2005,754569,Tamil Nadu,14,8,0,24,46,Pass
Aryan Verma,14-02-2006,456835,Odisha,21,20,13,2,56,Pass
Aryan Khan,01-01-2005,563129,Bihar,14,7,8,1,30,Pass
Raj Verma,16-01-2005,311412,West Bengal,3,23,9,18,53,Pass
Gurpreet Khan,15-09-2005,577611,Meghalaya,11,0,21,10,42,Pass
Paul Khan,03-03-2005,537490,Uttar Pradesh,15,9,8,9,41,Pass
Manpreet Reddy,08-06-2005,671765,Andhra Pradesh,15,20,18,13,66,Pass
Vivaan Reddy,29-07-2005,245968,Madhya Pradesh,2,23,1,5,31,Pass
Ishaan D'Souza,03-03-2006,997699,Jharkhand,3,16,5,21,45,Pass
Gurpreet Khan,21-09-2005,444587,Assam,0,9,4,13,26,Pass
Peter Reddy,20-05-2005,121275,Maharashtra,18,21,2,22,63,Pass
Aryan Sharma,19-12-2004,869775,Uttarakhand,11,11,3,9,34,Pass
Rohan Mehta,01-02-2005,946137,Punjab,0,19,2,18,39,Pass
Raj Mehta,23-07-2005,268892,Telangana,19,10,2,1,32,Pass
Krishna Verma,09-01-2005,625548,Himachal Pradesh,1,6,7,14,28,Pass
Yash Reddy,04-11-2005,663424,Andhra Pradesh,0,3,24,19,46,Pass
Rohan D'Souza,30-05-2005,455427,Maharashtra,6,10,10,0,26,Pass
Rohan Pillai,22-06-2005,590792,Uttar Pradesh,0,7,17,24,48,Pass
Ayaan Fernandes,31-01-2006,193273,Uttar Pradesh,15,15,15,21,66,Pass
Ishaan Mehta,03-02-2006,364231,Haryana,24,1,4,24,53,Pass
Krishna Pillai,05-01-2005,158452,Meghalaya,13,16,23,0,52,Pass
Manpreet Mehta,08-10-2005,821377,Andhra Pradesh,21,11,22,12,66,Pass
Vivaan Mehta,29-01-2006,104263,Manipur,9,2,14,12,37,Pass
John Reddy,23-03-2005,318895,Madhya Pradesh,19,0,16,18,53,Pass
Raj D'Souza,28-03-2006,746317,Madhya Pradesh,15,12,1,2,30,Pass
Raj Mehta,16-07-2005,513358,Gujarat,9,16,12,15,52,Fail
Raj Pillai,06-07-2005,429504,Bihar,10,8,1,1,20,Pass
Gurpreet D'Souza,29-06-2005,683753,Tamil Nadu,22,9,8,21,60,Pass
Vivaan Mehta,07-08-2005,488599,Maharashtra,5,14,4,13,36,Pass
Sukhwinder Reddy,10-11-2004,656504,Nagaland,5,2,12,4,23,Pass
Rehan Sharma,10-02-2006,220858,Maharashtra,5,13,6,12,36,Pass
Zaid Khan,07-10-2005,231236,Madhya Pradesh,19,16,11,0,46,Pass
Krishna Singh,23-02-2005,969079,Uttar Pradesh,10,16,18,4,48,Pass
Vivaan Sharma,15-02-2006,764014,Bihar,21,21,2,18,62,Pass
David Chopra,20-05-2005,362029,Kerala,13,5,12,1,31,Pass
Rohan Pillai,25-03-2006,355761,Andhra Pradesh,10,11,12,17,50,Pass
Sukhwinder Pillai,12-11-2005,467730,Bihar,1,0,20,20,41,Pass
Aryan Khan,27-06-2005,622478,Uttar Pradesh,11,23,17,15,66,Pass
Aarav Sharma,23-07-2005,819579,Rajasthan,8,2,11,23,44,Pass
Rohan Mehta,04-03-2005,920402,West Bengal,24,2,0,19,45,Pass
Imran Singh,05-12-2005,763723,Bihar,6,15,20,21,62,Pass
Aryan D'Souza,03-01-2006,320794,Gujarat,15,9,24,9,57,Fail
Vivaan Singh,21-09-2005,862975,Uttar Pradesh,21,24,11,9,65,Pass
Yash Chopra,28-06-2005,489215,Maharashtra,5,3,8,3,19,Pass
Aditya Singh,01-10-2005,890453,Uttarakhand,1,9,10,2,22,Pass
Kunal Sharma,08-07-2005,419181,Tamil Nadu,2,17,1,17,37,Pass
Ishaan Reddy,07-10-2005,757929,Nagaland,10,7,8,7,32,Pass
Raj Fernandes,13-11-2005,969670,Rajasthan,17,13,8,24,62,Pass
Aarav Fernandes,25-08-2005,587875,Uttar Pradesh,16,17,1,17,51,Pass
Yash Chopra,18-02-2006,986858,Gujarat,24,19,0,4,47,Fail
Aarav Khan,14-11-2005,140530,Haryana,14,3,7,24,48,Pass
Paul Pillai,07-06-2005,943770,Rajasthan,18,9,11,11,49,Pass
Balbir Pillai,18-10-2005,127092,Tamil Nadu,4,19,19,0,42,Pass
Ishaan Verma,19-07-2005,750438,Bihar,8,16,3,22,49,Pass
Ishaan Singh,06-07-2005,455448,Uttar Pradesh,15,8,9,20,52,Pass
Ishaan Khan,28-10-2005,670108,Gujarat,23,20,22,23,88,Fail
Harjeet D'Souza,16-03-2005,190122,Karnataka,15,14,19,5,53,Pass
Aarav Khan,07-06-2005,251870,Haryana,4,18,22,10,54,Pass
Yash Khan,01-07-2005,103345,Bihar,1,1,23,23,48,Pass
Rohan Chopra,24-06-2005,690775,Himachal Pradesh,15,5,15,16,51,Pass
Mathew Chopra,07-05-2005,153580,Tamil Nadu,12,14,16,16,58,Pass
Manpreet Pillai,21-03-2006,923659,Telangana,23,23,5,12,63,Pass
Harjeet D'Souza,27-02-2006,673626,Jharkhand,6,24,2,8,40,Pass
Gurpreet Khan,18-02-2005,370184,Chhattisgarh,5,2,10,15,32,Pass
Sukhwinder Fernandes,31-07-2005,585966,Uttar Pradesh,5,23,9,23,60,Pass
Aarav Pillai,01-05-2006,798929,Andhra Pradesh,22,0,6,15,43,Pass
Kunal D'Souza,25-12-2004,762094,Rajasthan,16,14,2,2,34,Pass
Balbir Sharma,12-07-2005,249686,West Bengal,12,3,4,1,20,Pass
Aryan Mehta,23-11-2004,699384,Uttar Pradesh,19,6,3,4,32,Pass
Manpreet Reddy,22-04-2005,391701,Odisha,5,11,24,2,42,Pass
Aarav Khan,15-09-2005,738057,Rajasthan,10,12,1,0,23,Pass
Kunal Reddy,16-11-2005,287579,Odisha,2,11,8,23,44,Pass
Rohan D'Souza,16-11-2004,369961,Madhya Pradesh,21,23,3,17,64,Pass
Aryan Fernandes,23-06-2005,574786,Tamil Nadu,23,8,14,21,66,Pass
Aarav Fernandes,16-01-2005,327562,Jharkhand,15,22,18,0,55,Pass
Raj Khan,04-01-2005,375228,Uttar Pradesh,6,7,8,23,44,Pass
Aditya Verma,01-12-2004,122009,Assam,23,9,21,3,56,Pass
Kunal Fernandes,28-12-2005,583136,Madhya Pradesh,9,5,12,1,27,Pass
Ishaan Mehta,25-11-2004,910445,Uttarakhand,6,13,3,12,34,Pass
Krishna Singh,16-01-2006,902052,Madhya Pradesh,4,12,15,14,45,Pass
Ishaan Chopra,13-05-2005,242328,Chhattisgarh,9,24,13,23,69,Pass
Aryan Pillai,08-05-2005,936836,Karnataka,14,9,7,13,43,Pass
Ishaan Sharma,02-11-2005,582889,Haryana,17,17,16,21,71,Pass
Vivaan Fernandes,08-03-2005,981000,Andhra Pradesh,11,15,7,9,42,Pass
Paul Khan,30-09-2005,388158,Madhya Pradesh,23,14,3,13,53,Pass
Aarav Chopra,30-03-2005,436071,Chhattisgarh,19,15,3,8,45,Pass
Aarav Khan,29-06-2005,594429,Rajasthan,20,2,19,10,51,Pass
Vivaan Fernandes,22-04-2005,220244,Jharkhand,22,12,15,21,70,Fail
Rohan Pillai,16-02-2005,446227,West Bengal,0,6,13,14,33,Pass
Ishaan Verma,21-05-2005,571305,Gujarat,1,0,15,7,23,Fail
Raj D'Souza,11-12-2004,482681,Manipur,15,4,2,24,45,Pass
Aarav Reddy,06-05-2005,823948,Tamil Nadu,5,18,6,13,42,Pass
Raj Fernandes,02-09-2005,888070,Uttar Pradesh,14,2,20,18,54,Pass
Krishna Fernandes,18-06-2005,335905,Andhra Pradesh,2,3,0,3,8,Pass
Raj Sharma,26-02-2005,554326,Odisha,23,24,11,18,76,Pass
Yash Verma,26-02-2005,116118,Haryana,4,11,2,0,17,Pass
Raj Reddy,05-03-2005,135900,Himachal Pradesh,5,9,1,21,36,Pass
Aarav Reddy,29-01-2005,780627,Uttarakhand,23,8,2,0,33,Pass
Yash Chopra,29-01-2006,184868,West Bengal,3,19,9,18,49,Pass
Yash Pillai,19-06-2005,663123,Andhra Pradesh,11,16,8,22,57,Pass
Ayaan D'Souza,30-01-2005,134444,Delhi,15,18,22,19,74,Pass
Yash Verma,20-07-2005,623421,Himachal Pradesh,9,15,19,12,55,Pass
Balbir D'Souza,06-08-2005,901125,Karnataka,13,24,22,17,76,Fail
Yash Chopra,15-01-2005,158673,Uttar Pradesh,4,4,18,24,50,Pass
Vivaan Fernandes,23-01-2006,729878,Rajasthan,0,4,10,23,37,Pass
Rohan Verma,17-03-2005,719204,Uttar Pradesh,13,13,14,24,64,Pass
Vivaan Reddy,14-10-2005,446991,Andhra Pradesh,24,14,12,0,50,Pass
Raj Fernandes,22-04-2006,805861,Andhra Pradesh,21,8,18,5,52,Pass
Raj Sharma,02-12-2004,925431,Punjab,5,11,19,10,45,Pass
Aditya D'Souza,23-10-2005,593689,Haryana,24,4,13,3,44,Pass
Vivaan Sharma,02-04-2005,476903,Bihar,20,2,21,7,50,Pass
Aryan Reddy,03-06-2005,697922,Uttar Pradesh,2,15,21,9,47,Pass
Aarav Pillai,24-10-2005,697911,Andhra Pradesh,14,14,13,9,50,Pass
Yash Verma,22-12-2005,277979,Rajasthan,3,12,13,6,34,Pass
Rehan Singh,14-09-2005,560448,Odisha,23,2,16,17,58,Pass
Raj Verma,20-07-2005,690059,Punjab,0,0,14,21,35,Pass
Vivaan Sharma,23-11-2004,819860,Rajasthan,10,11,24,5,50,Pass
Ishaan Chopra,12-03-2005,682625,Tamil Nadu,2,8,21,0,31,Pass
Rohan Fernandes,07-08-2005,111662,Karnataka,9,7,10,24,50,Pass
Raj Mehta,23-04-2006,755453,Tamil Nadu,14,11,18,16,59,Pass
Paul D'Souza,27-01-2005,227529,Uttarakhand,3,7,11,11,32,Pass
Manpreet Reddy,16-09-2005,790745,Punjab,20,23,16,22,81,Pass
Raj Sharma,19-05-2005,821850,Bihar,9,2,20,15,46,Pass
Mathew Verma,06-08-2005,820481,Karnataka,22,7,24,20,73,Fail
Rohan Khan,24-03-2006,199251,Rajasthan,21,19,17,12,69,Pass
Sukhwinder Khan,18-06-2005,345185,Andhra Pradesh,15,8,2,24,49,Pass
Aryan Reddy,09-07-2005,636467,Bihar,10,5,4,5,24,Pass
Yash Sharma,06-01-2006,339572,Andhra Pradesh,16,24,22,1,63,Pass
Aditya Fernandes,25-04-2006,854738,Maharashtra,4,1,0,13,18,Pass
Aditya Reddy,15-04-2006,604709,Chhattisgarh,8,18,10,5,41,Pass
Vivaan Singh,28-12-2005,935811,Uttar Pradesh,10,22,13,7,52,Pass
Aryan Chopra,11-09-2005,290345,Bihar,15,24,16,7,62,Pass
Aryan Mehta,12-01-2005,902496,Uttar Pradesh,1,3,21,12,37,Pass
Aarav Fernandes,29-11-2004,514000,Uttar Pradesh,17,16,18,19,70,Pass
Kunal Reddy,25-04-2005,323995,Bihar,12,0,22,21,55,Pass
Manpreet Chopra,19-06-2005,471604,Tamil Nadu,10,2,15,21,48,Pass
Kunal Singh,18-12-2005,752182,Punjab,6,4,14,12,36,Pass
Vivaan Pillai,22-11-2004,557312,Uttar Pradesh,17,24,22,5,68,Pass
Raj Singh,09-12-2004,537441,Haryana,1,19,5,5,30,Pass
Raj Verma,07-05-2005,465023,Uttar Pradesh,16,18,5,2,41,Pass
Rohan Reddy,14-01-2006,562420,Punjab,2,3,2,6,13,Pass
Paul Pillai,14-04-2006,742899,Telangana,12,6,7,19,44,Pass
Rohan Mehta,09-09-2005,937679,Delhi,5,12,10,8,35,Pass
Vivaan D'Souza,12-01-2006,205522,Andhra Pradesh,12,14,23,7,56,Pass
Rohan Fernandes,26-03-2006,261578,Andhra Pradesh,17,14,10,17,58,Pass
Zaid Pillai,31-03-2005,344672,Delhi,20,23,23,1,67,Pass
Vivaan Fernandes,21-02-2005,997549,Bihar,1,11,22,14,48,Pass
Ishaan Khan,23-11-2004,842586,Bihar,8,24,8,10,50,Pass
Rohan Reddy,27-08-2005,613844,Rajasthan,14,21,23,11,69,Pass
Aryan Reddy,10-01-2006,206393,Jammu & Kashmir + Ladakh,23,11,19,17,70,Pass
Kunal D'Souza,19-02-2005,368350,Uttar Pradesh,20,24,11,7,62,Pass
Aditya Chopra,03-04-2005,685170,Tamil Nadu,13,0,8,10,31,Pass
Ishaan Chopra,17-03-2005,300538,Telangana,15,20,7,0,42,Pass
Aarav Fernandes,31-10-2005,388211,Jammu & Kashmir + Ladakh,9,11,4,7,31,Pass
Rohan Chopra,12-07-2005,431772,Uttarakhand,19,12,0,1,32,Pass
Vivaan Khan,28-09-2005,160468,Madhya Pradesh,1,6,9,19,35,Pass
Sukhwinder Sharma,30-03-2005,995833,Uttar Pradesh,15,12,23,16,66,Pass
Yash Singh,14-06-2005,855595,Odisha,18,5,5,8,36,Pass
Krishna D'Souza,11-07-2005,482491,Chhattisgarh,18,20,4,12,54,Pass
Kunal Fernandes,23-10-2005,293280,Haryana,9,9,24,8,50,Pass
Aditya Pillai,20-02-2006,194027,Tamil Nadu,13,20,9,14,56,Pass
Rohan Fernandes,31-07-2005,764432,Madhya Pradesh,21,9,11,10,51,Pass
Kunal Reddy,23-03-2006,393265,Madhya Pradesh,8,20,3,17,48,Pass
Aryan Pillai,23-07-2005,534830,Bihar,18,19,8,11,56,Pass
Yash Sharma,25-08-2005,687228,Bihar,1,21,3,17,42,Pass
Raj Pillai,11-02-2006,297345,Maharashtra,23,6,2,22,53,Pass
David Fernandes,23-06-2005,241724,Jammu & Kashmir + Ladakh,20,8,19,12,59,Pass
Paul Pillai,01-06-2005,530848,Uttarakhand,0,0,7,20,27,Pass
Sukhwinder D'Souza,08-11-2005,884494,Maharashtra,18,13,2,7,40,Pass
Peter Pillai,11-02-2005,744529,West Bengal,6,9,7,21,43,Pass
Krishna Chopra,18-03-2005,777137,Telangana,16,24,21,6,67,Pass
Yash Verma,21-12-2005,471327,West Bengal,8,24,2,20,54,Pass
Aditya Fernandes,16-03-2006,636372,Jharkhand,12,0,1,0,13,Pass
Krishna Khan,27-12-2005,281897,Punjab,15,8,15,0,38,Pass
Kunal Fernandes,18-08-2005,323413,Kerala,20,16,18,12,66,Pass
Gurpreet Sharma,27-06-2005,611979,Andhra Pradesh,10,2,6,19,37,Pass
Aarav D'Souza,09-01-2006,609938,Jharkhand,13,13,17,13,56,Pass
Raj Reddy,05-04-2006,117884,Rajasthan,5,14,21,22,62,Pass
Aryan Singh,14-12-2005,873184,Punjab,1,17,16,14,48,Pass
Aditya Reddy,22-03-2006,503502,Chhattisgarh,5,16,23,20,64,Pass
Aditya Khan,02-01-2005,238997,Meghalaya,12,11,14,8,45,Pass
Raj Fernandes,04-05-2005,246530,Rajasthan,0,2,11,17,30,Pass
Paul Singh,12-04-2005,408986,Rajasthan,9,17,19,15,60,Pass
Raj Khan,29-08-2005,803427,Sikkim,1,5,5,14,25,Pass
Vivaan Chopra,08-03-2006,537528,Maharashtra,3,14,5,10,32,Pass
Peter Reddy,13-11-2004,774529,Delhi,14,21,3,24,62,Pass
Aarav D'Souza,09-07-2005,342661,Tamil Nadu,19,6,23,8,56,Pass
Ishaan Sharma,28-11-2005,505364,Telangana,4,20,19,21,64,Pass
Vivaan Mehta,22-04-2006,630684,Gujarat,5,4,19,14,42,Fail
Aryan Singh,01-03-2005,349483,Haryana,20,24,10,11,65,Pass
Aryan Singh,23-03-2005,785578,Uttar Pradesh,2,24,24,6,56,Pass
Kunal Sharma,10-02-2005,717420,Haryana,23,20,21,11,75,Pass
Balbir Verma,05-05-2006,114092,Manipur,4,12,6,16,38,Pass
Harjeet Reddy,26-02-2005,959433,Tamil Nadu,3,18,24,4,49,Pass
Kunal Pillai,18-05-2005,976797,Gujarat,15,6,17,1,39,Fail
Raj Singh,16-02-2006,486861,Rajasthan,18,2,19,16,55,Pass
Zaid Chopra,30-01-2006,177059,Madhya Pradesh,2,3,8,10,23,Pass
Kunal Fernandes,22-07-2005,480223,Uttar Pradesh,4,10,4,1,19,Pass
Aarav Reddy,24-09-2005,894123,Assam,4,20,10,22,56,Pass
Aditya Verma,07-04-2006,610666,Punjab,1,22,4,21,48,Pass
Aarav Fernandes,04-09-2005,469231,Maharashtra,19,13,4,11,47,Pass
Paul Sharma,16-01-2005,907632,Gujarat,16,11,21,5,53,Fail
Raj Fernandes,21-06-2005,312592,Uttar Pradesh,22,13,9,21,65,Pass
Ishaan Verma,01-08-2005,361353,Delhi,7,22,2,24,55,Pass
Mathew Sharma,11-01-2006,504888,Uttar Pradesh,17,9,15,11,52,Pass
Yash Sharma,04-01-2005,885983,Uttar Pradesh,24,23,16,9,72,Pass
Vivaan Reddy,28-06-2005,118537,Kerala,10,16,3,5,34,Pass
Aditya Khan,29-05-2005,123363,Haryana,13,14,22,19,68,Pass
Harjeet Khan,18-12-2004,377583,Rajasthan,16,18,15,22,71,Pass
Vivaan Reddy,23-03-2005,934402,Chhattisgarh,8,2,3,5,18,Pass
Vivaan Reddy,25-07-2005,659653,West Bengal,3,6,21,11,41,Pass
Vivaan Chopra,23-04-2006,442616,Uttar Pradesh,13,0,1,4,18,Pass
Kunal Sharma,02-06-2005,209809,Odisha,20,15,22,11,68,Pass
Vivaan Verma,07-04-2006,926258,Uttarakhand,7,20,8,12,47,Pass
Aarav D'Souza,14-02-2005,828548,Odisha,13,17,2,7,39,Pass
Yash Fernandes,25-09-2005,871051,Andhra Pradesh,18,5,24,22,69,Pass
Aryan Singh,04-11-2005,243165,Bihar,20,13,5,9,47,Pass
Vivaan Sharma,03-08-2005,832817,Rajasthan,22,12,9,13,56,Pass
David Fernandes,08-03-2006,147736,West Bengal,12,17,18,2,49,Pass
Krishna Verma,02-12-2004,333466,Bihar,11,16,13,24,64,Pass
Balbir Chopra,06-06-2005,532429,Uttar Pradesh,7,13,1,0,21,Pass
Harjeet Chopra,15-04-2005,131073,Himachal Pradesh,12,17,3,2,34,Pass
Krishna Khan,03-05-2005,434442,West Bengal,7,2,9,7,25,Pass
Paul D'Souza,28-04-2005,815605,Maharashtra,8,20,2,17,47,Pass
Raj Reddy,04-04-2005,574982,Gujarat,2,14,18,13,47,Fail
Mathew Fernandes,16-05-2005,655875,Punjab,11,19,17,18,65,Pass
Aryan Verma,27-12-2004,416216,Tamil Nadu,5,9,21,1,36,Pass
Raj Verma,28-12-2004,933903,Rajasthan,19,12,2,1,34,Pass
Raj Fernandes,05-02-2005,674079,Tamil Nadu,14,24,2,0,40,Pass
Kunal Pillai,10-01-2006,886830,Odisha,1,20,15,13,49,Pass
John Fernandes,10-03-2005,693655,Madhya Pradesh,6,4,15,8,33,Pass
Rehan Chopra,21-01-2006,742501,Kerala,11,23,20,18,72,Fail
Manpreet Khan,17-02-2005,507631,Telangana,3,16,18,21,58,Pass
Aarav Sharma,16-02-2006,438930,Rajasthan,7,19,17,16,59,Pass
David D'Souza,31-03-2005,896411,Tamil Nadu,21,5,7,20,53,Pass
Rohan Reddy,25-04-2005,908551,Tamil Nadu,17,22,20,0,59,Pass
Aryan Chopra,05-10-2005,735652,West Bengal,3,23,11,23,60,Pass
Vivaan Mehta,12-11-2005,191937,Tamil Nadu,0,18,0,24,42,Pass
Vivaan Sharma,13-05-2005,747314,Punjab,4,5,6,19,34,Pass
Yash Mehta,17-08-2005,879456,Himachal Pradesh,4,15,13,10,42,Pass
John D'Souza,27-02-2006,980996,Delhi,4,16,12,11,43,Pass
Vivaan Fernandes,04-11-2005,214380,Punjab,24,19,18,23,84,Pass
Vivaan Reddy,20-09-2005,604543,Delhi,3,5,13,6,27,Pass
Ishaan D'Souza,17-04-2005,333659,Odisha,1,13,19,11,44,Pass
Peter Chopra,11-04-2006,347091,Rajasthan,14,3,0,11,28,Pass
Aarav Sharma,18-01-2006,320454,Maharashtra,0,9,1,23,33,Pass
Raj Sharma,12-11-2005,313878,Andhra Pradesh,8,18,0,14,40,Pass
Aditya Singh,06-04-2006,496128,Madhya Pradesh,21,1,1,9,32,Pass
Aditya Mehta,24-03-2006,190834,Haryana,20,2,22,0,44,Pass
Zaid Singh,27-12-2005,300504,Uttar Pradesh,2,17,10,11,40,Pass
Raj Chopra,08-11-2005,833202,Delhi,10,3,3,6,22,Pass
Paul Reddy,01-12-2004,119245,Himachal Pradesh,1,3,24,23,51,Pass
Ishaan Fernandes,04-09-2005,629817,Punjab,24,20,10,0,54,Pass
Raj Verma,07-02-2006,955082,Punjab,21,15,13,9,58,Pass
Peter Fernandes,22-06-2005,813761,Uttar Pradesh,1,22,14,20,57,Pass
Aryan D'Souza,05-02-2005,373312,Jharkhand,18,18,6,21,63,Pass
Balbir Verma,05-12-2004,140235,Gujarat,16,17,19,24,76,Fail
Balbir Singh,09-06-2005,637228,Haryana,3,6,11,1,21,Pass
Harjeet Fernandes,31-01-2006,239421,Punjab,20,19,14,23,76,Pass
Vivaan Verma,05-03-2006,800351,Uttarakhand,3,22,3,14,42,Pass
Balbir Sharma,03-09-2005,459260,Odisha,3,2,3,20,28,Pass
Raj D'Souza,29-09-2005,249150,Madhya Pradesh,23,6,11,6,46,Pass
Yash Sharma,23-08-2005,837286,Kerala,13,5,17,7,42,Pass
Aryan Pillai,28-03-2005,198665,Madhya Pradesh,6,20,23,3,52,Pass
Aditya Khan,16-06-2005,157920,Uttar Pradesh,2,0,20,18,40,Pass
Rohan Reddy,12-08-2005,626964,Tamil Nadu,23,0,7,13,43,Pass
Aryan Verma,28-07-2005,407332,Uttar Pradesh,17,14,8,22,61,Pass
Aryan Verma,06-01-2005,256487,Jharkhand,2,22,12,4,40,Pass
Krishna Pillai,23-01-2005,385879,Bihar,24,24,21,15,84,Pass
Raj Chopra,19-03-2006,511768,Jharkhand,9,16,23,6,54,Pass
Vivaan Chopra,04-05-2005,111396,Rajasthan,13,2,9,24,48,Pass
Aryan Pillai,11-12-2005,846718,Andhra Pradesh,9,8,19,19,55,Pass
Rehan Sharma,31-12-2005,986726,Rajasthan,23,23,6,0,52,Pass
Aarav Khan,05-06-2005,593175,Delhi,13,5,18,11,47,Pass
Raj Reddy,17-05-2005,740942,Bihar,5,4,0,22,31,Pass
Ishaan Reddy,15-05-2005,962802,Andhra Pradesh,23,7,12,1,43,Pass
Ishaan Reddy,16-12-2004,848178,Bihar,3,16,17,20,56,Pass
Peter D'Souza,04-03-2006,975928,Rajasthan,23,15,17,22,77,Pass
Aarav Pillai,25-08-2005,227654,Kerala,14,23,10,6,53,Pass
Krishna Khan,19-10-2005,834541,Madhya Pradesh,11,6,11,19,47,Pass
Sukhwinder Chopra,06-10-2005,414042,Rajasthan,13,15,24,1,53,Pass
Rohan Reddy,06-06-2005,269470,Goa,3,7,2,13,25,Fail
Aditya Verma,03-05-2006,355446,Arunachal Pradesh,4,1,11,20,36,Pass
Krishna Chopra,07-07-2005,491236,Punjab,9,14,3,12,38,Pass
Raj Reddy,26-02-2005,964815,Uttar Pradesh,19,3,24,6,52,Pass
Mathew Khan,23-12-2004,353904,Madhya Pradesh,17,16,4,17,54,Pass
Kunal D'Souza,30-01-2006,556885,Bihar,20,23,12,8,63,Pass
Kunal Reddy,23-02-2005,194952,Bihar,23,8,0,7,38,Pass
Rehan Singh,02-12-2004,656641,Bihar,20,1,16,15,52,Pass
Ishaan Sharma,09-08-2005,241134,Maharashtra,3,20,4,19,46,Pass
Zaid Singh,22-12-2004,897823,Punjab,2,5,5,8,20,Pass
Manpreet Chopra,22-02-2005,873943,Andhra Pradesh,24,18,14,4,60,Pass
Harjeet Fernandes,27-12-2005,407975,Jharkhand,8,23,7,24,62,Pass
Kunal Sharma,13-12-2004,237812,Chhattisgarh,3,4,11,23,41,Pass
Aryan D'Souza,24-03-2006,239080,Andhra Pradesh,7,21,4,11,43,Pass
Sukhwinder Pillai,29-06-2005,926213,Rajasthan,4,21,4,0,29,Pass
Balbir Mehta,18-10-2005,837830,Bihar,16,6,20,17,59,Pass
Vivaan Verma,22-12-2005,854841,Maharashtra,16,1,2,23,42,Pass
Aryan Chopra,31-01-2005,824709,Tamil Nadu,4,6,11,14,35,Pass
Gurpreet Reddy,21-12-2004,101425,Himachal Pradesh,24,6,21,6,57,Pass
Manpreet Pillai,14-06-2005,979901,Haryana,6,2,6,10,24,Pass
Aditya Verma,13-11-2004,412146,Bihar,17,13,9,21,60,Pass
Balbir Verma,01-11-2005,804466,West Bengal,21,1,1,19,42,Pass
Aryan D'Souza,21-01-2006,122675,Jharkhand,13,8,8,18,47,Pass
David Reddy,28-09-2005,245125,West Bengal,13,16,5,14,48,Pass
Manpreet Khan,03-02-2005,152008,Himachal Pradesh,13,4,7,1,25,Pass
Manpreet Mehta,18-11-2004,699678,Manipur,9,19,7,15,50,Pass
John Pillai,26-08-2005,975556,Uttar Pradesh,5,21,9,15,50,Pass
Kunal Singh,22-08-2005,904630,Maharashtra,20,13,2,17,52,Pass
Krishna Fernandes,21-07-2005,343364,Bihar,22,16,24,13,75,Pass
Krishna Singh,21-12-2004,125582,Tamil Nadu,11,11,10,18,50,Pass
Manpreet Reddy,22-12-2004,952896,Uttar Pradesh,16,0,14,3,33,Pass
Rohan D'Souza,07-03-2005,483512,Punjab,7,24,11,14,56,Pass
Aarav Sharma,06-02-2005,968168,Odisha,17,21,16,8,62,Pass
Aditya Reddy,28-07-2005,733431,Tamil Nadu,4,21,17,21,63,Pass
Rohan Singh,24-04-2005,374510,Tamil Nadu,11,19,22,17,69,Pass
Aditya Fernandes,12-12-2004,547196,Bihar,10,16,1,15,42,Pass
Aditya D'Souza,12-12-2004,647111,Assam,12,11,8,8,39,Pass
Farhan Sharma,19-11-2005,455341,Jharkhand,15,19,0,19,53,Pass
Kunal Fernandes,03-07-2005,453757,Madhya Pradesh,5,4,16,17,42,Pass
John D'Souza,11-08-2005,850881,Jharkhand,22,21,21,0,64,Pass
Ishaan Reddy,15-01-2005,464714,Maharashtra,20,11,2,20,53,Pass
Vivaan Chopra,28-11-2005,942776,Andhra Pradesh,17,18,0,12,47,Pass
Farhan Sharma,06-09-2005,779959,Uttar Pradesh,6,4,2,11,23,Pass
Raj Mehta,28-01-2005,246564,Odisha,21,11,0,4,36,Pass
Aditya Verma,30-03-2005,303642,Uttar Pradesh,24,21,21,3,69,Pass
Vivaan Chopra,19-10-2005,128078,West Bengal,3,13,24,11,51,Pass
Mathew Sharma,13-04-2005,870155,Andhra Pradesh,4,4,6,18,32,Pass
Rohan Sharma,04-06-2005,598193,Bihar,1,11,6,7,25,Pass
Raj Khan,18-02-2005,727081,Bihar,12,11,8,15,46,Pass
Krishna Sharma,12-07-2005,100741,Uttar Pradesh,7,9,12,5,33,Pass
Aditya Sharma,15-03-2005,837971,Assam,13,18,19,8,58,Pass
Vivaan Pillai,19-01-2005,184643,Madhya Pradesh,12,17,3,23,55,Pass
Ishaan Verma,31-08-2005,174847,Rajasthan,10,5,18,3,36,Pass
Raj Verma,29-04-2006,656380,Punjab,20,9,4,23,56,Pass
Kunal Verma,06-10-2005,286022,Tamil Nadu,17,16,8,18,59,Pass
Raj Singh,27-02-2006,806689,Gujarat,1,22,7,13,43,Fail
Kunal Chopra,05-03-2006,926464,Kerala,11,14,11,13,49,Pass
Gurpreet Reddy,31-12-2004,219495,Andhra Pradesh,3,16,10,22,51,Pass
Raj Pillai,18-09-2005,442109,Punjab,11,16,7,17,51,Pass
Aryan Sharma,04-03-2006,777113,Uttar Pradesh,9,24,2,6,41,Pass
Gurpreet Chopra,18-12-2004,864315,Maharashtra,13,0,4,23,40,Pass
Yash Singh,24-08-2005,139319,Jharkhand,3,15,3,4,25,Pass
Ishaan Khan,15-11-2005,986090,Andhra Pradesh,0,17,16,20,53,Pass
Balbir Reddy,23-12-2005,682253,Uttar Pradesh,12,2,20,17,51,Pass
Rohan Sharma,30-09-2005,329290,Andhra Pradesh,18,16,4,16,54,Pass
Ishaan Khan,31-08-2005,863654,Andhra Pradesh,21,20,22,4,67,Pass
Vivaan Khan,22-10-2005,675522,Rajasthan,21,11,21,6,59,Pass
Krishna Fernandes,08-01-2006,817861,Andhra Pradesh,9,17,20,17,63,Pass
Manpreet D'Souza,21-03-2006,742558,Assam,14,6,12,4,36,Pass
Vivaan Fernandes,13-09-2005,391000,Jammu & Kashmir + Ladakh,7,21,12,20,60,Pass
Yash Singh,13-11-2004,481792,Bihar,7,10,16,11,44,Pass
Ishaan Verma,25-02-2005,541519,Manipur,4,23,22,5,54,Pass
Ishaan Sharma,12-08-2005,277675,Odisha,18,13,10,14,55,Pass
Raj Mehta,20-02-2006,585890,Gujarat,14,19,20,15,68,Fail
John Mehta,17-11-2004,736559,Uttar Pradesh,13,21,19,7,60,Pass
Farhan D'Souza,17-12-2005,460163,Uttar Pradesh,6,16,5,4,31,Pass
Ishaan Khan,18-02-2006,258221,Bihar,23,16,17,13,69,Pass
Rehan Mehta,04-06-2005,968728,Telangana,24,5,18,5,52,Pass
Harjeet Fernandes,07-05-2005,935290,Odisha,16,20,21,2,59,Pass
Aarav Pillai,15-02-2005,727786,Uttar Pradesh,7,3,9,9,28,Pass
Aditya Verma,19-05-2005,465379,Bihar,17,21,23,18,79,Pass
Vivaan Verma,14-06-2005,923413,Uttar Pradesh,20,14,7,9,50,Pass
Manpreet Verma,25-02-2006,183416,Haryana,7,23,22,3,55,Pass
Peter Sharma,11-04-2006,107387,West Bengal,16,5,9,17,47,Pass
Aarav Reddy,01-12-2004,316540,Uttar Pradesh,9,11,11,5,36,Pass
Paul Pillai,01-04-2006,478108,Jammu & Kashmir + Ladakh,4,19,12,0,35,Pass
Ishaan Chopra,11-07-2005,676624,Bihar,21,1,1,7,30,Pass
Harjeet Pillai,06-04-2006,358155,Gujarat,7,14,6,11,38,Fail
Rehan Sharma,13-07-2005,532378,Bihar,3,23,17,7,50,Pass
Kunal Fernandes,30-11-2005,345712,Madhya Pradesh,17,18,0,18,53,Pass
Rohan Sharma,01-03-2006,506201,Meghalaya,11,21,6,7,45,Pass
Raj Chopra,06-11-2005,604899,Tamil Nadu,24,18,7,6,55,Pass
Farhan Verma,08-02-2005,294718,Gujarat,3,2,18,23,46,Fail
Aditya Sharma,09-11-2004,127637,Bihar,1,6,2,11,20,Pass
Ishaan D'Souza,22-04-2006,232366,Uttar Pradesh,2,9,22,12,45,Pass
Vivaan Sharma,26-11-2004,303049,Madhya Pradesh,1,5,3,16,25,Pass
Imran Mehta,20-11-2005,725811,Tamil Nadu,9,7,14,3,33,Pass
Vivaan Chopra,16-08-2005,563997,Manipur,19,10,3,7,39,Pass
Rohan Khan,03-02-2006,415005,Telangana,2,13,2,9,26,Pass
Yash Verma,08-02-2005,509836,Rajasthan,17,8,10,8,43,Pass
Ishaan Chopra,23-04-2005,863470,Chhattisgarh,15,22,5,24,66,Pass
Harjeet Fernandes,12-08-2005,406169,Uttar Pradesh,1,7,15,23,46,Pass
Paul Fernandes,31-08-2005,625239,Bihar,24,16,1,16,57,Pass
Aarav Pillai,30-12-2005,328154,Haryana,3,20,19,13,55,Pass
Aarav Sharma,25-12-2005,306078,Uttar Pradesh,10,9,15,3,37,Pass
Mathew Mehta,24-03-2006,775061,Uttar Pradesh,17,10,3,13,43,Pass
Harjeet D'Souza,08-01-2005,431757,Delhi,20,4,13,18,55,Pass
Krishna Singh,31-05-2005,676788,Uttar Pradesh,12,22,14,24,72,Pass
Aditya Reddy,12-03-2005,797331,Tamil Nadu,8,4,5,6,23,Pass
Yash Mehta,29-06-2005,521886,Odisha,11,17,19,13,60,Pass
Sukhwinder Singh,17-03-2006,696508,Uttar Pradesh,15,15,24,8,62,Pass
Rohan Khan,10-11-2004,308002,Gujarat,13,0,3,17,33,Fail
Raj Pillai,04-05-2006,775251,Gujarat,6,8,23,20,57,Fail
Aryan Mehta,23-08-2005,239095,Maharashtra,17,13,2,17,49,Pass
Gurpreet D'Souza,08-11-2004,184256,Madhya Pradesh,6,3,22,14,45,Pass
Harjeet Khan,04-02-2005,914568,Uttar Pradesh,0,1,13,22,36,Pass
Krishna Pillai,25-02-2005,411892,Telangana,0,1,6,7,14,Pass
Aditya Verma,25-01-2006,311896,Madhya Pradesh,23,12,3,21,59,Pass
Rohan Verma,06-03-2005,784773,Rajasthan,17,5,11,14,47,Pass
Aditya Verma,02-11-2005,252878,Rajasthan,1,4,5,4,14,Pass
Ishaan Reddy,23-11-2005,545595,Punjab,3,13,3,11,30,Pass
Vivaan Reddy,20-09-2005,324587,Bihar,3,21,17,5,46,Pass
Sukhwinder Chopra,15-05-2005,578481,Uttar Pradesh,1,20,3,16,40,Pass
Harjeet Verma,05-12-2005,484012,Gujarat,20,15,14,16,65,Fail
Krishna Singh,16-09-2005,471915,West Bengal,6,15,6,16,43,Pass
Zaid Khan,08-01-2005,585657,Manipur,4,6,20,21,51,Pass
Aditya Singh,28-12-2005,214992,Tamil Nadu,20,5,19,16,60,Pass
Aarav Verma,13-01-2006,764088,Bihar,18,19,20,5,62,Pass
John Sharma,21-03-2005,905590,Andhra Pradesh,10,12,24,9,55,Pass
Kunal Verma,05-07-2005,337507,Uttar Pradesh,3,15,21,19,58,Pass
Aditya Pillai,12-04-2005,942846,Rajasthan,8,24,1,13,46,Pass
Balbir Reddy,20-11-2005,653490,Karnataka,14,2,7,17,40,Pass
Kunal Chopra,10-08-2005,782148,Kerala,7,4,11,7,29,Pass
Aarav Khan,04-08-2005,603849,Madhya Pradesh,13,1,1,6,21,Pass
Gurpreet D'Souza,29-10-2005,134829,Kerala,12,7,11,16,46,Pass
Rohan Fernandes,17-08-2005,503857,Andhra Pradesh,3,17,10,22,52,Pass
Balbir Khan,28-10-2005,277156,Tamil Nadu,5,9,8,8,30,Pass
Yash Pillai,18-11-2005,488492,Tamil Nadu,6,7,9,20,42,Pass
Kunal Fernandes,12-02-2005,455596,Punjab,3,14,7,20,44,Pass
Vivaan Reddy,17-03-2005,775784,Assam,12,14,12,7,45,Pass
Aryan Verma,18-08-2005,255410,Himachal Pradesh,17,6,4,4,31,Pass
Krishna Mehta,05-04-2006,787972,Uttar Pradesh,18,8,11,24,61,Pass
Ishaan Khan,16-04-2006,545306,Uttar Pradesh,21,3,16,22,62,Pass
Kunal Fernandes,15-11-2005,873271,Karnataka,3,0,5,2,10,Pass
Peter D'Souza,25-01-2005,498286,Kerala,22,13,3,3,41,Pass
Raj Khan,23-03-2005,838403,Chhattisgarh,1,18,15,17,51,Pass
Kunal Khan,30-11-2004,381736,Telangana,9,8,6,5,28,Pass
Peter Sharma,22-01-2006,917387,Maharashtra,21,3,8,5,37,Pass
Aarav Sharma,17-02-2006,602976,Odisha,4,2,19,16,41,Pass
David Verma,26-08-2005,964160,Bihar,12,8,2,21,43,Pass
Raj Chopra,16-01-2006,611127,Maharashtra,15,17,2,21,55,Pass
Yash Khan,15-01-2006,897791,Rajasthan,5,16,17,0,38,Pass
Balbir Pillai,14-11-2005,189510,Rajasthan,19,0,0,12,31,Pass
Yash Fernandes,28-11-2005,299067,Maharashtra,10,16,0,3,29,Pass
Aditya Khan,01-05-2005,603497,Odisha,9,4,4,10,27,Pass
Yash Sharma,21-11-2005,668196,Bihar,7,5,0,8,20,Pass
Balbir D'Souza,17-11-2004,518589,West Bengal,3,10,20,20,53,Pass
Raj Sharma,30-10-2005,743903,Chhattisgarh,24,9,14,17,64,Pass
Raj Khan,05-10-2005,713877,West Bengal,3,19,17,23,62,Pass
Zaid Singh,05-01-2005,154990,Uttar Pradesh,11,14,4,23,52,Pass
Kunal Sharma,28-10-2005,867331,Madhya Pradesh,5,5,21,21,52,Pass
Aarav Khan,28-09-2005,126592,Rajasthan,0,3,16,5,24,Pass
Aarav Pillai,23-12-2004,293713,Gujarat,11,20,13,7,51,Fail
Aditya D'Souza,06-10-2005,894376,Rajasthan,8,0,3,12,23,Pass
Aarav Khan,04-05-2006,314222,Andhra Pradesh,0,1,8,3,12,Pass
Ishaan Sharma,18-05-2005,665765,West Bengal,3,13,23,13,52,Pass
Farhan Singh,15-04-2005,864165,West Bengal,3,14,23,24,64,Pass
Aarav D'Souza,02-11-2005,348791,Madhya Pradesh,24,20,3,2,49,Pass
Vivaan Mehta,26-11-2005,307589,Maharashtra,14,24,2,5,45,Pass
Gurpreet Khan,25-09-2005,572853,Andhra Pradesh,19,16,22,2,59,Pass
Balbir Pillai,23-10-2005,357889,Delhi,13,16,12,15,56,Pass
Zaid Chopra,07-05-2006,982004,Punjab,15,4,24,9,52,Pass
Kunal Reddy,25-02-2006,298184,Chhattisgarh,3,22,3,20,48,Pass
Balbir Sharma,15-12-2005,618289,Odisha,17,7,12,2,38,Pass
Krishna D'Souza,23-08-2005,837508,Rajasthan,19,21,5,9,54,Pass
Ishaan Verma,23-02-2005,934033,Punjab,16,11,18,8,53,Pass
Paul Pillai,18-03-2005,903885,Uttarakhand,24,14,3,0,41,Pass
Krishna D'Souza,07-03-2005,275471,Andhra Pradesh,0,5,16,17,38,Pass
Krishna Reddy,18-09-2005,576485,Maharashtra,3,13,17,11,44,Pass
Aarav Reddy,08-04-2006,958826,Rajasthan,24,22,20,16,82,Pass
Rohan Khan,27-03-2006,257158,Gujarat,15,1,0,23,39,Fail
Peter D'Souza,28-02-2005,250644,Uttar Pradesh,3,6,2,6,17,Pass
David Fernandes,02-06-2005,698004,Maharashtra,5,11,7,8,31,Pass
Yash Mehta,05-01-2005,886599,Bihar,0,7,9,14,30,Pass
Aryan Pillai,31-03-2005,407273,Kerala,7,3,0,8,18,Pass
Ishaan D'Souza,16-01-2006,984701,Haryana,10,18,3,12,43,Pass
Vivaan Reddy,05-01-2005,112028,Tamil Nadu,9,4,18,15,46,Pass
Raj Pillai,23-10-2005,329811,Uttar Pradesh,1,19,17,19,56,Pass
David Chopra,18-01-2005,468469,Madhya Pradesh,6,18,15,12,51,Pass
Rohan D'Souza,19-04-2005,839264,Jharkhand,18,6,16,8,48,Pass
Aryan Singh,25-01-2006,572647,Tamil Nadu,18,22,23,20,83,Pass
Ishaan Fernandes,16-01-2006,537283,Tamil Nadu,13,22,22,20,77,Pass
Rohan Singh,12-06-2005,645906,Assam,3,19,19,11,52,Pass
Kunal Verma,29-11-2004,207741,Himachal Pradesh,11,11,19,8,49,Pass
Aryan Pillai,22-07-2005,377752,Andhra Pradesh,4,4,9,21,38,Pass
Krishna Fernandes,08-07-2005,951920,Assam,9,14,24,13,60,Pass
Kunal Chopra,26-11-2004,817286,Rajasthan,24,8,15,11,58,Pass
David Fernandes,22-01-2006,752675,Uttar Pradesh,12,6,6,13,37,Pass
Aryan Sharma,07-03-2006,814895,Haryana,14,6,5,3,28,Pass
Manpreet Verma,25-08-2005,500217,Gujarat,5,16,12,14,47,Fail
Krishna D'Souza,22-10-2005,108449,Meghalaya,22,21,16,7,66,Pass
Rohan Reddy,24-01-2005,449719,Maharashtra,0,9,22,13,44,Pass
Ayaan Sharma,27-02-2006,595237,Gujarat,3,6,7,24,40,Fail
Raj Singh,30-09-2005,897173,Assam,3,0,16,17,36,Pass
Aarav Verma,29-09-2005,536520,Uttar Pradesh,10,15,16,7,48,Pass
Aarav Pillai,19-10-2005,621583,West Bengal,3,18,24,24,69,Pass
David Pillai,19-07-2005,599544,Chhattisgarh,12,14,11,9,46,Pass
Aryan Reddy,15-05-2005,674438,Tamil Nadu,19,23,5,12,59,Pass
Aryan Pillai,06-02-2005,426445,Haryana,18,24,13,4,59,Pass
Kunal Chopra,23-12-2004,366498,Odisha,7,13,23,9,52,Pass
Raj Mehta,07-02-2005,343586,Jharkhand,9,10,7,5,31,Pass
Aditya Verma,11-07-2005,709433,Rajasthan,14,9,24,12,59,Pass
Aditya Chopra,16-03-2005,520264,Bihar,1,11,16,7,35,Pass
Ayaan D'Souza,08-11-2004,164946,Punjab,19,10,12,6,47,Pass
Balbir Sharma,20-03-2005,278647,Rajasthan,22,1,7,20,50,Pass
Rohan Fernandes,05-01-2006,340896,Karnataka,10,23,15,14,62,Pass
Raj Verma,01-07-2005,772626,Gujarat,17,6,1,1,25,Fail
Aditya Mehta,11-12-2004,285853,Telangana,4,6,8,19,37,Pass
Vivaan Chopra,31-12-2004,338094,Madhya Pradesh,10,5,8,3,26,Pass
Vivaan Khan,26-08-2005,498802,Bihar,2,6,13,18,39,Pass
Gurpreet D'Souza,26-08-2005,384925,Manipur,0,7,13,8,28,Pass
Aarav Pillai,23-09-2005,535974,Uttar Pradesh,8,16,22,19,65,Pass
Harjeet Mehta,12-01-2006,237355,Tamil Nadu,2,12,2,19,35,Pass
Krishna D'Souza,16-03-2005,181528,Uttar Pradesh,17,5,22,1,45,Pass
Yash Singh,08-11-2005,467801,Uttar Pradesh,11,6,5,5,27,Pass
Raj Chopra,19-08-2005,286329,Uttar Pradesh,18,14,7,8,47,Pass
Ishaan Verma,12-09-2005,964025,Bihar,21,2,16,22,61,Pass
Yash Mehta,07-02-2005,451574,Maharashtra,21,6,2,9,38,Pass
Yash Mehta,13-11-2005,127425,Punjab,12,6,1,10,29,Pass
Kunal Fernandes,10-08-2005,373359,Madhya Pradesh,6,24,3,19,52,Pass
Peter Reddy,27-06-2005,367171,Madhya Pradesh,18,5,1,5,29,Pass
Ishaan Verma,04-02-2005,941972,Rajasthan,24,8,24,13,69,Pass
Yash Sharma,27-12-2004,664368,Rajasthan,9,3,10,18,40,Pass
Rohan Fernandes,27-11-2004,468314,Chhattisgarh,11,7,5,16,39,Pass
Aarav D'Souza,29-11-2005,331636,West Bengal,1,24,24,4,53,Pass
John Chopra,25-04-2006,419533,Manipur,16,11,0,17,44,Pass
Ishaan Chopra,25-04-2005,397110,Andhra Pradesh,16,4,11,24,55,Pass
Manpreet Reddy,18-01-2006,247047,Rajasthan,8,24,24,20,76,Pass
Rohan Pillai,30-12-2004,343062,Tamil Nadu,24,22,2,23,71,Pass
Aryan Reddy,16-03-2006,461819,Jammu & Kashmir + Ladakh,2,5,6,2,15,Pass
Raj D'Souza,14-09-2005,971401,Rajasthan,7,12,13,11,43,Pass
Krishna Singh,04-08-2005,715549,Haryana,10,6,19,18,53,Pass
Aditya Reddy,25-01-2005,186322,Telangana,22,0,22,14,58,Pass
Aditya Sharma,11-03-2005,156598,Telangana,18,2,11,22,53,Pass
Rohan Verma,09-01-2005,514101,Uttar Pradesh,2,24,11,11,48,Pass
Ishaan Pillai,19-03-2005,378324,Sikkim,22,15,9,13,59,Pass
Krishna Fernandes,25-11-2005,565907,Himachal Pradesh,8,1,5,4,18,Pass
Harjeet Pillai,22-11-2005,866994,West Bengal,0,19,10,6,35,Pass
Aryan Reddy,23-07-2005,768967,Telangana,3,17,17,14,51,Pass
Vivaan Pillai,22-11-2005,873463,Uttar Pradesh,13,20,10,24,67,Pass
Raj Reddy,21-02-2006,100832,Bihar,1,6,9,1,17,Pass
Farhan Fernandes,18-02-2005,607649,Jammu & Kashmir + Ladakh,9,9,9,4,31,Pass
Rohan Reddy,15-04-2006,349017,Andhra Pradesh,13,10,13,20,56,Pass
Krishna Verma,19-04-2005,700530,Haryana,17,19,16,20,72,Pass
Ishaan Sharma,27-12-2005,837453,Haryana,14,19,8,3,44,Pass
Gurpreet Reddy,20-06-2005,310108,Odisha,7,24,14,8,53,Pass
Aarav Singh,21-11-2004,167929,Karnataka,23,19,8,9,59,Pass
Kunal Chopra,27-02-2005,440630,West Bengal,16,10,6,13,45,Pass
Raj Fernandes,04-06-2005,386917,Jharkhand,17,12,10,23,62,Pass
Krishna Mehta,17-01-2005,664640,Rajasthan,24,7,0,3,34,Pass
Peter Sharma,12-07-2005,337476,Kerala,3,3,24,7,37,Pass
Paul Pillai,02-12-2004,812623,Uttar Pradesh,19,17,7,24,67,Pass
Raj Pillai,19-07-2005,196559,Bihar,7,1,8,14,30,Pass
Rohan D'Souza,12-06-2005,274556,Tripura,7,18,3,0,28,Pass
Kunal Mehta,04-05-2005,227061,Bihar,24,11,17,10,62,Pass
Imran Singh,24-01-2005,684124,Jharkhand,2,6,18,22,48,Pass
Krishna Chopra,20-06-2005,329815,Bihar,15,2,18,1,36,Pass
Ishaan Fernandes,14-03-2005,254137,West Bengal,3,16,5,23,47,Pass
Gurpreet Khan,17-06-2005,188205,Uttar Pradesh,6,15,16,18,55,Pass
David Sharma,22-03-2005,307959,Chhattisgarh,16,8,4,1,29,Pass
David Verma,05-05-2006,849933,Uttar Pradesh,10,10,12,13,45,Pass
Aryan D'Souza,27-04-2006,597354,Bihar,17,14,22,1,54,Pass
Yash Pillai,03-05-2005,200745,Telangana,14,23,4,20,61,Pass
Aarav Sharma,05-12-2004,870605,Bihar,14,24,12,11,61,Pass
Aarav Mehta,07-02-2006,959061,Puducherry,6,7,6,17,36,Pass
Paul Pillai,07-06-2005,494506,Delhi,23,18,14,4,59,Pass
Kunal Sharma,01-01-2006,361054,Maharashtra,3,1,13,22,39,Pass
Krishna Pillai,15-11-2005,276590,Himachal Pradesh,3,8,4,1,16,Pass
Aryan Singh,15-12-2005,726830,Rajasthan,21,7,4,20,52,Pass
Harjeet Mehta,27-04-2006,661105,Telangana,0,19,0,15,34,Pass
Vivaan Reddy,04-06-2005,716934,Bihar,16,0,0,19,35,Pass
Raj Fernandes,18-02-2005,428269,Punjab,8,3,17,22,50,Pass
Krishna D'Souza,24-03-2006,349083,Rajasthan,20,9,7,12,48,Pass
Yash Fernandes,05-04-2006,100580,Rajasthan,17,3,2,16,38,Pass
Manpreet D'Souza,29-07-2005,554051,Chhattisgarh,16,4,12,0,32,Pass
Raj Chopra,01-04-2006,763031,Assam,22,8,0,13,43,Pass
Paul Chopra,19-09-2005,863636,Gujarat,4,15,6,4,29,Fail
Yash Sharma,04-04-2006,785058,Madhya Pradesh,0,14,13,13,40,Pass
Krishna Verma,03-05-2006,953522,Kerala,15,4,2,22,43,Pass
Vivaan D'Souza,08-05-2005,938553,Uttar Pradesh,9,16,14,6,45,Pass
Kunal Pillai,22-09-2005,266461,Kerala,1,21,0,16,38,Pass
Sukhwinder Sharma,09-04-2005,450506,Karnataka,19,11,15,14,59,Pass
Paul Reddy,04-01-2005,718715,Madhya Pradesh,10,10,11,21,52,Pass
Paul Chopra,01-05-2005,637900,Andhra Pradesh,9,21,10,12,52,Pass
Harjeet Chopra,25-01-2005,710693,Kerala,8,13,19,12,52,Pass
Aditya Verma,04-12-2004,838760,Madhya Pradesh,4,2,11,22,39,Pass
Aryan Fernandes,01-03-2006,579656,Karnataka,5,13,21,6,45,Pass
Harjeet Chopra,12-09-2005,969446,West Bengal,3,13,24,9,49,Pass
Sukhwinder Verma,10-11-2005,696307,Madhya Pradesh,5,20,3,16,44,Pass
Yash D'Souza,31-12-2004,576063,West Bengal,8,11,11,0,30,Pass
Aditya Chopra,06-12-2005,740376,Rajasthan,0,8,23,6,37,Pass
Gurpreet Chopra,18-07-2005,638541,Uttar Pradesh,3,14,22,14,53,Pass
Yash Sharma,28-05-2005,327237,Bihar,12,8,13,22,55,Pass
Kunal Sharma,21-06-2005,935054,Uttar Pradesh,3,19,16,21,59,Pass
Raj Chopra,08-05-2005,594629,Tamil Nadu,20,4,18,12,54,Pass
Kunal Verma,07-04-2006,446348,Andhra Pradesh,23,5,14,0,42,Pass
Gurpreet Verma,20-10-2005,169876,Haryana,20,10,12,3,45,Pass
Krishna Chopra,11-01-2005,273347,Jammu & Kashmir + Ladakh,9,2,24,21,56,Pass
Aryan Chopra,06-12-2004,226350,Maharashtra,13,18,12,5,48,Pass
Mathew Chopra,10-09-2005,268147,Uttar Pradesh,14,9,22,15,60,Pass
Aditya Khan,12-03-2005,376150,Rajasthan,20,4,5,21,50,Pass
Vivaan Singh,10-04-2005,337142,Uttar Pradesh,23,18,5,18,64,Pass
Raj Sharma,11-10-2005,299202,Bihar,12,0,0,9,21,Pass
Aryan Reddy,28-10-2005,526617,Telangana,2,22,12,12,48,Pass
Vivaan Sharma,10-02-2005,636283,Rajasthan,13,22,0,10,45,Pass
Aryan Chopra,19-11-2004,443838,Uttar Pradesh,14,20,3,11,48,Pass
Krishna Khan,06-01-2005,556708,Bihar,10,20,8,5,43,Pass
Aryan Reddy,03-04-2005,217720,Bihar,12,13,23,5,53,Pass
Vivaan Singh,04-05-2005,712637,Andhra Pradesh,0,13,23,13,49,Pass
Rohan Khan,24-02-2006,239585,Bihar,0,5,19,5,29,Pass
Vivaan Pillai,29-03-2005,869369,Karnataka,9,15,18,10,52,Pass
Harjeet Fernandes,25-09-2005,455740,Uttar Pradesh,6,2,18,19,45,Pass
Vivaan Chopra,16-04-2005,407666,Uttar Pradesh,8,24,10,12,54,Pass
Peter D'Souza,08-02-2005,316531,Bihar,14,23,22,13,72,Pass
Aarav Khan,16-02-2006,946083,Chhattisgarh,14,14,22,1,51,Pass
John Reddy,06-03-2006,370675,Uttar Pradesh,20,3,17,22,62,Pass
Vivaan Reddy,18-06-2005,170482,Rajasthan,12,19,10,17,58,Pass
Paul Verma,04-12-2005,805134,Andhra Pradesh,11,0,12,0,23,Pass
Aarav Verma,03-04-2006,169491,Tamil Nadu,12,14,0,20,46,Pass
Imran Mehta,08-02-2006,331950,Maharashtra,9,3,0,11,23,Pass
Kunal Verma,14-11-2005,524980,Maharashtra,12,17,2,11,42,Pass
Balbir Pillai,28-06-2005,616953,Assam,9,7,15,17,48,Pass
Yash Reddy,06-03-2006,975487,Uttar Pradesh,8,20,2,15,45,Pass
Aryan Chopra,03-12-2004,912596,Karnataka,22,24,13,11,70,Fail
Imran Khan,19-05-2005,420422,Andhra Pradesh,21,13,17,1,52,Pass
Rohan Reddy,21-04-2006,568579,Maharashtra,8,10,2,23,43,Pass
Paul Chopra,25-10-2005,632236,Bihar,24,22,9,5,60,Pass
Rohan Fernandes,01-04-2006,857212,Himachal Pradesh,17,4,3,3,27,Pass
Aarav Reddy,11-11-2004,244609,West Bengal,11,8,9,6,34,Pass
Gurpreet Fernandes,25-01-2006,499362,Haryana,12,5,0,16,33,Pass
Manpreet Mehta,09-04-2006,872488,Telangana,8,10,1,10,29,Pass
Yash Verma,23-11-2005,264146,Bihar,11,8,4,1,24,Pass
Ishaan Singh,02-12-2005,152361,Bihar,21,9,5,5,40,Pass
Sukhwinder Singh,02-06-2005,606928,West Bengal,3,23,20,8,54,Pass
Paul Singh,26-04-2006,166885,Madhya Pradesh,6,3,9,23,41,Pass
John Reddy,26-03-2005,497776,Rajasthan,3,3,18,23,47,Pass
Aryan D'Souza,21-12-2004,145142,Gujarat,17,19,2,15,53,Fail
Zaid Singh,16-03-2006,247504,Himachal Pradesh,11,19,20,5,55,Pass
Kunal Fernandes,24-05-2005,893658,Rajasthan,18,1,11,8,38,Pass
Rohan Sharma,07-05-2005,994295,Jharkhand,9,1,9,22,41,Pass
Ishaan D'Souza,10-02-2006,687736,Maharashtra,15,2,18,2,37,Pass
Aarav Fernandes,23-06-2005,834204,Rajasthan,9,15,18,11,53,Pass
Yash Reddy,03-04-2006,760904,Bihar,21,3,13,2,39,Pass
David Reddy,10-11-2005,171614,Bihar,23,11,24,10,68,Pass
Rohan Mehta,20-08-2005,887066,Tamil Nadu,17,17,3,8,45,Pass
Vivaan Chopra,14-11-2004,186134,Bihar,24,8,8,7,47,Pass
Vivaan Chopra,21-08-2005,510065,Maharashtra,19,9,2,4,34,Pass
Rohan Sharma,04-06-2005,663004,Gujarat,18,18,16,14,66,Fail
Raj Pillai,11-10-2005,665904,Maharashtra,24,17,2,4,47,Pass
Krishna Pillai,24-07-2005,616842,Karnataka,9,19,23,5,56,Pass
Kunal Sharma,08-02-2005,654083,Uttar Pradesh,5,2,6,23,36,Pass
Aarav D'Souza,19-01-2006,495297,Rajasthan,18,18,13,19,68,Pass
Gurpreet D'Souza,17-07-2005,756314,Maharashtra,9,6,2,15,32,Pass
Balbir Verma,08-05-2005,358835,Punjab,21,10,3,15,49,Pass
Ishaan Reddy,22-02-2005,445228,Rajasthan,16,0,8,10,34,Pass
Gurpreet Singh,31-12-2005,536214,Madhya Pradesh,15,11,5,22,53,Pass
Aditya D'Souza,24-06-2005,241361,Tamil Nadu,17,16,10,6,49,Pass
Krishna Singh,01-02-2005,926879,Jharkhand,22,6,17,6,51,Pass
Vivaan Singh,24-11-2004,264687,Madhya Pradesh,9,7,15,5,36,Pass
Raj Verma,19-06-2005,519550,Bihar,22,17,5,10,54,Pass
Aryan Reddy,01-02-2005,573816,Maharashtra,4,20,2,16,42,Pass
Aryan Singh,09-05-2005,133490,Uttar Pradesh,18,3,21,13,55,Pass
Raj Mehta,26-11-2004,467977,West Bengal,13,1,16,12,42,Pass
Krishna D'Souza,31-12-2005,540451,Maharashtra,2,4,1,12,19,Pass
Paul Pillai,24-06-2005,362343,Tamil Nadu,18,20,3,7,48,Pass
Balbir Reddy,28-05-2005,727846,Haryana,8,18,17,4,47,Pass
Aditya Sharma,21-12-2004,270990,West Bengal,24,5,1,8,38,Pass
Raj Khan,13-04-2005,241485,Punjab,17,8,21,7,53,Pass
Harjeet Singh,22-02-2005,451258,Rajasthan,13,0,1,13,27,Pass
Aarav Singh,13-02-2005,942849,Bihar,2,2,7,12,23,Pass
Aarav Sharma,04-04-2005,929567,Madhya Pradesh,6,0,2,9,17,Pass
Rehan Chopra,10-08-2005,635878,Karnataka,21,17,1,17,56,Pass
David Reddy,24-12-2004,114585,Telangana,4,2,20,1,27,Pass
David Khan,31-03-2005,390216,Punjab,21,1,9,13,44,Pass
John Sharma,06-12-2005,560219,Haryana,12,3,1,11,27,Pass
Krishna Fernandes,23-12-2005,266412,Maharashtra,1,10,23,12,46,Pass
Kunal Sharma,03-08-2005,814184,Rajasthan,22,22,13,5,62,Pass
Sukhwinder Chopra,14-11-2004,127831,Rajasthan,8,6,18,0,32,Pass
Rehan Reddy,19-05-2005,408540,Haryana,24,16,6,2,48,Pass
Aryan Singh,21-10-2005,114840,Maharashtra,23,8,2,13,46,Pass
Vivaan D'Souza,20-06-2005,434184,Tamil Nadu,18,13,17,24,72,Pass
Aditya Verma,20-03-2005,976548,Uttar Pradesh,11,0,10,21,42,Pass
Ishaan Mehta,04-10-2005,574699,Jharkhand,22,24,4,16,66,Pass
Aarav Pillai,09-02-2006,147714,West Bengal,6,7,3,22,38,Pass
Vivaan Singh,29-10-2005,536954,Andhra Pradesh,8,19,15,0,42,Pass
Aryan Singh,03-01-2006,292586,Punjab,19,7,14,23,63,Pass
Yash Verma,06-08-2005,628861,Telangana,10,16,0,20,46,Pass
Kunal Singh,18-01-2006,643808,Bihar,0,4,21,21,46,Pass
Aarav Singh,18-03-2006,529144,Bihar,20,20,1,4,45,Pass
Zaid Mehta,24-10-2005,534119,Uttar Pradesh,14,5,11,6,36,Pass
Peter Fernandes,28-01-2006,236084,Kerala,21,6,21,13,61,Pass
Rohan Mehta,23-03-2006,303802,Telangana,18,7,15,3,43,Pass
Harjeet Pillai,03-12-2005,268633,Bihar,5,7,11,21,44,Pass
Yash Khan,09-06-2005,560794,Rajasthan,3,20,7,18,48,Pass
Ishaan Mehta,27-12-2004,476032,Andhra Pradesh,2,7,16,13,38,Pass
Ishaan Mehta,29-12-2004,350991,Himachal Pradesh,19,17,13,5,54,Pass
Vivaan Reddy,02-11-2005,450723,Rajasthan,17,19,9,13,58,Pass
Kunal D'Souza,30-11-2004,215112,Uttar Pradesh,10,20,9,19,58,Pass
Aarav Pillai,25-01-2006,193447,Kerala,3,23,14,20,60,Pass
Ishaan Reddy,14-07-2005,645991,Delhi,1,14,5,6,26,Pass
Mathew Chopra,12-04-2006,212295,Telangana,4,0,6,2,12,Pass
Krishna Chopra,19-05-2005,787267,Jammu & Kashmir + Ladakh,22,21,23,13,79,Pass
Paul D'Souza,19-10-2005,619150,Bihar,14,1,0,18,33,Pass
Peter Sharma,15-07-2005,920954,Maharashtra,19,13,3,8,43,Pass
Rehan Fernandes,18-08-2005,535127,Jharkhand,0,1,18,5,24,Pass
Raj Fernandes,21-04-2005,832036,Andhra Pradesh,8,4,15,18,45,Pass
Gurpreet Mehta,14-12-2004,820960,Assam,8,24,10,15,57,Pass
Peter Verma,08-03-2005,156867,Maharashtra,1,10,9,8,28,Pass
Aryan Verma,07-11-2005,826871,Maharashtra,7,2,14,18,41,Pass
Mathew Sharma,04-02-2006,691680,Uttar Pradesh,23,8,24,5,60,Pass
Krishna Pillai,22-05-2005,526070,Madhya Pradesh,2,18,12,19,51,Pass
Ishaan Sharma,01-10-2005,701071,Karnataka,5,12,7,9,33,Pass
Aryan Reddy,04-07-2005,482006,Karnataka,12,5,9,15,41,Pass
Rohan Reddy,21-02-2005,169188,West Bengal,20,15,9,0,44,Pass
John Khan,29-06-2005,295490,Bihar,4,19,17,16,56,Pass
Yash Sharma,15-12-2005,375123,Andhra Pradesh,15,22,4,19,60,Pass
Rohan Khan,14-12-2005,593951,Odisha,19,23,18,23,83,Pass
Kunal Sharma,23-10-2005,785176,Uttar Pradesh,5,10,19,4,38,Pass
Kunal Chopra,11-04-2005,722375,Jammu & Kashmir + Ladakh,1,12,5,2,20,Pass
Krishna Verma,09-11-2004,838434,Andhra Pradesh,1,24,23,2,50,Pass
Aditya Pillai,20-11-2005,357088,Uttar Pradesh,8,15,17,16,56,Pass
John D'Souza,30-01-2006,523163,Odisha,3,12,10,8,33,Pass
Rohan Pillai,01-11-2005,949593,Haryana,7,8,22,24,61,Pass
Balbir Singh,02-04-2006,768464,Uttar Pradesh,20,22,7,19,68,Pass
Sukhwinder D'Souza,11-05-2005,370609,Haryana,7,14,22,15,58,Pass
Balbir Sharma,13-11-2004,250070,Tamil Nadu,12,7,9,6,34,Pass
Ayaan Reddy,29-03-2006,111665,Gujarat,23,11,11,11,56,Fail
Kunal Reddy,21-02-2006,116973,Rajasthan,15,7,11,9,42,Pass
Vivaan Sharma,14-02-2005,756680,Uttar Pradesh,0,24,0,10,34,Pass
Manpreet Verma,11-11-2004,553636,Assam,2,19,20,22,63,Pass
Kunal Mehta,19-08-2005,631170,Madhya Pradesh,0,2,10,3,15,Pass
Yash Reddy,30-09-2005,241131,Maharashtra,1,11,12,5,29,Pass
Yash Mehta,14-10-2005,333907,Uttar Pradesh,23,21,21,3,68,Pass
Balbir Khan,18-01-2005,608799,Uttar Pradesh,18,15,17,8,58,Pass
Raj Pillai,17-03-2005,982357,Telangana,1,0,15,0,16,Pass
Ayaan Chopra,09-12-2005,758588,Telangana,20,7,16,4,47,Pass
Aryan Pillai,10-09-2005,544251,Tamil Nadu,0,5,0,2,7,Pass
Raj D'Souza,06-02-2005,634821,West Bengal,7,7,18,12,44,Pass
Krishna D'Souza,26-04-2006,219687,Madhya Pradesh,17,12,3,17,49,Pass
Rohan Khan,19-01-2006,641821,Uttar Pradesh,5,21,14,21,61,Pass
Harjeet Pillai,16-06-2005,361657,Jharkhand,14,3,4,19,40,Pass
Rohan Pillai,18-08-2005,958971,Punjab,13,1,12,22,48,Pass
Krishna Sharma,26-09-2005,226851,Tamil Nadu,1,8,6,12,27,Pass
Peter Khan,06-03-2005,926155,Maharashtra,7,11,1,0,19,Pass
Vivaan Mehta,09-03-2005,845265,Andhra Pradesh,17,2,18,1,38,Pass
Gurpreet D'Souza,24-06-2005,823292,Odisha,16,24,1,23,64,Pass
Aryan Reddy,27-05-2005,671033,Gujarat,4,0,10,11,25,Fail
Rohan Reddy,03-03-2006,391077,Madhya Pradesh,19,19,3,15,56,Pass
Manpreet D'Souza,20-04-2005,883581,Chhattisgarh,7,18,7,0,32,Pass
Vivaan Mehta,27-08-2005,366398,Andhra Pradesh,6,17,20,5,48,Pass
Rohan Singh,31-01-2005,759849,Himachal Pradesh,9,11,3,19,42,Pass
Paul Singh,20-01-2006,572997,Bihar,24,14,14,8,60,Pass
Paul Khan,18-03-2006,781131,Haryana,2,12,1,18,33,Pass
David Verma,16-09-2005,805519,Bihar,20,5,4,1,30,Pass
Ishaan Singh,04-02-2005,354881,Uttarakhand,20,20,3,19,62,Pass
Rohan Singh,28-12-2004,559996,Telangana,1,3,8,8,20,Pass
Kunal Pillai,20-03-2005,305857,Telangana,11,16,7,6,40,Pass
Ishaan Chopra,14-04-2006,502711,Nagaland,17,4,8,7,36,Pass
Ayaan Chopra,14-07-2005,707172,Tamil Nadu,3,24,15,22,64,Pass
Mathew Mehta,16-03-2006,457892,West Bengal,24,5,4,8,41,Pass
Rohan Singh,07-11-2005,451960,Tamil Nadu,23,7,5,2,37,Pass
Vivaan Khan,24-01-2005,655498,Kerala,21,17,8,3,49,Pass
Harjeet Pillai,15-02-2006,761988,Rajasthan,18,2,18,5,43,Pass
Aryan Chopra,20-11-2004,374263,Madhya Pradesh,21,2,9,9,41,Pass
Aarav Khan,26-04-2005,719031,Karnataka,24,18,17,20,79,Fail
Aryan Chopra,14-08-2005,280426,Andhra Pradesh,19,0,17,17,53,Pass
Kunal Verma,04-08-2005,805245,Rajasthan,17,0,15,3,35,Pass
Ishaan Reddy,09-12-2004,917071,Rajasthan,12,0,4,5,21,Pass
Aryan Sharma,18-06-2005,567925,Uttar Pradesh,19,3,24,20,66,Pass
Krishna Khan,17-10-2005,324538,Bihar,15,0,7,13,35,Pass
Manpreet Mehta,13-12-2005,535454,Chhattisgarh,15,2,9,18,44,Pass
Aarav Fernandes,28-11-2005,962342,Maharashtra,20,6,2,24,52,Pass
Rohan Sharma,22-02-2006,131968,Maharashtra,9,14,2,18,43,Pass
David Mehta,28-05-2005,887611,Gujarat,24,7,1,6,38,Fail
Krishna Mehta,14-12-2005,328395,Jammu & Kashmir + Ladakh,6,8,19,16,49,Pass
Ishaan Mehta,02-06-2005,687357,Maharashtra,1,7,10,5,23,Pass
Aditya Reddy,07-05-2006,668099,Uttar Pradesh,16,23,2,21,62,Pass
Ishaan Pillai,02-02-2006,427129,Kerala,15,6,21,5,47,Pass
Krishna Sharma,04-11-2005,888784,West Bengal,0,14,0,5,19,Pass
Sukhwinder Fernandes,24-03-2006,624458,Bihar,23,11,24,10,68,Pass
Yash Fernandes,24-07-2005,411574,Jammu & Kashmir + Ladakh,20,19,16,7,62,Pass
Vivaan Khan,03-12-2005,190449,Madhya Pradesh,13,1,13,8,35,Pass
David Khan,11-03-2005,686614,Uttar Pradesh,16,22,22,12,72,Pass
Aarav Reddy,14-05-2005,534323,Manipur,3,20,6,10,39,Pass
Peter Singh,19-08-2005,422533,Manipur,4,12,14,17,47,Pass
Vivaan Pillai,01-02-2006,364875,Kerala,24,7,15,6,52,Pass
Ishaan Reddy,18-03-2005,171184,Andhra Pradesh,16,17,12,16,61,Pass
Vivaan Sharma,27-03-2006,251656,Madhya Pradesh,9,2,9,14,34,Pass
Raj Pillai,15-05-2005,746724,Uttar Pradesh,15,15,13,12,55,Pass
Krishna Reddy,16-10-2005,435477,West Bengal,4,8,21,19,52,Pass
Krishna Reddy,25-07-2005,363011,Rajasthan,22,17,12,16,67,Pass
Raj Singh,07-06-2005,411377,Uttar Pradesh,0,16,2,11,29,Pass
Aditya Chopra,01-03-2006,897763,Rajasthan,11,0,6,3,20,Pass
Zaid Pillai,21-08-2005,747279,Uttar Pradesh,4,9,0,18,31,Pass
Aarav Fernandes,07-12-2004,766502,Madhya Pradesh,20,22,3,10,55,Pass
Aryan Chopra,15-05-2005,194400,West Bengal,3,19,15,18,55,Pass
Aryan Verma,19-11-2004,393417,Gujarat,9,20,18,24,71,Fail
Harjeet Chopra,12-03-2006,478309,Rajasthan,20,19,22,20,81,Pass
Balbir Fernandes,06-08-2005,423647,Haryana,0,12,2,21,35,Pass
Ishaan Verma,24-02-2005,640256,Andhra Pradesh,15,3,16,9,43,Pass
Aditya D'Souza,30-01-2005,841902,Telangana,3,17,22,4,46,Pass
Aditya Singh,19-03-2006,496541,Madhya Pradesh,21,13,3,6,43,Pass
Raj Khan,27-11-2004,827349,Bihar,6,23,7,18,54,Pass
Gurpreet Mehta,03-10-2005,246775,Maharashtra,7,13,21,3,44,Pass
Yash D'Souza,20-02-2006,294972,Bihar,7,19,0,19,45,Pass
Aarav Reddy,13-03-2005,940232,Uttarakhand,4,4,15,23,46,Pass
Zaid Sharma,18-12-2004,157317,West Bengal,11,1,1,0,13,Pass
Ayaan Pillai,02-04-2005,166931,Andhra Pradesh,12,8,4,18,42,Pass
Kunal Khan,13-03-2006,335993,Assam,18,15,6,7,46,Pass
Aryan Verma,23-12-2005,760992,Uttar Pradesh,5,8,2,15,30,Pass
Harjeet Reddy,06-08-2005,776789,Odisha,17,17,23,5,62,Pass
Gurpreet Singh,03-04-2006,473060,Sikkim,10,5,4,24,43,Pass
Ishaan Singh,04-12-2005,866212,Maharashtra,23,12,2,20,57,Pass
Manpreet Sharma,01-07-2005,562468,Uttar Pradesh,16,20,7,24,67,Pass
Kunal Fernandes,12-05-2005,989257,Maharashtra,22,4,13,5,44,Pass
Ishaan Verma,22-08-2005,161089,Assam,4,16,1,20,41,Pass
Aarav Fernandes,14-12-2005,869823,Bihar,6,9,18,12,45,Pass
Sukhwinder Singh,27-09-2005,878763,Haryana,3,20,19,20,62,Pass
Krishna Verma,23-11-2005,540700,Rajasthan,13,18,5,13,49,Pass
Ishaan Reddy,21-04-2006,269694,Bihar,23,16,5,16,60,Pass
David Sharma,20-11-2004,244508,Maharashtra,5,9,6,8,28,Pass
Manpreet Fernandes,13-09-2005,505421,Haryana,9,8,23,23,63,Pass
Manpreet Reddy,22-11-2005,703144,West Bengal,3,2,22,3,30,Pass
Kunal Singh,10-12-2005,828778,Haryana,9,4,12,0,25,Pass
Aryan Pillai,22-10-2005,611005,Jharkhand,0,1,7,4,12,Pass
Aarav Chopra,31-01-2005,723944,Tamil Nadu,6,11,21,15,53,Pass
Mathew Verma,28-03-2006,718440,Jammu & Kashmir + Ladakh,12,11,2,12,37,Pass
Aryan Khan,08-01-2006,194149,Madhya Pradesh,24,9,4,4,41,Pass
Ishaan Pillai,02-04-2006,732653,Andhra Pradesh,0,17,20,20,57,Pass
Yash Sharma,01-05-2005,532287,Karnataka,19,11,4,18,52,Pass
Raj Verma,12-07-2005,456792,Rajasthan,6,4,4,20,34,Pass
Kunal Singh,23-01-2005,192742,Rajasthan,16,10,0,17,43,Pass
Mathew Sharma,25-10-2005,671201,Rajasthan,15,13,14,0,42,Pass
Peter D'Souza,06-06-2005,622293,West Bengal,12,16,5,7,40,Pass
Rohan Reddy,28-11-2005,418735,Madhya Pradesh,2,1,12,1,16,Pass
Farhan Fernandes,25-11-2004,451556,Tamil Nadu,17,24,22,17,80,Pass
Zaid Fernandes,22-02-2005,705945,Karnataka,17,6,15,19,57,Pass
Ishaan Reddy,18-12-2005,720283,West Bengal,21,6,13,12,52,Pass
Aryan Mehta,10-01-2005,510146,Assam,10,11,20,1,42,Pass
Balbir Khan,08-05-2006,869619,Uttar Pradesh,6,6,19,23,54,Pass
Ayaan Verma,31-10-2005,162558,Uttar Pradesh,23,2,22,17,64,Pass
Balbir Singh,03-05-2006,872014,Madhya Pradesh,8,6,17,1,32,Pass
Raj Mehta,14-05-2005,161051,Bihar,7,14,4,14,39,Pass
Aryan Sharma,20-04-2006,277379,Tamil Nadu,23,13,1,6,43,Pass
Rohan Fernandes,13-07-2005,316904,Uttar Pradesh,11,6,18,1,36,Pass
Rohan Fernandes,24-02-2005,154093,Jharkhand,3,19,2,2,26,Pass
Vivaan Singh,15-02-2006,959322,Madhya Pradesh,23,22,1,9,55,Pass
John Sharma,30-03-2005,895946,Punjab,7,3,16,24,50,Pass
Ishaan Mehta,04-02-2006,291924,Maharashtra,13,10,2,19,44,Pass
Yash Khan,30-12-2004,989645,Rajasthan,12,13,10,6,41,Pass
Gurpreet Fernandes,10-03-2006,195599,Tamil Nadu,20,20,21,17,78,Pass
Aarav Pillai,10-07-2005,594876,Madhya Pradesh,9,2,1,1,13,Pass
Yash Verma,03-07-2005,971783,Uttar Pradesh,17,3,24,21,65,Pass
Peter Khan,25-10-2005,245605,Meghalaya,2,22,21,13,58,Pass
Gurpreet Pillai,12-01-2006,518333,Odisha,23,8,2,17,50,Pass
Aryan Fernandes,03-04-2006,163894,Bihar,4,6,14,4,28,Pass
Vivaan Khan,03-05-2006,204994,West Bengal,3,15,15,19,52,Pass
Peter Mehta,07-03-2006,165321,Assam,9,5,7,0,21,Pass
Rohan Verma,07-01-2005,805323,West Bengal,3,12,23,5,43,Pass
Krishna Chopra,30-03-2006,796657,Jharkhand,2,1,23,16,42,Pass
Rohan Sharma,01-09-2005,620249,Punjab,18,3,8,6,35,Pass
Rohan Verma,24-01-2006,230105,Jharkhand,20,14,23,4,61,Pass
Aryan D'Souza,01-12-2005,933315,Bihar,4,7,22,0,33,Pass
Rohan Pillai,12-05-2005,760081,Punjab,8,4,11,11,34,Pass
Balbir Verma,18-02-2005,728954,Maharashtra,13,21,2,9,45,Pass
Yash Mehta,31-01-2005,281063,Madhya Pradesh,7,12,3,24,46,Pass
Krishna Verma,30-01-2005,419257,West Bengal,16,3,24,0,43,Pass
Rohan Fernandes,13-07-2005,472441,Andhra Pradesh,22,15,6,19,62,Pass
Vivaan Chopra,29-11-2004,636994,Uttar Pradesh,6,14,3,12,35,Pass
Imran Chopra,04-03-2005,394234,Jharkhand,11,21,13,21,66,Pass
Rohan Sharma,04-05-2006,593738,Rajasthan,18,0,2,15,35,Pass
Vivaan Khan,01-01-2006,669455,West Bengal,0,1,7,12,20,Pass
Kunal D'Souza,15-05-2005,290777,Uttar Pradesh,9,23,21,18,71,Pass
Raj Khan,02-01-2005,172228,Himachal Pradesh,0,8,7,22,37,Pass
Aditya Chopra,02-10-2005,612150,Bihar,8,10,10,23,51,Pass
Ishaan Khan,23-06-2005,274786,Telangana,18,2,14,10,44,Pass
Imran Khan,22-03-2005,353081,Bihar,15,14,1,4,34,Pass
Vivaan Mehta,13-10-2005,425295,Telangana,11,9,2,11,33,Pass
Kunal Fernandes,21-05-2005,624104,Jammu & Kashmir + Ladakh,20,2,21,10,53,Pass
Rohan D'Souza,05-10-2005,692025,Jharkhand,14,15,18,5,52,Pass
Paul Khan,27-04-2005,636513,Chhattisgarh,21,3,13,3,40,Pass
Yash Verma,17-04-2006,887746,Mizoram,16,6,0,7,29,Pass
Kunal Pillai,26-11-2005,458133,Andhra Pradesh,7,14,15,5,41,Pass
Sukhwinder Singh,28-09-2005,169534,Delhi,22,1,5,23,51,Pass
Krishna Khan,23-12-2005,653805,Madhya Pradesh,19,5,3,14,41,Pass
Paul Singh,17-08-2005,402867,Gujarat,13,4,19,12,48,Fail
Kunal Khan,13-01-2005,664729,Rajasthan,19,8,4,17,48,Pass
Aarav Chopra,06-06-2005,392423,Bihar,18,19,24,6,67,Pass
Harjeet Verma,16-01-2006,402557,Odisha,23,12,18,12,65,Pass
Aditya Fernandes,07-10-2005,225226,Madhya Pradesh,18,21,0,16,55,Pass
John Verma,20-09-2005,835799,Maharashtra,6,9,23,11,49,Pass
David Verma,07-05-2005,272749,Rajasthan,2,15,5,24,46,Pass
Aryan Khan,08-01-2006,826748,Madhya Pradesh,11,15,13,11,50,Pass
Aditya Chopra,18-06-2005,559903,Madhya Pradesh,11,2,8,10,31,Pass
Aryan D'Souza,15-10-2005,617782,Punjab,2,22,0,9,33,Pass
Vivaan Reddy,31-12-2004,516490,Rajasthan,22,2,19,11,54,Pass
Krishna Singh,13-04-2005,337022,Bihar,20,0,22,5,47,Pass
Aarav Chopra,06-01-2006,241736,Tamil Nadu,21,9,17,20,67,Pass
Krishna D'Souza,04-04-2005,601801,Tamil Nadu,14,9,7,17,47,Pass
David D'Souza,12-06-2005,803098,West Bengal,12,15,4,0,31,Pass
Yash Sharma,31-07-2005,298762,Kerala,13,14,2,4,33,Pass
Mathew Pillai,13-08-2005,578409,Rajasthan,22,3,4,24,53,Pass
Kunal Mehta,24-03-2005,921112,Andhra Pradesh,23,7,23,21,74,Pass
Aditya Pillai,31-12-2004,452782,Punjab,16,8,8,12,44,Pass
Aarav Reddy,03-07-2005,838705,West Bengal,8,8,24,13,53,Pass
Rohan Mehta,30-04-2006,304583,Uttar Pradesh,11,9,14,22,56,Pass
Paul Reddy,04-04-2006,384227,Maharashtra,16,2,11,3,32,Pass
Aditya Reddy,21-11-2004,455777,Haryana,21,17,10,19,67,Pass
Yash Fernandes,07-01-2005,202969,West Bengal,0,19,2,15,36,Pass
Ishaan Mehta,11-01-2006,361008,Bihar,5,13,2,1,21,Pass
Rohan Verma,14-01-2006,193947,Jharkhand,23,14,8,5,50,Pass
Yash Reddy,26-07-2005,462242,Maharashtra,5,19,2,12,38,Pass
Harjeet Mehta,13-01-2006,688804,Haryana,24,15,3,6,48,Pass
Krishna Chopra,18-07-2005,500348,Bihar,20,1,23,15,59,Pass
Yash Khan,24-01-2006,479661,Rajasthan,6,6,14,17,43,Pass
Rohan Pillai,10-03-2005,692392,West Bengal,3,18,9,7,37,Pass
Yash Sharma,15-03-2006,316948,Assam,15,4,15,10,44,Pass
Manpreet Sharma,14-03-2006,200421,Madhya Pradesh,13,16,3,2,34,Pass
Peter Mehta,08-09-2005,654354,Madhya Pradesh,15,14,3,10,42,Pass
Imran Verma,18-02-2006,665689,Madhya Pradesh,7,15,24,1,47,Pass
Krishna Sharma,28-12-2004,279632,Haryana,0,9,17,23,49,Pass
John Fernandes,12-08-2005,250501,Assam,12,8,11,19,50,Pass
Rohan Reddy,15-01-2005,605338,Kerala,20,6,11,23,60,Pass
Ishaan Khan,31-01-2006,496427,Karnataka,24,9,14,8,55,Pass
Krishna D'Souza,15-12-2004,864254,Andhra Pradesh,20,19,5,14,58,Pass
Aryan Singh,14-03-2005,657386,Haryana,12,21,1,21,55,Pass
Aarav Pillai,21-06-2005,860590,Chhattisgarh,9,7,0,11,27,Pass
Kunal Khan,11-01-2006,630844,Andhra Pradesh,22,21,1,8,52,Pass
Mathew Pillai,28-01-2006,943939,Uttar Pradesh,0,23,8,7,38,Pass
Kunal D'Souza,30-01-2005,274217,Uttar Pradesh,19,15,2,18,54,Pass
Aryan Singh,04-12-2004,812182,Gujarat,9,1,23,4,37,Fail
Aditya Reddy,08-04-2005,147142,Maharashtra,16,9,2,19,46,Pass
Rehan Singh,13-07-2005,215253,Maharashtra,10,18,5,0,33,Pass
Balbir Singh,18-12-2004,130373,Uttar Pradesh,17,2,6,21,46,Pass
Mathew Sharma,14-03-2005,391644,Rajasthan,1,6,5,15,27,Pass
Aryan Verma,09-03-2005,402342,Madhya Pradesh,7,18,6,14,45,Pass
Sukhwinder D'Souza,29-10-2005,605961,Andhra Pradesh,14,22,9,14,59,Pass
Aarav Sharma,29-09-2005,852293,Bihar,20,18,22,18,78,Pass
Manpreet D'Souza,30-03-2005,759692,Gujarat,22,24,20,17,83,Fail
Rohan Fernandes,20-03-2005,247313,Maharashtra,20,3,5,17,45,Pass
Paul Sharma,22-02-2005,970064,Uttar Pradesh,5,8,22,0,35,Pass
Vivaan Mehta,28-04-2006,833109,Uttar Pradesh,21,1,24,12,58,Pass
Farhan Khan,21-09-2005,180353,Punjab,14,7,16,6,43,Pass
Ishaan Verma,28-05-2005,520942,Punjab,18,24,5,18,65,Pass
Aryan Pillai,22-12-2005,952582,Assam,6,11,13,7,37,Pass
Kunal D'Souza,06-12-2005,101763,Chhattisgarh,17,17,3,2,39,Pass
Yash Pillai,30-01-2006,505201,Himachal Pradesh,22,10,8,2,42,Pass
Harjeet Reddy,09-02-2006,543407,Bihar,4,19,7,6,36,Pass
Aryan Khan,06-02-2006,482524,Uttarakhand,18,20,3,23,64,Pass
Krishna Khan,11-03-2005,488446,Punjab,22,21,20,12,75,Pass
Sukhwinder Mehta,25-04-2005,194569,Daman & Diu / D&N Haveli,9,9,11,7,36,Pass
Aditya Singh,09-03-2006,462419,Bihar,19,21,0,7,47,Pass
Peter Mehta,13-06-2005,227086,Punjab,4,22,16,4,46,Pass
John Singh,25-04-2005,123978,Uttar Pradesh,15,1,16,5,37,Pass
Peter Fernandes,25-02-2005,604204,West Bengal,3,16,22,16,57,Pass
Raj Khan,25-07-2005,207094,West Bengal,18,4,11,18,51,Pass
Vivaan D'Souza,16-01-2005,979015,Kerala,16,12,11,13,52,Pass
Ishaan Singh,03-05-2006,817355,Haryana,13,10,17,20,60,Pass
Rohan Pillai,26-08-2005,434943,Maharashtra,3,23,2,19,47,Pass
Aarav Singh,18-05-2005,731876,West Bengal,3,19,9,24,55,Pass
Vivaan Khan,11-12-2004,420256,Uttar Pradesh,5,18,15,9,47,Pass
Aditya Chopra,02-05-2006,404377,Meghalaya,9,19,18,5,51,Pass
Manpreet Verma,01-07-2005,957406,Madhya Pradesh,13,22,3,17,55,Pass
Krishna Pillai,26-01-2006,325620,Tamil Nadu,0,5,2,3,10,Pass
Aarav Singh,24-11-2005,977048,West Bengal,3,21,5,17,46,Pass
Rohan Pillai,26-01-2006,640640,Andhra Pradesh,19,13,20,12,64,Pass
David D'Souza,21-08-2005,472302,Punjab,5,5,24,3,37,Pass
Raj Chopra,26-06-2005,248934,Gujarat,18,0,0,4,22,Fail
Aryan D'Souza,26-07-2005,449167,Bihar,1,2,14,24,41,Pass
Yash Chopra,30-04-2006,676496,Madhya Pradesh,16,10,5,2,33,Pass
Ishaan Mehta,10-11-2004,114544,Andhra Pradesh,9,5,22,12,48,Pass
Aarav Fernandes,02-01-2006,895599,Uttar Pradesh,20,15,5,20,60,Pass
Vivaan D'Souza,05-01-2006,953840,Uttar Pradesh,21,23,2,5,51,Pass
Ishaan Sharma,09-06-2005,345293,Haryana,8,16,14,11,49,Pass
Yash Khan,01-03-2006,182178,Rajasthan,5,2,6,1,14,Pass
Aarav Chopra,12-03-2006,307860,West Bengal,17,9,11,10,47,Pass
Vivaan Singh,05-01-2006,281982,Andhra Pradesh,21,7,11,18,57,Pass
Yash Singh,16-04-2005,585278,Uttar Pradesh,13,16,20,1,50,Pass
Krishna Reddy,29-04-2005,265545,Assam,9,7,5,0,21,Pass
David Verma,13-05-2005,374219,Chhattisgarh,13,24,9,1,47,Pass
Ishaan Khan,24-01-2005,120756,Uttar Pradesh,19,15,17,13,64,Pass
Sukhwinder Reddy,07-12-2004,120559,Bihar,12,7,16,1,36,Pass
Raj Pillai,10-09-2005,506777,Telangana,12,10,14,7,43,Pass
Yash Reddy,12-12-2004,230798,Karnataka,23,5,12,6,46,Pass
Yash Mehta,02-07-2005,214765,West Bengal,3,17,17,14,51,Pass
Manpreet Sharma,13-01-2006,645673,Madhya Pradesh,4,15,3,3,25,Pass
Aryan Pillai,16-10-2005,801701,Assam,3,13,18,2,36,Pass
Yash Mehta,10-07-2005,911138,Rajasthan,12,17,2,8,39,Pass
Krishna Singh,07-01-2006,415471,Andhra Pradesh,1,17,15,23,56,Pass
Sukhwinder Verma,21-12-2005,825740,Tamil Nadu,17,20,4,4,45,Pass
Yash Pillai,13-06-2005,111892,Haryana,24,19,2,17,62,Pass
Kunal Fernandes,28-09-2005,128498,Tamil Nadu,22,18,12,2,54,Pass
Aarav Singh,07-12-2005,542871,Haryana,23,2,2,17,44,Pass
Kunal Chopra,02-01-2006,933298,Gujarat,6,2,19,4,31,Fail
John Verma,04-03-2005,382378,Assam,10,4,10,8,32,Pass
Aryan Reddy,18-11-2005,818509,Karnataka,21,9,9,9,48,Pass
Aryan Mehta,03-04-2006,254198,Maharashtra,19,5,2,16,42,Pass
Aditya Fernandes,12-11-2004,859425,Mizoram,9,7,4,9,29,Pass
Raj D'Souza,11-08-2005,151076,Madhya Pradesh,18,11,13,10,52,Pass
Aryan Khan,21-12-2004,130657,Andhra Pradesh,19,10,5,4,38,Pass
Yash Fernandes,21-12-2005,464552,Daman & Diu / D&N Haveli,24,8,20,1,53,Fail
Aryan Verma,01-01-2006,123862,Andhra Pradesh,8,17,23,15,63,Pass
Vivaan Chopra,31-12-2005,414385,Tamil Nadu,23,7,12,14,56,Pass
Vivaan Reddy,08-09-2005,924754,Tamil Nadu,19,18,4,3,44,Pass
Yash Verma,02-09-2005,102336,Punjab,15,0,22,0,37,Pass
Aryan D'Souza,11-08-2005,902268,Manipur,4,23,14,17,58,Pass
Raj Singh,31-01-2005,235630,Maharashtra,24,12,2,8,46,Pass
Aryan Reddy,01-11-2005,501650,West Bengal,8,16,22,0,46,Pass
Ishaan Pillai,05-06-2005,420499,Odisha,6,20,11,22,59,Pass
Aryan Mehta,06-10-2005,598355,Punjab,13,7,10,8,38,Pass
Gurpreet D'Souza,19-01-2006,530828,Uttar Pradesh,12,1,4,0,17,Pass
Kunal Singh,08-01-2006,522229,Delhi,8,10,20,3,41,Pass
Aarav D'Souza,06-06-2005,259851,Jharkhand,9,5,12,24,50,Pass
Balbir Pillai,20-09-2005,789399,Odisha,16,5,23,18,62,Pass
Aryan Khan,10-07-2005,476156,Telangana,15,8,1,24,48,Pass
Aryan Fernandes,01-09-2005,328862,Karnataka,23,19,10,12,64,Pass
Kunal Verma,10-07-2005,871926,Andhra Pradesh,0,20,1,22,43,Pass
Aarav Singh,27-12-2004,361419,Tamil Nadu,3,16,23,23,65,Pass
Paul D'Souza,19-11-2004,608007,Uttar Pradesh,24,7,2,19,52,Pass
Yash Khan,25-11-2004,431195,Assam,10,4,18,18,50,Pass
Farhan Verma,03-03-2005,315504,Karnataka,4,21,5,24,54,Pass
Peter Sharma,31-01-2006,774082,Bihar,8,13,20,19,60,Pass
Rohan Reddy,19-11-2005,256932,Odisha,5,4,23,2,34,Pass
Gurpreet Singh,02-01-2006,375340,Madhya Pradesh,6,13,1,24,44,Pass
John Fernandes,01-08-2005,168014,Tamil Nadu,2,13,21,20,56,Pass
Aarav Reddy,09-12-2004,309755,Haryana,20,10,14,18,62,Pass
Paul Mehta,23-11-2005,404247,Kerala,12,22,17,2,53,Pass
Farhan Verma,22-03-2006,695540,Assam,16,13,18,9,56,Pass
Aryan Chopra,27-09-2005,115868,Kerala,16,15,17,11,59,Pass
Balbir Fernandes,17-08-2005,999950,Gujarat,5,4,4,7,20,Fail
Vivaan Chopra,20-04-2005,972469,Uttar Pradesh,12,6,17,10,45,Pass
Aarav D'Souza,27-02-2005,712420,Uttar Pradesh,18,3,22,21,64,Pass
Manpreet Chopra,20-11-2005,968330,Odisha,10,13,13,22,58,Pass
Kunal Sharma,19-12-2005,287450,Punjab,24,16,1,16,57,Pass
Farhan Fernandes,07-09-2005,798294,Punjab,12,2,7,0,21,Pass
Aarav D'Souza,15-04-2006,608814,Maharashtra,23,9,2,0,34,Pass
Mathew Singh,27-01-2005,961284,Telangana,16,24,15,5,60,Pass
David Sharma,11-08-2005,809841,Haryana,0,13,4,24,41,Pass
Raj Chopra,19-03-2006,164023,Maharashtra,18,4,10,8,40,Pass
Kunal Fernandes,19-11-2004,995674,West Bengal,3,3,21,0,27,Pass
Paul Mehta,15-09-2005,475920,Mizoram,3,9,10,21,43,Pass
Aditya Khan,05-05-2006,286337,Punjab,22,24,6,9,61,Pass
Vivaan Fernandes,10-07-2005,484498,Gujarat,17,8,9,6,40,Fail
John Reddy,23-02-2005,205270,Assam,13,20,10,11,54,Pass
Ishaan Reddy,22-02-2005,887445,Madhya Pradesh,21,7,19,3,50,Pass
Ayaan Fernandes,23-02-2005,533428,Madhya Pradesh,0,12,13,19,44,Pass
Gurpreet Reddy,09-02-2006,868990,Punjab,8,19,21,8,56,Pass
Peter Verma,29-08-2005,568311,Uttar Pradesh,17,20,16,0,53,Pass
Harjeet Singh,13-04-2006,657374,Punjab,9,22,17,19,67,Pass
Sukhwinder Mehta,21-10-2005,800788,Bihar,7,9,4,5,25,Pass
Kunal Chopra,02-04-2005,947895,Bihar,24,13,20,24,81,Pass
Yash Verma,31-03-2005,422485,West Bengal,6,13,15,7,41,Pass
Aditya Mehta,29-12-2004,345671,Bihar,23,24,11,13,71,Pass
Kunal Singh,01-09-2005,207342,Andhra Pradesh,2,19,7,7,35,Pass
Rohan Verma,22-06-2005,500688,Madhya Pradesh,5,13,3,19,40,Pass
Yash Fernandes,31-03-2006,795925,Assam,2,1,16,5,24,Pass
Raj Sharma,18-01-2006,827512,Bihar,7,18,13,4,42,Pass
Krishna Singh,29-07-2005,153095,Jammu & Kashmir + Ladakh,12,8,24,6,50,Pass
Sukhwinder Verma,15-09-2005,576925,Himachal Pradesh,0,5,2,13,20,Pass
Kunal D'Souza,07-10-2005,846322,Assam,19,23,11,5,58,Pass
Krishna D'Souza,23-02-2005,892384,Odisha,21,17,21,24,83,Pass
Aarav Mehta,23-04-2005,523091,West Bengal,15,8,6,24,53,Pass
Gurpreet Chopra,20-12-2004,828121,Tamil Nadu,4,0,23,20,47,Pass
Vivaan Mehta,16-02-2005,675660,Chhattisgarh,6,21,13,4,44,Pass
Aryan Pillai,21-02-2005,279966,Jammu & Kashmir + Ladakh,14,6,8,19,47,Pass
Aarav Mehta,21-12-2004,328071,Rajasthan,19,24,16,17,76,Pass
Aarav Fernandes,06-07-2005,234969,Uttar Pradesh,19,6,4,13,42,Pass
Vivaan Verma,01-03-2005,252472,Maharashtra,4,12,0,4,20,Pass
Aditya Mehta,31-12-2005,384394,Bihar,3,11,11,24,49,Pass
Krishna Sharma,02-03-2006,393405,Uttar Pradesh,5,16,6,24,51,Pass
Farhan Sharma,05-12-2005,291844,Jharkhand,19,20,4,13,56,Pass
Imran Fernandes,01-01-2006,120585,Andhra Pradesh,5,4,11,24,44,Pass
John Sharma,31-01-2005,569344,Bihar,13,16,20,18,67,Pass
Kunal Fernandes,04-09-2005,386336,Andhra Pradesh,6,9,4,18,37,Pass
Peter Khan,09-09-2005,724782,Telangana,20,0,24,23,67,Pass
Yash Fernandes,25-04-2005,445090,Manipur,4,21,16,13,54,Pass
Krishna Pillai,18-04-2005,667285,Uttar Pradesh,2,3,18,9,32,Pass
Aarav Sharma,25-12-2004,516286,Kerala,6,20,0,13,39,Pass
Raj Mehta,11-03-2006,981459,Uttar Pradesh,9,1,13,10,33,Pass
Vivaan Fernandes,17-02-2006,428637,Gujarat,13,14,6,12,45,Fail
Ishaan Singh,25-06-2005,900639,Jharkhand,7,13,21,7,48,Pass
Aarav Singh,14-01-2006,330640,Rajasthan,1,19,16,22,58,Pass
Manpreet Fernandes,23-11-2004,915320,Gujarat,4,5,13,11,33,Fail
Vivaan Reddy,22-12-2005,138994,Gujarat,22,10,22,14,68,Fail
Rohan Sharma,02-05-2006,452150,Uttar Pradesh,14,10,18,20,62,Pass
Aditya D'Souza,25-09-2005,812213,Telangana,19,2,21,7,49,Pass
Peter Khan,19-02-2005,948456,Karnataka,21,3,21,10,55,Pass
Aditya Reddy,28-05-2005,741294,Bihar,24,11,5,21,61,Pass
Aarav Reddy,12-08-2005,579168,Uttar Pradesh,7,5,11,21,44,Pass
Mathew Chopra,13-01-2006,750575,Uttar Pradesh,0,20,3,0,23,Pass
Rohan Mehta,28-06-2005,994937,West Bengal,3,16,19,9,47,Pass
Paul Reddy,03-05-2006,324943,Maharashtra,16,7,10,3,36,Pass
David Pillai,24-12-2004,504323,Assam,6,21,0,0,27,Pass
Raj Khan,06-07-2005,566223,Rajasthan,23,21,7,17,68,Pass
Raj Fernandes,10-01-2006,533492,Maharashtra,20,16,7,0,43,Pass
Aditya Verma,15-11-2004,846430,Maharashtra,24,15,2,12,53,Pass
Vivaan Pillai,01-01-2005,839961,West Bengal,7,22,6,18,53,Pass
Aarav Verma,09-03-2005,638577,Madhya Pradesh,4,15,16,16,51,Pass
Vivaan Sharma,24-02-2006,416761,Karnataka,4,22,14,24,64,Pass
Rohan D'Souza,12-11-2004,155616,Madhya Pradesh,21,4,9,14,48,Pass
John Verma,15-04-2005,367964,Jharkhand,10,22,22,23,77,Fail
Aarav Chopra,18-12-2005,350314,Karnataka,8,3,2,16,29,Pass
Aarav Pillai,19-11-2005,503720,Tamil Nadu,8,4,18,2,32,Pass
Vivaan Sharma,03-07-2005,794249,Telangana,14,5,6,3,28,Pass
Kunal Fernandes,06-02-2006,840569,Tamil Nadu,21,22,3,17,63,Pass
Peter Chopra,16-12-2004,461043,Uttar Pradesh,11,24,2,19,56,Pass
Ishaan Mehta,11-11-2005,753772,West Bengal,23,5,6,9,43,Pass
Aryan Sharma,09-02-2006,545072,Chhattisgarh,18,20,12,12,62,Pass
David Sharma,20-05-2005,645435,West Bengal,3,6,22,19,50,Pass
Raj Khan,30-06-2005,520030,Jharkhand,13,6,24,22,65,Pass
Rehan Chopra,06-01-2005,892028,Maharashtra,8,7,21,10,46,Pass
Sukhwinder Chopra,15-03-2005,204709,Haryana,10,1,17,1,29,Pass
Kunal Pillai,13-03-2005,322972,Chhattisgarh,20,7,16,2,45,Pass
Peter Fernandes,03-09-2005,268887,Haryana,18,13,13,19,63,Pass
Ayaan Chopra,09-03-2006,408554,Bihar,19,8,21,3,51,Pass
Aryan Sharma,27-10-2005,875368,Bihar,16,15,20,20,71,Pass
John Fernandes,14-01-2005,994275,Bihar,8,8,22,12,50,Pass
Manpreet Fernandes,09-03-2005,913627,Kerala,21,6,12,11,50,Pass
Krishna Singh,22-06-2005,302603,Uttar Pradesh,4,4,17,15,40,Pass
Gurpreet Khan,27-03-2005,788419,Madhya Pradesh,19,9,3,23,54,Pass
Raj D'Souza,21-02-2005,398453,Delhi,22,10,9,18,59,Pass
Vivaan Sharma,08-03-2006,261232,Jharkhand,24,14,15,11,64,Pass
David Sharma,13-03-2005,301435,Uttar Pradesh,10,3,8,18,39,Pass
Raj Verma,09-06-2005,597215,Uttarakhand,18,4,3,20,45,Pass
David Singh,01-04-2005,540918,Punjab,12,23,14,22,71,Pass
Gurpreet Sharma,21-10-2005,994003,West Bengal,3,22,1,19,45,Pass
Ishaan Chopra,30-10-2005,902649,Madhya Pradesh,7,24,2,12,45,Pass
Gurpreet Chopra,20-12-2005,442564,Assam,15,1,3,10,29,Pass
Rohan Pillai,18-12-2005,103873,Haryana,3,10,13,2,28,Pass
Peter Sharma,26-02-2005,815102,West Bengal,4,10,11,5,30,Pass
Aarav Reddy,07-08-2005,124467,Madhya Pradesh,1,12,22,6,41,Pass
Aryan Verma,16-01-2005,172383,Bihar,24,22,14,20,80,Pass
Kunal D'Souza,30-05-2005,757353,Bihar,16,23,17,18,74,Pass
Mathew Pillai,15-07-2005,643254,Madhya Pradesh,24,22,3,3,52,Pass
Vivaan D'Souza,20-04-2006,821816,Telangana,5,9,7,15,36,Pass
Balbir Chopra,29-03-2006,482841,Bihar,4,7,21,20,52,Pass
Rohan Verma,27-11-2004,689430,Punjab,8,8,14,4,34,Pass
Paul Pillai,02-01-2006,606489,Uttar Pradesh,4,5,17,22,48,Pass
Yash Khan,25-06-2005,565385,Uttar Pradesh,24,15,19,10,68,Pass
Raj Verma,21-01-2006,310576,Uttarakhand,24,21,3,20,68,Pass
Kunal Reddy,06-02-2006,514410,Punjab,3,5,3,17,28,Pass
Gurpreet D'Souza,11-02-2006,906185,Madhya Pradesh,2,4,3,0,9,Pass
Vivaan Fernandes,06-05-2006,844856,Rajasthan,17,23,5,19,64,Pass
Sukhwinder Chopra,16-02-2005,646027,Assam,13,8,18,2,41,Pass
Zaid Reddy,03-10-2005,159761,Bihar,5,9,10,15,39,Pass
Aarav Sharma,18-01-2005,477038,Telangana,19,3,16,19,57,Pass
Harjeet Reddy,02-09-2005,986334,Delhi,13,16,19,21,69,Pass
John Khan,20-02-2005,933853,Karnataka,4,15,5,5,29,Pass
Peter Reddy,14-02-2006,210531,Bihar,19,4,8,19,50,Pass
Peter D'Souza,27-01-2006,597706,Gujarat,13,6,4,18,41,Fail
Aditya Singh,25-02-2005,161119,Haryana,18,4,17,22,61,Pass
Kunal Mehta,20-04-2005,781969,Madhya Pradesh,12,23,6,5,46,Pass
Krishna Pillai,17-06-2005,263415,Rajasthan,19,22,10,21,72,Pass
Aryan Khan,08-01-2005,736501,Tamil Nadu,4,20,16,24,64,Pass
Raj Sharma,10-02-2006,278658,Himachal Pradesh,12,1,4,0,17,Pass
Raj D'Souza,07-09-2005,446850,Rajasthan,5,8,17,19,49,Pass
Vivaan Khan,06-02-2005,965348,Bihar,21,23,13,22,79,Pass
Aditya Sharma,13-01-2006,824164,Uttar Pradesh,14,8,10,8,40,Pass
Ishaan Singh,05-11-2005,596270,Bihar,23,6,8,10,47,Pass
David Khan,18-12-2004,406225,Gujarat,12,4,12,11,39,Fail
Aryan Reddy,23-03-2006,839626,Assam,1,18,14,15,48,Pass
Kunal Reddy,26-01-2005,746071,Jharkhand,4,8,14,23,49,Pass
Rohan D'Souza,10-03-2005,123656,Bihar,22,19,3,6,50,Pass
Sukhwinder Chopra,15-09-2005,120879,Jharkhand,12,10,16,23,61,Pass
Krishna Singh,16-11-2004,780687,Puducherry,18,6,4,8,36,Pass
Gurpreet Pillai,28-01-2005,757710,Punjab,7,6,12,15,40,Pass
Krishna Fernandes,23-02-2005,581535,Uttar Pradesh,13,20,4,14,51,Pass
Aditya Singh,20-02-2006,778511,West Bengal,3,10,16,3,32,Pass
Ayaan D'Souza,30-05-2005,946027,Andhra Pradesh,1,22,10,22,55,Pass
Sukhwinder Mehta,28-09-2005,696032,Madhya Pradesh,6,11,24,2,43,Pass
Rehan Chopra,14-03-2006,285392,Tamil Nadu,1,18,1,9,29,Pass
Ishaan D'Souza,05-07-2005,477034,Telangana,13,9,17,17,56,Pass
Aryan Chopra,29-07-2005,267968,Rajasthan,7,12,8,1,28,Pass
Rohan D'Souza,20-07-2005,852828,Tamil Nadu,21,23,11,1,56,Pass
Vivaan Verma,24-04-2005,623833,Haryana,16,23,8,3,50,Pass
Aarav Pillai,11-06-2005,427709,Rajasthan,23,23,6,15,67,Pass
Aarav Khan,07-02-2005,117713,Tamil Nadu,23,8,21,2,54,Pass
Yash Chopra,28-04-2005,295832,Maharashtra,19,12,2,19,52,Pass
Manpreet Singh,28-04-2005,761130,Punjab,1,2,10,18,31,Pass
Kunal Khan,09-05-2005,473359,Himachal Pradesh,5,14,7,10,36,Pass
Raj Pillai,05-12-2005,347812,Rajasthan,3,9,0,22,34,Pass
Yash Reddy,19-02-2006,330023,Telangana,12,22,10,2,46,Pass
Rohan Sharma,14-04-2006,597800,Himachal Pradesh,4,19,15,14,52,Pass
Kunal D'Souza,31-12-2004,549587,Uttar Pradesh,18,19,9,18,64,Pass
Peter Pillai,11-11-2005,263860,Karnataka,4,20,11,2,37,Pass
Rohan Sharma,27-08-2005,291319,Madhya Pradesh,7,4,19,23,53,Pass
Peter Verma,12-04-2006,487945,Arunachal Pradesh,14,10,17,6,47,Pass
Rohan Singh,30-03-2005,946311,Chhattisgarh,20,5,14,13,52,Pass
Mathew Chopra,19-03-2006,738526,Uttar Pradesh,24,3,13,24,64,Pass
Ishaan Pillai,21-09-2005,507405,Madhya Pradesh,8,13,5,17,43,Pass
Aditya Khan,14-09-2005,408383,Gujarat,1,23,17,12,53,Fail
Ishaan D'Souza,08-06-2005,569205,Haryana,21,18,2,4,45,Pass
Yash D'Souza,18-05-2005,689777,Maharashtra,4,3,6,22,35,Pass
Gurpreet Fernandes,15-02-2005,900426,Bihar,12,11,15,11,49,Pass
Yash Singh,25-07-2005,642813,Rajasthan,22,19,4,16,61,Pass
Rohan Khan,26-05-2005,721717,Bihar,2,15,16,16,49,Pass
Vivaan Sharma,02-07-2005,254601,Gujarat,22,21,13,7,63,Fail
Vivaan D'Souza,19-02-2005,907781,Odisha,1,10,4,7,22,Pass
Kunal Khan,14-01-2006,518349,Uttarakhand,16,18,8,3,45,Pass
Farhan Fernandes,09-12-2004,310599,Madhya Pradesh,21,22,3,20,66,Pass
Zaid Khan,28-12-2005,923465,Tamil Nadu,22,15,12,16,65,Pass
Vivaan Sharma,30-01-2005,382363,Uttar Pradesh,7,19,14,23,63,Pass
Sukhwinder Reddy,22-02-2006,859346,Delhi,11,16,21,8,56,Pass
Aarav Verma,28-03-2005,466285,Maharashtra,10,11,2,18,41,Pass
Krishna Verma,16-11-2005,585045,Odisha,14,24,1,19,58,Pass
Vivaan Chopra,09-11-2004,258495,Haryana,5,0,20,23,48,Pass
Raj Verma,29-11-2005,851457,Uttar Pradesh,15,12,7,18,52,Pass
Vivaan Verma,05-12-2004,209615,Madhya Pradesh,8,14,18,16,56,Pass
Ishaan Fernandes,28-03-2005,878750,Andhra Pradesh,16,9,10,1,36,Pass
Kunal Khan,26-07-2005,834717,Uttar Pradesh,9,20,15,4,48,Pass
Vivaan Khan,26-02-2005,538428,Rajasthan,18,0,2,21,41,Pass
Balbir Sharma,07-08-2005,517003,Bihar,21,14,7,11,53,Pass
Raj Chopra,14-02-2005,356577,Andhra Pradesh,12,7,20,12,51,Pass
Kunal Khan,20-09-2005,651075,Maharashtra,19,8,2,19,48,Pass
Aryan Singh,22-10-2005,769152,Maharashtra,18,8,2,13,41,Pass
Yash Sharma,03-08-2005,852813,Tamil Nadu,22,14,13,17,66,Pass
John Reddy,22-02-2005,473551,Uttar Pradesh,0,24,13,19,56,Pass
Mathew Chopra,16-04-2005,421212,West Bengal,3,23,2,14,42,Pass
Aarav Mehta,22-06-2005,201631,Uttar Pradesh,11,7,12,4,34,Pass
Krishna Singh,13-11-2005,657457,Odisha,6,6,7,0,19,Pass
Krishna Khan,03-08-2005,581899,Bihar,16,10,11,12,49,Pass
Vivaan Fernandes,15-02-2006,442415,Uttar Pradesh,5,21,17,8,51,Pass
Aarav Verma,03-03-2006,862269,Maharashtra,23,21,2,8,54,Pass
Aarav Verma,08-05-2006,137009,Bihar,24,8,16,3,51,Pass
Aditya D'Souza,02-03-2006,976614,Haryana,15,3,19,16,53,Pass
Ishaan Pillai,06-12-2004,997752,Uttar Pradesh,13,22,2,1,38,Pass
Krishna Sharma,14-07-2005,827234,Jharkhand,7,21,1,11,40,Pass
Zaid Fernandes,18-01-2006,623432,Uttar Pradesh,6,8,21,15,50,Pass
Mathew Fernandes,22-09-2005,267930,Bihar,14,6,8,9,37,Pass
Ishaan Singh,24-12-2005,865499,Delhi,6,1,0,20,27,Pass
Aryan D'Souza,15-11-2004,359774,Maharashtra,9,1,15,14,39,Pass
Kunal Khan,18-04-2006,202338,Odisha,6,19,23,16,64,Pass
Raj Chopra,24-01-2005,782913,Jharkhand,16,24,22,17,79,Fail
Raj Chopra,27-12-2004,972972,Madhya Pradesh,4,15,11,12,42,Pass
Ayaan Reddy,07-02-2005,418665,Uttar Pradesh,24,3,10,1,38,Pass
Kunal D'Souza,11-12-2005,345956,Tamil Nadu,22,11,16,21,70,Pass
Aditya Fernandes,03-05-2005,346403,Bihar,8,4,23,13,48,Pass
Rohan Verma,24-02-2006,260771,Punjab,1,20,12,22,55,Pass
Aarav Khan,28-04-2006,444816,Uttar Pradesh,3,16,21,15,55,Pass
Aditya Pillai,20-05-2005,403877,Bihar,4,4,21,19,48,Pass
Harjeet D'Souza,06-10-2005,181724,Tamil Nadu,22,9,23,23,77,Pass
Ishaan Mehta,15-05-2005,234957,Bihar,11,1,16,11,39,Pass
Sukhwinder Pillai,23-05-2005,606942,Tamil Nadu,14,0,12,6,32,Pass
Vivaan Singh,13-10-2005,281016,Himachal Pradesh,16,11,7,24,58,Pass
Aryan Reddy,07-05-2006,650693,Madhya Pradesh,19,1,22,6,48,Pass
Yash Chopra,21-04-2006,879044,Maharashtra,20,24,2,14,60,Pass
Balbir Sharma,26-08-2005,625204,Maharashtra,1,12,0,4,17,Pass
Rehan Sharma,10-12-2005,115769,Punjab,22,10,9,8,49,Pass
Aarav Chopra,29-04-2006,363574,Rajasthan,2,7,19,2,30,Pass
Farhan Pillai,02-03-2005,250221,Madhya Pradesh,13,0,8,8,29,Pass
Sukhwinder Reddy,20-08-2005,851361,Uttarakhand,20,1,3,21,45,Pass
Aditya Khan,20-04-2005,665423,Rajasthan,1,24,5,9,39,Pass
Aditya Fernandes,23-01-2006,558120,Punjab,7,22,19,14,62,Pass
Aditya Chopra,14-09-2005,932157,Andhra Pradesh,22,7,5,0,34,Pass
Vivaan Verma,24-11-2005,501109,Rajasthan,9,9,15,20,53,Pass
Mathew Chopra,21-02-2006,824214,Jharkhand,2,8,12,11,33,Pass
Rehan Singh,25-02-2006,456793,Kerala,19,16,0,8,43,Pass
Yash Mehta,13-11-2005,185087,West Bengal,3,21,11,20,55,Pass
Raj D'Souza,17-08-2005,172214,Himachal Pradesh,20,5,15,0,40,Pass
Sukhwinder Sharma,14-11-2004,462925,Uttar Pradesh,8,12,20,15,55,Pass
Aditya Singh,08-03-2005,140509,Chhattisgarh,12,12,13,1,38,Pass
Aarav D'Souza,30-05-2005,185738,Bihar,18,17,0,1,36,Pass
Vivaan Singh,14-03-2006,862107,West Bengal,19,0,7,23,49,Pass
Aditya Fernandes,05-11-2005,932464,Punjab,18,11,3,5,37,Pass
Aarav Chopra,14-12-2005,610311,Haryana,0,10,11,15,36,Pass
Gurpreet Mehta,10-01-2005,425018,Haryana,15,18,6,7,46,Pass
Paul Chopra,13-02-2006,622209,Delhi,3,0,4,4,11,Pass
Aditya Khan,03-03-2005,855080,Uttar Pradesh,5,2,4,10,21,Pass
Ayaan Singh,22-11-2004,827730,Jharkhand,8,19,15,16,58,Pass
Raj D'Souza,05-11-2005,331622,Karnataka,20,3,17,17,57,Pass
Rohan Chopra,17-01-2005,922619,Delhi,13,9,5,7,34,Pass
Sukhwinder Verma,12-03-2006,455466,Haryana,24,3,2,3,32,Pass
Ishaan Mehta,15-05-2005,171905,Odisha,10,5,1,7,23,Pass
Aarav Verma,23-12-2004,856833,Tamil Nadu,4,22,22,16,64,Pass
Krishna Mehta,05-06-2005,985304,Odisha,19,9,10,2,40,Pass
Yash Pillai,18-07-2005,947873,West Bengal,7,15,17,8,47,Pass
Aditya Pillai,05-10-2005,551635,Uttarakhand,16,23,3,20,62,Pass
Vivaan Reddy,04-12-2004,560530,Bihar,13,9,4,8,34,Pass
Harjeet Chopra,03-05-2006,122172,Karnataka,9,22,15,10,56,Pass
Vivaan Pillai,28-11-2005,673296,Jammu & Kashmir + Ladakh,0,17,16,17,50,Pass
Aarav Verma,03-12-2005,407890,Assam,1,18,6,1,26,Pass
Yash Sharma,26-01-2006,406523,Madhya Pradesh,24,2,6,3,35,Pass
Yash Verma,26-07-2005,580526,Puducherry,12,6,7,5,30,Pass
Kunal D'Souza,24-02-2006,248870,Bihar,18,13,5,19,55,Pass
Manpreet Mehta,17-06-2005,940913,Madhya Pradesh,23,7,5,18,53,Pass
Farhan Verma,27-05-2005,979014,Gujarat,13,20,10,22,65,Fail
Gurpreet Sharma,15-11-2005,844072,Kerala,4,15,19,24,62,Pass
Ishaan Reddy,29-05-2005,530756,Maharashtra,7,14,2,24,47,Pass
Ishaan Pillai,10-03-2006,722163,Telangana,18,20,10,0,48,Pass
Aarav Pillai,20-05-2005,422449,Madhya Pradesh,7,2,12,1,22,Pass
Peter Reddy,08-02-2005,867356,Bihar,3,1,2,21,27,Pass
Rohan Verma,26-06-2005,533612,Telangana,5,21,0,3,29,Pass
Aditya Fernandes,25-10-2005,244422,Andhra Pradesh,15,21,7,12,55,Pass
Gurpreet Sharma,05-07-2005,269897,West Bengal,3,24,15,16,58,Pass
Mathew Fernandes,25-07-2005,583954,West Bengal,3,24,9,19,55,Pass
David D'Souza,04-02-2006,344450,Rajasthan,18,2,4,24,48,Pass
Krishna Pillai,24-04-2005,496909,Uttar Pradesh,7,16,3,5,31,Pass
Yash Khan,04-02-2005,913721,Jammu & Kashmir + Ladakh,13,18,2,14,47,Pass
Rehan Pillai,11-06-2005,212682,Bihar,23,14,0,11,48,Pass
Gurpreet Singh,13-12-2005,685642,Karnataka,13,18,18,15,64,Pass
John Sharma,11-11-2004,741571,Kerala,6,5,22,0,33,Pass
Ishaan Singh,06-08-2005,164492,Rajasthan,14,12,22,21,69,Pass
Raj Khan,23-02-2005,672701,Tamil Nadu,11,3,9,21,44,Pass
Rohan Verma,07-01-2005,979497,Rajasthan,11,20,23,17,71,Pass
Aarav Verma,12-12-2004,686494,Andhra Pradesh,14,9,20,2,45,Pass
Aarav Fernandes,13-12-2004,462493,West Bengal,3,22,20,20,65,Pass
Harjeet Khan,19-10-2005,227239,Uttar Pradesh,4,10,15,4,33,Pass
Sukhwinder Singh,08-02-2006,668256,Uttar Pradesh,20,1,5,1,27,Pass
Raj Pillai,17-03-2005,192034,West Bengal,8,16,11,10,45,Pass
Balbir Chopra,03-08-2005,843839,Madhya Pradesh,20,5,7,22,54,Pass
Harjeet Verma,04-05-2006,176840,Tamil Nadu,19,2,0,9,30,Pass
Raj Chopra,07-05-2006,529423,Uttar Pradesh,2,13,22,14,51,Pass
Yash Reddy,02-08-2005,433794,Maharashtra,1,8,23,8,40,Pass
Balbir D'Souza,30-11-2005,977933,Rajasthan,1,5,8,4,18,Pass
Raj D'Souza,01-05-2005,561203,Rajasthan,18,17,3,20,58,Pass
Peter Reddy,23-04-2005,515142,Rajasthan,0,13,2,10,25,Pass
Gurpreet Verma,11-07-2005,621502,Uttarakhand,2,12,3,22,39,Pass
Krishna Reddy,14-01-2005,565542,Gujarat,12,3,3,14,32,Fail
Sukhwinder Verma,26-11-2004,572628,Bihar,3,5,1,19,28,Pass
Ishaan Pillai,15-10-2005,673763,Andhra Pradesh,14,5,17,23,59,Pass
Mathew Pillai,31-10-2005,503629,Bihar,18,19,9,7,53,Pass
Vivaan Sharma,25-02-2005,375945,Rajasthan,14,24,8,12,58,Pass
Krishna Verma,15-05-2005,961320,Madhya Pradesh,11,0,8,21,40,Pass
Rohan Sharma,19-02-2006,126882,Gujarat,16,3,13,19,51,Fail
Yash Pillai,24-03-2005,378560,Himachal Pradesh,13,16,11,22,62,Pass
Kunal Chopra,16-02-2006,295347,Uttar Pradesh,17,15,22,16,70,Pass
Kunal Singh,07-11-2005,983521,Rajasthan,6,1,5,13,25,Pass
Yash Reddy,29-05-2005,585647,Uttar Pradesh,19,20,13,17,69,Pass
Aditya Sharma,29-04-2006,448320,Telangana,3,4,18,18,43,Pass
Rohan Singh,04-11-2005,613544,Andhra Pradesh,9,12,2,3,26,Pass
Kunal Fernandes,14-03-2006,613875,Bihar,5,13,6,19,43,Pass
Yash Singh,16-11-2005,132590,Maharashtra,18,13,10,2,43,Pass
Kunal Khan,13-03-2005,771095,Karnataka,18,23,18,8,67,Pass
John Chopra,16-06-2005,497899,Manipur,1,1,14,6,22,Pass
Vivaan Fernandes,23-11-2005,825590,Rajasthan,12,12,6,2,32,Pass
Kunal D'Souza,03-03-2005,740830,Assam,0,23,17,11,51,Pass
Vivaan Fernandes,21-11-2004,200322,Assam,21,12,6,24,63,Pass
Krishna Pillai,11-01-2005,228623,Chhattisgarh,3,17,23,18,61,Pass
Raj Reddy,22-01-2006,997275,Odisha,21,8,19,12,60,Pass
Kunal Sharma,15-01-2006,968896,Telangana,24,17,3,11,55,Pass
Kunal Verma,16-04-2006,232717,Himachal Pradesh,3,21,7,15,46,Pass
Aryan Verma,09-10-2005,441857,Odisha,6,11,15,20,52,Pass
Aarav Chopra,28-11-2004,739373,Uttarakhand,0,4,3,23,30,Pass
Vivaan Reddy,17-12-2005,688237,Punjab,19,21,1,1,42,Pass
Rohan Mehta,18-03-2006,806951,Kerala,20,7,14,9,50,Pass
Krishna D'Souza,05-07-2005,547312,Bihar,19,11,7,18,55,Pass
Vivaan Sharma,23-03-2006,612774,Odisha,13,20,2,13,48,Pass
Krishna Verma,11-12-2005,714964,Haryana,3,17,10,1,31,Pass
Aditya Mehta,19-07-2005,470603,Bihar,3,5,20,9,37,Pass
Krishna Sharma,11-12-2005,873375,Maharashtra,23,10,2,2,37,Pass
Sukhwinder Fernandes,24-02-2006,896452,Rajasthan,20,9,11,12,52,Pass
Raj Pillai,05-05-2006,175404,Punjab,3,18,22,2,45,Pass
Manpreet Fernandes,15-03-2005,564576,Bihar,11,5,20,13,49,Pass
Gurpreet Reddy,20-03-2006,949330,Telangana,1,24,11,0,36,Pass
Yash D'Souza,20-11-2005,280445,Bihar,3,8,8,0,19,Pass
Aarav Singh,25-09-2005,777120,Chhattisgarh,6,24,22,11,63,Pass
Yash Khan,18-04-2005,630545,Delhi,8,11,18,2,39,Pass
Aryan Singh,27-08-2005,517231,Bihar,5,13,0,22,40,Pass
Mathew Verma,03-03-2005,978183,Odisha,14,4,15,3,36,Pass
Aarav Fernandes,13-06-2005,416855,Uttar Pradesh,4,13,1,14,32,Pass
Mathew Fernandes,24-08-2005,833164,Uttar Pradesh,0,20,3,4,27,Pass
Mathew Singh,17-11-2005,375296,Haryana,4,1,11,20,36,Pass
Mathew Chopra,28-02-2005,989871,Uttar Pradesh,24,10,0,23,57,Pass
David Sharma,21-03-2005,103713,Punjab,13,9,16,5,43,Pass
Aryan Khan,09-07-2005,946033,Rajasthan,11,18,7,18,54,Pass
Kunal Chopra,11-01-2006,533413,Assam,23,17,17,3,60,Pass
Ishaan Sharma,13-01-2006,721577,Uttar Pradesh,11,15,23,16,65,Pass
Rohan Fernandes,12-03-2006,509752,Madhya Pradesh,3,15,5,7,30,Pass
Aryan D'Souza,23-07-2005,462210,Haryana,4,15,3,21,43,Pass
Sukhwinder Chopra,08-02-2005,115586,Jharkhand,16,11,11,10,48,Pass
Paul Chopra,30-06-2005,189756,Chhattisgarh,6,9,20,15,50,Pass
Aryan Fernandes,06-12-2005,914915,Kerala,15,12,3,7,37,Pass
Krishna Chopra,06-10-2005,603743,Tamil Nadu,22,3,24,5,54,Pass
Harjeet Reddy,12-03-2006,163892,Jammu & Kashmir + Ladakh,17,8,11,9,45,Pass
Farhan Reddy,10-01-2005,846117,Gujarat,23,10,16,11,60,Fail
Vivaan Fernandes,26-05-2005,644544,Tamil Nadu,17,0,20,18,55,Pass
Sukhwinder D'Souza,03-04-2005,823322,Maharashtra,17,22,2,18,59,Pass
Ishaan Chopra,29-09-2005,249487,Bihar,11,8,19,6,44,Pass
Mathew Reddy,03-04-2005,997996,Telangana,22,22,1,20,65,Pass
Yash Chopra,15-03-2006,188600,Bihar,11,21,22,9,63,Pass
Aditya Fernandes,28-11-2005,874237,Madhya Pradesh,14,3,5,0,22,Pass
Sukhwinder Sharma,07-09-2005,282144,Gujarat,17,10,14,21,62,Fail
Balbir Khan,01-02-2006,482084,Rajasthan,18,15,8,10,51,Pass
Vivaan Reddy,05-09-2005,275588,Bihar,3,17,1,24,45,Pass
Harjeet Mehta,21-05-2005,943476,Madhya Pradesh,22,3,9,8,42,Pass
Aryan Sharma,15-02-2005,816293,Uttar Pradesh,17,18,7,13,55,Pass
Vivaan Mehta,06-01-2006,415120,Maharashtra,7,4,7,21,39,Pass
David D'Souza,24-01-2005,346191,Madhya Pradesh,21,2,5,11,39,Pass
Aryan Pillai,11-01-2005,491767,Rajasthan,12,7,9,21,49,Pass
Krishna Verma,02-05-2006,110515,Uttarakhand,8,6,11,8,33,Pass
Rohan Singh,20-12-2004,219020,Nagaland,4,7,4,8,23,Pass
Kunal Mehta,20-12-2005,394774,Bihar,4,19,14,24,61,Pass
Krishna Reddy,12-03-2006,616528,Andhra Pradesh,23,20,11,14,68,Pass
Raj Chopra,17-01-2006,210036,Andhra Pradesh,3,16,17,21,57,Pass
Rohan Mehta,19-05-2005,461462,Jammu & Kashmir + Ladakh,18,12,14,18,62,Pass
Aarav Verma,11-05-2005,808606,Punjab,1,20,4,24,49,Pass
Aditya Sharma,18-05-2005,974805,Punjab,5,3,11,18,37,Pass
Krishna Pillai,16-01-2005,936222,Uttarakhand,18,23,3,7,51,Pass
Kunal Pillai,23-01-2006,608108,Punjab,10,1,14,21,46,Pass
Ishaan Pillai,12-12-2004,811269,Assam,23,14,15,20,72,Pass
Rehan Sharma,13-02-2005,588135,Punjab,12,7,12,6,37,Pass
Aarav Verma,08-08-2005,462549,Assam,14,4,10,6,34,Pass
Harjeet Fernandes,01-07-2005,699125,Kerala,10,23,14,8,55,Pass
Krishna Reddy,18-01-2005,386798,Maharashtra,0,9,16,8,33,Pass
Harjeet Verma,16-02-2006,571341,Maharashtra,19,8,5,10,42,Pass
Imran Fernandes,26-06-2005,995882,Manipur,3,2,12,9,26,Pass
Yash Fernandes,26-02-2006,148973,West Bengal,24,3,13,8,48,Pass
Raj Khan,15-08-2005,289685,Maharashtra,24,12,2,14,52,Pass
Raj Reddy,03-03-2006,134513,Bihar,5,23,14,16,58,Pass
Aryan Singh,03-01-2006,844202,Bihar,2,5,1,23,31,Pass
Kunal Singh,04-02-2006,364406,West Bengal,3,15,19,16,53,Pass
Aarav Fernandes,01-03-2006,989283,West Bengal,3,16,24,21,64,Pass
Mathew Pillai,12-06-2005,998113,Karnataka,4,14,17,4,39,Pass
Raj Sharma,31-05-2005,961912,Chhattisgarh,3,18,21,15,57,Pass
Balbir Singh,13-10-2005,918129,Maharashtra,11,9,1,2,23,Pass
Ishaan D'Souza,28-11-2005,670353,Uttar Pradesh,8,17,8,5,38,Pass
Vivaan Reddy,03-03-2006,883207,Jammu & Kashmir + Ladakh,13,0,12,16,41,Pass
Krishna Verma,08-04-2005,720388,Uttar Pradesh,22,14,1,8,45,Pass
Krishna D'Souza,24-08-2005,720133,Madhya Pradesh,6,23,2,12,43,Pass
Manpreet D'Souza,03-02-2006,277460,Tamil Nadu,16,19,17,21,73,Pass
Kunal Reddy,13-02-2006,395122,Rajasthan,16,12,4,1,33,Pass
Sukhwinder Verma,11-03-2006,621756,West Bengal,2,3,17,14,36,Pass
Harjeet Sharma,07-12-2005,908751,Rajasthan,1,14,18,12,45,Pass
Krishna Mehta,24-10-2005,622315,Kerala,18,22,20,9,69,Fail
Manpreet Verma,11-02-2005,797569,Maharashtra,7,23,2,13,45,Pass
Imran Fernandes,28-04-2005,433837,Delhi,4,17,8,9,38,Pass
Krishna Reddy,23-03-2006,837569,Assam,23,2,17,6,48,Pass
Yash Fernandes,24-11-2005,417100,Rajasthan,14,21,1,0,36,Pass
Mathew Fernandes,17-01-2006,795972,Maharashtra,0,21,7,14,42,Pass
Aditya Sharma,25-03-2005,673068,Rajasthan,21,23,10,20,74,Pass
Kunal Chopra,07-04-2006,422952,Rajasthan,16,7,1,24,48,Pass
Aryan Chopra,25-09-2005,739505,Karnataka,7,19,13,15,54,Pass
Vivaan Reddy,20-03-2006,118551,Bihar,10,15,5,4,34,Pass
Balbir Pillai,02-04-2005,370862,Tamil Nadu,12,10,9,7,38,Pass
Zaid Chopra,13-05-2005,669340,Maharashtra,1,12,22,8,43,Pass
Paul Singh,04-07-2005,174950,Haryana,3,23,7,3,36,Pass
Rohan Verma,11-03-2006,930676,Uttar Pradesh,4,0,12,23,39,Pass
Kunal Reddy,04-09-2005,453461,Mizoram,4,8,6,8,26,Pass
Ayaan Reddy,21-07-2005,633375,Telangana,1,15,17,6,39,Pass
Rohan Mehta,21-12-2004,741293,Uttarakhand,14,6,13,5,38,Pass
Vivaan Pillai,09-05-2005,454433,Uttar Pradesh,19,23,1,10,53,Pass
Manpreet D'Souza,11-09-2005,555262,Madhya Pradesh,5,21,5,5,36,Pass
Aarav Fernandes,22-03-2006,100606,Maharashtra,6,13,9,10,38,Pass
Rehan Mehta,02-04-2006,516173,Rajasthan,2,5,24,22,53,Pass
Krishna D'Souza,05-01-2006,707674,Maharashtra,5,11,11,15,42,Pass
David Pillai,30-03-2006,546506,Andhra Pradesh,9,13,8,4,34,Pass
Raj Sharma,02-11-2005,135675,Punjab,9,13,12,2,36,Pass
Ishaan Chopra,01-06-2005,308361,Tamil Nadu,10,3,19,22,54,Pass
Raj Fernandes,14-02-2005,859377,Chhattisgarh,1,22,17,4,44,Pass
Yash Khan,06-03-2006,173683,Haryana,0,2,21,5,28,Pass
Harjeet Reddy,11-05-2005,103423,Madhya Pradesh,7,7,3,24,41,Pass
Rohan Reddy,22-12-2005,272829,Odisha,12,20,9,3,44,Pass
Krishna Reddy,30-07-2005,815828,Madhya Pradesh,15,11,18,3,47,Pass
Krishna Pillai,11-11-2005,511329,Himachal Pradesh,19,21,3,5,48,Pass
Sukhwinder Chopra,02-03-2005,982484,Himachal Pradesh,17,13,11,18,59,Pass
Raj Fernandes,13-04-2005,572882,Uttar Pradesh,22,16,7,4,49,Pass
Rohan D'Souza,14-08-2005,327433,Uttar Pradesh,5,4,6,24,39,Pass
Rohan Reddy,18-08-2005,791301,Gujarat,0,4,1,3,8,Fail
Raj Fernandes,09-12-2005,817506,Maharashtra,18,8,2,21,49,Pass
Aarav Fernandes,25-11-2005,187178,Uttar Pradesh,16,3,0,17,36,Pass
Yash Singh,07-11-2004,299010,Madhya Pradesh,22,7,5,14,48,Pass
Raj Chopra,20-03-2005,113630,Rajasthan,21,13,11,13,58,Pass
Raj Chopra,20-08-2005,718516,Bihar,17,3,9,15,44,Pass
Aarav Singh,31-03-2005,175865,Odisha,16,18,3,7,44,Pass
Krishna Pillai,10-05-2005,961987,Karnataka,3,10,17,23,53,Pass
Aryan Fernandes,28-04-2005,434472,Andhra Pradesh,3,23,19,4,49,Pass
Rohan Khan,16-06-2005,654264,Manipur,1,4,18,13,36,Pass
Sukhwinder Sharma,28-04-2006,939630,Madhya Pradesh,3,24,7,21,55,Pass
Aryan Fernandes,19-07-2005,260739,Bihar,19,7,19,13,58,Pass
Raj Singh,31-12-2004,208287,West Bengal,0,2,22,18,42,Pass
Farhan Sharma,12-03-2006,588111,Uttar Pradesh,11,15,17,23,66,Pass
Paul Sharma,16-09-2005,605744,Himachal Pradesh,3,19,7,8,37,Pass
Aarav Fernandes,18-08-2005,177931,Bihar,20,19,24,20,83,Pass
Yash Singh,07-06-2005,946868,West Bengal,12,11,16,6,45,Pass
Aarav Singh,10-11-2005,158928,Punjab,10,8,8,10,36,Pass
Yash Verma,15-06-2005,924978,Madhya Pradesh,16,22,3,19,60,Pass
Kunal Chopra,20-11-2005,360983,Madhya Pradesh,20,8,3,10,41,Pass
Yash Khan,04-03-2006,384581,Bihar,7,24,18,19,68,Pass
Raj Singh,26-09-2005,570778,Bihar,13,16,3,23,55,Pass
Raj Fernandes,23-05-2005,989451,Uttarakhand,14,21,3,3,41,Pass
Manpreet Mehta,03-03-2005,189111,Delhi,21,21,20,21,83,Pass
Sukhwinder Chopra,26-04-2006,329300,Punjab,2,19,10,13,44,Pass
Aditya Pillai,18-02-2006,431359,Bihar,11,10,5,23,49,Pass
Sukhwinder D'Souza,13-04-2006,442086,Uttar Pradesh,21,18,7,13,59,Pass
Ishaan Mehta,17-04-2005,758462,Bihar,7,22,20,24,73,Pass
Kunal Reddy,08-10-2005,156836,Bihar,23,1,9,0,33,Pass
Rehan Sharma,02-01-2005,207970,Bihar,5,16,3,19,43,Pass
Rohan Khan,28-11-2005,547491,Rajasthan,2,23,24,24,73,Pass
Zaid Verma,05-11-2005,171695,Bihar,5,17,16,4,42,Pass
Gurpreet Chopra,04-12-2004,888522,Jammu & Kashmir + Ladakh,21,10,20,0,51,Pass
Kunal Fernandes,08-08-2005,429092,Bihar,14,9,3,21,47,Pass
Aditya Verma,12-02-2005,952115,West Bengal,1,11,8,23,43,Pass
Vivaan D'Souza,29-03-2006,945458,Uttar Pradesh,22,8,11,3,44,Pass
Ishaan Singh,06-06-2005,666780,Karnataka,7,24,10,11,52,Pass
Kunal Singh,26-01-2006,372225,Nagaland,1,5,6,6,18,Pass
Aditya Khan,21-11-2004,754087,Kerala,16,4,16,23,59,Pass
Manpreet Mehta,22-12-2004,498818,Telangana,7,10,20,18,55,Pass
Aryan Reddy,30-07-2005,504031,West Bengal,8,16,10,15,49,Pass
Ishaan Pillai,13-03-2006,124533,Gujarat,5,18,10,7,40,Fail
Ishaan Chopra,15-03-2006,942376,Telangana,1,3,3,13,20,Pass
Aditya Singh,03-03-2006,870374,Delhi,6,21,22,2,51,Pass
Sukhwinder Fernandes,22-04-2006,190407,Arunachal Pradesh,9,6,9,18,42,Pass
Aditya Khan,13-12-2005,892479,Gujarat,23,11,20,3,57,Fail
Vivaan Mehta,12-02-2005,733569,Madhya Pradesh,6,22,0,9,37,Pass
Ishaan Sharma,12-06-2005,947953,Chhattisgarh,8,23,6,22,59,Pass
John Fernandes,11-03-2006,419166,Madhya Pradesh,24,14,3,7,48,Pass
Zaid Singh,28-05-2005,879433,Rajasthan,6,7,12,0,25,Pass
Aarav Fernandes,22-04-2005,944037,Bihar,17,1,14,3,35,Pass
Raj Reddy,28-08-2005,725403,Haryana,24,14,10,5,53,Pass
David Reddy,03-06-2005,346690,Uttar Pradesh,2,2,13,23,40,Pass
Ishaan Singh,15-10-2005,896729,Haryana,24,14,3,13,54,Pass
Raj Khan,22-12-2005,518906,Karnataka,24,9,19,5,57,Pass
Aarav Chopra,12-08-2005,484026,Goa,7,8,22,2,39,Fail
Rohan Singh,29-04-2005,493688,Chhattisgarh,3,2,2,23,30,Pass
Ishaan Khan,04-03-2006,626566,Andhra Pradesh,20,18,5,12,55,Pass
Aarav Fernandes,20-01-2005,844346,West Bengal,3,22,16,6,47,Pass
Gurpreet Singh,23-01-2006,496860,Rajasthan,5,10,9,9,33,Pass
David Mehta,05-02-2006,624854,Himachal Pradesh,10,9,19,3,41,Pass
Harjeet Singh,08-06-2005,290368,Uttar Pradesh,24,3,22,12,61,Pass
Vivaan Pillai,16-11-2005,843806,Kerala,20,20,10,21,71,Fail
Mathew Reddy,05-11-2005,242488,Rajasthan,16,16,12,24,68,Pass
Aditya Singh,25-02-2005,577240,Chhattisgarh,10,6,5,17,38,Pass
Raj Chopra,10-12-2005,169042,Madhya Pradesh,14,20,3,21,58,Pass
Peter Singh,29-12-2004,714759,Andhra Pradesh,5,13,16,4,38,Pass
Harjeet Khan,10-08-2005,158259,Maharashtra,23,3,4,9,39,Pass
Mathew Fernandes,01-12-2004,205197,Jharkhand,21,2,19,11,53,Pass
Paul Singh,07-07-2005,703378,Bihar,24,8,24,21,77,Pass
Raj Mehta,24-02-2005,896653,Gujarat,1,18,5,3,27,Fail
Aryan Mehta,06-12-2004,428375,Madhya Pradesh,2,18,10,14,44,Pass
John Reddy,11-12-2005,323937,Tamil Nadu,2,20,11,1,34,Pass
David Chopra,02-05-2006,677981,Tamil Nadu,14,7,9,19,49,Pass
Vivaan Reddy,22-01-2005,570863,Assam,1,19,8,9,37,Pass
Rohan Reddy,08-09-2005,890588,Chhattisgarh,0,13,0,17,30,Pass
Aryan Fernandes,23-08-2005,568114,Uttar Pradesh,16,19,17,20,72,Pass
Aryan Khan,18-04-2006,575706,Uttar Pradesh,11,23,16,6,56,Pass
Gurpreet Sharma,24-11-2005,497350,Uttar Pradesh,13,3,16,8,40,Pass
Vivaan Singh,26-11-2004,803410,Jharkhand,4,22,23,0,49,Pass
Kunal Chopra,19-09-2005,459651,Haryana,9,9,6,23,47,Pass
Imran Sharma,14-04-2006,882156,Assam,20,0,18,21,59,Pass
Manpreet Pillai,21-06-2005,159532,Haryana,20,14,6,24,64,Pass
Vivaan Fernandes,01-04-2006,455167,Maharashtra,11,18,2,23,54,Pass
Paul Sharma,07-08-2005,911552,Haryana,5,1,5,10,21,Pass
Krishna Pillai,14-01-2006,991070,Jharkhand,16,3,12,22,53,Pass
Aryan Chopra,07-02-2006,690793,West Bengal,3,15,6,24,48,Pass
Vivaan Khan,12-01-2005,184404,Uttar Pradesh,5,2,24,10,41,Pass
Krishna Singh,29-12-2004,714762,Uttar Pradesh,0,10,22,17,49,Pass
Vivaan D'Souza,26-09-2005,607816,Chhattisgarh,10,23,5,13,51,Pass
Rohan Fernandes,02-05-2006,315313,Telangana,12,4,11,2,29,Pass
Vivaan Reddy,23-01-2006,979714,Uttar Pradesh,21,10,11,5,47,Pass
Rehan D'Souza,08-05-2006,934051,Tamil Nadu,15,23,4,14,56,Pass
Sukhwinder Sharma,25-03-2006,542798,Maharashtra,17,19,4,6,46,Pass
Aditya Khan,16-09-2005,303600,Delhi,3,2,18,21,44,Pass
Aarav Singh,12-10-2005,437562,Bihar,3,21,7,12,43,Pass
Ishaan Reddy,03-07-2005,769026,Madhya Pradesh,15,16,13,4,48,Pass
Manpreet Reddy,22-09-2005,554803,Jharkhand,22,9,2,2,35,Pass
Raj Chopra,10-04-2005,340723,Bihar,12,13,18,11,54,Pass
Zaid Mehta,19-05-2005,440013,Bihar,15,3,24,2,44,Pass
Ishaan Fernandes,21-03-2005,542255,Tamil Nadu,3,9,22,23,57,Pass
Aryan Mehta,15-03-2005,857210,West Bengal,13,16,5,14,48,Pass
Rohan Chopra,10-02-2005,579061,Madhya Pradesh,18,0,3,19,40,Pass
Yash Chopra,15-02-2006,164055,Uttar Pradesh,18,16,4,7,45,Pass
Raj Pillai,14-02-2005,500741,Haryana,16,17,3,21,57,Pass
Gurpreet Sharma,17-11-2004,733388,Punjab,3,11,7,9,30,Pass
Zaid Sharma,26-09-2005,525113,Telangana,8,6,7,2,23,Pass
John Mehta,16-02-2005,496663,Tamil Nadu,19,24,9,22,74,Pass
Balbir Verma,22-03-2005,707068,Meghalaya,3,17,14,15,49,Pass
Vivaan Chopra,18-11-2004,562010,Manipur,4,17,9,13,43,Pass
Mathew D'Souza,21-06-2005,641043,Maharashtra,9,6,2,18,35,Pass
David D'Souza,06-07-2005,144738,Madhya Pradesh,3,4,2,10,19,Pass
Sukhwinder Verma,11-04-2006,711826,West Bengal,16,23,1,5,45,Pass
Vivaan Chopra,05-01-2005,788530,Himachal Pradesh,23,0,14,12,49,Pass
Raj Reddy,27-05-2005,241844,Bihar,13,15,4,18,50,Pass
Aarav Khan,29-09-2005,219515,Andhra Pradesh,9,15,16,5,45,Pass
David Pillai,19-11-2005,295194,Uttar Pradesh,2,9,6,13,30,Pass
Balbir Sharma,11-01-2006,972344,Uttar Pradesh,2,15,8,18,43,Pass
Aarav Fernandes,28-03-2005,712041,Bihar,5,4,3,15,27,Pass
Aryan Singh,16-03-2006,397667,Punjab,4,8,13,22,47,Pass
Rohan Sharma,28-10-2005,839728,Uttarakhand,8,5,17,0,30,Pass
Vivaan D'Souza,28-12-2004,544389,Kerala,0,1,12,19,32,Pass
Krishna Sharma,17-03-2006,876498,Uttar Pradesh,23,11,8,17,59,Pass
Aditya Mehta,17-01-2005,458190,Bihar,8,11,8,5,32,Pass
Aditya Reddy,06-01-2005,336048,Rajasthan,14,12,23,16,65,Pass
Rohan Fernandes,11-11-2005,805919,Uttar Pradesh,18,16,19,6,59,Pass
Aryan Verma,01-02-2005,149789,Chhattisgarh,21,11,22,10,64,Pass
Ishaan Fernandes,26-03-2006,747072,Uttar Pradesh,2,8,12,0,22,Pass
Raj Sharma,14-07-2005,934641,Himachal Pradesh,24,11,6,1,42,Pass
Raj Khan,17-02-2005,206114,Jammu & Kashmir + Ladakh,14,19,4,2,39,Pass
Gurpreet Reddy,06-07-2005,483715,Haryana,6,23,11,14,54,Pass
Paul Fernandes,14-07-2005,530480,Haryana,15,10,18,13,56,Pass
Vivaan Sharma,06-07-2005,959095,Uttar Pradesh,2,14,2,11,29,Pass
Yash Reddy,30-11-2004,246283,Chhattisgarh,16,15,12,2,45,Pass
Yash Fernandes,31-12-2004,934671,Madhya Pradesh,5,4,0,15,24,Pass
Kunal Pillai,19-01-2005,471698,Tripura,3,17,23,8,51,Pass
Vivaan Pillai,05-03-2005,302654,Rajasthan,17,13,6,7,43,Pass
Kunal Sharma,05-04-2006,822405,Maharashtra,9,15,2,22,48,Pass
Rohan Sharma,04-07-2005,113683,Himachal Pradesh,8,9,16,15,48,Pass
Kunal Chopra,12-02-2006,954735,Andhra Pradesh,3,2,8,20,33,Pass
Aarav Sharma,01-08-2005,218409,Haryana,0,0,13,1,14,Pass
Ishaan D'Souza,14-03-2006,464985,Maharashtra,10,12,2,17,41,Pass
Rohan Singh,14-02-2005,610117,Rajasthan,8,24,19,11,62,Pass
Vivaan Khan,25-01-2006,544718,Punjab,19,2,21,4,46,Pass
Sukhwinder Singh,07-08-2005,126356,Madhya Pradesh,24,11,7,2,44,Pass
David Reddy,26-07-2005,696893,Uttar Pradesh,9,9,4,4,26,Pass
Kunal Chopra,13-03-2006,853414,Maharashtra,0,10,23,16,49,Pass
Manpreet Mehta,20-04-2006,820834,West Bengal,3,13,22,10,48,Pass
Ishaan D'Souza,18-09-2005,812474,Andhra Pradesh,12,8,2,24,46,Pass
Aryan Sharma,06-03-2006,630113,Uttar Pradesh,17,9,21,14,61,Pass
Gurpreet Singh,11-11-2005,822365,Chhattisgarh,9,17,16,24,66,Pass
Kunal D'Souza,20-12-2005,601978,Jharkhand,20,16,1,24,61,Pass
Aryan Fernandes,15-10-2005,443745,Odisha,8,20,2,20,50,Pass
Rohan Mehta,16-11-2005,470618,Uttar Pradesh,5,8,12,7,32,Pass
Zaid Mehta,07-04-2006,111596,Rajasthan,24,20,6,14,64,Pass
Sukhwinder Sharma,09-10-2005,978248,Madhya Pradesh,22,3,7,20,52,Pass
Kunal Singh,03-02-2005,473718,Madhya Pradesh,4,18,4,18,44,Pass
Mathew Fernandes,15-05-2005,732506,Uttar Pradesh,22,1,14,11,48,Pass
Harjeet Chopra,23-01-2006,289366,Maharashtra,13,23,2,1,39,Pass
Aditya Sharma,09-01-2005,624527,Uttarakhand,23,13,12,0,48,Pass
Yash Reddy,14-07-2005,765080,Uttarakhand,22,21,3,17,63,Pass
Raj Singh,31-01-2006,161194,Andhra Pradesh,24,17,1,8,50,Pass
Ayaan Chopra,16-05-2005,478857,Haryana,7,1,1,12,21,Pass
Manpreet Mehta,25-02-2006,820140,Tamil Nadu,23,24,2,19,68,Pass
Vivaan Chopra,10-01-2005,386989,Haryana,15,3,4,21,43,Pass
Harjeet Chopra,30-03-2005,218092,Uttar Pradesh,19,3,19,22,63,Pass
Zaid Pillai,09-12-2005,989615,Punjab,1,1,21,14,37,Pass
Aditya Verma,07-02-2005,809556,Maharashtra,12,17,2,17,48,Pass
Kunal D'Souza,24-01-2005,718822,Punjab,19,4,6,7,36,Pass
Gurpreet D'Souza,07-04-2005,678394,Punjab,5,20,16,8,49,Pass
Sukhwinder Fernandes,28-03-2006,588595,Tamil Nadu,5,8,24,17,54,Pass
Vivaan Pillai,27-11-2004,300147,Uttarakhand,14,19,3,11,47,Pass
Aditya D'Souza,02-02-2006,757143,Assam,12,1,3,23,39,Pass
Aryan Chopra,07-01-2005,590511,Rajasthan,8,10,18,18,54,Pass
Aarav D'Souza,16-04-2005,158938,Maharashtra,1,7,18,4,30,Pass
Peter Khan,04-02-2005,797003,West Bengal,3,24,15,0,42,Pass
Mathew Sharma,29-04-2006,604763,Telangana,4,2,1,0,7,Pass
John Khan,29-03-2005,153746,Telangana,6,10,24,5,45,Pass
Zaid Sharma,24-12-2004,704674,Tamil Nadu,13,20,16,24,73,Pass
Kunal Pillai,25-06-2005,284190,Uttar Pradesh,24,2,16,3,45,Pass
Mathew Khan,23-03-2006,524120,Uttar Pradesh,13,4,10,24,51,Pass
Ishaan Verma,27-12-2004,456266,Punjab,8,2,24,19,53,Pass
Ayaan Reddy,24-03-2005,282542,Telangana,5,19,19,13,56,Pass
Ishaan Mehta,08-03-2005,328320,Madhya Pradesh,6,14,17,11,48,Pass
Aarav Pillai,10-12-2005,764792,Uttar Pradesh,17,23,3,0,43,Pass
Gurpreet Khan,16-12-2004,573896,Uttar Pradesh,23,4,0,18,45,Pass
Manpreet Fernandes,04-12-2005,973741,Maharashtra,1,9,6,2,18,Pass
Ishaan Verma,06-08-2005,889861,Punjab,14,1,12,23,50,Pass
Kunal Khan,23-06-2005,753987,Odisha,6,20,8,1,35,Pass
Raj Singh,02-10-2005,575446,Andhra Pradesh,14,12,4,1,31,Pass
Krishna D'Souza,18-04-2005,218282,Bihar,24,6,3,21,54,Pass
Raj Sharma,08-03-2006,919089,Bihar,6,18,1,5,30,Pass
Aryan Verma,03-05-2006,109653,Daman & Diu / D&N Haveli,10,19,12,20,61,Fail
Paul Pillai,09-04-2006,848375,Jammu & Kashmir + Ladakh,17,9,19,23,68,Pass
Aditya Fernandes,08-05-2006,915691,Haryana,12,2,22,1,37,Pass
Aryan Singh,13-12-2005,756442,Assam,14,10,13,1,38,Pass
Vivaan Verma,19-06-2005,620435,Himachal Pradesh,12,7,15,10,44,Pass
Aarav Chopra,17-10-2005,465915,Punjab,19,19,12,22,72,Pass
Kunal Chopra,14-12-2004,117365,Punjab,17,17,0,2,36,Pass
Aditya Sharma,06-02-2006,773376,Madhya Pradesh,23,19,5,1,48,Pass
Aarav Verma,24-02-2006,419655,West Bengal,21,10,9,11,51,Pass
Kunal Pillai,24-03-2006,343925,Madhya Pradesh,1,10,0,0,11,Pass
Aditya Pillai,02-12-2005,173598,Uttar Pradesh,15,6,9,0,30,Pass
Paul Khan,07-04-2005,154771,Bihar,7,24,13,2,46,Pass
Kunal Sharma,01-02-2006,865243,Jammu & Kashmir + Ladakh,6,2,21,4,33,Pass
Ishaan Reddy,06-08-2005,691342,Karnataka,15,10,10,22,57,Pass
Aarav D'Souza,13-03-2005,140707,Jammu & Kashmir + Ladakh,24,4,10,13,51,Pass
Balbir Mehta,15-12-2005,900231,Odisha,0,12,13,13,38,Pass
Kunal Mehta,30-03-2005,984382,Haryana,4,4,8,18,34,Pass
Aditya D'Souza,19-11-2005,606214,Uttar Pradesh,11,18,18,22,69,Pass
Raj Khan,20-11-2004,517893,Maharashtra,10,9,17,3,39,Pass
John Chopra,13-03-2006,467187,Rajasthan,12,18,11,2,43,Pass
Aryan Mehta,16-12-2005,594752,Bihar,11,9,17,8,45,Pass
Krishna Verma,09-10-2005,332748,Tamil Nadu,5,13,3,10,31,Pass
Vivaan Singh,13-07-2005,270017,Bihar,14,18,14,20,66,Pass
Aarav Chopra,25-02-2005,593363,Bihar,14,17,12,22,65,Pass
Paul Fernandes,09-11-2004,260356,Himachal Pradesh,21,5,20,9,55,Pass
Rohan Reddy,10-05-2005,348019,Kerala,4,0,16,11,31,Fail
Mathew Mehta,01-11-2005,450072,Uttar Pradesh,8,9,17,11,45,Pass
David Verma,03-10-2005,294094,Tamil Nadu,21,19,15,4,59,Pass
Krishna Fernandes,07-07-2005,671527,Jammu & Kashmir + Ladakh,20,22,13,15,70,Pass
Krishna Reddy,29-12-2004,756527,Madhya Pradesh,22,8,3,23,56,Pass
Kunal D'Souza,11-11-2005,446683,Uttar Pradesh,10,8,14,2,34,Pass
Yash Verma,17-01-2006,293141,Delhi,3,1,19,2,25,Pass
Sukhwinder Verma,31-05-2005,386441,Madhya Pradesh,17,17,1,0,35,Pass
Rohan Chopra,04-12-2004,644543,West Bengal,3,18,4,16,41,Pass
Yash Verma,16-04-2006,597627,Madhya Pradesh,19,3,7,0,29,Pass
Kunal Chopra,16-06-2005,155159,Kerala,11,19,13,12,55,Fail
Raj Chopra,11-04-2005,817150,Maharashtra,6,0,23,19,48,Pass
Sukhwinder Reddy,14-03-2006,885571,Punjab,5,3,15,14,37,Pass
Vivaan Singh,27-06-2005,816712,Rajasthan,8,19,17,0,44,Pass
Aarav Mehta,25-04-2005,675111,Odisha,1,14,18,18,51,Pass
Yash Singh,29-09-2005,441799,Uttar Pradesh,4,19,0,6,29,Pass
Yash Khan,06-01-2005,424569,Madhya Pradesh,7,17,17,3,44,Pass
Yash Sharma,03-06-2005,190264,Jharkhand,18,21,22,10,71,Fail
Peter Chopra,04-01-2006,333872,Manipur,0,5,14,0,19,Pass
Balbir Reddy,21-08-2005,444777,Rajasthan,7,10,14,5,36,Pass
Aditya Reddy,26-11-2004,872359,Andhra Pradesh,15,22,4,1,42,Pass
Yash Chopra,25-08-2005,682684,Uttar Pradesh,3,19,0,5,27,Pass
Zaid Mehta,06-04-2005,237939,West Bengal,3,8,19,21,51,Pass
Aryan Mehta,04-04-2006,583868,Kerala,21,11,20,21,73,Fail
Aarav Sharma,04-02-2006,981992,Karnataka,12,21,13,7,53,Pass
Yash Khan,27-01-2005,448879,West Bengal,3,21,6,5,35,Pass
Aryan D'Souza,15-02-2006,835560,Rajasthan,11,20,1,19,51,Pass
Aryan Reddy,26-11-2004,943784,Madhya Pradesh,24,19,3,6,52,Pass
Rohan Chopra,07-01-2006,415163,West Bengal,14,10,3,1,28,Pass
Aarav Sharma,05-04-2005,514053,Tamil Nadu,1,16,18,2,37,Pass
Aditya Mehta,14-02-2006,857005,Jharkhand,13,3,7,4,27,Pass
David Mehta,13-04-2005,482196,Maharashtra,7,17,2,22,48,Pass
Raj Sharma,22-09-2005,654486,Madhya Pradesh,5,1,11,2,19,Pass
Yash Verma,25-02-2005,366756,Jammu & Kashmir + Ladakh,20,21,12,1,54,Pass
Aryan Sharma,01-12-2004,241862,Uttar Pradesh,10,8,14,6,38,Pass
Kunal Reddy,08-10-2005,445722,Odisha,13,19,1,13,46,Pass
Krishna Reddy,13-11-2004,795321,Madhya Pradesh,7,3,18,17,45,Pass
Gurpreet Fernandes,29-04-2005,423744,Maharashtra,15,18,2,4,39,Pass
Yash Khan,10-02-2005,192458,Gujarat,7,14,24,11,56,Fail
Raj Singh,21-12-2004,544065,Uttar Pradesh,24,20,6,7,57,Pass
Rohan Verma,14-06-2005,688710,Telangana,21,21,12,6,60,Pass
Aryan Chopra,02-11-2005,197762,Madhya Pradesh,22,10,1,7,40,Pass
Balbir Fernandes,31-01-2005,192614,Bihar,11,3,6,23,43,Pass
Vivaan Chopra,15-04-2006,443468,Jammu & Kashmir + Ladakh,0,12,12,13,37,Pass
Aryan Reddy,10-12-2005,596945,Rajasthan,15,15,3,8,41,Pass
Ishaan Reddy,03-05-2006,725376,Uttar Pradesh,21,22,5,13,61,Pass
Mathew Fernandes,28-04-2005,804584,Punjab,19,16,20,2,57,Pass
Paul Singh,02-10-2005,487844,Odisha,23,2,21,13,59,Pass
Yash D'Souza,23-11-2005,461905,Andhra Pradesh,16,8,23,2,49,Pass
Rohan Pillai,14-12-2005,894486,Bihar,24,24,4,23,75,Pass
Aarav Verma,28-11-2005,901807,Gujarat,14,5,18,14,51,Fail
Aditya Sharma,03-11-2005,293439,Uttar Pradesh,0,3,11,2,16,Pass
Ishaan Fernandes,06-06-2005,873836,Bihar,16,6,7,18,47,Pass
Aditya Fernandes,05-10-2005,468816,Tamil Nadu,20,16,1,5,42,Pass
Kunal Singh,08-09-2005,235865,Bihar,18,15,16,1,50,Pass
Aditya Singh,15-04-2005,291339,Punjab,19,24,13,18,74,Pass
Balbir Mehta,02-03-2005,357894,Maharashtra,17,3,7,4,31,Pass
Vivaan Verma,27-03-2005,346306,Uttarakhand,23,13,3,21,60,Pass
Kunal Reddy,12-11-2005,393879,Uttar Pradesh,23,9,24,14,70,Pass
Aditya Khan,23-06-2005,922846,Rajasthan,7,20,16,15,58,Pass
Vivaan Mehta,12-01-2006,968703,Uttar Pradesh,4,6,23,15,48,Pass
Ishaan Chopra,22-02-2006,204676,Andhra Pradesh,8,8,23,10,49,Pass
Mathew Verma,22-12-2004,906149,Uttar Pradesh,21,18,21,3,63,Pass
Yash Khan,21-01-2006,314174,Andaman & Nicobar,24,9,5,23,61,Fail
Manpreet Khan,13-06-2005,306924,Bihar,17,4,10,4,35,Pass
Rohan D'Souza,03-05-2006,207292,Tamil Nadu,0,4,18,12,34,Pass
Aryan Reddy,30-04-2006,739101,Himachal Pradesh,16,2,16,7,41,Pass
Kunal Mehta,28-01-2005,301587,Mizoram,4,4,4,4,16,Pass
John Reddy,10-02-2006,518055,Uttar Pradesh,4,0,21,24,49,Pass
Aryan Pillai,04-03-2005,303435,Uttar Pradesh,16,0,1,7,24,Pass
Rohan Singh,30-01-2005,940547,Rajasthan,23,9,3,13,48,Pass
Harjeet Chopra,14-08-2005,595335,Uttar Pradesh,15,7,21,22,65,Pass
Ayaan Khan,07-03-2005,724386,Tamil Nadu,16,0,10,9,35,Pass
John Verma,27-06-2005,592988,Madhya Pradesh,6,5,21,12,44,Pass
Sukhwinder Verma,27-10-2005,634017,Madhya Pradesh,24,23,3,20,70,Pass
Raj Reddy,08-05-2005,684233,Uttarakhand,21,22,3,20,66,Pass
Kunal Mehta,19-09-2005,359001,Bihar,18,16,15,8,57,Pass
Ishaan Pillai,22-09-2005,642582,Jammu & Kashmir + Ladakh,14,10,20,22,66,Pass
Sukhwinder Singh,24-01-2006,674115,Telangana,18,22,12,7,59,Pass
Vivaan Sharma,22-04-2005,605676,Odisha,12,10,6,16,44,Pass
Ishaan Fernandes,29-08-2005,753087,Kerala,22,19,17,8,66,Fail
Peter Khan,11-08-2005,507004,Maharashtra,11,21,2,14,48,Pass
Harjeet D'Souza,09-05-2005,784191,Andhra Pradesh,18,20,3,5,46,Pass
Sukhwinder Singh,01-01-2006,570169,Uttar Pradesh,22,19,9,8,58,Pass
Rohan Pillai,07-10-2005,903330,Uttar Pradesh,23,3,22,17,65,Pass
Mathew D'Souza,05-10-2005,621415,Uttar Pradesh,11,10,8,14,43,Pass
Krishna D'Souza,10-09-2005,861508,Madhya Pradesh,4,4,16,4,28,Pass
Krishna Verma,08-12-2004,753473,Jharkhand,3,20,22,12,57,Pass
Kunal Fernandes,16-08-2005,796572,Karnataka,17,12,15,7,51,Pass
Sukhwinder D'Souza,24-02-2005,591510,Jharkhand,11,11,23,3,48,Pass
Yash Verma,25-11-2004,975207,Bihar,10,16,23,3,52,Pass
Rohan Reddy,25-11-2004,458998,Rajasthan,17,4,14,2,37,Pass
Raj Khan,11-03-2006,946871,Uttar Pradesh,17,7,15,23,62,Pass
Aditya Pillai,29-12-2005,771815,Rajasthan,13,20,7,11,51,Pass
Aditya Pillai,21-09-2005,786970,Jharkhand,20,14,20,23,77,Fail
Aryan Mehta,23-02-2005,599441,Rajasthan,22,0,0,7,29,Pass
Gurpreet Sharma,14-02-2005,667024,Haryana,4,0,17,21,42,Pass
Krishna Khan,23-02-2006,942029,Jammu & Kashmir + Ladakh,6,19,19,0,44,Pass
Yash Sharma,25-05-2005,712700,Uttarakhand,17,18,3,12,50,Pass
Raj Khan,17-04-2006,101544,Maharashtra,22,4,2,24,52,Pass
Paul Reddy,13-02-2005,520136,Rajasthan,10,17,4,18,49,Pass
Aarav Verma,30-11-2004,270992,West Bengal,15,18,10,0,43,Pass
Aditya Verma,22-08-2005,667322,Bihar,21,22,3,11,57,Pass
Rohan Fernandes,23-06-2005,648494,Uttar Pradesh,5,21,23,10,59,Pass
Peter Singh,01-04-2006,103701,Uttar Pradesh,5,13,14,9,41,Pass
Aryan Reddy,05-11-2005,576864,Andhra Pradesh,21,5,3,20,49,Pass
Mathew Fernandes,11-08-2005,283996,Uttarakhand,16,21,3,1,41,Pass
Krishna Sharma,08-07-2005,463714,Kerala,7,4,17,13,41,Fail
Aditya Pillai,05-02-2006,778674,Madhya Pradesh,18,4,21,10,53,Pass
Aarav Sharma,08-12-2005,928963,Kerala,3,16,4,21,44,Fail
Paul Khan,22-02-2005,726910,Uttar Pradesh,5,0,6,0,11,Pass
Raj Mehta,16-04-2006,650498,Gujarat,24,10,4,24,62,Fail
Raj Singh,28-01-2005,532160,Madhya Pradesh,21,2,20,8,51,Pass
Manpreet Reddy,03-10-2005,598726,West Bengal,10,0,7,22,39,Pass
Zaid Mehta,16-12-2005,645558,Assam,4,12,9,9,34,Pass
Ishaan Khan,09-02-2005,225050,Tamil Nadu,14,22,12,21,69,Pass
Harjeet D'Souza,17-09-2005,919451,Bihar,2,20,3,23,48,Pass
Aryan Singh,13-11-2004,645423,Uttarakhand,7,19,3,9,38,Pass
Aarav Sharma,21-01-2005,784378,Maharashtra,6,18,2,17,43,Pass
Ishaan Mehta,27-07-2005,272012,Karnataka,3,0,5,21,29,Pass
John Pillai,19-07-2005,751089,Himachal Pradesh,19,5,3,4,31,Pass
Ayaan Pillai,03-09-2005,460336,Punjab,24,15,15,11,65,Pass
Aditya Khan,02-08-2005,798525,Rajasthan,15,14,6,10,45,Pass
Ishaan D'Souza,17-01-2006,263973,Punjab,14,15,19,0,48,Pass
Kunal Verma,27-02-2005,359559,Madhya Pradesh,17,15,3,21,56,Pass
Krishna Pillai,14-02-2006,955998,Bihar,8,11,5,6,30,Pass
Yash Fernandes,21-04-2005,448107,Arunachal Pradesh,18,13,11,4,46,Pass
Vivaan Khan,01-09-2005,640711,Bihar,10,7,18,9,44,Pass
Kunal Mehta,21-01-2006,942704,Tamil Nadu,17,1,23,22,63,Pass
Ishaan Chopra,05-11-2005,135404,Gujarat,18,9,10,18,55,Fail
John Pillai,03-02-2006,141059,Bihar,22,22,5,16,65,Pass
Krishna Reddy,14-04-2006,406366,Maharashtra,20,9,2,24,55,Pass
Zaid Pillai,01-07-2005,708954,Jammu & Kashmir + Ladakh,12,23,14,17,66,Pass
Yash Fernandes,18-09-2005,405482,Uttar Pradesh,0,20,18,11,49,Pass
Rehan Reddy,13-02-2005,303443,Punjab,1,1,14,4,20,Pass
Rehan Fernandes,10-09-2005,323578,Bihar,14,21,0,22,57,Pass
Vivaan Mehta,07-04-2005,889971,Rajasthan,12,10,1,12,35,Pass
Aditya Mehta,23-04-2005,105363,Gujarat,2,3,6,24,35,Fail
Peter Khan,14-01-2006,834624,Madhya Pradesh,4,12,4,14,34,Pass
David Khan,28-01-2005,253829,Tamil Nadu,11,3,16,14,44,Pass
Aryan Pillai,29-07-2005,779353,West Bengal,5,14,14,2,35,Pass
Rehan Pillai,03-12-2005,449432,Madhya Pradesh,18,10,1,0,29,Pass
Rohan Verma,15-11-2005,554792,Bihar,1,10,5,21,37,Pass
Ishaan Singh,15-08-2005,311440,Madhya Pradesh,2,10,3,10,25,Pass
Yash D'Souza,11-07-2005,732227,Tamil Nadu,6,17,13,11,47,Pass
Zaid Mehta,19-10-2005,541809,Maharashtra,4,6,2,23,35,Pass
Kunal Sharma,14-07-2005,918428,Haryana,6,19,10,8,43,Pass
Aditya Mehta,10-03-2006,664302,West Bengal,18,8,19,6,51,Pass
Krishna Singh,16-08-2005,986328,Uttar Pradesh,9,1,20,5,35,Pass
John Pillai,04-05-2005,107274,Uttarakhand,0,13,16,11,40,Pass
Raj D'Souza,23-08-2005,981651,Madhya Pradesh,0,13,21,6,40,Pass
Yash Chopra,06-04-2005,189076,Jammu & Kashmir + Ladakh,11,19,19,0,49,Pass
Raj Verma,12-02-2006,744547,Andhra Pradesh,20,14,2,3,39,Pass
Balbir Singh,10-03-2005,214619,Karnataka,12,9,8,3,32,Pass
John Fernandes,30-10-2005,190118,Uttar Pradesh,1,5,20,11,37,Pass
Yash Reddy,01-11-2005,317010,Rajasthan,18,4,4,23,49,Pass
Aarav Khan,16-04-2005,650149,Punjab,4,1,0,22,27,Pass
Aryan Pillai,23-11-2005,420841,Punjab,0,20,18,18,56,Pass
Balbir Verma,11-09-2005,613281,Bihar,11,4,21,4,40,Pass
Aarav Verma,25-01-2006,698159,Assam,18,8,15,21,62,Pass
Rohan D'Souza,02-12-2004,181542,Andhra Pradesh,19,1,6,9,35,Pass
Aarav Fernandes,05-04-2006,611048,Madhya Pradesh,4,13,0,6,23,Pass
John Chopra,23-11-2004,672201,Punjab,8,20,2,2,32,Pass
Vivaan Singh,15-07-2005,458127,Haryana,13,1,0,5,19,Pass
Vivaan Sharma,03-09-2005,203771,Jammu & Kashmir + Ladakh,24,3,6,12,45,Pass
Imran Mehta,18-04-2006,338337,Karnataka,15,1,1,19,36,Pass
Yash Fernandes,13-01-2006,197219,Andhra Pradesh,6,20,24,11,61,Pass
Vivaan Singh,27-06-2005,563410,Andhra Pradesh,14,2,8,21,45,Pass
Ishaan Reddy,03-11-2005,963765,West Bengal,22,18,5,8,53,Pass
Aryan Chopra,04-03-2005,882082,Maharashtra,5,20,2,10,37,Pass
Yash Singh,12-02-2005,343036,West Bengal,11,6,17,20,54,Pass
Vivaan Verma,30-03-2005,739965,Uttar Pradesh,23,7,11,18,59,Pass
John Singh,10-12-2004,813911,Punjab,18,22,20,0,60,Pass
Ayaan Khan,26-01-2006,657467,Maharashtra,10,10,1,2,23,Pass
Kunal Sharma,19-05-2005,918657,Kerala,11,13,19,9,52,Fail
Zaid Mehta,18-02-2005,968970,Andhra Pradesh,24,20,12,12,68,Pass
Kunal Fernandes,22-01-2006,317320,Haryana,18,8,23,14,63,Pass
Balbir Sharma,09-08-2005,135831,Uttar Pradesh,20,5,19,10,54,Pass
Rohan Chopra,26-02-2006,944692,Tamil Nadu,8,17,14,3,42,Pass
Kunal Sharma,05-05-2006,985821,Haryana,23,14,0,15,52,Pass
Harjeet Reddy,24-10-2005,489952,Assam,16,20,4,1,41,Pass
Aarav Singh,07-02-2006,839797,Andhra Pradesh,10,21,8,15,54,Pass
Ishaan Mehta,06-08-2005,248985,Madhya Pradesh,0,3,7,8,18,Pass
Aarav Sharma,19-05-2005,774598,Assam,13,2,23,6,44,Pass
Raj Khan,16-12-2005,876622,Karnataka,4,19,17,11,51,Pass
Vivaan D'Souza,23-03-2006,903527,Punjab,17,5,7,8,37,Pass
Rohan Mehta,20-12-2005,228352,Gujarat,8,13,8,10,39,Fail
Ishaan Khan,02-05-2005,623745,Gujarat,0,21,2,3,26,Fail
Aryan Chopra,13-01-2006,125271,Karnataka,20,13,17,14,64,Pass
Krishna Singh,20-06-2005,944543,Gujarat,0,10,21,5,36,Fail
Gurpreet Sharma,02-11-2005,549229,Maharashtra,19,20,2,14,55,Pass
Vivaan Singh,13-05-2005,544561,Tamil Nadu,9,12,15,20,56,Pass
Yash Verma,27-12-2005,724725,Telangana,2,8,16,5,31,Pass
Sukhwinder Verma,13-03-2006,460632,Tamil Nadu,6,6,11,24,47,Pass
Balbir Sharma,10-02-2005,882183,Maharashtra,19,23,2,18,62,Pass
Raj Khan,24-07-2005,676445,West Bengal,0,15,23,11,49,Pass
Imran Chopra,13-11-2005,671861,Rajasthan,8,0,19,21,48,Pass
Yash Pillai,13-06-2005,708968,Telangana,14,22,0,13,49,Pass
Harjeet Fernandes,03-02-2006,592906,Tamil Nadu,1,9,18,7,35,Pass
Gurpreet Khan,11-12-2004,423499,West Bengal,19,21,2,5,47,Pass
Yash Verma,23-04-2005,919102,Bihar,3,21,16,0,40,Pass
Rohan Sharma,31-12-2004,308277,Madhya Pradesh,13,12,3,22,50,Pass
Kunal Mehta,22-02-2006,878248,Rajasthan,0,1,18,7,26,Pass
Rohan Reddy,05-12-2004,311625,Andhra Pradesh,1,16,11,4,32,Pass
Raj Chopra,12-03-2005,131378,Uttar Pradesh,24,23,10,9,66,Pass
Imran Reddy,14-02-2005,856994,Rajasthan,8,20,20,18,66,Pass
Raj Chopra,01-05-2006,150584,Andhra Pradesh,2,24,5,9,40,Pass
Peter Khan,07-10-2005,634922,Assam,21,4,20,3,48,Pass
Peter Fernandes,03-11-2005,848083,Maharashtra,3,7,9,20,39,Pass
Krishna Verma,10-09-2005,693041,Uttar Pradesh,4,18,0,4,26,Pass
Ishaan Fernandes,24-11-2005,834319,West Bengal,3,17,5,24,49,Pass
Manpreet Verma,31-12-2005,543351,Uttar Pradesh,21,3,24,19,67,Pass
David Chopra,25-01-2005,876935,Uttar Pradesh,10,13,3,7,33,Pass
Rohan D'Souza,23-10-2005,355582,Uttar Pradesh,6,5,1,21,33,Pass
Ishaan Verma,02-04-2005,632513,Himachal Pradesh,1,15,11,1,28,Pass
Sukhwinder Singh,11-01-2006,501787,Uttar Pradesh,13,0,7,11,31,Pass
Gurpreet Khan,16-02-2006,976018,Andaman & Nicobar,6,0,16,21,43,Fail
Gurpreet Pillai,06-02-2005,946441,Uttar Pradesh,11,21,3,5,40,Pass
Vivaan Mehta,05-04-2005,386432,Tamil Nadu,24,6,1,3,34,Pass
Raj Khan,31-03-2005,567887,Gujarat,24,22,13,15,74,Fail
Aditya Sharma,16-12-2004,407725,Chhattisgarh,10,2,6,13,31,Pass
Gurpreet Khan,02-03-2005,983984,Haryana,21,24,15,3,63,Pass
Aryan Singh,23-07-2005,144050,Gujarat,13,3,4,13,33,Fail
Ishaan Khan,17-01-2006,250476,Telangana,5,4,15,20,44,Pass
Krishna Fernandes,20-04-2005,610264,Tamil Nadu,2,18,19,22,61,Pass
Vivaan Chopra,04-04-2005,770004,Karnataka,2,2,17,9,30,Pass
Aditya Pillai,27-02-2005,350058,Puducherry,6,4,5,3,18,Pass
Aryan Sharma,12-01-2005,395932,Maharashtra,11,2,2,19,34,Pass
Rohan Chopra,21-08-2005,991471,Rajasthan,24,11,22,9,66,Pass
Rohan Reddy,12-02-2005,368613,Tamil Nadu,7,1,2,9,19,Pass
Yash Pillai,21-02-2006,906328,Uttarakhand,4,10,21,1,36,Pass
Gurpreet D'Souza,16-01-2005,833256,Assam,18,19,7,20,64,Pass
Aarav Chopra,06-05-2006,854491,Himachal Pradesh,4,12,24,21,61,Pass
Kunal D'Souza,27-12-2004,541741,Bihar,24,24,17,2,67,Pass
Kunal Fernandes,15-11-2004,375113,Odisha,6,17,24,13,60,Pass
Vivaan Pillai,27-08-2005,667269,Uttar Pradesh,23,11,1,10,45,Pass
Imran Reddy,26-08-2005,223068,Punjab,24,6,20,20,70,Pass
Kunal Pillai,30-01-2006,941916,Mizoram,4,4,4,4,16,Pass
Aarav Pillai,04-01-2006,536874,Uttar Pradesh,18,16,2,24,60,Pass
Rohan Sharma,25-09-2005,409949,Uttar Pradesh,21,10,19,4,54,Pass
Aditya Reddy,24-06-2005,523575,Bihar,8,2,3,10,23,Pass
Aryan Mehta,18-07-2005,335903,Punjab,7,24,12,10,53,Pass
Gurpreet Khan,27-06-2005,512764,Bihar,20,21,0,11,52,Pass
Aditya Mehta,29-06-2005,999353,Uttar Pradesh,16,14,2,12,44,Pass
Aryan Pillai,13-04-2005,475172,Bihar,14,4,12,24,54,Pass
Imran Pillai,23-05-2005,143216,Maharashtra,16,9,2,18,45,Pass
Ishaan Singh,17-05-2005,586337,Manipur,1,19,2,5,27,Pass
Aarav Reddy,16-04-2005,618533,Delhi,16,6,6,3,31,Pass
Kunal Sharma,23-03-2006,455642,Tamil Nadu,0,13,6,4,23,Pass
Ishaan Chopra,03-10-2005,171076,Gujarat,5,17,10,2,34,Fail
Raj Khan,25-03-2006,489246,West Bengal,3,24,23,9,59,Pass
Balbir Sharma,18-09-2005,360181,Punjab,14,23,17,12,66,Pass
Vivaan Mehta,07-07-2005,908637,Tamil Nadu,3,18,17,11,49,Pass
Aditya Fernandes,07-02-2006,129322,Assam,1,0,22,12,35,Pass
Vivaan D'Souza,28-11-2005,486912,Odisha,4,6,15,20,45,Pass
Aryan Fernandes,05-03-2006,449867,West Bengal,3,19,17,11,50,Pass
Raj Fernandes,30-03-2006,744588,Uttar Pradesh,17,12,12,6,47,Pass
Aditya Reddy,02-05-2006,761191,Telangana,2,23,0,13,38,Pass
Mathew D'Souza,12-08-2005,356422,Tripura,22,20,16,17,75,Pass
Yash Singh,28-06-2005,111235,Karnataka,10,19,0,23,52,Pass
Krishna Pillai,04-11-2005,216514,Kerala,3,22,20,7,52,Fail
John Verma,19-11-2004,212558,Odisha,18,7,5,10,40,Pass
Yash Sharma,18-12-2004,575895,Haryana,14,23,5,10,52,Pass
Yash Singh,01-02-2005,151203,Maharashtra,10,18,2,19,49,Pass
Rohan Sharma,10-02-2005,737213,Karnataka,11,7,6,20,44,Pass
Kunal Pillai,11-04-2006,543843,Maharashtra,11,22,2,14,49,Pass
Kunal D'Souza,27-11-2005,335558,Uttar Pradesh,11,0,13,8,32,Pass
Zaid Mehta,25-01-2006,611601,Telangana,20,17,20,2,59,Pass
Aditya Khan,14-10-2005,184228,Uttar Pradesh,7,19,16,15,57,Pass
Aditya Fernandes,17-02-2005,149893,Rajasthan,24,18,9,23,74,Pass
John Reddy,07-12-2005,342104,Jammu & Kashmir + Ladakh,11,1,0,18,30,Pass
Krishna D'Souza,26-01-2006,718155,Tamil Nadu,5,19,17,3,44,Pass
Zaid D'Souza,22-02-2005,403151,Uttar Pradesh,6,0,15,13,34,Pass
Yash Verma,10-10-2005,453230,Punjab,7,9,22,23,61,Pass
Aditya Singh,14-04-2005,354604,Jharkhand,11,4,20,10,45,Pass
Kunal D'Souza,15-08-2005,477091,Tamil Nadu,19,1,1,18,39,Pass
David Khan,03-03-2005,938544,West Bengal,2,15,3,20,40,Pass
Balbir Khan,28-01-2006,136622,Maharashtra,13,4,8,7,32,Pass
Aryan Khan,10-02-2006,856930,Rajasthan,16,14,15,16,61,Pass
Yash Khan,21-11-2005,279432,Bihar,14,10,20,3,47,Pass
Aryan Pillai,17-02-2005,239198,Maharashtra,1,10,16,20,47,Pass
Aditya Mehta,22-03-2005,788727,Uttarakhand,21,12,3,20,56,Pass
Ishaan Singh,03-02-2005,711903,Uttar Pradesh,3,19,20,11,53,Pass
Krishna Chopra,31-07-2005,999063,Kerala,17,1,7,1,26,Fail
Aarav Verma,08-04-2006,105827,Manipur,4,19,20,5,48,Pass
Aarav Sharma,27-12-2005,402180,Kerala,19,18,16,14,67,Fail
Paul Mehta,22-06-2005,426164,Rajasthan,20,4,3,12,39,Pass
Rohan Pillai,07-12-2005,832911,Karnataka,24,8,5,12,49,Pass
Aryan Mehta,17-12-2005,632470,Jharkhand,3,2,19,24,48,Pass
Aarav Sharma,28-03-2005,982239,Tamil Nadu,2,8,14,17,41,Pass
Krishna Fernandes,07-02-2005,533540,West Bengal,3,2,24,22,51,Pass
Balbir Pillai,10-03-2006,800325,Madhya Pradesh,2,20,2,11,35,Pass
Yash Sharma,31-03-2006,274311,Jharkhand,6,5,7,1,19,Pass
Krishna Verma,20-01-2006,637256,West Bengal,18,8,8,9,43,Pass
Aryan Mehta,22-11-2005,945335,Tamil Nadu,24,23,14,8,69,Pass
Aarav Pillai,17-05-2005,336032,Uttar Pradesh,2,18,2,20,42,Pass
Gurpreet Reddy,15-01-2005,296533,Jharkhand,23,5,9,13,50,Pass
Krishna Fernandes,07-02-2006,574881,Punjab,5,10,22,12,49,Pass
Zaid Mehta,30-01-2006,491849,Kerala,8,1,6,10,25,Fail
Raj Pillai,01-08-2005,488360,Madhya Pradesh,9,14,9,21,53,Pass
Aditya Mehta,26-05-2005,557585,Kerala,20,7,17,0,44,Fail
Rohan Khan,12-05-2005,934473,Uttar Pradesh,2,5,15,3,25,Pass
Aryan Singh,26-11-2004,487646,Tamil Nadu,4,24,12,22,62,Pass
Vivaan Verma,23-01-2006,512960,Jharkhand,23,3,7,14,47,Pass
Rohan Pillai,06-06-2005,707555,Madhya Pradesh,4,6,22,4,36,Pass
Ishaan D'Souza,08-04-2006,606059,Telangana,22,23,23,3,71,Pass
Aditya Pillai,08-12-2004,650023,West Bengal,0,15,22,11,48,Pass
Gurpreet Pillai,02-05-2005,855618,Punjab,17,23,14,12,66,Pass
Yash Verma,31-03-2006,764344,West Bengal,9,19,11,7,46,Pass
Peter Chopra,05-04-2006,749493,Chhattisgarh,17,16,24,19,76,Pass
David Fernandes,09-06-2005,155697,Gujarat,0,7,5,6,18,Fail
Aditya Pillai,29-09-2005,921217,Maharashtra,9,15,2,17,43,Pass
Vivaan Verma,20-02-2006,177152,Karnataka,20,18,18,8,64,Pass
Aditya Singh,02-09-2005,133111,Madhya Pradesh,16,22,3,21,62,Pass
Ishaan Verma,12-01-2006,238668,Gujarat,16,1,22,6,45,Fail
Krishna Reddy,14-07-2005,469979,Punjab,7,13,12,20,52,Pass
Manpreet Singh,10-12-2005,240976,Bihar,14,16,19,6,55,Pass
Yash Khan,08-06-2005,756381,Kerala,17,4,21,6,48,Fail
Yash Singh,04-01-2006,438685,Kerala,7,3,21,19,50,Fail
Rohan Fernandes,18-06-2005,748422,Haryana,3,7,7,13,30,Pass
Zaid Reddy,30-07-2005,745191,Uttar Pradesh,9,23,12,0,44,Pass
Krishna Mehta,17-07-2005,519804,Bihar,13,12,24,7,56,Pass
Peter D'Souza,04-05-2005,345550,Bihar,2,14,16,2,34,Pass
Aryan D'Souza,13-04-2005,577052,Gujarat,22,14,14,23,73,Fail
Vivaan Sharma,28-11-2005,753400,Karnataka,8,2,8,3,21,Pass
Harjeet Pillai,20-12-2004,582482,Madhya Pradesh,12,6,13,9,40,Pass
Mathew Chopra,04-06-2005,619377,Rajasthan,11,24,23,0,58,Pass
Krishna Sharma,20-10-2005,613255,Assam,18,23,13,16,70,Pass
Ishaan Pillai,06-03-2005,670757,Madhya Pradesh,23,1,9,8,41,Pass
John Fernandes,27-05-2005,726858,Madhya Pradesh,18,2,0,13,33,Pass
Harjeet D'Souza,29-12-2005,672161,Maharashtra,11,19,2,3,35,Pass
Krishna Sharma,01-09-2005,539421,Karnataka,14,15,4,3,36,Pass
Aarav Reddy,21-02-2005,418106,Rajasthan,18,8,20,17,63,Pass
Harjeet Verma,05-03-2006,929704,Rajasthan,18,4,17,5,44,Pass
Zaid Mehta,18-11-2005,140814,West Bengal,3,20,14,21,58,Pass
Ishaan Khan,22-09-2005,216736,Rajasthan,17,14,3,13,47,Pass
Raj Singh,17-04-2005,571776,Delhi,21,22,5,18,66,Pass
Ishaan Sharma,11-10-2005,135784,Rajasthan,21,19,0,18,58,Pass
Rohan Chopra,08-11-2005,844374,Maharashtra,7,16,2,24,49,Pass
Ishaan Khan,04-07-2005,832963,West Bengal,3,21,3,23,50,Pass
Rohan D'Souza,17-04-2006,982360,Tamil Nadu,24,18,1,2,45,Pass
Aarav Chopra,09-01-2006,571245,Karnataka,12,4,23,7,46,Pass
Rohan D'Souza,15-02-2006,705466,Gujarat,10,1,6,17,34,Fail
Kunal D'Souza,01-11-2005,231617,Uttar Pradesh,2,0,10,24,36,Pass
Vivaan Sharma,04-05-2005,439079,Karnataka,6,4,6,6,22,Pass
Sukhwinder Khan,05-11-2005,416585,Mizoram,6,4,14,4,28,Pass
Aarav Chopra,05-03-2006,165230,Jharkhand,10,0,7,17,34,Pass
Vivaan Pillai,02-03-2006,754206,Uttar Pradesh,19,4,20,2,45,Pass
Ishaan Fernandes,03-08-2005,769993,Delhi,7,13,7,11,38,Pass
Harjeet Chopra,06-03-2005,502167,Rajasthan,8,18,20,16,62,Pass
Vivaan Verma,19-11-2005,670453,West Bengal,17,18,18,0,53,Pass
Krishna Fernandes,23-07-2005,758612,Andhra Pradesh,9,7,13,10,39,Pass
Imran Sharma,08-05-2006,406135,Uttar Pradesh,11,1,6,3,21,Pass
Paul D'Souza,27-01-2006,560400,Madhya Pradesh,0,11,10,0,21,Pass
Harjeet D'Souza,24-01-2006,871491,Bihar,23,18,18,20,79,Pass
Balbir Sharma,15-02-2006,653516,Meghalaya,2,9,1,3,15,Pass
Mathew Sharma,10-11-2005,516906,Rajasthan,15,23,19,4,61,Pass
Ishaan Reddy,17-01-2006,996099,Bihar,13,21,8,9,51,Pass
Kunal Singh,19-06-2005,303025,Manipur,21,9,3,13,46,Pass
Ayaan Sharma,06-10-2005,392634,Maharashtra,8,4,16,9,37,Pass
Raj Singh,31-03-2006,972207,Chhattisgarh,0,7,4,19,30,Pass
Sukhwinder Pillai,07-05-2006,316522,Bihar,7,22,3,3,35,Pass
Yash Singh,21-01-2006,413153,Andhra Pradesh,10,1,11,2,24,Pass
John Khan,04-11-2005,948673,Andhra Pradesh,9,9,20,8,46,Pass
Aryan Verma,08-11-2005,434310,Andhra Pradesh,15,9,17,17,58,Pass
Aditya Pillai,23-05-2005,384595,Maharashtra,9,1,11,16,37,Pass
David Pillai,02-04-2006,189469,Tamil Nadu,12,2,8,3,25,Pass
Manpreet Reddy,24-10-2005,837023,Bihar,23,17,4,16,60,Pass
Paul Reddy,24-12-2005,564249,Odisha,2,7,22,8,39,Pass
Vivaan D'Souza,26-08-2005,612745,Meghalaya,23,22,6,7,58,Pass
Mathew Reddy,11-07-2005,350708,Andhra Pradesh,17,24,3,22,66,Pass
Vivaan Sharma,07-01-2006,993597,Uttarakhand,17,9,3,22,51,Pass
Raj Reddy,04-06-2005,858428,Bihar,21,19,11,21,72,Pass
Aditya Singh,29-03-2005,586641,Tripura,9,16,6,10,41,Pass
Aryan Reddy,19-05-2005,549781,Punjab,15,16,9,16,56,Pass
Yash D'Souza,21-03-2006,142756,Madhya Pradesh,7,18,24,2,51,Pass
Rohan Chopra,25-04-2005,108223,Uttar Pradesh,9,7,4,20,40,Pass
Aryan Khan,16-12-2004,699008,West Bengal,3,19,22,14,58,Pass
Aditya Mehta,27-09-2005,861738,Telangana,9,8,5,17,39,Pass
Aditya Verma,22-04-2005,740373,Rajasthan,23,12,10,15,60,Pass
Raj Pillai,21-02-2006,989060,Rajasthan,7,22,23,21,73,Pass
Vivaan Mehta,06-06-2005,195589,Uttar Pradesh,5,15,21,6,47,Pass
Sukhwinder Reddy,28-07-2005,487749,Bihar,2,12,9,23,46,Pass
Raj Pillai,15-03-2006,796607,Jharkhand,13,18,22,2,55,Pass
Krishna D'Souza,24-02-2005,589295,Bihar,13,2,6,6,27,Pass
Raj Khan,14-10-2005,606990,Karnataka,20,19,8,18,65,Pass
Aditya Pillai,12-03-2006,389123,Madhya Pradesh,1,14,3,23,41,Pass
Manpreet D'Souza,01-02-2006,289288,Assam,2,18,17,4,41,Pass
Yash D'Souza,08-01-2005,536548,Rajasthan,13,20,13,5,51,Pass
Aditya Singh,17-07-2005,836081,Uttar Pradesh,1,10,20,19,50,Pass
Rohan Verma,10-03-2005,800926,Rajasthan,16,1,21,18,56,Pass
Harjeet Sharma,10-12-2005,485778,Uttar Pradesh,17,20,0,6,43,Pass
Yash Chopra,09-01-2006,209612,Andaman & Nicobar,4,3,21,7,35,Pass
Ishaan Chopra,23-02-2006,974051,Gujarat,4,12,19,4,39,Fail
Krishna Pillai,24-07-2005,602444,Rajasthan,17,20,9,8,54,Pass
Aditya Singh,19-06-2005,199419,Rajasthan,14,11,23,17,65,Pass
Raj Khan,05-11-2005,653880,Uttarakhand,8,10,3,20,41,Pass
Yash Verma,17-07-2005,118134,Bihar,22,20,0,8,50,Pass
Vivaan Mehta,28-01-2005,577832,Maharashtra,13,9,2,17,41,Pass
Kunal D'Souza,14-05-2005,594182,Jharkhand,18,11,21,16,66,Pass
Rohan Chopra,19-07-2005,334670,Rajasthan,15,7,9,6,37,Pass
Ishaan Mehta,09-04-2005,938085,Telangana,15,18,14,14,61,Pass
Aarav Singh,13-06-2005,693200,Odisha,4,19,0,18,41,Pass
Vivaan Fernandes,02-10-2005,553807,Tamil Nadu,14,20,15,5,54,Pass
Aarav Reddy,10-02-2005,486874,Rajasthan,20,13,6,23,62,Pass
Aarav Chopra,21-02-2005,341876,Rajasthan,18,16,3,12,49,Pass
Ishaan Chopra,25-02-2005,247381,Odisha,17,5,14,21,57,Pass
Manpreet Khan,12-04-2005,920505,West Bengal,8,16,17,12,53,Pass
Vivaan Fernandes,21-04-2005,165114,Odisha,19,0,20,12,51,Pass
Aryan D'Souza,19-11-2005,595271,Bihar,16,9,13,16,54,Pass
Kunal Singh,03-11-2005,111306,Punjab,16,6,24,6,52,Pass
Yash Verma,08-06-2005,145531,Rajasthan,1,6,18,23,48,Pass
Rohan Singh,18-01-2006,534886,Rajasthan,17,15,15,12,59,Pass
Aditya Chopra,07-08-2005,176809,Uttar Pradesh,8,19,21,12,60,Pass
Krishna Singh,07-05-2006,243580,Uttar Pradesh,4,16,6,18,44,Pass
Gurpreet Fernandes,14-08-2005,471948,Uttar Pradesh,23,17,14,11,65,Pass
Vivaan Khan,24-04-2006,158432,Odisha,7,9,6,20,42,Pass
Ishaan D'Souza,28-06-2005,616626,Rajasthan,2,22,0,5,29,Pass
Peter Fernandes,14-11-2004,118482,Delhi,6,18,20,13,57,Pass
Yash Verma,03-01-2006,406134,West Bengal,23,21,0,7,51,Pass
Krishna Sharma,03-11-2005,224475,West Bengal,3,22,2,18,45,Pass
Ishaan Verma,27-04-2006,423748,Rajasthan,3,6,21,4,34,Pass
Aryan Pillai,27-01-2005,220935,Maharashtra,8,22,2,20,52,Pass
Aarav Reddy,09-08-2005,781966,Jammu & Kashmir + Ladakh,24,20,3,20,67,Pass
Aarav Sharma,25-11-2004,550548,Odisha,5,12,9,7,33,Pass
John Verma,01-03-2006,200629,Madhya Pradesh,17,22,3,8,50,Pass
Aarav Verma,27-01-2005,945552,Rajasthan,21,15,10,15,61,Pass
Ayaan Verma,10-01-2006,583719,Madhya Pradesh,1,0,7,12,20,Pass
John Sharma,31-03-2006,309601,Rajasthan,14,7,14,21,56,Pass
Ishaan Sharma,26-05-2005,412142,Manipur,9,13,1,4,27,Pass
John Fernandes,24-08-2005,353521,Odisha,5,22,22,18,67,Pass
Manpreet Khan,17-01-2005,324606,Bihar,18,10,2,23,53,Pass
Ishaan Singh,19-05-2005,177983,Telangana,8,17,3,22,50,Pass
Gurpreet Sharma,23-11-2005,269675,Jammu & Kashmir + Ladakh,16,16,22,17,71,Pass
Aditya D'Souza,01-09-2005,559898,Bihar,11,14,24,11,60,Pass
David Reddy,02-06-2005,415158,West Bengal,3,16,13,15,47,Pass
Krishna Verma,14-03-2005,590122,Bihar,8,19,13,8,48,Pass
Raj Mehta,12-11-2004,934245,Bihar,3,22,16,21,62,Pass
Ishaan D'Souza,24-12-2005,656347,Karnataka,22,18,1,4,45,Pass
Aryan Sharma,15-01-2006,246714,Delhi,12,20,15,21,68,Pass
Rehan Fernandes,05-04-2005,683715,Rajasthan,4,9,8,6,27,Pass
Ishaan Verma,16-01-2006,898514,Punjab,14,24,18,17,73,Pass
Rohan Khan,11-02-2006,418032,Andhra Pradesh,16,0,17,8,41,Pass
Rohan Reddy,01-08-2005,474113,Maharashtra,15,17,6,10,48,Pass
Ishaan Sharma,21-04-2005,580952,Himachal Pradesh,5,16,6,14,41,Pass
Rohan Fernandes,14-12-2005,587889,Uttar Pradesh,11,22,2,5,40,Pass
Rohan Singh,22-10-2005,932726,Tamil Nadu,9,3,14,8,34,Pass
Aryan Khan,20-01-2006,183034,Telangana,11,16,19,3,49,Pass
Aryan D'Souza,21-05-2005,709525,West Bengal,1,20,2,9,32,Pass
Vivaan D'Souza,31-03-2006,625968,Uttar Pradesh,19,3,22,22,66,Pass
Rohan Pillai,09-01-2005,177616,Andhra Pradesh,1,16,10,19,46,Pass
Krishna Chopra,02-11-2005,350805,Uttar Pradesh,20,20,2,2,44,Pass
Aryan Khan,17-11-2004,629387,Uttar Pradesh,19,16,22,12,69,Pass
Yash Sharma,21-06-2005,512867,Punjab,2,11,19,0,32,Pass
David D'Souza,14-01-2006,354087,Andhra Pradesh,18,12,20,3,53,Pass
Raj Chopra,11-02-2005,722850,Maharashtra,11,6,2,17,36,Pass
Krishna Reddy,06-12-2005,104106,Maharashtra,5,20,2,18,45,Pass
Sukhwinder Chopra,13-11-2005,290985,Jammu & Kashmir + Ladakh,4,22,22,13,61,Pass
John Chopra,04-11-2005,483343,Rajasthan,3,4,23,19,49,Pass
Aarav Mehta,28-05-2005,757056,Himachal Pradesh,20,4,14,9,47,Pass
Kunal Sharma,05-12-2005,727394,Uttar Pradesh,16,3,23,21,63,Pass
Peter D'Souza,15-12-2005,872888,Tamil Nadu,6,20,9,12,47,Pass
Aryan Pillai,13-09-2005,458662,Punjab,23,14,5,6,48,Pass
Aarav Fernandes,01-01-2006,132617,Haryana,2,17,13,3,35,Pass
Raj Reddy,30-04-2005,545987,Rajasthan,10,11,13,17,51,Pass
Rohan Khan,17-04-2006,828816,Haryana,9,5,3,24,41,Pass
Aryan Khan,03-03-2005,425262,West Bengal,10,7,12,13,42,Pass
Raj Singh,31-03-2005,863012,Madhya Pradesh,9,17,19,3,48,Pass
Raj Reddy,20-04-2005,545260,Andhra Pradesh,24,3,12,10,49,Pass
Yash Singh,23-06-2005,967621,Uttar Pradesh,0,4,18,11,33,Pass
Aditya Verma,15-10-2005,317427,Madhya Pradesh,9,0,0,5,14,Pass
Manpreet Singh,08-04-2005,314125,Gujarat,18,15,20,15,68,Fail
Krishna Sharma,11-03-2006,161414,Telangana,21,12,23,4,60,Pass
Yash Reddy,31-01-2005,758526,Rajasthan,3,8,15,24,50,Pass
Kunal Singh,07-09-2005,239171,Jharkhand,3,21,9,8,41,Pass
Krishna Chopra,02-09-2005,154787,Bihar,21,21,0,0,42,Pass
Vivaan Verma,28-06-2005,113760,Telangana,6,10,18,20,54,Pass
Vivaan D'Souza,10-09-2005,644085,West Bengal,3,11,18,24,56,Pass
Aditya Pillai,21-03-2006,986875,Punjab,2,4,8,15,29,Pass
Balbir Chopra,18-05-2005,371920,Maharashtra,18,6,17,5,46,Pass
David Sharma,03-02-2006,276376,Andhra Pradesh,11,1,0,22,34,Pass
Vivaan Fernandes,18-04-2006,643413,Uttar Pradesh,15,17,2,17,51,Pass
Raj Sharma,30-01-2006,614991,Assam,4,21,4,11,40,Pass
Kunal Sharma,05-08-2005,680126,Rajasthan,19,13,15,12,59,Pass
Aryan Verma,27-09-2005,416660,Himachal Pradesh,4,13,9,13,39,Pass
John Reddy,19-05-2005,241155,Bihar,13,6,12,20,51,Pass
Aditya Reddy,24-12-2005,727482,Gujarat,8,1,24,24,57,Fail
Mathew Reddy,12-04-2005,941345,Bihar,17,16,18,19,70,Pass
Peter D'Souza,27-06-2005,808847,Madhya Pradesh,5,2,6,9,22,Pass
David Reddy,25-08-2005,667746,Bihar,18,16,19,23,76,Pass
Vivaan Singh,06-06-2005,489375,West Bengal,19,5,10,17,51,Pass
Kunal Sharma,27-01-2005,588637,Rajasthan,21,14,14,19,68,Pass
John Mehta,14-12-2005,467581,Uttar Pradesh,2,0,8,5,15,Pass
Krishna Singh,12-04-2006,425960,Tamil Nadu,5,21,18,22,66,Pass
Krishna Singh,17-11-2005,544983,Gujarat,11,24,17,0,52,Fail
Raj Khan,04-07-2005,268026,Maharashtra,12,23,2,22,59,Pass
Rohan Sharma,09-03-2005,321644,Jammu & Kashmir + Ladakh,16,4,23,23,66,Pass
Vivaan Mehta,27-08-2005,711471,Uttar Pradesh,19,3,14,1,37,Pass
Yash Mehta,28-03-2006,255225,Rajasthan,12,4,17,23,56,Pass
Raj Reddy,13-08-2005,552662,Gujarat,10,3,18,5,36,Fail
Aryan D'Souza,17-07-2005,680430,Madhya Pradesh,8,3,3,6,20,Pass
Krishna Chopra,01-08-2005,179952,Tamil Nadu,9,19,3,23,54,Pass
Yash Pillai,01-03-2005,199218,Uttar Pradesh,18,0,14,21,53,Pass
Aryan Verma,28-03-2006,447312,Haryana,19,24,20,14,77,Pass
Ayaan Verma,20-09-2005,677910,Tamil Nadu,17,18,24,8,67,Pass
Vivaan Pillai,15-11-2004,173252,Bihar,10,1,16,16,43,Pass
Kunal Mehta,04-10-2005,260615,Madhya Pradesh,10,12,6,2,30,Pass
Krishna Chopra,12-03-2006,124899,Madhya Pradesh,9,1,12,1,23,Pass
Rohan Reddy,20-05-2005,493523,Uttar Pradesh,17,9,0,13,39,Pass
Kunal Reddy,18-02-2006,709619,Assam,1,19,6,2,28,Pass
Yash D'Souza,11-03-2005,423060,Telangana,19,7,3,24,53,Pass
Vivaan Sharma,28-04-2005,128003,Bihar,10,12,2,13,37,Pass
Vivaan Singh,07-06-2005,773554,Arunachal Pradesh,12,11,3,21,47,Pass
Sukhwinder Khan,06-12-2005,663378,Uttarakhand,18,14,12,3,47,Pass
Aditya D'Souza,15-01-2005,337695,Bihar,13,16,6,7,42,Pass
Ishaan Pillai,19-11-2005,939270,Odisha,24,2,8,2,36,Pass
Paul Singh,27-07-2005,470313,Madhya Pradesh,2,18,5,2,27,Pass
Aryan Singh,14-11-2005,795796,Telangana,24,7,9,10,50,Pass
Aditya Pillai,16-09-2005,688927,Gujarat,10,12,22,2,46,Fail
David Verma,30-09-2005,317415,Maharashtra,12,17,4,5,38,Pass
Raj Verma,13-05-2005,964111,Bihar,9,17,6,17,49,Pass
Farhan Pillai,26-04-2006,160558,Haryana,19,3,4,11,37,Pass
Manpreet D'Souza,23-01-2005,657895,Punjab,21,18,2,9,50,Pass
Vivaan Reddy,06-02-2006,478314,Uttar Pradesh,21,13,8,18,60,Pass
Vivaan Verma,09-04-2006,206816,Punjab,12,2,11,2,27,Pass
Zaid Khan,08-06-2005,561497,Uttar Pradesh,2,22,6,12,42,Pass
Manpreet Khan,09-10-2005,892131,Tamil Nadu,10,13,2,11,36,Pass
Krishna Chopra,28-05-2005,296108,Maharashtra,16,4,2,20,42,Pass
Kunal Reddy,29-04-2006,178716,Bihar,5,2,13,10,30,Pass
Aarav Khan,19-03-2005,696776,Haryana,10,22,24,9,65,Pass
Gurpreet Sharma,27-10-2005,406342,Rajasthan,6,1,4,24,35,Pass
Raj Singh,08-06-2005,671142,Madhya Pradesh,10,4,3,21,38,Pass
Raj Mehta,06-05-2006,272942,Uttar Pradesh,15,2,18,19,54,Pass
Vivaan Verma,12-04-2005,150235,Haryana,17,8,2,17,44,Pass
Aarav Singh,12-12-2004,719520,West Bengal,10,1,18,6,35,Pass
Aarav Khan,23-05-2005,138249,Uttar Pradesh,10,18,1,22,51,Pass
Rohan D'Souza,04-09-2005,148117,Odisha,12,14,14,9,49,Pass
Peter Reddy,21-05-2005,298219,Bihar,7,10,23,3,43,Pass
Gurpreet Pillai,25-12-2005,272163,Maharashtra,6,17,2,20,45,Pass
Ishaan Fernandes,28-04-2006,919275,Tamil Nadu,5,21,6,23,55,Pass
Krishna Reddy,24-12-2004,456806,Maharashtra,20,1,9,3,33,Pass
Yash Verma,11-04-2005,704468,Uttar Pradesh,14,11,20,22,67,Pass
Vivaan Khan,08-07-2005,663832,Karnataka,20,0,24,3,47,Pass
Rohan Mehta,26-04-2006,165718,Karnataka,12,3,14,4,33,Pass
Yash Mehta,30-09-2005,819541,Karnataka,4,24,12,20,60,Pass
Balbir Fernandes,08-12-2004,848151,Madhya Pradesh,6,8,3,6,23,Pass
Yash Verma,23-01-2006,533044,Uttar Pradesh,6,5,1,14,26,Pass
Zaid D'Souza,05-02-2005,111789,Tamil Nadu,10,20,15,20,65,Pass
Aryan Sharma,24-06-2005,331572,Karnataka,17,20,24,16,77,Fail
Aditya Reddy,14-11-2005,196631,Rajasthan,13,17,0,5,35,Pass
Vivaan Khan,26-11-2005,783166,Punjab,16,17,22,12,67,Pass
Aarav Pillai,08-12-2004,486563,Rajasthan,13,23,18,24,78,Pass
Aryan Pillai,19-04-2005,906430,Punjab,5,8,12,13,38,Pass
David Mehta,13-09-2005,721491,Maharashtra,23,1,2,19,45,Pass
Krishna Reddy,14-09-2005,592529,Maharashtra,23,6,2,3,34,Pass
Mathew D'Souza,16-04-2006,286226,Andhra Pradesh,23,10,18,2,53,Pass
Raj Chopra,20-11-2005,206954,Tamil Nadu,10,8,1,11,30,Pass
Kunal D'Souza,30-07-2005,226112,Rajasthan,8,4,15,19,46,Pass
Krishna Mehta,23-10-2005,648782,Bihar,0,5,5,9,19,Pass
Aarav Khan,22-02-2005,417569,Madhya Pradesh,4,10,8,15,37,Pass
Aryan Pillai,29-01-2005,929267,Uttar Pradesh,5,6,20,9,40,Pass
Gurpreet Pillai,25-09-2005,227985,Maharashtra,20,22,2,4,48,Pass
Vivaan Verma,20-07-2005,194853,Uttarakhand,5,19,3,23,50,Pass
Harjeet Fernandes,17-11-2004,110295,Andhra Pradesh,23,14,10,15,62,Pass
Imran Singh,17-01-2006,444752,Uttar Pradesh,5,10,0,24,39,Pass
Aryan Fernandes,27-03-2005,756982,Haryana,1,21,17,2,41,Pass
Vivaan Verma,24-12-2005,318961,Haryana,21,23,1,9,54,Pass
Raj Sharma,09-04-2005,541261,Maharashtra,23,22,2,7,54,Pass
Vivaan D'Souza,04-12-2004,791507,Gujarat,2,23,18,20,63,Fail
David Pillai,05-02-2005,901174,Chhattisgarh,0,5,14,7,26,Pass
Kunal Singh,18-08-2005,474222,Uttar Pradesh,20,21,10,4,55,Pass
Krishna Pillai,01-06-2005,833976,Uttarakhand,0,3,2,15,20,Pass
Aarav Sharma,25-03-2006,631894,Tamil Nadu,14,14,22,1,51,Pass
Manpreet Sharma,01-02-2006,775428,West Bengal,9,16,11,0,36,Pass
Kunal Verma,02-07-2005,321278,Uttar Pradesh,14,7,12,19,52,Pass
Aryan Singh,10-09-2005,429792,Tamil Nadu,1,0,20,2,23,Pass
Manpreet Singh,31-10-2005,206158,Rajasthan,4,8,16,12,40,Pass
Manpreet Pillai,03-06-2005,800371,Bihar,12,8,19,16,55,Pass
Rohan Mehta,14-04-2005,413524,Himachal Pradesh,4,0,15,2,21,Pass
Manpreet D'Souza,08-06-2005,295818,Maharashtra,4,22,6,5,37,Pass
Raj Khan,07-02-2005,337522,Odisha,2,11,0,13,26,Pass
Manpreet D'Souza,14-03-2005,555770,Bihar,3,13,22,16,54,Pass
Aryan Verma,03-10-2005,941753,Bihar,20,9,4,18,51,Pass
Kunal Verma,27-01-2005,460612,West Bengal,3,13,24,14,54,Pass
Aditya Fernandes,27-03-2005,203323,Maharashtra,15,17,2,6,40,Pass
John Fernandes,14-04-2005,857407,Punjab,7,13,20,4,44,Pass
Yash Singh,12-04-2006,636126,Puducherry,5,6,1,24,36,Pass
Farhan D'Souza,18-12-2004,257993,Delhi,2,5,16,20,43,Pass
Raj Chopra,28-12-2005,729534,Haryana,8,16,5,4,33,Pass
Kunal Khan,29-03-2006,957871,Tamil Nadu,21,16,8,10,55,Pass
Imran Khan,01-12-2005,457508,Telangana,3,2,6,11,22,Pass
Rohan Fernandes,13-12-2005,966105,Uttar Pradesh,10,14,8,0,32,Pass
Rohan Verma,24-04-2006,471546,Rajasthan,13,4,4,4,25,Pass
Mathew Sharma,28-12-2004,285898,Karnataka,2,6,5,11,24,Pass
Gurpreet Reddy,02-05-2005,896119,Karnataka,24,3,16,12,55,Pass
Gurpreet Chopra,22-03-2006,514834,Haryana,0,16,17,11,44,Pass
Harjeet Khan,06-03-2006,195634,Kerala,1,7,9,5,22,Fail
Manpreet Mehta,31-01-2005,995898,Chhattisgarh,24,18,24,21,87,Pass
Sukhwinder Sharma,03-05-2005,893052,Madhya Pradesh,10,9,13,17,49,Pass
Sukhwinder D'Souza,09-09-2005,972144,Maharashtra,0,6,15,15,36,Pass
Zaid Chopra,23-08-2005,768680,Delhi,9,24,21,24,78,Pass
Zaid Pillai,23-04-2006,374304,Bihar,1,2,18,14,35,Pass
Gurpreet Singh,16-01-2006,221039,Uttar Pradesh,4,22,1,17,44,Pass
Aditya Chopra,31-07-2005,732557,Madhya Pradesh,9,6,1,9,25,Pass
Yash Mehta,29-01-2005,668438,Uttar Pradesh,15,22,22,1,60,Pass
Raj Singh,06-01-2005,561676,Uttar Pradesh,11,21,7,11,50,Pass
Mathew Verma,03-04-2005,698352,Uttarakhand,0,15,3,23,41,Pass
Gurpreet Fernandes,30-03-2005,571764,West Bengal,10,20,5,2,37,Pass
Ishaan Khan,19-04-2005,926021,Maharashtra,6,21,2,19,48,Pass
Vivaan Khan,31-03-2005,694710,Uttar Pradesh,10,4,14,7,35,Pass
Aditya Singh,04-03-2005,117187,Odisha,3,21,8,5,37,Pass
Vivaan D'Souza,24-01-2006,529751,Uttar Pradesh,1,23,20,22,66,Pass
Aarav Reddy,04-02-2005,205169,Bihar,9,19,3,20,51,Pass
Kunal Reddy,24-12-2004,649680,Madhya Pradesh,14,13,3,21,51,Pass
John Pillai,09-12-2005,451399,Maharashtra,19,0,18,2,39,Pass
Raj Chopra,13-02-2005,145121,Maharashtra,14,0,2,21,37,Pass
David Pillai,19-02-2006,967067,Punjab,13,23,7,0,43,Pass
Rohan D'Souza,18-02-2006,114300,Punjab,7,19,19,20,65,Pass
Vivaan Reddy,06-03-2005,793568,Sikkim,5,16,12,5,38,Pass
Yash Mehta,12-03-2005,789224,Uttar Pradesh,13,10,19,8,50,Pass
Aarav Fernandes,21-09-2005,657351,West Bengal,17,14,2,8,41,Pass
Imran Verma,13-02-2005,102914,Odisha,4,5,5,23,37,Pass
Raj Reddy,29-11-2004,422777,Bihar,11,24,6,7,48,Pass
Ayaan Pillai,09-03-2006,111089,Gujarat,4,9,17,1,31,Fail
Farhan Sharma,21-07-2005,862282,Rajasthan,5,13,1,19,38,Pass
Balbir Reddy,14-02-2006,215712,Andhra Pradesh,1,23,13,22,59,Pass
Aarav Chopra,06-01-2006,777863,Madhya Pradesh,14,22,2,5,43,Pass
Aryan D'Souza,16-02-2006,692459,Haryana,9,2,7,8,26,Pass
Aarav Khan,22-02-2005,266758,Chhattisgarh,11,11,11,12,45,Pass
Rohan Verma,26-02-2006,126644,Odisha,14,2,0,24,40,Pass
Aditya Pillai,29-12-2005,581193,Jammu & Kashmir + Ladakh,8,17,20,3,48,Pass
Kunal Reddy,08-01-2006,932190,Uttar Pradesh,17,0,22,20,59,Pass
Aditya Khan,01-02-2006,900804,West Bengal,13,7,3,6,29,Pass
Mathew Chopra,11-01-2005,202522,Tamil Nadu,17,5,8,7,37,Pass
Sukhwinder Verma,29-04-2005,893566,Uttarakhand,5,7,0,15,27,Pass
Aarav D'Souza,25-08-2005,672676,Uttarakhand,19,4,3,9,35,Pass
Balbir D'Souza,04-12-2005,681281,Madhya Pradesh,11,22,16,3,52,Pass
Aarav Khan,21-10-2005,605445,Chhattisgarh,8,8,22,14,52,Pass
Vivaan Pillai,14-12-2005,235610,Maharashtra,13,14,2,24,53,Pass
Krishna Sharma,23-03-2005,713802,Maharashtra,2,5,21,17,45,Pass
Kunal Reddy,21-03-2005,267272,Punjab,16,7,22,24,69,Pass
Krishna Reddy,06-10-2005,506754,Rajasthan,21,9,0,20,50,Pass
Kunal Verma,06-12-2005,180593,Maharashtra,12,15,2,12,41,Pass
Ishaan Mehta,26-04-2006,874262,Bihar,16,24,22,23,85,Pass
Kunal Sharma,20-02-2005,184786,Maharashtra,7,18,2,21,48,Pass
Ishaan Reddy,07-10-2005,833636,Rajasthan,9,7,19,8,43,Pass
Aditya Mehta,15-06-2005,940376,Uttar Pradesh,19,12,1,8,40,Pass
Aditya Sharma,11-11-2005,450559,Madhya Pradesh,1,19,15,17,52,Pass
Raj Pillai,11-06-2005,413082,Punjab,14,13,14,24,65,Pass
John D'Souza,09-11-2004,492026,Rajasthan,5,1,2,1,9,Pass
Aarav Verma,14-12-2005,428663,Telangana,24,7,2,6,39,Pass
Rohan Fernandes,08-01-2005,247348,Bihar,22,16,15,18,71,Pass
Yash D'Souza,17-03-2005,117842,Chhattisgarh,11,24,17,16,68,Pass
Balbir D'Souza,07-01-2005,720446,Bihar,19,7,21,13,60,Pass
Aditya Pillai,03-09-2005,376141,West Bengal,15,10,1,7,33,Pass
Krishna Fernandes,16-01-2005,589867,Andhra Pradesh,1,0,3,21,25,Pass
Yash D'Souza,15-02-2006,424151,Chhattisgarh,13,21,0,18,52,Pass
Raj Pillai,27-01-2006,544862,Gujarat,4,12,11,6,33,Fail
Vivaan Fernandes,01-09-2005,244499,Bihar,23,22,8,5,58,Pass
David Verma,29-05-2005,372087,West Bengal,5,10,22,10,47,Pass
Harjeet Khan,05-07-2005,623040,Himachal Pradesh,0,5,4,6,15,Pass
Kunal Reddy,21-03-2005,474564,Madhya Pradesh,9,11,7,9,36,Pass
Mathew Fernandes,19-03-2005,562767,Bihar,24,12,20,10,66,Pass
Aditya Pillai,22-04-2005,932259,Rajasthan,18,11,0,3,32,Pass
Vivaan Verma,14-12-2004,895708,Tamil Nadu,14,17,24,6,61,Pass
Rohan Pillai,24-06-2005,125167,Tamil Nadu,9,1,8,20,38,Pass
Ishaan Khan,07-09-2005,438399,Punjab,0,19,19,7,45,Pass
Aditya Reddy,03-04-2005,728226,Maharashtra,21,2,0,24,47,Pass
Kunal Fernandes,21-01-2006,123826,Karnataka,21,0,2,18,41,Pass
Aryan Khan,29-10-2005,247474,Madhya Pradesh,2,5,2,8,17,Pass
Ishaan Mehta,29-04-2006,161241,Uttar Pradesh,3,23,4,12,42,Pass
Raj Verma,09-01-2006,180864,Uttar Pradesh,20,20,1,23,64,Pass
Ishaan Pillai,26-12-2004,503676,Rajasthan,2,23,11,14,50,Pass
Rohan Khan,12-07-2005,943994,West Bengal,20,9,15,3,47,Pass
Aditya Fernandes,11-09-2005,959058,Jharkhand,17,17,10,7,51,Pass
Aarav Verma,06-02-2006,120481,Assam,18,16,1,4,39,Pass
Ishaan Chopra,10-01-2005,898790,Rajasthan,22,14,24,19,79,Pass
Harjeet Reddy,21-03-2005,732616,Telangana,13,10,6,24,53,Pass
Raj Reddy,06-09-2005,263037,Tamil Nadu,14,24,8,7,53,Pass
Ishaan Mehta,08-01-2005,954609,Andhra Pradesh,3,24,13,22,62,Pass
Manpreet Reddy,06-10-2005,494532,Karnataka,10,7,20,16,53,Pass
Rohan Pillai,28-12-2005,348412,Tamil Nadu,6,17,23,20,66,Pass
Kunal Reddy,13-12-2005,348212,Mizoram,4,6,8,4,22,Pass
Aditya D'Souza,01-12-2005,838843,Karnataka,3,21,6,12,42,Pass
Aarav Verma,14-02-2005,107015,Rajasthan,9,0,8,23,40,Pass
Vivaan Chopra,16-02-2005,482379,Kerala,14,6,15,9,44,Fail
Yash Khan,09-09-2005,237364,Uttar Pradesh,18,9,1,8,36,Pass
Manpreet Khan,17-11-2005,757315,Rajasthan,21,18,10,20,69,Pass
Rehan D'Souza,31-05-2005,326582,Bihar,11,13,14,7,45,Pass
Manpreet Khan,21-12-2004,389939,Madhya Pradesh,4,2,10,19,35,Pass
Ishaan Chopra,02-09-2005,115740,Andhra Pradesh,14,4,4,17,39,Pass
Kunal Chopra,03-05-2005,293063,Chhattisgarh,16,23,1,14,54,Pass
Kunal Khan,02-05-2006,967258,Bihar,6,21,23,17,67,Pass
Raj Singh,19-09-2005,773822,Rajasthan,18,11,17,19,65,Pass
Rohan Reddy,27-02-2006,337616,Rajasthan,2,24,11,17,54,Pass
Vivaan Singh,19-01-2005,589404,Uttar Pradesh,10,8,16,20,54,Pass
Vivaan Pillai,04-04-2005,527031,Haryana,1,22,14,6,43,Pass
Manpreet Pillai,18-09-2005,610820,Rajasthan,13,3,4,19,39,Pass
Yash Chopra,15-01-2006,496637,Bihar,24,6,13,2,45,Pass
Krishna Chopra,14-05-2005,671882,West Bengal,3,16,18,22,59,Pass
Manpreet Reddy,11-01-2006,515589,Andhra Pradesh,13,16,1,10,40,Pass
Ishaan Verma,04-08-2005,174904,Bihar,5,7,12,12,36,Pass
Rohan Chopra,03-07-2005,912727,Maharashtra,18,18,2,22,60,Pass
Rohan Pillai,22-02-2006,802545,Gujarat,4,1,8,20,33,Fail
Rohan Khan,11-10-2005,608215,Maharashtra,11,6,22,2,41,Pass
Peter Fernandes,11-02-2006,446279,Tamil Nadu,11,13,18,18,60,Pass
John D'Souza,09-01-2006,545653,Maharashtra,21,7,2,23,53,Pass
Gurpreet Khan,01-07-2005,304319,Rajasthan,1,16,10,2,29,Pass
Ishaan Sharma,05-10-2005,768671,Gujarat,0,24,16,5,45,Fail
Sukhwinder Verma,26-12-2005,175683,Bihar,7,1,22,14,44,Pass
Aditya Verma,08-04-2005,624529,Tamil Nadu,2,13,15,0,30,Pass
Kunal Singh,31-03-2005,155903,Bihar,23,13,22,23,81,Pass
Raj Singh,11-01-2006,557513,Rajasthan,19,16,16,14,65,Pass
Vivaan Pillai,08-12-2005,347420,Jharkhand,19,4,22,5,50,Pass
Yash Sharma,16-05-2005,851998,Uttar Pradesh,5,3,21,0,29,Pass
Kunal Mehta,15-05-2005,390606,Kerala,10,19,24,11,64,Fail
Kunal Khan,11-07-2005,644695,Andhra Pradesh,20,12,15,18,65,Pass
Gurpreet Khan,12-01-2005,313247,Bihar,2,22,14,22,60,Pass
Aryan Pillai,04-01-2005,668692,Punjab,12,11,12,9,44,Pass
Rohan Singh,23-04-2006,486770,Bihar,24,17,19,13,73,Pass
Mathew Fernandes,05-06-2005,880518,Punjab,24,4,17,18,63,Pass
Vivaan Fernandes,06-04-2006,708608,Telangana,0,19,15,11,45,Pass
Yash Chopra,07-12-2004,725075,West Bengal,1,5,3,15,24,Pass
Mathew D'Souza,27-11-2005,198263,West Bengal,3,5,10,6,24,Pass
Aarav Fernandes,11-12-2005,997157,Tamil Nadu,14,22,11,0,47,Pass
Aditya Sharma,08-01-2006,662556,Punjab,0,11,7,23,41,Pass
Manpreet D'Souza,26-04-2005,758281,Rajasthan,7,2,15,24,48,Pass
Sukhwinder Sharma,20-01-2005,257426,Jharkhand,3,19,3,9,34,Pass
Paul D'Souza,26-08-2005,242165,Bihar,5,19,20,18,62,Pass
Rohan Sharma,06-12-2004,210070,Uttar Pradesh,16,3,2,6,27,Pass
Raj Mehta,13-05-2005,835550,Karnataka,2,10,8,24,44,Pass
Aarav D'Souza,22-02-2005,975635,Gujarat,19,23,16,23,81,Fail
John D'Souza,18-02-2005,137098,Punjab,22,1,20,4,47,Pass
Yash D'Souza,30-03-2005,952358,Punjab,11,17,11,16,55,Pass
Balbir Mehta,22-01-2006,527910,Maharashtra,22,9,2,4,37,Pass
Aarav Khan,25-04-2006,864631,Madhya Pradesh,8,2,3,16,29,Pass
Aditya D'Souza,18-03-2006,227546,Bihar,23,12,9,15,59,Pass
Aditya Fernandes,12-03-2005,409491,Uttar Pradesh,16,13,24,17,70,Pass
Aarav Sharma,03-10-2005,855276,Uttar Pradesh,5,15,13,18,51,Pass
Yash Mehta,20-03-2005,209646,Bihar,0,1,4,11,16,Pass
Raj D'Souza,11-04-2005,280909,Puducherry,4,7,6,17,34,Pass
Rohan Fernandes,18-04-2006,977779,Jammu & Kashmir + Ladakh,11,2,15,7,35,Pass
Manpreet Mehta,29-06-2005,142479,Himachal Pradesh,6,4,14,14,38,Pass
Raj Verma,15-12-2005,547353,Rajasthan,22,11,16,18,67,Pass
Yash Khan,20-01-2005,884574,Madhya Pradesh,3,20,1,1,25,Pass
Paul Chopra,14-02-2006,652833,Punjab,10,13,5,11,39,Pass
Harjeet Pillai,25-11-2005,796736,Tamil Nadu,10,11,21,0,42,Pass
Farhan Mehta,22-10-2005,123650,Jharkhand,13,4,18,1,36,Pass
Sukhwinder Mehta,03-12-2005,339168,Delhi,4,6,5,20,35,Pass
Peter Reddy,15-02-2006,795658,Uttar Pradesh,1,1,5,16,23,Pass
Aditya Khan,12-08-2005,405067,West Bengal,10,22,3,0,35,Pass
Kunal Chopra,17-05-2005,622067,Madhya Pradesh,6,16,4,20,46,Pass
Kunal D'Souza,21-01-2005,406462,Madhya Pradesh,21,8,5,1,35,Pass
Aarav D'Souza,30-11-2005,669725,Uttar Pradesh,12,13,10,11,46,Pass
Aditya Singh,08-01-2006,218230,Tamil Nadu,21,9,18,14,62,Pass
Manpreet D'Souza,27-06-2005,378429,Haryana,19,3,7,15,44,Pass
Yash Pillai,11-12-2005,547239,Puducherry,4,0,5,16,25,Pass
Ishaan Verma,23-05-2005,940827,Chhattisgarh,18,22,3,18,61,Pass
Aditya Verma,11-04-2006,343777,West Bengal,14,19,3,5,41,Pass
John Singh,15-07-2005,526260,West Bengal,1,16,18,2,37,Pass
Harjeet Fernandes,22-05-2005,605264,Chhattisgarh,14,13,7,0,34,Pass
Krishna Verma,28-02-2006,991358,Jharkhand,10,4,11,22,47,Pass
Ayaan Fernandes,30-11-2004,207478,Meghalaya,3,20,4,4,31,Pass
Aarav Sharma,10-12-2004,503431,Bihar,0,24,1,18,43,Pass
Kunal Fernandes,17-09-2005,348252,Punjab,1,4,7,0,12,Pass
John Reddy,06-04-2006,343192,Haryana,6,15,17,11,49,Pass
Raj Pillai,05-05-2006,964391,Kerala,21,7,17,13,58,Fail
Harjeet Pillai,22-11-2005,807864,Bihar,0,16,5,21,42,Pass
Yash Pillai,27-07-2005,577842,Madhya Pradesh,3,13,20,18,54,Pass
Aryan Pillai,09-02-2006,540586,Bihar,6,20,10,6,42,Pass
Manpreet Sharma,19-09-2005,449579,Madhya Pradesh,24,13,3,0,40,Pass
Kunal Verma,20-08-2005,477254,Bihar,16,1,18,5,40,Pass
Ishaan Pillai,06-05-2005,751968,Karnataka,1,8,1,21,31,Pass
Aryan Fernandes,03-03-2006,551265,Gujarat,0,4,24,4,32,Fail
Aditya Reddy,03-03-2006,180609,Gujarat,17,4,12,13,46,Fail
Rohan Khan,14-12-2005,418024,Kerala,8,16,1,4,29,Fail
Kunal D'Souza,21-07-2005,964323,Rajasthan,22,2,1,7,32,Pass
Kunal Sharma,24-06-2005,402510,Maharashtra,8,4,15,15,42,Pass
Krishna Sharma,29-01-2006,157198,Haryana,4,4,6,16,30,Pass
Aarav D'Souza,29-11-2005,449010,Daman & Diu / D&N Haveli,6,19,3,5,33,Fail
Raj Mehta,25-02-2006,339648,Punjab,2,24,17,19,62,Pass
Peter Fernandes,22-06-2005,748456,Maharashtra,20,13,2,15,50,Pass
Vivaan Verma,24-09-2005,609760,Assam,8,2,17,24,51,Pass
Vivaan D'Souza,28-10-2005,844360,Gujarat,3,1,10,19,33,Fail
Raj Khan,07-01-2005,459298,Kerala,15,6,5,2,28,Fail
Kunal Reddy,10-03-2005,225657,West Bengal,3,3,2,21,29,Pass
John Khan,19-02-2005,677418,Madhya Pradesh,13,11,23,2,49,Pass
Raj Pillai,23-05-2005,400209,West Bengal,16,16,12,1,45,Pass
Raj Khan,12-12-2004,940025,Bihar,0,24,15,5,44,Pass
Raj Fernandes,04-11-2005,631861,West Bengal,3,12,20,23,58,Pass
Rohan Singh,16-10-2005,109830,Maharashtra,10,16,1,15,42,Pass
Harjeet Verma,16-12-2004,657119,Telangana,0,0,3,18,21,Pass
Gurpreet Chopra,06-04-2006,836851,Rajasthan,0,16,21,21,58,Pass
Krishna Singh,21-03-2006,443825,Rajasthan,8,14,22,1,45,Pass
Mathew Fernandes,17-03-2006,617381,Chhattisgarh,2,8,3,18,31,Pass
Vivaan Khan,22-10-2005,627766,Assam,15,4,22,13,54,Pass
Aarav Singh,16-04-2006,344562,Punjab,23,17,18,22,80,Pass
Krishna D'Souza,23-03-2006,293482,Maharashtra,0,8,7,0,15,Pass
Harjeet Khan,02-07-2005,190581,Chhattisgarh,0,6,10,21,37,Pass
Aryan Chopra,19-10-2005,965275,West Bengal,2,5,6,11,24,Pass
Kunal Pillai,11-04-2005,232432,Bihar,22,9,20,4,55,Pass
Vivaan Verma,11-01-2006,919887,Kerala,8,15,16,1,40,Fail
Aarav Khan,19-04-2005,994866,Punjab,2,4,17,19,42,Pass
Aryan Fernandes,25-11-2004,637585,Maharashtra,20,23,2,11,56,Pass
Kunal Fernandes,30-01-2005,562541,Karnataka,9,22,6,1,38,Pass
Aarav Khan,28-12-2005,517571,Assam,20,6,2,3,31,Pass
Raj Khan,28-12-2005,174743,Rajasthan,0,1,8,1,10,Pass
Yash Mehta,13-04-2005,512799,Madhya Pradesh,4,22,11,8,45,Pass
Gurpreet Reddy,04-05-2006,525547,Uttarakhand,7,18,3,22,50,Pass
Mathew Chopra,13-11-2004,477033,Haryana,22,22,9,10,63,Pass
Rehan Chopra,02-10-2005,920122,Haryana,3,9,19,10,41,Pass
Krishna Pillai,06-03-2005,868511,Telangana,11,20,10,7,48,Pass
Krishna Sharma,01-04-2006,648116,Odisha,24,18,1,8,51,Pass
Yash Khan,22-06-2005,554619,Gujarat,17,16,19,21,73,Fail
Ayaan Sharma,28-09-2005,497273,Himachal Pradesh,8,7,12,23,50,Pass
Aryan Verma,31-03-2006,750026,Punjab,10,8,19,11,48,Pass
Raj D'Souza,18-04-2005,559468,Haryana,13,17,1,5,36,Pass
Raj Chopra,11-12-2005,428997,Haryana,21,10,15,23,69,Pass
Raj Singh,08-01-2005,396399,Rajasthan,3,21,6,21,51,Pass
Ishaan Pillai,12-06-2005,594176,Tamil Nadu,1,19,13,12,45,Pass
Rohan Reddy,19-04-2005,242916,Maharashtra,8,19,13,5,45,Pass
Mathew Reddy,30-11-2005,804317,Madhya Pradesh,22,0,2,18,42,Pass
Aryan Khan,31-01-2005,596819,Punjab,4,8,24,2,38,Pass
Vivaan Pillai,03-01-2005,650566,Maharashtra,10,11,0,16,37,Pass
Kunal Chopra,20-05-2005,172717,Haryana,14,5,4,2,25,Pass
Raj Reddy,26-05-2005,854447,Madhya Pradesh,23,22,3,5,53,Pass
Aditya Chopra,05-03-2006,902582,Gujarat,24,2,8,4,38,Fail
Aditya Verma,09-11-2004,449565,Uttarakhand,7,16,3,1,27,Pass
Paul Khan,04-02-2006,288908,Andhra Pradesh,9,7,3,16,35,Pass
Gurpreet Chopra,09-10-2005,307918,Maharashtra,19,23,2,3,47,Pass
Yash Chopra,02-03-2005,612748,Rajasthan,6,0,23,15,44,Pass
Peter Fernandes,01-01-2006,314558,Andhra Pradesh,1,17,9,6,33,Pass
Ishaan Sharma,07-12-2004,885139,Arunachal Pradesh,9,6,10,15,40,Pass
Aditya Reddy,08-12-2004,388931,Tamil Nadu,4,2,14,16,36,Pass
Ishaan D'Souza,15-07-2005,294435,Assam,14,18,12,1,45,Pass
Gurpreet Pillai,27-11-2004,842926,Bihar,17,10,22,14,63,Pass
Ishaan Verma,30-11-2005,837467,Karnataka,3,6,18,1,28,Pass
Vivaan Reddy,30-11-2005,458671,Chhattisgarh,12,5,14,0,31,Pass
Krishna Pillai,13-02-2005,263081,Madhya Pradesh,16,23,3,6,48,Pass
Vivaan Chopra,18-11-2005,630969,Haryana,23,12,6,23,64,Pass
Harjeet Reddy,03-03-2006,977201,Andhra Pradesh,17,22,23,4,66,Pass
Rohan Mehta,27-07-2005,885090,Uttar Pradesh,14,19,21,6,60,Pass
Raj Reddy,12-11-2005,375713,Chhattisgarh,0,8,13,16,37,Pass
Ishaan D'Souza,09-05-2005,836002,Rajasthan,7,17,3,11,38,Pass
Aryan Fernandes,08-03-2006,157787,Telangana,9,4,11,17,41,Pass
Vivaan Sharma,23-06-2005,428180,Bihar,17,5,5,22,49,Pass
Aryan Chopra,21-11-2005,511054,Maharashtra,13,23,2,12,50,Pass
Ishaan Singh,27-04-2005,925817,Kerala,23,15,4,13,55,Fail
Ishaan Chopra,07-10-2005,759121,Odisha,13,11,11,7,42,Pass
Harjeet Chopra,06-05-2005,918400,Uttar Pradesh,15,11,6,0,32,Pass
Aryan Mehta,03-05-2006,505662,Uttar Pradesh,5,0,15,17,37,Pass
Kunal Khan,11-02-2006,940795,Uttar Pradesh,3,14,3,14,34,Pass
Krishna Fernandes,02-04-2006,429220,Rajasthan,14,9,22,8,53,Pass
Vivaan Reddy,31-03-2005,858333,Rajasthan,16,19,3,14,52,Pass
Kunal Fernandes,27-08-2005,528591,Kerala,13,19,7,19,58,Fail
Imran Chopra,08-03-2005,515586,Bihar,23,21,15,8,67,Pass
Manpreet Chopra,14-11-2005,957524,Assam,19,16,19,10,64,Pass
Mathew Sharma,16-09-2005,102287,Bihar,17,7,14,22,60,Pass
Aditya Singh,25-02-2005,209009,Chhattisgarh,2,8,2,24,36,Pass
Manpreet Chopra,07-04-2005,258033,Rajasthan,5,17,3,11,36,Pass
Aditya Khan,21-04-2005,736252,Rajasthan,23,14,14,20,71,Pass
Rohan Reddy,05-02-2005,686111,Punjab,12,11,23,21,67,Pass
Sukhwinder Fernandes,23-12-2004,319559,Bihar,19,11,16,23,69,Pass
Harjeet Mehta,24-01-2006,476581,Bihar,18,10,6,15,49,Pass
Ishaan Chopra,10-11-2004,526917,Rajasthan,18,10,15,3,46,Pass
Aryan Pillai,19-01-2006,306452,Karnataka,17,19,6,14,56,Pass
Rohan Chopra,18-09-2005,439671,Rajasthan,13,23,11,13,60,Pass
Kunal Singh,14-12-2005,234799,Uttar Pradesh,22,3,23,15,63,Pass
Balbir Reddy,18-09-2005,754801,Odisha,16,13,5,0,34,Pass
Aryan Mehta,24-10-2005,707058,Chhattisgarh,11,6,12,3,32,Pass
Kunal D'Souza,28-11-2005,284695,Maharashtra,5,12,17,14,48,Pass
Rohan Mehta,11-12-2004,222842,Assam,3,7,10,13,33,Pass
Rohan Singh,05-10-2005,760407,Uttar Pradesh,4,18,24,23,69,Pass
Aditya Khan,19-05-2005,132671,Odisha,15,13,23,1,52,Pass
Rohan Singh,08-05-2005,987418,Maharashtra,20,24,2,1,47,Pass
Rehan Khan,04-12-2005,793187,Telangana,11,24,5,4,44,Pass
Manpreet Verma,16-05-2005,435439,Maharashtra,11,9,21,1,42,Pass
Rehan Fernandes,06-07-2005,194681,Himachal Pradesh,13,10,6,2,31,Pass
Krishna Mehta,16-03-2005,838543,Andhra Pradesh,15,3,14,15,47,Pass
Yash Fernandes,03-05-2005,851533,Madhya Pradesh,1,21,12,11,45,Pass
Balbir Singh,31-07-2005,901839,Kerala,8,8,16,20,52,Fail
Aarav Mehta,24-12-2004,201627,Rajasthan,15,14,5,9,43,Pass
Ayaan Pillai,13-07-2005,430868,Maharashtra,3,1,18,24,46,Pass
Vivaan Sharma,11-05-2005,890235,Karnataka,23,24,10,1,58,Pass
Aarav Verma,02-12-2005,933616,West Bengal,1,21,5,19,46,Pass
Yash Khan,08-07-2005,511389,Maharashtra,1,14,13,14,42,Pass
Aarav Singh,25-07-2005,326427,Madhya Pradesh,6,23,3,13,45,Pass
Krishna Sharma,08-02-2006,316469,West Bengal,12,1,8,21,42,Pass
Rohan Pillai,17-05-2005,173868,Chhattisgarh,3,13,19,15,50,Pass
Yash Sharma,06-06-2005,950171,Haryana,18,9,23,3,53,Pass
Manpreet Verma,04-05-2006,175370,Madhya Pradesh,2,11,16,5,34,Pass
Kunal Verma,23-01-2005,559206,Rajasthan,3,16,18,4,41,Pass
Rehan Reddy,22-01-2006,760833,Punjab,12,9,19,19,59,Pass
David Mehta,13-11-2005,757514,Bihar,8,9,18,6,41,Pass
Krishna Fernandes,14-09-2005,469313,Madhya Pradesh,22,2,3,9,36,Pass
Krishna Sharma,16-06-2005,276458,Maharashtra,10,23,2,17,52,Pass
Gurpreet Mehta,11-10-2005,561461,Uttar Pradesh,13,18,11,1,43,Pass
Aryan Chopra,05-03-2006,913179,Uttar Pradesh,0,19,23,2,44,Pass
Zaid Pillai,20-12-2005,946196,Maharashtra,8,5,19,1,33,Pass
Farhan Verma,14-04-2006,183117,Rajasthan,9,10,9,3,31,Pass
Ayaan Pillai,06-12-2004,350998,Tamil Nadu,0,21,14,24,59,Pass
Vivaan Singh,11-05-2005,360231,Rajasthan,16,2,21,10,49,Pass
Rohan Khan,24-08-2005,719142,Jammu & Kashmir + Ladakh,6,21,21,1,49,Pass
Krishna Fernandes,12-12-2004,927533,Telangana,18,21,11,8,58,Pass
Mathew Fernandes,07-04-2006,218706,Maharashtra,23,19,2,15,59,Pass
Peter Khan,04-10-2005,513917,Odisha,5,4,9,20,38,Pass
Paul Pillai,18-01-2005,394252,Manipur,11,19,5,13,48,Pass
Ishaan Verma,11-04-2006,172398,Gujarat,22,9,13,20,64,Fail
Aarav Sharma,03-02-2005,557407,Rajasthan,3,16,7,16,42,Pass
Kunal Mehta,09-11-2005,251375,Rajasthan,2,23,8,5,38,Pass
Aditya Fernandes,01-11-2005,697611,Rajasthan,3,20,6,19,48,Pass
Balbir D'Souza,13-12-2005,898626,Bihar,21,7,12,6,46,Pass
Raj Singh,13-08-2005,496803,Chhattisgarh,0,17,8,9,34,Pass
Kunal Fernandes,22-10-2005,159323,Gujarat,22,24,3,5,54,Fail
Rohan Mehta,29-01-2006,158208,Maharashtra,7,5,8,5,25,Pass
Vivaan Khan,26-12-2004,917374,Bihar,16,12,5,1,34,Pass
Imran Mehta,27-01-2005,769132,Tamil Nadu,7,4,1,4,16,Pass
Vivaan Sharma,28-07-2005,815532,Rajasthan,17,24,22,19,82,Pass
Peter Khan,02-01-2005,232699,West Bengal,10,19,5,3,37,Pass
Raj D'Souza,13-09-2005,233307,Odisha,17,16,23,8,64,Pass
Mathew Singh,28-06-2005,612996,Rajasthan,6,16,12,23,57,Pass
Aryan Fernandes,15-02-2005,724969,Rajasthan,8,16,23,7,54,Pass
Rohan D'Souza,22-06-2005,102008,Maharashtra,9,6,18,3,36,Pass
Aryan Singh,29-07-2005,482182,Kerala,14,6,13,9,42,Fail
Peter Khan,28-02-2005,597424,Rajasthan,4,14,8,20,46,Pass
Raj Reddy,26-03-2005,385442,Telangana,22,6,19,17,64,Pass
Krishna Chopra,12-10-2005,329062,Maharashtra,9,7,2,18,36,Pass
Rohan Fernandes,10-09-2005,470194,Uttar Pradesh,23,3,19,12,57,Pass
Peter Singh,11-09-2005,843067,Gujarat,3,10,11,23,47,Fail
Sukhwinder Khan,13-10-2005,265559,Punjab,11,20,23,4,58,Pass
Aditya Pillai,30-11-2005,999503,West Bengal,0,17,22,0,39,Pass
Harjeet D'Souza,16-03-2006,162549,Jharkhand,7,8,22,22,59,Pass
Imran Reddy,01-04-2005,634750,Himachal Pradesh,4,12,8,14,38,Pass
Krishna D'Souza,22-11-2004,286345,Tamil Nadu,2,23,18,22,65,Pass
Manpreet Khan,05-03-2006,609203,Bihar,2,3,10,22,37,Pass
Kunal Mehta,17-09-2005,428690,Tamil Nadu,18,9,6,14,47,Pass
Raj Khan,17-03-2006,940423,Uttarakhand,15,18,3,15,51,Pass
Ishaan Sharma,30-01-2006,908383,Uttar Pradesh,18,15,18,6,57,Pass
Aarav Singh,17-04-2005,423784,Tamil Nadu,22,1,24,13,60,Pass
Gurpreet Sharma,03-06-2005,369613,Bihar,18,4,6,8,36,Pass
Paul Verma,02-09-2005,532711,Punjab,6,19,12,10,47,Pass
Aditya Reddy,05-07-2005,368706,Haryana,4,20,20,20,64,Pass
Ishaan Sharma,17-12-2004,451596,Uttar Pradesh,14,6,18,8,46,Pass
Aditya Sharma,22-12-2004,747766,West Bengal,3,18,22,18,61,Pass
Peter Reddy,02-07-2005,295970,Madhya Pradesh,10,14,13,0,37,Pass
Manpreet Chopra,01-03-2005,494100,Rajasthan,0,6,17,4,27,Pass
Yash Khan,23-02-2005,320430,Bihar,3,21,6,7,37,Pass
David Fernandes,07-01-2005,976088,Bihar,19,15,1,21,56,Pass
Krishna Chopra,23-01-2005,359923,Sikkim,9,0,1,8,18,Pass
Rohan Singh,01-10-2005,512696,Haryana,19,17,5,1,42,Pass
Yash Singh,13-10-2005,622777,Bihar,1,2,20,12,35,Pass
Paul Chopra,06-06-2005,823317,Gujarat,0,19,11,18,48,Fail
Manpreet D'Souza,12-10-2005,372571,Karnataka,1,11,9,23,44,Pass
Aditya Mehta,03-02-2006,101912,Kerala,2,19,24,5,50,Fail
Balbir Pillai,31-12-2004,300109,Maharashtra,6,14,2,23,45,Pass
Manpreet Khan,19-04-2005,252334,Punjab,15,20,12,3,50,Pass
Rohan Sharma,09-02-2006,212511,Rajasthan,14,1,5,15,35,Pass
Yash Khan,07-03-2005,970121,Kerala,8,16,7,3,34,Fail
Ishaan D'Souza,30-10-2005,919503,Uttar Pradesh,23,3,20,21,67,Pass
Yash Sharma,23-01-2006,600392,Jammu & Kashmir + Ladakh,12,18,20,14,64,Pass
Peter Verma,05-05-2005,957591,Gujarat,7,16,21,15,59,Fail
Raj Singh,15-07-2005,918358,Delhi,19,15,8,22,64,Pass
Gurpreet Khan,11-05-2005,643549,Jharkhand,18,16,19,16,69,Fail
Sukhwinder Pillai,20-06-2005,440105,Uttarakhand,23,7,3,24,57,Pass
Yash Chopra,19-11-2004,140524,Bihar,13,23,9,11,56,Pass
Gurpreet Chopra,08-08-2005,303997,Gujarat,23,18,21,5,67,Fail
Manpreet Mehta,24-01-2006,528919,Madhya Pradesh,2,10,5,16,33,Pass
Aryan D'Souza,28-11-2004,878379,Gujarat,16,9,12,15,52,Fail
Zaid Reddy,20-07-2005,992327,Uttar Pradesh,23,3,23,22,71,Pass
Vivaan Verma,16-09-2005,898682,Rajasthan,11,19,23,3,56,Pass
Yash Fernandes,04-03-2005,958219,West Bengal,6,11,5,12,34,Pass
Ishaan Fernandes,08-07-2005,219979,Bihar,16,3,21,18,58,Pass
Raj Fernandes,03-06-2005,927092,Bihar,8,6,6,7,27,Pass
Krishna Khan,01-04-2005,803564,Bihar,13,3,15,12,43,Pass
Paul Reddy,05-01-2006,582359,Nagaland,7,14,16,8,45,Pass
Harjeet Reddy,07-10-2005,362223,Uttar Pradesh,19,3,23,18,63,Pass
Raj Singh,12-08-2005,495963,Rajasthan,10,7,24,10,51,Pass
Aryan Verma,16-03-2006,785988,Maharashtra,10,8,2,22,42,Pass
Balbir Singh,20-05-2005,660709,West Bengal,14,0,7,23,44,Pass
Kunal Pillai,31-05-2005,719905,Uttar Pradesh,7,12,16,23,58,Pass
Raj Chopra,03-08-2005,659501,Uttar Pradesh,14,5,19,23,61,Pass
Aryan Verma,05-03-2006,130265,Karnataka,19,9,11,10,49,Pass
Ayaan Pillai,04-02-2006,331310,Madhya Pradesh,17,7,14,8,46,Pass
Aarav Khan,14-02-2006,334585,Haryana,13,11,1,9,34,Pass
Yash Reddy,25-02-2005,219615,Haryana,1,3,3,24,31,Pass
Kunal Verma,03-04-2005,288184,Jharkhand,24,13,0,15,52,Pass
Aditya Verma,23-02-2006,447489,Jharkhand,10,12,11,10,43,Pass
Vivaan Sharma,01-08-2005,296741,Uttar Pradesh,22,7,2,7,38,Pass
Vivaan Khan,12-12-2004,295249,Rajasthan,9,7,20,4,40,Pass
Rohan Mehta,03-12-2005,490648,Kerala,3,12,10,20,45,Fail
Balbir Sharma,08-03-2005,547573,Punjab,14,4,13,14,45,Pass
Krishna Singh,23-02-2006,286109,Karnataka,21,24,18,22,85,Fail
Raj Verma,28-04-2006,300005,Uttar Pradesh,1,13,17,6,37,Pass
Vivaan D'Souza,11-01-2005,536432,Punjab,12,10,10,9,41,Pass
Ishaan Reddy,29-04-2005,236762,Madhya Pradesh,10,7,1,2,20,Pass
Sukhwinder Chopra,28-05-2005,625856,Madhya Pradesh,15,10,3,13,41,Pass
Ishaan Verma,12-12-2004,891888,Jharkhand,10,1,15,24,50,Pass
Paul Singh,09-08-2005,887577,Rajasthan,11,20,8,5,44,Pass
Kunal Pillai,03-03-2005,852087,Uttar Pradesh,12,16,6,8,42,Pass
Rohan Khan,09-01-2006,326816,Rajasthan,3,23,1,10,37,Pass
Raj Fernandes,30-01-2005,962324,Rajasthan,7,24,23,23,77,Pass
Aditya Mehta,15-02-2005,492890,Andhra Pradesh,9,24,13,16,62,Pass
Aarav Chopra,19-01-2006,869287,Madhya Pradesh,0,1,24,11,36,Pass
Aarav Fernandes,08-01-2005,562971,Himachal Pradesh,23,6,2,24,55,Pass
Aryan Pillai,06-02-2005,698712,Gujarat,23,7,24,6,60,Fail
Aditya Chopra,27-04-2006,242737,Andhra Pradesh,24,1,22,8,55,Pass
Ishaan Singh,16-06-2005,786695,Bihar,18,20,0,13,51,Pass
Raj Singh,24-04-2006,619885,Rajasthan,18,20,22,22,82,Pass
Krishna Fernandes,27-11-2004,676023,Jharkhand,0,0,20,11,31,Pass
Ayaan Fernandes,15-04-2006,842774,Chhattisgarh,1,8,19,17,45,Pass
Sukhwinder Chopra,10-06-2005,104551,Uttar Pradesh,16,17,6,15,54,Pass
Aryan Pillai,25-01-2005,395329,Bihar,3,2,16,22,43,Pass
Peter Sharma,18-04-2005,426143,Gujarat,14,5,19,18,56,Fail
Aryan Singh,03-05-2005,481616,Punjab,23,20,15,19,77,Pass
Aarav Pillai,01-01-2005,810705,West Bengal,3,14,9,21,47,Pass
Rohan Singh,10-01-2005,879287,Rajasthan,20,18,1,0,39,Pass
Vivaan Mehta,06-01-2005,830030,West Bengal,3,17,20,20,60,Pass
Manpreet D'Souza,26-01-2005,804256,Punjab,4,4,17,17,42,Pass
Gurpreet Sharma,15-06-2005,627385,Madhya Pradesh,8,4,1,23,36,Pass
Aarav Chopra,08-11-2004,424542,Madhya Pradesh,0,7,7,7,21,Pass
Aarav Verma,30-04-2006,254480,Maharashtra,22,7,7,3,39,Pass
Yash Fernandes,30-01-2005,164231,Madhya Pradesh,1,22,3,15,41,Pass
Ayaan D'Souza,14-04-2006,132274,Meghalaya,5,9,8,7,29,Pass
Krishna Verma,03-09-2005,499508,Odisha,9,7,19,2,37,Pass
Aarav Pillai,27-12-2005,805268,Uttar Pradesh,5,13,19,24,61,Pass
Raj Verma,12-05-2005,535208,West Bengal,6,2,12,24,44,Pass
Rohan Verma,08-12-2005,555568,Bihar,7,12,4,15,38,Pass
Krishna D'Souza,25-12-2005,192036,Kerala,13,22,2,14,51,Fail
Aryan Chopra,09-03-2006,221606,West Bengal,0,0,6,21,27,Pass
Yash Mehta,24-03-2005,770756,West Bengal,3,8,18,21,50,Pass
Manpreet Verma,16-05-2005,297956,Punjab,23,0,1,18,42,Pass
Aditya Mehta,01-08-2005,984342,Telangana,11,19,5,2,37,Pass
Rohan D'Souza,27-01-2005,861563,Rajasthan,7,5,3,6,21,Pass
Kunal Verma,29-05-2005,708329,Bihar,6,20,0,0,26,Pass
Imran Singh,29-11-2005,812877,Uttar Pradesh,17,1,22,20,60,Pass
Krishna Pillai,17-08-2005,874488,West Bengal,3,19,7,22,51,Pass
Aarav Singh,10-08-2005,664685,Chhattisgarh,11,11,11,11,44,Pass
Raj Reddy,13-01-2006,299757,Uttar Pradesh,16,21,7,21,65,Pass
Manpreet Pillai,27-12-2004,213033,Andaman & Nicobar,16,9,23,4,52,Pass
Harjeet Pillai,25-02-2006,263600,Mizoram,21,0,8,13,42,Pass
Aditya Khan,13-03-2006,284557,Jharkhand,2,20,17,3,42,Pass
Raj Verma,03-02-2005,697184,Uttar Pradesh,10,16,24,6,56,Pass
Krishna Sharma,18-12-2004,979416,Gujarat,14,11,3,24,52,Fail
Krishna Sharma,02-01-2005,310668,Uttar Pradesh,0,13,22,11,46,Pass
Aryan Pillai,23-08-2005,339435,Himachal Pradesh,5,2,17,14,38,Pass
Farhan Verma,10-01-2006,520282,Odisha,15,1,24,7,47,Pass
Ishaan Verma,23-05-2005,122949,Punjab,5,4,2,22,33,Pass
David Fernandes,02-10-2005,755641,Chhattisgarh,9,5,9,15,38,Pass
Aarav Sharma,11-08-2005,711166,Andhra Pradesh,2,8,10,14,34,Pass
Kunal Chopra,04-11-2005,263499,West Bengal,3,13,16,19,51,Pass
Aarav Sharma,22-01-2006,465642,Uttar Pradesh,7,1,13,22,43,Pass
Imran Mehta,01-04-2006,492929,Jharkhand,4,23,19,7,53,Fail
Yash Reddy,20-02-2005,748978,Bihar,9,2,20,24,55,Pass
David Verma,06-12-2005,894100,Madhya Pradesh,2,1,7,8,18,Pass
Balbir Pillai,07-11-2004,366056,Odisha,3,8,4,5,20,Pass
Kunal Khan,09-11-2005,890095,Rajasthan,10,24,12,22,68,Pass
Balbir Mehta,23-04-2006,997393,Madhya Pradesh,6,10,7,5,28,Pass
David Mehta,17-12-2004,505462,Telangana,5,13,19,6,43,Pass
Krishna Chopra,21-07-2005,496070,Bihar,17,12,9,5,43,Pass
Sukhwinder Sharma,07-10-2005,396538,Madhya Pradesh,11,6,17,7,41,Pass
Krishna Verma,21-11-2005,276289,Telangana,13,11,9,21,54,Pass
David Khan,17-12-2004,720548,Punjab,17,7,14,4,42,Pass
Aryan Chopra,18-12-2005,559575,Kerala,5,1,3,7,16,Fail
Ishaan Pillai,29-03-2006,137153,Maharashtra,23,12,20,3,58,Pass
Kunal Verma,01-02-2006,455409,Maharashtra,16,21,4,5,46,Pass
Kunal Reddy,03-01-2005,553869,Maharashtra,22,9,12,4,47,Pass
John Mehta,10-01-2006,388692,Maharashtra,4,4,24,14,46,Pass
Yash D'Souza,07-12-2004,318782,Maharashtra,21,14,10,3,48,Pass
Yash D'Souza,13-05-2005,845161,Uttar Pradesh,13,6,18,1,38,Pass
Rehan Mehta,04-04-2005,239651,Kerala,6,8,9,13,36,Fail
Ishaan D'Souza,18-06-2005,736609,Tamil Nadu,16,23,5,13,57,Pass
Yash Mehta,16-01-2005,437588,Uttarakhand,11,13,1,5,30,Pass
Balbir D'Souza,07-01-2005,395925,Arunachal Pradesh,7,5,22,24,58,Pass
Ishaan Mehta,08-10-2005,203587,Bihar,15,9,12,6,42,Pass
Yash Fernandes,06-11-2005,708524,Bihar,3,24,22,5,54,Pass
Aditya Mehta,12-01-2005,519223,Arunachal Pradesh,6,4,6,17,33,Pass
Manpreet Fernandes,13-03-2005,928023,Kerala,17,2,21,24,64,Fail
Ishaan Singh,14-09-2005,111672,Jharkhand,16,20,22,21,79,Fail
Gurpreet Chopra,16-01-2005,844514,Bihar,19,6,17,1,43,Pass
Manpreet Singh,19-01-2006,714094,Himachal Pradesh,2,7,24,19,52,Pass
Ishaan Fernandes,14-04-2006,679494,Bihar,15,21,12,16,64,Pass
Aryan Mehta,13-04-2005,989572,Telangana,23,13,13,9,58,Pass
Krishna Verma,12-01-2006,620515,Uttar Pradesh,13,15,9,4,41,Pass
Mathew Fernandes,27-09-2005,296093,Maharashtra,18,7,17,3,45,Pass
Aryan Verma,13-02-2006,524783,Himachal Pradesh,24,17,6,6,53,Pass
Vivaan Fernandes,17-09-2005,312884,Punjab,21,16,8,4,49,Pass
Vivaan Reddy,05-10-2005,538789,Rajasthan,15,18,23,21,77,Pass
Rohan Verma,18-05-2005,667801,Bihar,17,14,4,8,43,Pass
Balbir Singh,15-12-2005,427927,Uttar Pradesh,15,18,11,24,68,Pass
Balbir Chopra,06-06-2005,522550,Delhi,13,4,10,3,30,Pass
Rohan Singh,17-03-2005,303447,Punjab,5,7,13,4,29,Pass
David Mehta,20-02-2005,192310,West Bengal,3,14,8,21,46,Pass
Kunal Mehta,30-04-2005,546066,Uttar Pradesh,24,0,1,6,31,Pass
Aarav Mehta,27-12-2004,131437,West Bengal,3,18,5,16,42,Pass
Aryan Pillai,02-12-2005,860875,Karnataka,10,23,8,14,55,Pass
Vivaan Fernandes,31-08-2005,179237,Assam,17,23,7,10,57,Pass
Balbir Sharma,27-01-2005,466366,Tamil Nadu,13,20,17,24,74,Pass
Rohan Verma,08-02-2006,421539,Mizoram,4,4,4,5,17,Pass
Sukhwinder Singh,15-03-2005,772566,Uttar Pradesh,10,4,16,2,32,Pass
Vivaan Chopra,21-06-2005,745205,Maharashtra,3,16,7,6,32,Pass
Ishaan D'Souza,28-03-2005,804020,West Bengal,3,14,21,15,53,Pass
Kunal Verma,20-10-2005,672072,Uttar Pradesh,5,3,22,23,53,Pass
Yash Mehta,13-12-2004,454438,Gujarat,11,4,8,15,38,Fail
Vivaan Singh,01-01-2006,527933,Haryana,8,10,4,19,41,Pass
Aryan Mehta,19-04-2006,870921,Uttar Pradesh,19,3,23,11,56,Pass
John Chopra,14-11-2005,845914,Uttar Pradesh,9,1,1,15,26,Pass
David Pillai,01-12-2004,323466,Tamil Nadu,7,17,11,15,50,Pass
Paul Reddy,03-02-2005,602108,Bihar,16,6,22,24,68,Pass
Krishna D'Souza,08-11-2004,556877,Maharashtra,14,20,17,3,54,Pass
Balbir Mehta,07-04-2005,106495,Andhra Pradesh,4,12,21,14,51,Pass
Ishaan Sharma,19-02-2005,473771,Punjab,12,1,3,22,38,Pass
Harjeet Reddy,18-04-2005,318992,Haryana,22,9,7,19,57,Pass
Rohan Fernandes,10-02-2006,655031,Telangana,1,13,23,9,46,Pass
Sukhwinder Verma,05-05-2005,879440,Tripura,19,20,7,19,65,Pass
Vivaan D'Souza,11-07-2005,558816,Rajasthan,23,9,6,1,39,Pass
Aarav Singh,11-08-2005,441151,Rajasthan,17,20,3,6,46,Pass
Aditya Verma,29-08-2005,221150,Bihar,20,18,2,6,46,Pass
Raj Sharma,15-12-2005,861901,Chhattisgarh,3,2,18,8,31,Pass
Gurpreet D'Souza,15-03-2006,702056,Odisha,8,22,15,12,57,Pass
Mathew Verma,30-11-2005,932016,Haryana,19,21,0,2,42,Pass
Ishaan Pillai,20-02-2005,844224,Telangana,1,0,11,8,20,Pass
Peter Chopra,16-03-2005,613839,Rajasthan,4,16,20,2,42,Pass
Farhan Chopra,21-08-2005,697265,Rajasthan,15,19,14,9,57,Pass
Raj Singh,27-03-2005,510611,Chhattisgarh,13,15,24,18,70,Pass
Farhan Verma,01-03-2005,431456,Jharkhand,7,12,8,2,29,Pass
Sukhwinder Pillai,01-11-2005,247154,Uttar Pradesh,12,19,9,14,54,Pass
Vivaan Verma,06-12-2004,995301,Punjab,21,11,14,12,58,Pass
Kunal Khan,08-04-2006,153340,Bihar,7,4,6,22,39,Pass
Vivaan Mehta,02-04-2006,759173,Karnataka,23,13,19,0,55,Pass
Kunal Khan,24-11-2004,828810,Jharkhand,23,15,9,19,66,Pass
Krishna D'Souza,24-01-2006,989490,West Bengal,8,7,7,24,46,Pass
Raj Singh,31-05-2005,141919,Rajasthan,1,10,7,16,34,Pass
Aarav Fernandes,26-07-2005,597325,Maharashtra,24,23,12,3,62,Pass
Krishna Chopra,03-03-2006,245894,Uttar Pradesh,23,24,7,0,54,Pass
Peter D'Souza,22-03-2006,756928,Kerala,18,9,21,19,67,Fail
Peter Verma,11-01-2006,966988,Gujarat,17,16,20,20,73,Fail
Aditya Fernandes,11-06-2005,476674,Maharashtra,7,19,20,3,49,Pass
Paul Fernandes,06-03-2005,627405,Uttar Pradesh,2,20,19,7,48,Pass
Raj Khan,11-09-2005,441821,Uttar Pradesh,22,24,5,5,56,Pass
Ishaan Khan,08-08-2005,436601,Manipur,1,6,19,10,36,Pass
Rohan Khan,16-04-2006,252951,Bihar,22,22,24,24,92,Pass
Yash Khan,27-03-2006,409758,Rajasthan,5,17,10,7,39,Pass
Aarav Reddy,05-06-2005,106276,Gujarat,14,2,13,12,41,Fail
Raj Singh,08-02-2006,648148,Mizoram,4,4,5,4,17,Pass
Gurpreet Fernandes,05-07-2005,964921,Odisha,9,5,1,20,35,Pass
Balbir Khan,30-03-2005,329659,West Bengal,3,9,16,11,39,Pass
Sukhwinder Mehta,21-10-2005,451799,Uttar Pradesh,23,0,21,1,45,Pass
Ishaan Mehta,05-08-2005,766827,Himachal Pradesh,23,17,10,1,51,Pass
Aditya Sharma,04-08-2005,275388,Karnataka,7,23,9,7,46,Pass
Peter Fernandes,03-05-2006,974361,Uttar Pradesh,19,22,9,1,51,Pass
Aarav Khan,01-01-2005,857102,Uttarakhand,1,3,1,2,7,Pass
Yash Pillai,19-03-2006,831167,Karnataka,7,3,12,2,24,Pass
Vivaan Verma,22-06-2005,741864,Karnataka,8,11,18,12,49,Pass
Kunal Verma,06-04-2005,791072,Madhya Pradesh,20,17,3,17,57,Pass
John Fernandes,19-06-2005,846509,Andhra Pradesh,15,12,1,4,32,Pass
Yash Reddy,21-06-2005,659784,Maharashtra,9,19,0,21,49,Pass
Aditya Verma,11-12-2005,947311,Telangana,14,18,18,15,65,Pass
Ishaan Chopra,11-05-2005,956447,Rajasthan,17,2,16,7,42,Pass
Raj Singh,05-05-2005,135150,Bihar,5,4,11,1,21,Pass
Yash Sharma,28-01-2005,480447,Maharashtra,4,9,7,9,29,Pass
Krishna Sharma,08-05-2006,177263,Uttar Pradesh,20,14,21,0,55,Pass
Rohan D'Souza,23-12-2005,129342,Uttar Pradesh,4,11,10,13,38,Pass
Ishaan Verma,03-05-2006,549525,Rajasthan,8,23,11,6,48,Pass
Sukhwinder Verma,23-06-2005,495515,Madhya Pradesh,19,18,5,14,56,Pass
Sukhwinder D'Souza,29-04-2006,116984,Uttar Pradesh,1,13,19,4,37,Pass
Gurpreet Sharma,28-10-2005,575460,Assam,12,9,21,16,58,Pass
Aditya Verma,10-12-2005,544882,Kerala,12,16,2,12,42,Fail
Sukhwinder Reddy,08-09-2005,705184,Uttarakhand,24,12,4,1,41,Pass
Manpreet Singh,12-08-2005,751172,Punjab,21,15,11,2,49,Pass
Peter D'Souza,09-10-2005,435590,Bihar,2,11,12,7,32,Pass
Yash Pillai,21-03-2005,971066,Andhra Pradesh,6,10,10,2,28,Pass
Vivaan Khan,30-11-2004,666182,Kerala,8,24,5,20,57,Fail
John Pillai,18-12-2005,944984,Haryana,3,24,11,3,41,Pass
Rohan Verma,28-02-2005,949101,Gujarat,7,1,21,23,52,Fail
Raj Sharma,27-11-2004,871571,Maharashtra,11,5,7,0,23,Pass
Gurpreet Chopra,27-04-2005,953047,Telangana,19,10,18,11,58,Pass
Raj Khan,17-04-2006,934449,Karnataka,24,10,4,9,47,Pass
Aryan Chopra,03-07-2005,930995,Maharashtra,24,23,13,3,63,Pass
Aarav Chopra,16-09-2005,567874,Gujarat,4,7,13,14,38,Fail
Kunal Sharma,22-12-2004,186612,Haryana,9,24,12,11,56,Pass
Aryan Khan,01-04-2006,641536,Madhya Pradesh,3,15,11,3,32,Pass
Kunal Verma,17-07-2005,859868,Madhya Pradesh,13,20,9,0,42,Pass
Ishaan Pillai,24-08-2005,139182,Bihar,21,9,3,17,50,Pass
Vivaan Fernandes,10-03-2006,227687,Karnataka,16,1,12,23,52,Pass
Raj Sharma,05-12-2005,127270,West Bengal,3,3,24,22,52,Pass
Raj Reddy,17-04-2006,852900,Rajasthan,24,0,12,16,52,Pass
Raj D'Souza,31-12-2005,490921,Uttar Pradesh,23,9,2,6,40,Pass
Raj Verma,19-07-2005,386510,Maharashtra,14,14,5,3,36,Pass
Kunal Fernandes,08-03-2005,652643,Assam,1,15,9,6,31,Pass
Ishaan Pillai,31-07-2005,922787,Bihar,10,8,11,18,47,Pass
John Pillai,11-02-2006,291666,Maharashtra,19,15,13,3,50,Pass
Raj Reddy,10-12-2004,671357,Gujarat,16,5,3,4,28,Fail
Yash Sharma,09-03-2005,283230,Uttar Pradesh,11,3,23,22,59,Pass
Vivaan Chopra,14-01-2006,560520,Uttar Pradesh,6,14,6,7,33,Pass
Kunal Verma,14-09-2005,295961,Uttar Pradesh,22,0,12,8,42,Pass
Vivaan Verma,19-02-2006,909202,Uttar Pradesh,11,5,23,19,58,Pass
David Fernandes,21-01-2006,953272,Assam,23,19,24,14,80,Pass
Vivaan Fernandes,13-03-2006,970006,Punjab,5,21,8,7,41,Pass
Krishna Mehta,30-06-2005,922086,Assam,12,17,22,24,75,Pass
Kunal Singh,29-11-2004,755001,Bihar,4,2,0,15,21,Pass
David D'Souza,07-09-2005,774942,Himachal Pradesh,22,5,16,24,67,Pass
Aarav Singh,31-08-2005,381338,Uttar Pradesh,7,7,17,3,34,Pass
Ayaan Fernandes,24-11-2005,399653,Bihar,23,13,20,8,64,Pass
Aryan Sharma,29-08-2005,354122,Uttar Pradesh,5,2,17,3,27,Pass
John D'Souza,29-12-2004,960981,Haryana,14,17,10,14,55,Pass
Krishna Chopra,19-04-2006,354097,Gujarat,20,16,19,6,61,Fail
Aarav Sharma,23-03-2005,837349,Rajasthan,8,9,20,5,42,Pass
Aditya Verma,03-02-2005,526668,Uttar Pradesh,5,14,5,5,29,Pass
Aarav Fernandes,26-05-2005,124393,Jharkhand,12,22,11,2,47,Pass
Aarav Reddy,24-01-2005,893209,Kerala,18,4,24,17,63,Fail
Aditya Khan,14-03-2005,387661,West Bengal,18,23,1,8,50,Pass
Ishaan Chopra,24-06-2005,691990,Punjab,21,13,19,8,61,Pass
Harjeet D'Souza,13-01-2006,383519,Andhra Pradesh,16,24,15,16,71,Pass
Peter D'Souza,19-02-2006,999062,Rajasthan,17,10,6,9,42,Pass
Sukhwinder Sharma,27-05-2005,810969,Karnataka,23,7,12,17,59,Pass
Krishna Khan,31-12-2004,972713,Maharashtra,3,24,18,3,48,Pass
Raj Reddy,24-01-2005,385224,Andhra Pradesh,15,20,11,18,64,Pass
Ayaan Khan,05-09-2005,328817,Andhra Pradesh,12,19,1,1,33,Pass
Aryan Chopra,12-01-2006,479597,West Bengal,0,10,21,1,32,Pass
David Verma,28-04-2006,817734,Rajasthan,15,13,11,3,42,Pass
Raj Khan,04-11-2005,210038,Daman & Diu / D&N Haveli,6,8,16,12,42,Fail
Manpreet D'Souza,10-03-2006,814265,Kerala,8,5,21,4,38,Fail
Yash Mehta,17-04-2006,447985,Bihar,8,4,9,0,21,Pass
Kunal Reddy,18-02-2005,709132,Uttar Pradesh,1,5,13,3,22,Pass
Raj Sharma,27-11-2005,983724,Assam,16,3,16,1,36,Pass
Raj Khan,28-02-2005,301187,Uttar Pradesh,19,1,9,2,31,Pass
Farhan Pillai,04-12-2004,217279,Bihar,9,19,2,18,48,Pass
Raj Reddy,21-12-2004,345529,Bihar,5,10,1,14,30,Pass
Imran Reddy,17-04-2006,490373,Punjab,24,3,7,15,49,Pass
Aryan Fernandes,13-12-2005,899226,Kerala,3,10,1,0,14,Fail
Peter Mehta,20-07-2005,222392,Bihar,23,23,12,10,68,Pass
Raj Chopra,18-04-2005,685899,Odisha,11,16,6,19,52,Pass
John Verma,27-04-2006,473193,West Bengal,7,9,6,12,34,Pass
Krishna Chopra,10-10-2005,486767,Madhya Pradesh,13,10,8,24,55,Pass
Aarav Fernandes,07-11-2005,908800,Madhya Pradesh,20,15,3,6,44,Pass
Aditya Verma,07-04-2006,257566,Bihar,11,11,0,11,33,Pass
Aarav Fernandes,05-05-2006,444847,Uttar Pradesh,23,13,3,12,51,Pass
Vivaan Singh,13-11-2004,397340,Uttar Pradesh,6,23,0,10,39,Pass
Vivaan Chopra,05-05-2006,712944,Andhra Pradesh,11,22,22,4,59,Pass
Aryan Mehta,25-02-2005,301997,Uttar Pradesh,4,13,1,3,21,Pass
Balbir Pillai,29-08-2005,186299,Bihar,1,11,3,5,20,Pass
Aryan Fernandes,29-10-2005,560153,Telangana,22,8,6,14,50,Pass
Sukhwinder Singh,23-02-2005,407107,Madhya Pradesh,2,8,5,12,27,Pass
Rehan Khan,11-08-2005,399256,Madhya Pradesh,2,15,6,6,29,Pass
Manpreet Singh,22-05-2005,420851,Andhra Pradesh,24,24,0,2,50,Pass
David Chopra,26-01-2006,823134,Haryana,15,12,19,11,57,Pass
Kunal Fernandes,02-06-2005,828333,Maharashtra,13,21,14,3,51,Pass
Raj Verma,28-03-2005,435412,Haryana,14,14,6,4,38,Pass
Raj Verma,19-10-2005,149862,Uttar Pradesh,19,22,12,10,63,Pass
Aditya Chopra,07-10-2005,181675,Jharkhand,3,8,9,21,41,Pass
Yash Reddy,24-11-2004,917076,Tamil Nadu,4,18,2,3,27,Pass
Farhan Pillai,29-08-2005,579755,Maharashtra,21,11,22,3,57,Pass
Aarav Fernandes,29-03-2006,955838,Bihar,3,17,13,5,38,Pass
Mathew Pillai,28-02-2005,674897,Bihar,23,4,1,22,50,Pass
Ishaan Pillai,26-04-2005,193176,West Bengal,2,16,14,9,41,Pass
Sukhwinder Sharma,16-04-2005,998666,West Bengal,1,21,3,1,26,Pass
David Sharma,17-11-2005,689053,Bihar,3,3,8,3,17,Pass
Yash Sharma,21-01-2006,223606,Punjab,5,6,15,20,46,Pass
Aryan Sharma,01-12-2005,300834,Telangana,12,21,7,9,49,Pass
Krishna Pillai,12-12-2004,425602,Gujarat,9,20,13,8,50,Fail
Peter D'Souza,03-08-2005,172802,Andhra Pradesh,11,21,19,21,72,Pass
Vivaan Pillai,05-12-2004,253767,Madhya Pradesh,18,13,3,21,55,Pass
Aarav Pillai,29-12-2004,500186,Jammu & Kashmir + Ladakh,7,5,8,7,27,Pass
David Verma,20-06-2005,789861,Bihar,17,4,8,12,41,Pass
Vivaan Singh,24-12-2004,826115,Telangana,12,21,2,3,38,Pass
Kunal Chopra,03-11-2005,798563,Telangana,8,18,24,7,57,Pass
Krishna Sharma,31-12-2004,811909,Andhra Pradesh,22,20,11,7,60,Pass
Ishaan Pillai,27-01-2005,457150,Madhya Pradesh,18,17,7,4,46,Pass
Aditya Singh,10-07-2005,376876,Tamil Nadu,0,21,20,11,52,Pass
David Singh,05-11-2005,906384,Maharashtra,0,0,1,0,1,Pass
Ishaan Singh,26-10-2005,595959,Odisha,15,3,23,13,54,Pass
Harjeet Singh,20-11-2004,134304,Madhya Pradesh,7,14,12,21,54,Pass
Mathew Mehta,26-12-2004,912942,Madhya Pradesh,12,19,1,3,35,Pass
Aditya Sharma,19-08-2005,825508,Kerala,4,23,15,3,45,Fail
Sukhwinder Chopra,14-06-2005,355215,Karnataka,4,18,0,4,26,Pass
Peter Fernandes,05-09-2005,840928,Andhra Pradesh,23,12,8,5,48,Pass
Raj Pillai,28-02-2006,627232,Uttar Pradesh,16,20,21,1,58,Pass
Harjeet Fernandes,27-02-2005,567152,Maharashtra,10,18,17,4,49,Pass
Harjeet D'Souza,27-04-2005,249750,Chhattisgarh,8,22,17,19,66,Pass
David Sharma,27-02-2006,575315,Madhya Pradesh,7,11,6,6,30,Pass
Vivaan Pillai,18-05-2005,887398,Bihar,15,0,9,15,39,Pass
John Reddy,30-04-2005,685542,Rajasthan,13,14,6,3,36,Pass
David Mehta,30-03-2005,688302,Uttar Pradesh,7,16,6,3,32,Pass
Vivaan Chopra,28-12-2004,162832,Bihar,4,6,24,6,40,Pass
Aarav Khan,13-03-2006,327863,Uttarakhand,12,15,3,12,42,Pass
Aryan Chopra,07-12-2004,436249,Uttarakhand,18,14,5,9,46,Pass
Yash Verma,04-12-2004,398916,Assam,10,22,14,15,61,Pass
Aryan Chopra,09-12-2004,627222,Haryana,6,3,19,14,42,Pass
Aditya Fernandes,20-07-2005,296834,Madhya Pradesh,22,14,6,3,45,Pass
Paul Mehta,11-11-2004,131698,Tamil Nadu,18,8,21,5,52,Pass
John Chopra,08-02-2005,678703,Tamil Nadu,6,12,3,3,24,Pass
Krishna Chopra,13-12-2005,689905,Madhya Pradesh,2,15,5,18,40,Pass
Rohan Singh,22-03-2006,819366,Bihar,22,24,5,2,53,Pass
Ayaan Chopra,10-09-2005,326278,West Bengal,14,2,1,20,37,Pass
Ishaan Sharma,14-12-2005,181749,Punjab,19,11,11,16,57,Pass
Ayaan Khan,13-01-2005,130004,Karnataka,14,8,14,22,58,Pass
Kunal D'Souza,28-05-2005,780711,Madhya Pradesh,11,8,16,20,55,Pass
Farhan Verma,07-04-2005,478991,West Bengal,10,13,4,1,28,Pass
Raj Singh,03-01-2005,883280,Delhi,2,15,18,10,45,Pass
Rohan Verma,30-03-2006,792091,Uttar Pradesh,19,22,1,20,62,Pass
Rohan Reddy,14-05-2005,142979,Haryana,18,12,0,13,43,Pass
Aryan Pillai,14-01-2006,840893,Kerala,13,16,14,16,59,Fail
Rohan D'Souza,15-02-2006,555753,Gujarat,21,21,3,0,45,Fail
Raj Mehta,14-01-2006,642252,Uttar Pradesh,5,8,4,18,35,Pass
Yash Verma,07-11-2005,343702,Maharashtra,14,2,3,19,38,Pass
Aryan Sharma,22-10-2005,313279,Andhra Pradesh,8,18,5,8,39,Pass
Ishaan Chopra,25-10-2005,189017,Arunachal Pradesh,10,17,13,6,46,Fail
Aryan Reddy,30-12-2004,457789,Maharashtra,19,3,16,3,41,Pass
Aarav Chopra,18-08-2005,590953,Haryana,22,23,9,15,69,Pass
Aditya D'Souza,05-10-2005,426463,Bihar,1,15,3,20,39,Pass
Aryan D'Souza,08-06-2005,151720,Madhya Pradesh,24,15,3,16,58,Pass
Ishaan Reddy,14-04-2006,288723,Uttar Pradesh,19,9,1,14,43,Pass
Rohan Mehta,25-02-2005,301094,Maharashtra,12,24,3,4,43,Pass
Farhan Singh,25-10-2005,935686,Gujarat,7,22,1,12,42,Fail
Rohan Verma,09-11-2004,983929,Jharkhand,23,9,12,5,49,Pass
Aarav Fernandes,31-12-2005,960377,Uttar Pradesh,23,11,16,15,65,Pass
Raj Mehta,13-02-2006,176578,Tamil Nadu,9,24,5,7,45,Pass
John D'Souza,27-08-2005,648348,Bihar,13,24,23,22,82,Pass
Sukhwinder Fernandes,23-11-2004,971281,Maharashtra,3,3,20,18,44,Pass
Krishna Singh,05-05-2005,815345,Karnataka,4,20,10,14,48,Pass
Farhan Chopra,18-07-2005,608499,Jharkhand,22,2,3,23,50,Pass
Krishna D'Souza,09-08-2005,201108,Maharashtra,16,0,15,3,34,Pass
Vivaan Sharma,12-09-2005,900394,Maharashtra,7,6,17,5,35,Pass
Yash Sharma,14-04-2005,828639,Bihar,24,15,2,17,58,Pass
Krishna Reddy,22-12-2004,563481,Chhattisgarh,20,0,10,20,50,Pass
Aryan Pillai,28-11-2005,149856,Assam,3,6,10,16,35,Pass
Kunal Khan,25-08-2005,188119,Daman & Diu / D&N Haveli,17,10,2,6,35,Fail
Yash Singh,04-12-2004,137152,Rajasthan,12,11,12,8,43,Pass
Yash Khan,09-04-2005,432981,Haryana,3,5,4,17,29,Pass
Aarav Chopra,16-10-2005,701179,Rajasthan,16,21,23,23,83,Pass
Aryan Khan,04-08-2005,583443,Bihar,7,14,0,8,29,Pass
Aarav Singh,27-02-2006,687093,Kerala,16,10,7,5,38,Fail
Mathew Pillai,31-05-2005,361910,Delhi,2,2,18,16,38,Pass
Aditya Mehta,11-06-2005,442754,Delhi,3,19,20,18,60,Pass
Rohan Fernandes,07-09-2005,349666,Haryana,4,9,1,13,27,Pass
Aditya Singh,12-03-2005,400783,Bihar,8,7,3,2,20,Pass
Mathew Singh,12-03-2006,810396,Jharkhand,3,11,11,6,31,Pass
Aarav Mehta,27-10-2005,858502,Uttar Pradesh,2,19,3,3,27,Pass
Manpreet Pillai,08-11-2005,790019,Manipur,2,19,3,7,31,Pass
Yash Fernandes,28-04-2006,866242,West Bengal,18,5,18,9,50,Pass
Vivaan Pillai,29-03-2005,386954,Jharkhand,5,20,20,11,56,Pass
Aryan Mehta,11-10-2005,582321,Chhattisgarh,24,5,14,15,58,Pass
Aryan Pillai,30-01-2006,687958,Andhra Pradesh,20,2,5,2,29,Pass
Balbir Mehta,06-04-2005,565455,West Bengal,0,15,15,11,41,Pass
Balbir Pillai,29-03-2006,998181,Delhi,10,9,4,2,25,Pass
David Singh,03-03-2005,195454,Maharashtra,3,5,10,4,22,Pass
Vivaan Pillai,20-08-2005,401184,Madhya Pradesh,15,18,3,21,57,Pass
Aditya Chopra,20-08-2005,289001,West Bengal,24,9,5,9,47,Pass
Rehan Pillai,15-02-2005,613485,West Bengal,3,8,4,23,38,Pass
David Reddy,11-09-2005,784685,Andhra Pradesh,1,12,14,11,38,Pass
Aarav Sharma,16-12-2005,492043,West Bengal,19,4,11,7,41,Pass
Aditya Reddy,27-05-2005,172266,Puducherry,12,11,12,3,38,Pass
John Pillai,10-07-2005,754573,West Bengal,14,13,10,12,49,Pass
Raj Verma,24-01-2005,194199,Maharashtra,4,9,4,18,35,Pass
John Khan,30-03-2006,271365,Odisha,1,5,17,18,41,Pass
Ayaan D'Souza,02-08-2005,540245,Maharashtra,14,21,12,1,48,Pass
Krishna Verma,03-10-2005,277747,Maharashtra,1,0,16,16,33,Pass
Aarav Singh,02-05-2005,593408,Uttar Pradesh,0,4,24,5,33,Pass
Harjeet Sharma,15-03-2006,223240,West Bengal,3,13,22,24,62,Pass
Rohan Sharma,25-02-2005,804693,Bihar,15,10,24,9,58,Pass
Rohan Singh,23-05-2005,666855,Tamil Nadu,12,21,15,21,69,Pass
Aditya Pillai,20-12-2004,798309,Maharashtra,10,13,19,3,45,Pass
Zaid Sharma,21-01-2006,619850,Jharkhand,1,6,8,7,22,Pass
Aarav Singh,25-04-2006,256726,Haryana,14,5,4,18,41,Pass
Vivaan Singh,20-06-2005,224966,Uttar Pradesh,11,4,11,8,34,Pass
Krishna Fernandes,01-03-2006,624242,Haryana,20,4,16,23,63,Pass
Aryan Khan,22-03-2005,690150,Madhya Pradesh,15,21,3,4,43,Pass
Sukhwinder Reddy,04-10-2005,872504,Uttar Pradesh,6,8,20,13,47,Pass
Gurpreet D'Souza,17-04-2006,565180,Maharashtra,21,10,0,18,49,Pass
Raj Khan,06-10-2005,678995,Uttar Pradesh,17,10,24,17,68,Pass
Zaid D'Souza,12-03-2006,455238,Tamil Nadu,24,8,6,19,57,Pass
Rohan Reddy,22-05-2005,231253,Maharashtra,15,10,23,3,51,Pass
Aditya Pillai,30-11-2005,731644,Jammu & Kashmir + Ladakh,1,13,16,19,49,Pass
John D'Souza,13-04-2006,453324,Uttar Pradesh,12,1,0,19,32,Pass
Vivaan Sharma,26-01-2005,146790,Kerala,2,21,7,11,41,Fail
Vivaan Sharma,30-04-2005,385319,Telangana,18,24,19,3,64,Pass
Krishna Verma,19-10-2005,186996,Uttar Pradesh,8,17,19,19,63,Pass
Aryan Chopra,15-12-2004,468678,Karnataka,14,19,21,20,74,Fail
Krishna D'Souza,31-12-2004,126877,Uttar Pradesh,20,12,15,12,59,Pass
Krishna Singh,09-12-2004,674235,Rajasthan,19,24,4,2,49,Pass
Gurpreet Fernandes,07-11-2005,405769,Maharashtra,5,12,13,3,33,Pass
Vivaan Pillai,08-12-2005,639790,Gujarat,0,20,20,23,63,Fail
Harjeet Singh,11-12-2004,228677,Punjab,8,1,19,4,32,Pass
Rohan Verma,15-01-2005,963586,Maharashtra,8,11,15,3,37,Pass
Aditya D'Souza,21-02-2005,130282,Uttar Pradesh,9,21,10,5,45,Pass
Raj Chopra,23-09-2005,300016,Bihar,7,14,2,19,42,Pass
Aryan Chopra,23-04-2005,815396,Odisha,24,2,19,11,56,Pass
Aarav Fernandes,09-02-2005,261806,Kerala,23,4,4,19,50,Fail
Yash Chopra,12-03-2006,460806,Bihar,17,12,18,7,54,Pass
Ishaan Reddy,13-09-2005,411939,Tamil Nadu,20,6,4,18,48,Pass
John Khan,14-02-2005,130937,Jharkhand,18,4,19,17,58,Pass
John Chopra,21-03-2006,291448,Rajasthan,7,2,2,19,30,Pass
Kunal Mehta,16-03-2006,178122,Andhra Pradesh,21,1,15,8,45,Pass
Balbir D'Souza,02-10-2005,983089,Bihar,22,11,6,13,52,Pass
Kunal Reddy,19-12-2004,737066,Rajasthan,15,7,16,1,39,Pass
Balbir Fernandes,15-03-2006,475246,Rajasthan,14,8,24,7,53,Pass
Balbir Chopra,25-11-2005,334067,Bihar,13,16,23,10,62,Pass
Harjeet Verma,06-04-2006,448940,Madhya Pradesh,12,0,0,21,33,Pass
Yash Fernandes,02-10-2005,512631,Maharashtra,1,16,18,9,44,Pass
Ishaan Singh,19-04-2006,966596,Tamil Nadu,5,18,13,24,60,Pass
Aryan Verma,19-07-2005,975937,Uttar Pradesh,0,24,19,18,61,Pass
Krishna Mehta,29-12-2004,151348,Bihar,13,20,22,17,72,Pass
Aarav Chopra,05-10-2005,205867,Rajasthan,22,0,1,7,30,Pass
Harjeet Mehta,20-11-2004,544060,Kerala,10,10,1,0,21,Fail
Aarav Chopra,15-11-2005,348719,Uttar Pradesh,21,13,22,11,67,Pass
Vivaan Khan,23-05-2005,930715,Bihar,16,24,3,11,54,Pass
Yash Verma,10-05-2005,281074,Haryana,22,12,22,23,79,Pass
Manpreet Mehta,23-05-2005,446139,Telangana,7,16,23,20,66,Pass
Kunal Pillai,26-12-2004,622202,Uttar Pradesh,8,23,8,0,39,Pass
Aditya Sharma,29-12-2004,634656,Rajasthan,4,2,18,10,34,Pass
Yash Pillai,27-12-2005,246126,Uttar Pradesh,18,0,3,22,43,Pass
Manpreet Verma,03-02-2005,363769,Manipur,7,7,4,17,35,Pass
Paul Mehta,03-01-2006,960511,Bihar,14,13,4,14,45,Pass
Raj Mehta,30-01-2005,241118,Punjab,14,8,0,4,26,Pass
Gurpreet Reddy,04-01-2006,612849,Bihar,5,24,9,19,57,Pass
Aryan Khan,29-07-2005,668435,Rajasthan,14,17,15,13,59,Pass
Yash Reddy,23-02-2006,176365,Telangana,1,5,21,13,40,Pass
Raj Fernandes,10-10-2005,705905,Meghalaya,0,17,0,6,23,Pass
Aditya Reddy,25-10-2005,776914,West Bengal,7,17,5,21,50,Pass
Krishna Fernandes,10-02-2005,158901,Uttar Pradesh,20,11,16,15,62,Pass
Aryan Chopra,24-01-2005,982509,Madhya Pradesh,3,5,15,24,47,Pass
Kunal Khan,07-12-2004,213604,Uttar Pradesh,11,5,20,9,45,Pass
Manpreet Reddy,07-11-2005,209548,Rajasthan,8,17,12,15,52,Pass
Paul Fernandes,11-12-2005,984311,Madhya Pradesh,18,13,2,5,38,Pass
Zaid Sharma,16-03-2005,961898,Karnataka,1,0,15,21,37,Pass
Peter Reddy,23-12-2005,813937,Bihar,13,1,9,9,32,Pass
Paul Sharma,05-09-2005,132854,Punjab,5,19,11,1,36,Pass
Aryan Mehta,09-05-2006,762075,Jharkhand,14,13,0,23,50,Pass
Vivaan Mehta,02-12-2004,729442,Telangana,23,24,14,3,64,Pass
Ishaan Fernandes,08-02-2005,667397,Odisha,20,7,3,10,40,Pass
Raj D'Souza,22-11-2005,752029,Gujarat,24,15,13,14,66,Fail
Aarav Pillai,10-12-2005,481006,Rajasthan,8,11,15,20,54,Pass
David D'Souza,19-05-2005,619592,Rajasthan,14,14,1,23,52,Pass
Ishaan D'Souza,08-10-2005,677771,Madhya Pradesh,5,4,11,9,29,Pass
Gurpreet Chopra,02-08-2005,687416,Maharashtra,17,19,10,3,49,Pass
Balbir Fernandes,06-02-2006,289035,West Bengal,3,1,16,2,22,Pass
Krishna Chopra,24-02-2005,175580,Maharashtra,17,4,20,3,44,Pass
Gurpreet Khan,25-03-2006,764905,Punjab,22,18,14,15,69,Pass
Raj Verma,23-08-2005,388948,Andhra Pradesh,20,21,16,21,78,Pass
Harjeet Reddy,06-11-2005,831756,Kerala,3,7,1,16,27,Fail
Yash Chopra,19-04-2005,582813,Haryana,20,12,19,13,64,Pass
Yash D'Souza,28-02-2006,563033,Uttar Pradesh,13,12,5,2,32,Pass
Manpreet Chopra,04-01-2005,941322,Himachal Pradesh,3,19,23,4,49,Pass
David Mehta,27-02-2005,946334,Tripura,18,1,17,21,57,Pass
Aryan Sharma,19-07-2005,369042,Bihar,1,16,13,12,42,Pass
Manpreet Reddy,12-10-2005,777439,Chhattisgarh,11,14,4,0,29,Pass
Raj D'Souza,07-05-2005,575034,Odisha,8,23,18,22,71,Pass
Raj Fernandes,18-01-2005,213429,Uttar Pradesh,5,4,20,14,43,Pass
Manpreet Singh,24-05-2005,270519,Chhattisgarh,17,15,18,4,54,Pass
Mathew Reddy,01-10-2005,660160,Gujarat,10,21,0,20,51,Fail
Krishna Pillai,31-01-2005,759296,Tamil Nadu,9,11,13,15,48,Pass
Yash Khan,04-08-2005,622697,Uttar Pradesh,24,11,5,19,59,Pass
Aarav Sharma,08-03-2005,308864,Rajasthan,15,3,21,6,45,Pass
Aarav Sharma,11-03-2005,637790,Bihar,4,15,2,18,39,Pass
David Mehta,10-01-2006,175559,West Bengal,20,1,24,2,47,Pass
Aryan Pillai,29-11-2005,523831,Rajasthan,16,24,20,3,63,Pass
Harjeet Chopra,07-03-2006,631526,Punjab,15,10,4,13,42,Pass
Sukhwinder D'Souza,09-11-2005,205818,Tamil Nadu,23,10,23,5,61,Pass
Aryan Verma,02-07-2005,499366,Haryana,12,8,13,23,56,Pass
Aarav Mehta,08-04-2005,239467,Tamil Nadu,6,0,10,6,22,Pass
Zaid Mehta,08-05-2005,629265,Jharkhand,2,15,3,7,27,Pass
Aryan Pillai,23-03-2005,700376,Madhya Pradesh,5,8,3,20,36,Pass
Ayaan Verma,03-06-2005,531990,Punjab,12,2,3,12,29,Pass
Krishna Chopra,01-07-2005,984545,Jammu & Kashmir + Ladakh,2,4,23,24,53,Pass
Krishna Verma,19-02-2005,418380,Himachal Pradesh,6,15,5,5,31,Pass
Balbir Reddy,30-04-2006,234232,West Bengal,7,20,5,11,43,Pass
Vivaan Reddy,13-06-2005,987469,Chhattisgarh,8,3,11,7,29,Pass
Aryan Fernandes,29-08-2005,531311,Telangana,19,13,12,23,67,Fail
Yash Sharma,11-12-2005,647372,Andhra Pradesh,17,13,21,2,53,Pass
Rohan Pillai,17-10-2005,791455,Delhi,5,12,19,13,49,Pass
Aarav Verma,22-08-2005,556246,Delhi,9,3,8,17,37,Pass
Ishaan Sharma,09-04-2005,599339,Andhra Pradesh,18,2,18,13,51,Pass
Rohan Pillai,26-05-2005,826798,Jammu & Kashmir + Ladakh,23,14,15,7,59,Pass
Paul Fernandes,01-08-2005,292848,Himachal Pradesh,21,4,4,5,34,Pass
Kunal Verma,26-03-2005,996325,Uttar Pradesh,20,0,1,7,28,Pass
Kunal Fernandes,08-04-2005,550592,Maharashtra,12,11,20,3,46,Pass
Ishaan Singh,19-02-2006,544950,Arunachal Pradesh,5,3,3,17,28,Pass
John Khan,08-05-2006,945489,Maharashtra,20,24,2,1,47,Pass
David Chopra,13-07-2005,536823,Assam,18,16,5,19,58,Pass
Harjeet Sharma,30-01-2006,498616,Telangana,12,5,23,3,43,Pass
Ishaan Mehta,27-07-2005,566014,Tamil Nadu,22,18,23,10,73,Pass
Kunal Khan,07-08-2005,449729,Tamil Nadu,8,5,11,1,25,Pass
Raj Singh,24-10-2005,104076,Jharkhand,13,17,17,6,53,Pass
Aditya Verma,26-06-2005,989927,Jharkhand,1,3,8,8,20,Pass
Ishaan Fernandes,29-11-2005,425280,Chhattisgarh,23,24,20,3,70,Pass
Ishaan Mehta,28-08-2005,737664,Rajasthan,10,23,13,3,49,Pass
Rohan Fernandes,04-02-2005,283667,Madhya Pradesh,6,13,15,4,38,Pass
Aryan Verma,07-01-2006,811106,Tamil Nadu,10,3,15,1,29,Pass
Vivaan Chopra,19-12-2005,220747,Tamil Nadu,15,11,9,5,40,Pass
Gurpreet Khan,24-03-2006,304919,Rajasthan,18,7,3,9,37,Pass
Aditya Sharma,26-01-2006,859819,Mizoram,4,23,19,15,61,Fail
Raj Sharma,22-10-2005,205283,Madhya Pradesh,19,6,3,12,40,Pass
Yash Verma,04-06-2005,910862,Madhya Pradesh,5,8,13,1,27,Pass
Manpreet Khan,06-09-2005,848713,Haryana,5,12,24,0,41,Pass
Aarav Fernandes,30-10-2005,210502,Rajasthan,14,22,15,13,64,Pass
Aditya Chopra,06-07-2005,514332,Maharashtra,22,17,2,2,43,Pass
Aryan Verma,01-08-2005,814346,Madhya Pradesh,17,2,13,4,36,Pass
Vivaan Chopra,30-04-2005,116441,Maharashtra,13,22,22,3,60,Pass
Krishna Reddy,19-12-2004,875469,Punjab,16,12,24,21,73,Pass
Aarav Chopra,08-11-2005,905890,Haryana,6,6,5,24,41,Pass
Mathew Sharma,04-05-2006,180946,Bihar,24,20,17,18,79,Pass
David Khan,21-01-2005,271795,Gujarat,1,1,3,4,9,Fail
Rohan Mehta,17-01-2005,896514,Haryana,19,8,9,20,56,Pass
Kunal Reddy,04-10-2005,194082,Haryana,9,17,6,16,48,Pass
Rohan D'Souza,30-12-2004,244484,Uttar Pradesh,13,16,11,20,60,Pass
Krishna Mehta,19-11-2004,662145,Himachal Pradesh,10,2,3,22,37,Pass
Krishna Mehta,13-04-2005,277575,Chhattisgarh,16,15,3,20,54,Pass
Rehan Verma,05-01-2006,781918,Assam,22,22,17,4,65,Pass
Peter Khan,09-11-2005,460449,Gujarat,9,4,14,15,42,Fail
Harjeet Khan,21-01-2006,462111,Nagaland,24,0,4,6,34,Pass
Aarav Fernandes,04-06-2005,290076,Telangana,4,16,11,9,40,Pass
Vivaan Pillai,09-11-2005,567846,Uttar Pradesh,23,1,0,5,29,Pass
Rohan Mehta,22-02-2005,419296,Rajasthan,19,23,8,15,65,Pass
Gurpreet Pillai,09-12-2005,835646,Andhra Pradesh,14,11,2,17,44,Pass
Kunal Verma,08-09-2005,281330,West Bengal,3,9,19,13,44,Pass
Manpreet Pillai,23-02-2005,214490,Uttar Pradesh,21,4,15,19,59,Pass
Balbir Chopra,02-11-2005,247843,Uttar Pradesh,22,0,14,2,38,Pass
Sukhwinder D'Souza,09-11-2005,703883,Himachal Pradesh,2,14,23,24,63,Pass
Rohan D'Souza,21-09-2005,146868,Rajasthan,2,19,10,6,37,Pass
Krishna Pillai,13-11-2004,898094,Bihar,11,0,24,6,41,Pass
Yash Pillai,07-04-2006,607822,Uttar Pradesh,0,4,18,20,42,Pass
Paul D'Souza,24-04-2006,101537,Punjab,3,11,15,5,34,Pass
Vivaan Chopra,18-03-2006,137918,Uttar Pradesh,4,20,0,18,42,Pass
Aditya Khan,04-01-2005,349942,Odisha,14,12,7,21,54,Pass
Ishaan Reddy,28-04-2005,314501,Bihar,20,18,6,23,67,Pass
Vivaan Reddy,10-12-2004,498511,Maharashtra,15,6,21,3,45,Pass
Mathew Sharma,24-07-2005,211025,West Bengal,3,15,22,3,43,Pass
John Pillai,30-12-2004,794726,Tamil Nadu,3,14,17,4,38,Pass
Paul Mehta,29-06-2005,896456,Rajasthan,19,19,0,2,40,Pass
Peter D'Souza,11-03-2006,390064,Bihar,8,16,11,0,35,Pass
Kunal Sharma,10-04-2005,600792,Tripura,16,6,14,21,57,Pass
Ishaan Chopra,26-11-2004,218701,Gujarat,24,8,20,6,58,Fail
David D'Souza,01-02-2006,596942,Rajasthan,13,12,15,8,48,Pass
David Singh,11-01-2006,168188,Manipur,2,6,12,18,38,Pass
Rohan Reddy,22-04-2006,850005,Uttar Pradesh,22,2,20,5,49,Pass
Manpreet Mehta,15-01-2005,669152,Bihar,24,17,21,16,78,Pass
Aditya Fernandes,11-04-2006,457147,Madhya Pradesh,4,15,1,8,28,Pass
Aditya Reddy,20-07-2005,525555,Punjab,24,3,10,15,52,Pass
Raj D'Souza,13-02-2005,838558,Maharashtra,21,2,9,3,35,Pass
Aditya Pillai,31-07-2005,366457,Madhya Pradesh,1,4,17,1,23,Pass
Aarav Sharma,29-03-2005,511812,Rajasthan,17,18,11,5,51,Pass
Vivaan Mehta,21-08-2005,429255,Jharkhand,23,12,24,20,79,Fail
Krishna D'Souza,10-04-2006,682752,Rajasthan,8,13,10,3,34,Pass
Harjeet Khan,24-05-2005,126828,West Bengal,9,19,3,13,44,Pass
Aarav Mehta,25-03-2005,192631,Kerala,17,24,22,17,80,Fail
Ishaan Chopra,27-07-2005,829275,Bihar,0,24,11,19,54,Pass
Aarav Reddy,28-01-2006,873113,Telangana,18,3,23,22,66,Pass
Balbir Verma,20-11-2005,838613,Odisha,18,16,23,1,58,Pass
Paul Fernandes,03-04-2006,558537,Madhya Pradesh,24,7,3,19,53,Pass
Harjeet Khan,04-03-2006,295368,Maharashtra,2,15,0,15,32,Pass
Aarav Sharma,08-12-2005,841951,Punjab,3,13,22,20,58,Pass
Kunal Singh,22-04-2005,236546,Bihar,13,6,22,5,46,Pass
Yash Reddy,19-06-2005,792814,Madhya Pradesh,0,8,15,14,37,Pass
Krishna Chopra,20-08-2005,773718,Himachal Pradesh,14,4,4,13,35,Pass
Peter Sharma,01-08-2005,895214,Andhra Pradesh,6,0,15,21,42,Pass
Rohan Singh,02-03-2006,775098,Maharashtra,22,12,23,3,60,Pass
Imran Mehta,02-03-2006,215129,Madhya Pradesh,23,23,3,15,64,Pass
John Pillai,28-03-2005,323892,Punjab,4,15,13,19,51,Pass
Kunal Singh,31-03-2005,156212,Gujarat,10,10,12,7,39,Fail
Harjeet Pillai,19-05-2005,104999,Uttar Pradesh,21,10,15,1,47,Pass
Raj Reddy,02-04-2005,687244,Kerala,17,11,15,17,60,Fail
Harjeet D'Souza,05-12-2004,724937,Bihar,15,5,6,15,41,Pass
Paul Singh,31-07-2005,441593,Rajasthan,16,3,18,19,56,Pass
Rehan Reddy,03-03-2006,327425,Punjab,14,4,16,21,55,Pass
Aarav Reddy,16-02-2005,996928,Bihar,17,9,5,5,36,Pass
Raj Mehta,08-09-2005,416656,Madhya Pradesh,0,10,11,18,39,Pass
Raj Verma,31-12-2005,576640,Rajasthan,14,13,18,22,67,Pass
Aditya Chopra,05-04-2005,507518,Karnataka,0,17,15,18,50,Pass
Paul Mehta,11-03-2005,727993,Madhya Pradesh,6,20,3,23,52,Pass
Krishna Khan,28-08-2005,426242,Madhya Pradesh,18,18,11,3,50,Pass
Rohan Verma,20-10-2005,182217,Uttar Pradesh,24,4,14,6,48,Pass
Aditya Fernandes,08-05-2006,911781,Rajasthan,6,11,16,24,57,Pass
Harjeet D'Souza,29-11-2004,582586,Maharashtra,10,21,21,3,55,Pass
Kunal Reddy,11-06-2005,315446,Kerala,18,3,11,5,37,Fail
Aryan Verma,17-11-2005,554441,Mizoram,8,13,9,18,48,Fail
Ishaan Chopra,26-12-2004,760748,Punjab,19,21,4,15,59,Pass
Ayaan Khan,28-11-2005,833215,Bihar,24,0,16,22,62,Pass
Vivaan Sharma,16-03-2005,708342,Rajasthan,4,8,19,4,35,Pass
John Mehta,17-03-2005,383752,Bihar,15,7,14,2,38,Pass
Farhan Fernandes,22-12-2005,907839,Bihar,1,2,17,6,26,Pass
Rohan Singh,15-03-2005,908987,Uttar Pradesh,0,11,1,23,35,Pass
Sukhwinder Mehta,08-03-2005,655348,Punjab,15,13,16,24,68,Pass
Raj Pillai,02-12-2004,579739,Uttar Pradesh,19,21,9,7,56,Pass
Gurpreet Fernandes,06-02-2005,830326,Madhya Pradesh,2,13,20,16,51,Pass
Aryan Pillai,22-02-2006,529976,Punjab,16,5,0,10,31,Pass
Rohan Fernandes,08-05-2005,642296,Karnataka,16,20,3,13,52,Pass
Krishna Fernandes,13-08-2005,533241,West Bengal,11,0,18,7,36,Pass
Vivaan Verma,27-11-2005,205028,Maharashtra,11,23,12,3,49,Pass
Gurpreet Khan,11-08-2005,579431,Haryana,4,11,3,18,36,Pass
Mathew Verma,20-03-2005,985803,Andhra Pradesh,15,0,9,15,39,Pass
Krishna Reddy,09-02-2006,711715,Uttar Pradesh,4,10,10,12,36,Pass
Gurpreet Reddy,10-04-2006,960968,Bihar,2,19,7,23,51,Pass
Krishna Khan,21-01-2005,249337,Karnataka,1,9,17,6,33,Pass
Vivaan Mehta,12-01-2006,196701,Gujarat,22,12,20,10,64,Fail
Ayaan D'Souza,17-04-2005,337725,Karnataka,8,5,18,1,32,Pass
Rohan Verma,11-03-2005,678669,Puducherry,11,4,8,6,29,Pass
Rehan Fernandes,27-10-2005,644546,Tripura,12,22,4,9,47,Pass
Vivaan Reddy,07-12-2004,512557,Bihar,14,2,23,19,58,Pass
Kunal Sharma,24-05-2005,690668,Uttar Pradesh,15,15,11,24,65,Pass
Vivaan Khan,02-02-2005,491956,Maharashtra,13,23,15,3,54,Pass
Balbir Fernandes,13-06-2005,723122,Madhya Pradesh,18,1,3,14,36,Pass
Gurpreet Khan,12-12-2005,996310,Punjab,3,11,11,11,36,Pass
Manpreet Chopra,12-04-2005,940570,Gujarat,16,7,0,9,32,Fail
Aryan Khan,07-05-2006,909574,Bihar,2,16,24,10,52,Pass
Rohan Singh,09-02-2006,586181,Chhattisgarh,9,19,17,19,64,Pass
Rohan Singh,20-08-2005,948299,Odisha,7,10,0,21,38,Pass
Balbir Sharma,01-01-2005,158413,Maharashtra,9,6,4,8,27,Pass
Kunal D'Souza,02-02-2006,343971,Uttar Pradesh,2,24,17,6,49,Pass
Rohan Sharma,13-04-2005,327327,Uttar Pradesh,19,23,13,11,66,Pass
Manpreet Chopra,02-09-2005,552989,Punjab,15,2,3,23,43,Pass
Sukhwinder Sharma,11-06-2005,611999,Haryana,17,17,22,16,72,Pass
Aryan Mehta,22-06-2005,566071,Maharashtra,12,18,19,3,52,Pass
Manpreet D'Souza,08-05-2005,981713,Bihar,4,20,22,7,53,Pass
Balbir Singh,24-11-2005,627282,Uttarakhand,10,13,14,6,43,Pass
Aryan Verma,05-04-2006,445776,Uttar Pradesh,3,18,22,19,62,Pass
Kunal Reddy,02-03-2005,967121,Haryana,12,1,7,21,41,Pass
Gurpreet Mehta,13-04-2006,713781,Madhya Pradesh,12,5,24,11,52,Pass
Aarav Mehta,01-02-2006,906301,Haryana,1,10,22,5,38,Pass
Paul Khan,01-12-2005,446615,Andhra Pradesh,8,21,0,1,30,Pass
John Singh,12-11-2005,235750,Madhya Pradesh,3,10,24,12,49,Pass
Vivaan Reddy,09-12-2005,979757,Gujarat,15,3,8,1,27,Fail
Aditya Mehta,17-03-2005,840169,Madhya Pradesh,17,5,23,8,53,Pass
Kunal Pillai,17-07-2005,553343,Himachal Pradesh,23,14,2,19,58,Pass
Manpreet Fernandes,24-12-2005,881708,Uttar Pradesh,1,0,20,16,37,Pass
Harjeet Pillai,05-12-2004,540244,Tamil Nadu,4,5,23,19,51,Pass
Rohan Mehta,23-04-2006,171778,Gujarat,22,4,6,5,37,Fail
Vivaan Mehta,31-12-2004,626197,Maharashtra,15,15,3,3,36,Pass
Aryan Chopra,03-02-2005,814014,Madhya Pradesh,2,0,15,21,38,Pass
Aarav Pillai,14-03-2006,860644,Assam,22,18,14,10,64,Pass
Sukhwinder Verma,13-04-2005,472259,Gujarat,24,9,15,8,56,Fail
Aditya D'Souza,17-02-2006,965550,Andhra Pradesh,7,11,18,13,49,Pass
Yash Mehta,04-04-2005,435896,Chhattisgarh,14,0,24,20,58,Pass
Aarav Mehta,25-02-2005,402088,Maharashtra,9,15,17,3,44,Pass
Peter Singh,19-11-2005,948535,Chhattisgarh,22,15,11,22,70,Pass
Ishaan Sharma,16-04-2005,598059,Tamil Nadu,16,4,18,21,59,Pass
Rohan Pillai,26-05-2005,446752,Uttar Pradesh,2,2,5,23,32,Pass
Aditya Verma,05-03-2006,298502,Telangana,12,15,12,16,55,Fail
Kunal D'Souza,24-08-2005,655224,Uttarakhand,0,11,4,18,33,Pass
Raj Mehta,18-04-2006,219212,Bihar,20,5,14,0,39,Pass
Aditya Chopra,07-06-2005,441389,Jammu & Kashmir + Ladakh,7,7,7,7,28,Pass
Raj Verma,22-10-2005,924163,Maharashtra,23,13,14,3,53,Pass
Kunal Singh,28-05-2005,891115,Punjab,24,7,13,7,51,Pass
Vivaan Khan,02-05-2005,506564,West Bengal,3,16,22,20,61,Pass
Aryan Sharma,11-02-2005,497529,Uttar Pradesh,15,17,12,13,57,Pass
John Fernandes,31-12-2004,701626,Tamil Nadu,23,16,4,24,67,Pass
Gurpreet Mehta,29-01-2005,150459,Rajasthan,6,18,3,24,51,Pass
Vivaan Singh,13-12-2004,902323,Tamil Nadu,18,14,24,11,67,Pass
Ayaan Reddy,18-05-2005,288416,Madhya Pradesh,13,4,5,21,43,Pass
Aryan Khan,14-11-2004,829047,Uttarakhand,11,14,13,12,50,Pass
Rohan Sharma,13-12-2004,245539,Chhattisgarh,16,9,19,16,60,Pass
Ayaan Fernandes,09-07-2005,647061,Maharashtra,15,21,13,3,52,Pass
Ishaan Singh,01-09-2005,922281,Andhra Pradesh,8,18,20,24,70,Pass
John Chopra,01-11-2005,940034,Assam,19,22,8,22,71,Pass
Rohan Khan,19-04-2005,840021,Haryana,21,18,18,24,81,Pass
Kunal Pillai,25-11-2004,768901,Tamil Nadu,3,19,8,14,44,Pass
Ishaan Fernandes,08-03-2006,630538,Uttar Pradesh,15,10,20,22,67,Pass
Aryan Chopra,31-01-2006,636186,Kerala,24,5,4,6,39,Fail
Raj D'Souza,13-07-2005,989876,Uttar Pradesh,4,7,4,17,32,Pass
Harjeet Mehta,10-01-2005,166061,Maharashtra,3,17,19,7,46,Pass
Rohan Verma,30-01-2006,121182,Andhra Pradesh,14,5,13,17,49,Pass
Gurpreet D'Souza,27-03-2005,201650,West Bengal,3,16,14,13,46,Pass
Manpreet D'Souza,12-02-2005,496386,Goa,0,14,21,22,57,Fail
Ishaan Khan,31-01-2005,703788,Uttar Pradesh,2,23,8,14,47,Pass
Aarav D'Souza,15-01-2005,510328,Assam,8,6,6,22,42,Pass
Aarav Pillai,20-03-2006,651138,Bihar,23,22,8,5,58,Pass
Manpreet D'Souza,10-12-2004,355653,Meghalaya,16,10,21,10,57,Pass
David Reddy,22-01-2005,587441,Jharkhand,17,22,0,21,60,Pass
Mathew Fernandes,07-01-2005,485619,Uttar Pradesh,17,9,9,22,57,Pass
Mathew D'Souza,02-07-2005,390151,Haryana,11,7,22,24,64,Pass
Aryan Singh,15-01-2006,286909,Rajasthan,24,13,5,22,64,Pass
Rohan Khan,17-01-2006,795192,Maharashtra,16,16,4,11,47,Pass
Raj Reddy,23-09-2005,517058,Himachal Pradesh,8,23,9,0,40,Pass
Aryan Mehta,06-09-2005,540827,Tamil Nadu,23,5,12,12,52,Pass
Vivaan D'Souza,01-03-2006,429623,Haryana,9,6,13,2,30,Pass
Aarav D'Souza,11-02-2005,445277,Jharkhand,8,11,2,12,33,Pass
Paul D'Souza,31-01-2006,733043,Uttar Pradesh,15,21,3,5,44,Pass
Kunal Pillai,05-03-2006,819373,Telangana,21,23,0,15,59,Pass
Kunal Fernandes,29-09-2005,736128,Tripura,20,17,9,12,58,Pass
Aditya Singh,16-11-2004,277903,Rajasthan,21,9,2,3,35,Pass
Manpreet Reddy,19-07-2005,422529,Maharashtra,16,17,2,3,38,Pass
Aarav Mehta,21-11-2004,516291,Uttar Pradesh,7,9,24,2,42,Pass
Aarav Reddy,28-02-2006,547548,Maharashtra,3,8,15,15,41,Pass
Peter Khan,13-11-2004,134098,Bihar,0,5,15,1,21,Pass
Rohan Verma,24-04-2006,425458,Gujarat,17,10,1,18,46,Fail
Gurpreet Chopra,09-04-2005,748298,Punjab,6,13,22,16,57,Pass
Rohan Khan,25-01-2005,806671,Madhya Pradesh,9,7,6,11,33,Pass
Yash Verma,18-05-2005,268016,West Bengal,3,5,10,24,42,Pass
Aditya Sharma,01-07-2005,989687,Bihar,3,16,21,6,46,Pass
Aditya Pillai,20-03-2005,253251,Gujarat,4,8,24,10,46,Fail
Aarav Reddy,08-02-2005,192801,Himachal Pradesh,20,4,17,12,53,Pass
Krishna Reddy,05-11-2005,265588,Himachal Pradesh,15,12,24,13,64,Pass
Krishna Mehta,18-11-2004,554020,Rajasthan,9,3,1,6,19,Pass
Paul Singh,02-11-2005,649576,Chhattisgarh,0,2,14,18,34,Pass
Farhan Reddy,12-11-2004,550844,Bihar,17,24,2,1,44,Pass
Aditya Pillai,10-04-2005,228728,Punjab,18,6,3,11,38,Pass
Aryan Verma,26-01-2006,615050,Rajasthan,11,24,10,24,69,Pass
Ishaan Reddy,20-11-2005,686113,Uttar Pradesh,2,22,17,24,65,Pass
Aarav Reddy,05-08-2005,634262,Rajasthan,13,4,16,22,55,Pass
Harjeet Verma,28-02-2005,430143,Gujarat,24,21,15,1,61,Fail
Ishaan Mehta,28-01-2005,338617,Rajasthan,17,5,3,16,41,Pass
Imran Mehta,29-05-2005,931067,Puducherry,6,6,5,7,24,Pass
Rohan Sharma,09-04-2006,921448,Uttar Pradesh,19,21,10,8,58,Pass
Aarav D'Souza,11-07-2005,736477,Rajasthan,20,14,6,16,56,Pass
Aryan Reddy,03-12-2004,717524,Punjab,16,15,3,6,40,Pass
Sukhwinder Fernandes,05-12-2004,746205,West Bengal,22,5,5,1,33,Pass
Mathew Chopra,04-04-2006,406982,Kerala,21,13,15,15,64,Fail
Harjeet Khan,29-01-2006,882875,Uttar Pradesh,13,12,5,9,39,Pass
Aarav Mehta,16-04-2005,677735,Madhya Pradesh,23,13,3,17,56,Pass
Raj D'Souza,15-02-2006,838220,Tamil Nadu,3,0,21,19,43,Pass
Ishaan Chopra,04-04-2005,348424,Uttar Pradesh,12,19,17,17,65,Pass
Zaid Chopra,09-07-2005,231481,Himachal Pradesh,13,8,19,23,63,Pass
Harjeet Reddy,24-12-2005,383426,Bihar,20,13,22,0,55,Pass
Vivaan Reddy,10-11-2005,116643,Bihar,3,6,18,1,28,Pass
Aditya Khan,18-04-2006,452389,Madhya Pradesh,21,23,3,20,67,Pass
Balbir Chopra,23-04-2005,846669,Odisha,16,7,3,21,47,Pass
Vivaan Sharma,07-04-2006,201282,Rajasthan,12,7,2,24,45,Pass
Ishaan Mehta,25-07-2005,894632,Rajasthan,12,20,19,24,75,Pass
Harjeet Pillai,22-10-2005,426643,Madhya Pradesh,6,22,3,23,54,Pass
Kunal Sharma,13-01-2006,390447,Rajasthan,17,4,8,16,45,Pass
Paul Sharma,19-02-2005,926648,Bihar,10,22,0,20,52,Pass
Raj Pillai,11-04-2006,661589,Chhattisgarh,20,6,10,0,36,Pass
Krishna Pillai,02-12-2005,933253,Haryana,5,3,19,23,50,Pass
Sukhwinder Verma,27-04-2005,270015,Manipur,4,9,21,22,56,Pass
Aditya Mehta,16-10-2005,791655,Madhya Pradesh,21,8,1,4,34,Pass
Raj Chopra,12-12-2004,678458,West Bengal,21,12,0,15,48,Pass
Vivaan Verma,19-02-2005,404524,West Bengal,1,23,19,6,49,Pass
Raj Fernandes,04-09-2005,195774,Rajasthan,17,10,14,3,44,Pass
Kunal Reddy,29-12-2004,449045,West Bengal,10,4,1,14,29,Pass
Kunal Chopra,11-04-2006,373392,Chhattisgarh,7,5,24,8,44,Pass
Ishaan Verma,10-01-2005,181351,Tamil Nadu,22,11,24,23,80,Pass
Rohan Reddy,26-11-2005,415950,Gujarat,13,19,16,11,59,Fail
Vivaan Khan,21-05-2005,961449,Maharashtra,18,14,10,3,45,Pass
Aarav Sharma,05-11-2005,111339,Jharkhand,8,12,1,11,32,Pass
Peter Reddy,12-11-2004,498645,West Bengal,3,13,6,24,46,Pass
Aryan Pillai,23-08-2005,265113,Tamil Nadu,16,4,5,18,43,Pass
Vivaan Singh,10-01-2006,699248,Uttar Pradesh,11,20,7,20,58,Pass
Rohan Pillai,03-12-2004,746650,Kerala,10,21,18,21,70,Fail
Krishna Khan,26-05-2005,611333,Rajasthan,17,8,9,15,49,Pass
Gurpreet Fernandes,06-04-2006,476773,Madhya Pradesh,15,18,1,5,39,Pass
Ishaan Fernandes,29-06-2005,319050,Maharashtra,0,11,3,19,33,Pass
Raj Pillai,02-01-2006,152098,Maharashtra,3,21,9,3,36,Pass
Kunal Fernandes,10-03-2006,234382,Gujarat,13,20,6,10,49,Fail
Zaid Reddy,16-11-2005,932287,Puducherry,10,6,6,6,28,Pass
Aarav Fernandes,07-03-2005,446782,Uttar Pradesh,6,4,0,9,19,Pass
Manpreet Verma,01-09-2005,573161,Haryana,18,24,4,3,49,Pass
Aryan Fernandes,02-03-2005,564425,Rajasthan,16,1,13,22,52,Pass
Manpreet Singh,18-05-2005,692167,Uttarakhand,14,15,2,9,40,Pass
Aryan Sharma,16-12-2005,322490,Bihar,24,1,3,18,46,Pass
Raj Singh,08-03-2005,239233,Telangana,5,17,15,10,47,Pass
Krishna Reddy,14-01-2006,781243,Uttar Pradesh,12,13,12,3,40,Pass
Ishaan Reddy,08-12-2005,362898,Tamil Nadu,10,17,17,21,65,Pass
Raj Sharma,11-03-2006,928110,Punjab,14,4,9,13,40,Pass
Sukhwinder Reddy,08-12-2004,157676,Maharashtra,14,6,19,0,39,Pass
Ishaan Sharma,21-11-2004,807202,Tamil Nadu,9,13,21,18,61,Pass
Aditya Fernandes,23-03-2006,891426,West Bengal,9,23,4,13,49,Pass
Aarav Chopra,22-04-2006,145233,Odisha,0,4,0,11,15,Pass
Harjeet Pillai,03-01-2006,717910,Bihar,4,9,18,17,48,Pass
Peter Singh,15-02-2006,995216,Maharashtra,7,8,21,3,39,Pass
Aditya Pillai,19-02-2005,433586,Bihar,10,9,20,9,48,Pass
Sukhwinder Chopra,22-02-2006,882089,Bihar,19,5,4,20,48,Pass
Yash Sharma,09-11-2004,866861,Madhya Pradesh,15,17,4,11,47,Pass
Gurpreet Singh,23-12-2004,721073,Telangana,5,19,9,21,54,Fail
Aditya Chopra,07-04-2006,648691,Bihar,3,8,17,1,29,Pass
John Mehta,19-02-2006,573692,Madhya Pradesh,10,7,0,19,36,Pass
Rohan Mehta,18-07-2005,746508,Telangana,3,14,4,0,21,Pass
Balbir D'Souza,17-10-2005,865282,Tamil Nadu,13,13,14,22,62,Pass
David D'Souza,11-06-2005,532974,Telangana,8,3,8,9,28,Pass
Raj Verma,03-05-2005,549647,Madhya Pradesh,6,22,14,12,54,Pass
Kunal D'Souza,21-04-2006,634340,Himachal Pradesh,18,3,7,10,38,Pass
Rohan Chopra,24-05-2005,850252,Odisha,10,23,7,22,62,Pass
Raj Mehta,25-05-2005,903815,Maharashtra,8,3,10,4,25,Pass
Yash Chopra,09-11-2005,935984,Maharashtra,24,15,5,3,47,Pass
Yash D'Souza,06-01-2006,310093,Karnataka,2,4,2,4,12,Pass
Raj Sharma,20-11-2004,484129,Telangana,24,13,7,19,63,Fail
Gurpreet Mehta,16-07-2005,803369,Maharashtra,6,8,0,1,15,Pass
Aryan Singh,23-11-2004,278028,Himachal Pradesh,17,4,12,17,50,Pass
Vivaan Pillai,27-11-2005,945513,Delhi,2,20,16,22,60,Pass
Aryan Sharma,26-03-2005,538912,Bihar,2,22,2,20,46,Pass
Peter Singh,13-09-2005,916582,Uttarakhand,4,14,10,7,35,Pass
Kunal Fernandes,08-01-2006,401383,Tamil Nadu,23,13,11,5,52,Pass
Krishna Fernandes,30-03-2005,989142,Tamil Nadu,24,6,19,6,55,Pass
Paul Singh,30-06-2005,306036,Haryana,7,13,5,9,34,Pass
Raj Chopra,08-04-2006,970202,Rajasthan,1,11,15,22,49,Pass
Krishna Reddy,04-04-2005,149526,Gujarat,24,9,10,17,60,Fail
Yash Khan,23-02-2006,826411,Bihar,14,23,24,14,75,Pass
Rohan Singh,23-12-2005,806608,Jharkhand,9,1,23,16,49,Pass
Aryan Fernandes,17-08-2005,480517,Uttar Pradesh,12,12,2,22,48,Pass
Kunal Singh,14-06-2005,116552,Tamil Nadu,17,23,13,22,75,Pass
Gurpreet Fernandes,12-12-2004,547854,Tamil Nadu,4,12,8,20,44,Pass
Mathew Mehta,13-07-2005,441786,Uttarakhand,4,4,2,5,15,Pass
Rohan Reddy,29-11-2005,272119,Karnataka,4,20,7,22,53,Pass
Krishna Reddy,17-12-2005,803761,Telangana,22,12,3,22,59,Pass
Gurpreet Mehta,19-09-2005,270797,Himachal Pradesh,22,13,24,13,72,Fail
Rohan Pillai,26-04-2005,763202,Punjab,22,3,21,15,61,Pass
Vivaan Pillai,14-01-2006,350515,Karnataka,9,17,16,6,48,Pass
Aditya Pillai,28-01-2006,926116,Telangana,17,8,5,1,31,Pass
Aryan Verma,26-04-2005,289938,Tamil Nadu,8,5,24,23,60,Pass
Krishna Fernandes,02-09-2005,408775,Rajasthan,12,4,23,6,45,Pass
Aryan Sharma,08-12-2004,769889,Uttarakhand,2,3,0,4,9,Pass
Krishna Reddy,02-04-2005,747596,West Bengal,3,22,19,9,53,Pass
Ishaan D'Souza,09-05-2005,425564,Bihar,14,21,21,13,69,Pass
Kunal Chopra,02-03-2006,685765,Uttar Pradesh,23,0,2,8,33,Pass
Aryan Singh,30-11-2005,353485,Punjab,11,12,24,18,65,Pass
Krishna Pillai,04-10-2005,642049,Rajasthan,22,9,10,6,47,Pass
Aryan Singh,27-12-2004,869402,Andhra Pradesh,7,13,5,12,37,Pass
John Khan,12-06-2005,614505,Haryana,11,14,12,20,57,Pass
Ishaan Khan,18-02-2005,187079,Madhya Pradesh,13,10,20,5,48,Pass
Aditya Singh,12-11-2005,612143,Chhattisgarh,24,19,13,8,64,Pass
Aditya Sharma,07-03-2005,653925,Rajasthan,7,6,15,23,51,Pass
Aryan D'Souza,10-01-2005,902021,Andhra Pradesh,19,10,14,10,53,Pass
Harjeet Reddy,29-11-2004,209643,Punjab,4,23,5,1,33,Pass
Ishaan Verma,12-06-2005,588801,Rajasthan,0,4,6,13,23,Pass
Kunal Chopra,17-11-2005,501317,Uttar Pradesh,20,7,24,20,71,Pass
Mathew Pillai,09-06-2005,395544,Uttar Pradesh,7,4,22,22,55,Pass
Aryan Verma,01-04-2006,794390,Haryana,24,19,12,14,69,Pass
John Khan,11-11-2005,413684,Gujarat,9,11,18,3,41,Fail
Krishna Pillai,07-04-2005,949365,West Bengal,3,17,24,18,62,Pass
Balbir Khan,09-11-2004,727759,Bihar,9,23,22,6,60,Pass
Manpreet Fernandes,14-01-2005,429085,Maharashtra,6,15,16,11,48,Pass
Gurpreet D'Souza,12-04-2006,722631,Tamil Nadu,21,5,18,5,49,Pass
Aarav Reddy,04-04-2006,797978,Madhya Pradesh,6,19,11,13,49,Pass
Manpreet Fernandes,07-02-2006,623816,Kerala,1,24,0,13,38,Fail
Aditya Pillai,15-03-2006,945948,Himachal Pradesh,8,3,24,7,42,Pass
Rohan Reddy,13-03-2006,331172,Tamil Nadu,1,10,16,22,49,Pass
Aryan Mehta,23-02-2006,960685,Himachal Pradesh,2,19,17,13,51,Pass
Manpreet Sharma,17-09-2005,576064,Madhya Pradesh,19,15,3,22,59,Pass
Ishaan Pillai,11-03-2005,646299,Maharashtra,18,6,4,1,29,Pass
Ishaan Mehta,10-03-2005,769153,Madhya Pradesh,23,23,3,3,52,Pass
Krishna Singh,21-02-2006,851919,Uttar Pradesh,11,15,24,13,63,Pass
Peter D'Souza,05-12-2004,338702,Odisha,17,12,0,23,52,Pass
Aarav Pillai,13-09-2005,426270,Bihar,4,17,19,8,48,Pass
Aryan Mehta,07-05-2005,811077,Rajasthan,23,7,24,4,58,Pass
Krishna Khan,03-05-2005,597887,Andhra Pradesh,11,3,4,24,42,Pass
David Reddy,27-02-2006,867051,Haryana,4,7,4,0,15,Pass
Vivaan Sharma,13-08-2005,527358,Uttar Pradesh,8,7,8,21,44,Pass
Mathew Chopra,28-11-2004,129173,Rajasthan,10,18,13,12,53,Pass
Gurpreet Reddy,09-07-2005,401226,Madhya Pradesh,0,1,19,11,31,Pass
David Mehta,05-11-2005,573984,Himachal Pradesh,6,20,8,3,37,Pass
Harjeet Reddy,28-12-2004,496508,Maharashtra,1,22,11,3,37,Pass
Ayaan Pillai,12-08-2005,525510,Andhra Pradesh,20,2,18,10,50,Pass
Sukhwinder D'Souza,11-11-2004,239395,Madhya Pradesh,12,0,21,10,43,Pass
Sukhwinder Khan,26-09-2005,808525,Tamil Nadu,11,16,13,9,49,Pass
Manpreet Khan,31-01-2005,357470,Telangana,4,4,21,3,32,Pass
Aarav Reddy,22-11-2004,538632,Himachal Pradesh,20,1,24,19,64,Pass
David Singh,20-09-2005,328212,Andhra Pradesh,11,4,5,4,24,Pass
John Reddy,12-10-2005,304692,Haryana,12,6,6,19,43,Pass
Raj Chopra,05-12-2004,479344,Uttar Pradesh,7,12,24,2,45,Pass
Ayaan Fernandes,21-03-2006,299656,Tamil Nadu,18,16,3,17,54,Pass
Aryan Pillai,11-03-2006,721650,Assam,18,3,13,9,43,Pass
Krishna Sharma,22-02-2006,381681,Andhra Pradesh,13,21,5,24,63,Pass
John Mehta,26-03-2006,286010,Bihar,2,23,9,6,40,Pass
Paul Chopra,28-12-2005,537231,Delhi,1,0,12,5,18,Pass
John Reddy,24-02-2005,315459,Rajasthan,22,3,22,13,60,Pass
Yash Fernandes,21-08-2005,260294,Madhya Pradesh,3,2,15,14,34,Pass
Balbir D'Souza,12-03-2005,541628,Rajasthan,7,7,4,3,21,Pass
Paul Sharma,08-09-2005,634301,Maharashtra,23,19,0,3,45,Pass
Manpreet Singh,04-02-2006,299351,Telangana,22,20,11,6,59,Pass
Kunal Chopra,05-04-2005,516619,Andhra Pradesh,22,12,17,9,60,Pass
David Fernandes,30-07-2005,606390,Jharkhand,13,21,21,2,57,Pass
Farhan Reddy,13-03-2006,266565,Bihar,13,5,17,2,37,Pass
Balbir Khan,06-02-2006,292968,Rajasthan,4,1,7,9,21,Pass
John Reddy,02-11-2005,718256,Punjab,6,13,1,23,43,Pass
Ishaan Singh,19-08-2005,840267,Rajasthan,18,9,21,23,71,Pass
Mathew D'Souza,02-04-2006,906933,Puducherry,11,19,6,3,39,Pass
Harjeet Singh,21-10-2005,606561,Bihar,21,3,23,1,48,Pass
Raj D'Souza,13-09-2005,304119,Jharkhand,6,19,14,7,46,Pass
Aditya Mehta,04-08-2005,907617,Chhattisgarh,12,7,13,23,55,Pass
David Khan,04-04-2005,583751,Haryana,3,14,8,21,46,Pass
Ishaan Singh,17-01-2006,351924,Chhattisgarh,11,9,22,5,47,Pass
Rohan D'Souza,09-06-2005,232357,Puducherry,6,13,7,7,33,Pass
Kunal Singh,18-04-2005,557263,Kerala,20,11,7,11,49,Fail
Sukhwinder Chopra,11-02-2006,627171,Gujarat,2,24,11,24,61,Fail
Vivaan Fernandes,02-09-2005,992653,Uttar Pradesh,16,6,9,6,37,Pass
David Khan,15-03-2005,999042,Uttar Pradesh,24,8,15,16,63,Pass
Rohan Singh,03-08-2005,329976,Uttarakhand,3,24,0,2,29,Pass
Rohan Fernandes,30-07-2005,857719,Uttar Pradesh,3,21,11,18,53,Pass
Vivaan Khan,13-10-2005,398298,Uttar Pradesh,16,12,0,11,39,Pass
Aditya Mehta,22-01-2006,260394,Madhya Pradesh,14,21,0,6,41,Pass
Aditya Fernandes,30-11-2005,499554,West Bengal,1,11,11,7,30,Pass
Aarav Verma,14-03-2005,803297,Haryana,5,3,24,18,50,Pass
John Fernandes,05-02-2005,303972,Andhra Pradesh,19,17,4,6,46,Pass
Aarav D'Souza,13-04-2006,965984,Bihar,1,0,21,16,38,Pass
Aarav Sharma,31-03-2006,161092,Rajasthan,15,14,3,16,48,Pass
Aditya Chopra,18-02-2006,668540,Tamil Nadu,20,15,16,19,70,Pass
Mathew Chopra,09-02-2006,180573,Telangana,0,15,11,7,33,Pass
Harjeet Chopra,18-12-2004,872342,Maharashtra,10,0,19,13,42,Pass
Yash Khan,31-03-2006,257882,Punjab,10,20,10,14,54,Pass
Sukhwinder Chopra,05-10-2005,722100,Maharashtra,21,0,11,1,33,Pass
Vivaan Singh,09-09-2005,540010,West Bengal,5,8,15,8,36,Pass
Kunal Fernandes,22-08-2005,780792,Bihar,16,1,1,24,42,Pass
Raj Fernandes,08-03-2005,528507,Uttar Pradesh,18,10,4,8,40,Pass
Ishaan Fernandes,29-06-2005,445295,Assam,3,2,15,3,23,Pass
Aditya Khan,02-06-2005,480407,Tamil Nadu,1,19,10,15,45,Pass
Aarav D'Souza,22-06-2005,300489,Tamil Nadu,24,5,14,10,53,Pass
Krishna Pillai,25-11-2005,311344,Maharashtra,8,19,16,3,46,Pass
Kunal Singh,18-08-2005,454197,Bihar,21,17,14,23,75,Pass
Zaid Mehta,24-03-2006,797135,Uttar Pradesh,19,8,7,10,44,Pass
Yash Khan,20-03-2006,325226,Madhya Pradesh,9,18,3,19,49,Pass
Kunal Sharma,25-11-2005,672107,Rajasthan,10,17,15,1,43,Pass
Harjeet Reddy,15-12-2004,303320,Uttar Pradesh,15,3,19,20,57,Pass
Paul Reddy,18-03-2005,340572,Gujarat,9,7,24,11,51,Fail
Vivaan Chopra,22-09-2005,999508,Jharkhand,11,6,18,2,37,Pass
Yash Pillai,06-12-2004,928838,Telangana,0,6,23,10,39,Pass
Zaid Verma,01-05-2005,906875,Maharashtra,9,15,3,1,28,Pass
Aarav Sharma,26-08-2005,883983,Telangana,10,21,15,14,60,Pass
Raj Mehta,12-07-2005,195791,Bihar,0,8,8,20,36,Pass
David Verma,13-02-2006,589621,Tamil Nadu,2,1,11,23,37,Pass
Aditya Chopra,19-02-2006,859852,Telangana,9,8,12,22,51,Pass
Aarav Singh,04-12-2005,564431,Himachal Pradesh,11,21,20,14,66,Pass
Zaid Khan,02-01-2006,466596,Uttarakhand,20,18,3,14,55,Pass
Aditya D'Souza,11-11-2004,932644,Uttar Pradesh,9,7,8,23,47,Pass
Kunal Reddy,26-07-2005,289590,Rajasthan,8,3,10,10,31,Pass
Ayaan Pillai,03-12-2005,664201,Andhra Pradesh,21,2,0,21,44,Pass
Raj Singh,11-12-2004,863717,Tamil Nadu,12,22,21,19,74,Pass
Aryan Pillai,20-01-2006,728045,Madhya Pradesh,7,4,5,16,32,Pass
Krishna Singh,23-11-2005,990826,Bihar,7,13,21,10,51,Pass
Aditya Chopra,01-01-2005,818226,Telangana,0,20,15,1,36,Pass
Aarav Mehta,28-03-2006,458939,Chhattisgarh,8,10,5,13,36,Pass
Harjeet Sharma,15-03-2005,401187,Madhya Pradesh,3,10,4,22,39,Pass
Aarav Khan,18-02-2006,285565,Gujarat,3,18,4,14,39,Fail
Aditya D'Souza,14-06-2005,849475,Punjab,19,16,24,21,80,Pass
Balbir Fernandes,20-11-2004,424316,Uttar Pradesh,11,13,13,7,44,Pass
Rohan Pillai,24-04-2006,250868,Rajasthan,1,17,15,24,57,Pass
Aryan Khan,18-01-2006,585559,Madhya Pradesh,24,21,3,18,66,Pass
Yash Verma,27-09-2005,734324,Telangana,17,13,7,19,56,Pass
Kunal Khan,03-01-2005,407193,Uttar Pradesh,5,21,7,14,47,Pass
Aarav Fernandes,03-02-2006,518645,Himachal Pradesh,5,0,11,2,18,Pass
Ishaan Chopra,01-08-2005,575924,Odisha,16,23,17,15,71,Pass
Raj Singh,11-07-2005,643920,Madhya Pradesh,18,21,3,8,50,Pass
Rohan Fernandes,19-07-2005,650520,Madhya Pradesh,14,24,3,24,65,Pass
Krishna Verma,10-11-2005,979758,Uttar Pradesh,10,1,19,22,52,Pass
Sukhwinder Khan,14-08-2005,624626,Bihar,1,5,20,8,34,Pass
Yash Chopra,02-10-2005,903261,Uttar Pradesh,24,17,2,15,58,Pass
Sukhwinder Chopra,25-03-2006,774200,Maharashtra,13,1,13,22,49,Pass
Krishna Reddy,26-04-2006,973640,Haryana,13,6,15,6,40,Pass
John Verma,05-04-2006,477773,Rajasthan,19,2,16,10,47,Pass
Krishna Sharma,31-07-2005,431800,Gujarat,13,24,23,5,65,Fail
Raj Chopra,03-12-2004,704942,Haryana,18,10,6,24,58,Pass
Raj Singh,08-12-2005,562691,Bihar,17,17,9,13,56,Pass
Kunal Fernandes,01-12-2004,200326,Maharashtra,13,19,9,3,44,Pass
Aditya Khan,23-04-2005,721065,Uttarakhand,8,24,3,12,47,Pass
Balbir Mehta,11-03-2006,536834,Assam,8,24,15,11,58,Pass
Vivaan Chopra,30-10-2005,127726,Tamil Nadu,1,0,5,5,11,Pass
Manpreet D'Souza,30-03-2005,110917,Maharashtra,14,8,4,16,42,Pass
Aryan Reddy,06-01-2005,580165,Bihar,17,7,2,24,50,Pass
Aditya Verma,27-12-2004,388464,Maharashtra,2,4,4,11,21,Pass
Aarav Pillai,06-12-2004,477267,Tamil Nadu,10,9,6,17,42,Pass
Ishaan Fernandes,06-01-2006,159511,West Bengal,22,7,12,4,45,Pass
Peter Reddy,09-03-2006,385913,West Bengal,3,11,21,16,51,Pass
Ishaan Sharma,06-11-2005,313552,Gujarat,8,22,19,15,64,Fail
Ishaan Pillai,04-12-2004,224304,Bihar,13,14,5,20,52,Pass
Imran D'Souza,21-11-2005,348449,Uttar Pradesh,9,0,12,22,43,Pass
Ishaan Reddy,06-02-2006,850802,Andhra Pradesh,24,15,23,6,68,Pass
Ishaan Singh,13-05-2005,394960,Manipur,19,3,22,10,54,Pass
Raj D'Souza,13-03-2005,692597,Madhya Pradesh,5,13,7,5,30,Pass
Krishna D'Souza,06-04-2006,302000,Rajasthan,21,13,1,20,55,Pass
Manpreet Pillai,15-06-2005,757621,Bihar,16,2,4,11,33,Pass
Rohan Reddy,02-12-2005,697201,Haryana,21,9,6,19,55,Pass
Krishna Reddy,22-04-2006,128672,Haryana,14,2,8,17,41,Pass
Aarav D'Souza,20-09-2005,711008,Kerala,10,14,11,23,58,Fail
Harjeet Pillai,18-12-2004,428753,Rajasthan,10,2,12,6,30,Pass
Peter Pillai,05-11-2005,251553,Maharashtra,18,22,17,3,60,Pass
Balbir Mehta,01-12-2005,702827,Madhya Pradesh,8,14,14,11,47,Pass
Gurpreet Khan,13-01-2005,221507,Haryana,18,2,16,21,57,Pass
Ishaan Khan,02-01-2006,813740,Delhi,20,20,0,5,45,Pass
Vivaan Singh,22-03-2006,866367,Tamil Nadu,11,0,11,11,33,Pass
Aryan Reddy,31-03-2005,465711,Bihar,11,14,16,22,63,Pass
Mathew Singh,31-01-2005,622399,Kerala,3,16,5,10,34,Fail
Raj Khan,28-03-2005,606637,Rajasthan,12,6,23,24,65,Pass
Vivaan Sharma,22-02-2005,320163,Uttar Pradesh,16,20,17,9,62,Pass
Raj Fernandes,07-12-2004,438209,Uttarakhand,7,19,3,8,37,Pass
Rohan Fernandes,08-01-2006,903296,Karnataka,15,9,18,19,61,Pass
Mathew Fernandes,02-01-2005,142038,Andhra Pradesh,13,0,4,6,23,Pass
Ishaan Fernandes,05-04-2006,979783,Haryana,19,22,21,2,64,Pass
Peter Khan,24-10-2005,424853,Punjab,20,6,11,4,41,Pass
Vivaan Verma,24-01-2005,759968,Manipur,15,3,23,19,60,Pass
Yash Sharma,03-07-2005,546250,Punjab,3,7,17,3,30,Pass
Ishaan D'Souza,07-03-2005,108017,Telangana,23,24,13,3,63,Pass
Ishaan Verma,10-11-2005,212052,Tamil Nadu,24,8,14,20,66,Pass
John Pillai,03-02-2005,646266,Bihar,7,23,5,0,35,Pass
Ishaan Mehta,07-02-2005,892228,West Bengal,10,17,22,0,49,Pass
Aditya Khan,26-11-2005,684139,Rajasthan,21,21,21,7,70,Pass
Rohan Pillai,01-10-2005,217546,Assam,2,3,1,12,18,Pass
Aarav Verma,24-12-2004,519595,Kerala,2,18,0,5,25,Fail
Aditya Pillai,02-01-2005,128419,Uttar Pradesh,17,7,0,3,27,Pass
Aarav Singh,06-02-2005,332531,Bihar,3,9,23,23,58,Pass
Aryan Sharma,18-04-2005,683039,Chhattisgarh,14,23,2,19,58,Pass
Ishaan Pillai,24-05-2005,650747,Rajasthan,5,13,17,5,40,Pass
Rohan Mehta,18-06-2005,244002,Bihar,5,21,19,13,58,Pass
Yash Verma,30-10-2005,292284,Delhi,22,16,22,5,65,Pass
Rohan Verma,18-01-2005,724590,Odisha,11,5,19,11,46,Pass
Raj Khan,27-04-2006,455998,Himachal Pradesh,3,15,13,3,34,Pass
Vivaan Fernandes,19-02-2005,983076,Delhi,20,17,11,22,70,Pass
Raj D'Souza,14-06-2005,323582,Madhya Pradesh,11,5,3,22,41,Pass
Kunal Verma,18-07-2005,539083,Uttar Pradesh,2,15,1,0,18,Pass
Aditya Khan,05-05-2005,149232,Bihar,15,17,17,2,51,Pass
Aarav Fernandes,06-07-2005,163455,West Bengal,19,11,1,11,42,Pass
Balbir Fernandes,14-12-2005,960484,West Bengal,18,4,9,9,40,Pass
Ishaan Pillai,31-03-2005,179449,Bihar,14,17,3,11,45,Pass
David Mehta,17-12-2004,550507,Madhya Pradesh,24,15,3,20,62,Pass
Krishna Fernandes,24-01-2006,832490,Maharashtra,8,5,17,3,33,Pass
Kunal Fernandes,22-08-2005,355471,Himachal Pradesh,17,21,10,7,55,Pass
Aryan Mehta,30-08-2005,145368,Meghalaya,12,24,2,8,46,Pass
Balbir Reddy,23-05-2005,898268,Uttarakhand,17,11,1,8,37,Pass
Harjeet Sharma,12-02-2006,367326,Tamil Nadu,21,9,11,13,54,Pass
Imran Fernandes,02-01-2006,220634,Maharashtra,0,5,6,3,14,Pass
Aditya Mehta,15-11-2005,190944,Assam,0,11,14,3,28,Pass
Kunal Fernandes,01-01-2005,992915,Uttarakhand,16,0,13,21,50,Pass
Aarav Sharma,11-10-2005,341789,Uttar Pradesh,19,7,20,0,46,Pass
Aryan D'Souza,13-01-2006,907071,Gujarat,15,21,9,4,49,Fail
Raj Khan,15-11-2004,694183,Bihar,19,20,24,8,71,Pass
Peter D'Souza,06-05-2006,143804,Himachal Pradesh,7,1,9,15,32,Pass
Rohan Singh,22-04-2006,405158,Rajasthan,1,3,1,14,19,Pass
Manpreet Mehta,14-01-2006,747380,Rajasthan,21,22,7,19,69,Pass
Yash D'Souza,07-10-2005,308204,Kerala,19,1,6,1,27,Fail
Kunal Singh,07-04-2005,847044,Rajasthan,6,2,8,4,20,Pass
Aarav D'Souza,20-01-2006,445168,West Bengal,15,1,18,18,52,Pass
Aryan Reddy,06-01-2006,914412,Uttar Pradesh,7,11,16,21,55,Pass
Krishna Verma,29-09-2005,588641,Manipur,16,13,6,0,35,Pass
Krishna Verma,24-07-2005,272041,Chhattisgarh,11,7,9,1,28,Pass
Ishaan D'Souza,01-09-2005,973220,Assam,4,15,22,16,57,Pass
Krishna Khan,21-04-2006,459204,Madhya Pradesh,4,4,12,0,20,Pass
Balbir Khan,04-06-2005,943580,Meghalaya,24,13,15,2,54,Pass
Yash Mehta,21-11-2005,232408,Haryana,20,15,7,19,61,Pass
Harjeet Chopra,12-01-2005,459200,Uttarakhand,0,15,0,10,25,Pass
Raj Sharma,20-01-2005,783012,Maharashtra,18,5,21,3,47,Pass
Krishna Sharma,11-08-2005,952977,Uttar Pradesh,22,9,3,2,36,Pass
Imran Mehta,20-07-2005,828560,Uttar Pradesh,9,0,18,6,33,Pass
Aditya Mehta,13-10-2005,330756,Telangana,8,6,14,14,42,Pass
Aarav Khan,24-10-2005,679888,Madhya Pradesh,4,0,7,4,15,Pass
Krishna Mehta,13-09-2005,256864,Rajasthan,19,10,7,5,41,Pass
Rohan Khan,28-02-2005,655423,Jharkhand,24,17,23,23,87,Pass
Aarav Reddy,12-04-2006,739111,Maharashtra,11,0,2,7,20,Pass
Harjeet Singh,21-02-2006,876283,Bihar,16,18,19,8,61,Pass
Manpreet Sharma,07-09-2005,568934,Tamil Nadu,9,1,23,12,45,Pass
Aditya Sharma,03-01-2006,146153,Bihar,12,7,8,13,40,Pass
Aarav Verma,27-01-2005,744619,Uttar Pradesh,4,22,2,1,29,Pass
Krishna Sharma,07-03-2005,685918,Uttar Pradesh,21,11,23,1,56,Pass
Zaid Singh,02-07-2005,122285,Karnataka,9,23,18,5,55,Pass
Raj Sharma,16-11-2005,272845,Bihar,9,10,22,7,48,Pass
Zaid Mehta,12-02-2005,535771,Gujarat,15,23,22,21,81,Fail
Vivaan Reddy,24-06-2005,216247,Gujarat,12,4,7,11,34,Fail
Vivaan Pillai,02-02-2006,922219,Karnataka,23,2,24,4,53,Pass
Rehan D'Souza,14-08-2005,877230,Madhya Pradesh,12,3,10,4,29,Pass
Manpreet Verma,10-03-2005,933727,West Bengal,13,15,1,2,31,Pass
Ishaan Sharma,31-12-2005,660185,Rajasthan,13,24,2,18,57,Pass
Harjeet Pillai,25-07-2005,581416,Uttar Pradesh,3,15,16,18,52,Pass
Krishna Pillai,25-12-2004,281714,Jharkhand,2,2,3,12,19,Pass
Rohan Reddy,11-09-2005,999399,Maharashtra,24,23,6,3,56,Pass
Kunal Fernandes,11-11-2005,516383,Haryana,0,18,12,10,40,Pass
Rohan Khan,30-09-2005,236691,Karnataka,21,8,14,8,51,Pass
Vivaan Khan,01-01-2006,411915,Tamil Nadu,17,20,14,12,63,Pass
Balbir D'Souza,03-06-2005,692733,West Bengal,20,1,7,17,45,Pass
Manpreet Singh,30-09-2005,738120,Delhi,21,6,10,13,50,Pass
John Mehta,22-12-2005,779871,Andhra Pradesh,2,3,4,17,26,Pass
Imran Mehta,01-08-2005,330988,Rajasthan,16,1,16,12,45,Pass
Rohan Pillai,02-03-2006,584763,Haryana,1,8,9,8,26,Pass
Peter Reddy,09-11-2004,265648,Himachal Pradesh,15,19,22,19,75,Fail
Raj Verma,06-10-2005,280541,Rajasthan,7,2,6,17,32,Pass
Ishaan Singh,26-09-2005,779508,Bihar,18,23,14,9,64,Pass
Raj Pillai,25-01-2005,603829,Bihar,20,3,6,9,38,Pass
Ayaan D'Souza,12-07-2005,316962,Jammu & Kashmir + Ladakh,7,20,4,22,53,Pass
Zaid Mehta,20-02-2005,634746,Uttar Pradesh,7,7,4,11,29,Pass
Krishna Reddy,12-11-2004,716886,Tamil Nadu,15,9,15,5,44,Pass
Aditya D'Souza,01-03-2005,971998,Uttar Pradesh,16,7,17,12,52,Pass
Kunal Sharma,27-01-2006,846659,Karnataka,13,17,3,7,40,Pass
Ishaan Chopra,28-03-2005,768570,West Bengal,3,2,11,3,19,Pass
Aditya Reddy,14-02-2005,713435,Rajasthan,3,1,8,10,22,Pass
Kunal Verma,07-02-2005,264917,Uttar Pradesh,11,19,15,9,54,Pass
Paul Singh,08-02-2005,219123,Punjab,15,6,3,7,31,Pass
Vivaan Chopra,01-03-2005,856195,Gujarat,11,6,5,13,35,Fail
Yash Chopra,06-08-2005,592587,Odisha,21,15,16,21,73,Pass
Yash Reddy,12-09-2005,293309,Uttar Pradesh,14,14,23,12,63,Pass
Harjeet Reddy,05-06-2005,258425,Assam,1,1,23,1,26,Pass
Raj Verma,17-01-2005,827870,Uttar Pradesh,5,22,17,7,51,Pass
Krishna Fernandes,21-12-2005,242477,Kerala,19,13,21,10,63,Fail
Rohan Chopra,07-02-2006,247730,Madhya Pradesh,16,24,3,12,55,Pass
Ishaan D'Souza,25-01-2005,521788,Uttar Pradesh,16,3,24,17,60,Pass
Aditya Chopra,15-02-2005,181206,Tamil Nadu,19,19,4,2,44,Pass
Gurpreet Pillai,05-01-2005,629845,West Bengal,2,12,0,9,23,Pass
Raj Mehta,25-08-2005,588741,Haryana,0,15,16,1,32,Pass
Ishaan Reddy,29-11-2004,537674,Chhattisgarh,23,17,17,9,66,Pass
Rohan Khan,31-10-2005,530805,Uttar Pradesh,6,24,17,10,57,Pass
Manpreet Verma,19-11-2005,140371,Maharashtra,2,13,4,4,23,Pass
Vivaan Mehta,13-12-2004,919768,Madhya Pradesh,3,21,4,16,44,Pass
Raj Reddy,21-01-2006,528653,Uttar Pradesh,19,15,18,11,63,Pass
Kunal Reddy,03-01-2006,311703,West Bengal,1,6,17,6,30,Pass
Rohan Fernandes,10-11-2004,216226,Tamil Nadu,12,18,22,2,54,Pass
Krishna Sharma,02-01-2005,492924,Odisha,13,16,7,5,41,Pass
Aditya Sharma,15-05-2005,899244,Telangana,6,7,13,20,46,Pass
Sukhwinder Sharma,07-05-2005,623595,Odisha,24,10,24,15,73,Pass
Paul Mehta,12-10-2005,754017,Rajasthan,8,16,19,15,58,Pass
Vivaan Reddy,31-07-2005,119830,Punjab,23,7,4,10,44,Pass
Rohan Verma,06-01-2006,768641,Uttarakhand,4,10,22,10,46,Pass
Sukhwinder Verma,19-04-2005,498235,Rajasthan,23,5,10,18,56,Pass
Aryan Verma,29-11-2004,274877,Punjab,8,20,9,5,42,Pass
Rohan Reddy,11-11-2005,209932,Maharashtra,14,8,1,8,31,Pass
Aditya Mehta,21-04-2006,335583,Haryana,7,1,4,21,33,Pass
Sukhwinder Mehta,12-01-2006,580496,Arunachal Pradesh,20,18,1,8,47,Fail
Rohan Reddy,22-04-2005,489538,Bihar,18,21,8,9,56,Pass
Aryan Reddy,22-02-2006,409983,Delhi,5,22,12,19,58,Pass
Yash Reddy,27-01-2005,230048,Madhya Pradesh,12,21,3,7,43,Pass
Aarav Pillai,11-09-2005,914180,Assam,1,7,24,13,45,Pass
Sukhwinder Chopra,22-12-2005,777950,Punjab,18,16,10,18,62,Pass
Farhan Pillai,25-05-2005,317327,Telangana,20,1,11,10,42,Pass
Yash Reddy,14-12-2005,757318,Telangana,19,9,5,6,39,Pass
Peter Pillai,20-06-2005,615847,Delhi,14,16,22,8,60,Pass
Kunal Reddy,16-03-2006,186480,Jammu & Kashmir + Ladakh,2,2,7,16,27,Pass
Sukhwinder Fernandes,29-11-2004,683257,Uttar Pradesh,10,3,11,24,48,Pass
Mathew D'Souza,08-03-2006,333734,Punjab,23,5,23,4,55,Pass
Balbir Fernandes,17-09-2005,687428,Tamil Nadu,1,10,6,24,41,Pass
Yash Singh,06-11-2005,723058,Haryana,6,8,6,23,43,Pass
Balbir Khan,21-01-2005,432674,Bihar,18,14,21,13,66,Pass
Kunal Pillai,25-12-2005,721134,West Bengal,7,17,15,0,39,Pass
Rohan Khan,01-12-2005,257491,Sikkim,1,12,11,13,37,Pass
Rehan Fernandes,06-07-2005,705944,Kerala,13,21,23,0,57,Fail
Krishna Reddy,06-12-2004,237767,Maharashtra,3,3,13,9,28,Pass
Vivaan Reddy,18-11-2004,631536,Tripura,18,17,3,7,45,Pass
Manpreet Reddy,13-04-2006,364291,Mizoram,7,19,22,4,52,Fail
Aarav Pillai,21-12-2004,501517,Bihar,10,11,4,5,30,Pass
Kunal Singh,18-02-2005,112596,Andhra Pradesh,8,14,19,12,53,Pass
Rohan Mehta,03-09-2005,966237,Haryana,22,6,1,9,38,Pass
Vivaan Verma,29-06-2005,869992,Tamil Nadu,15,21,17,0,53,Pass
Yash D'Souza,09-04-2006,151328,Uttar Pradesh,1,9,6,24,40,Pass
Balbir Chopra,25-06-2005,811390,Rajasthan,7,8,0,17,32,Pass
Krishna Pillai,22-05-2005,813743,Tamil Nadu,2,18,15,4,39,Pass
Imran Khan,12-06-2005,590882,Assam,4,18,2,7,31,Pass
Aryan Chopra,29-03-2006,508852,Assam,10,22,0,8,40,Pass
Sukhwinder Chopra,29-03-2005,539597,Madhya Pradesh,20,11,3,14,48,Pass
Kunal Verma,09-01-2006,410518,Jharkhand,10,18,1,19,48,Pass
Harjeet Reddy,18-02-2005,239333,Uttarakhand,11,0,15,13,39,Pass
Balbir Mehta,05-03-2005,637402,Bihar,8,15,14,22,59,Pass
Manpreet Reddy,17-11-2004,636058,Uttar Pradesh,15,12,10,22,59,Pass
Rohan Fernandes,14-02-2006,464652,Andhra Pradesh,1,17,11,2,31,Pass
Gurpreet Fernandes,24-05-2005,343567,Tamil Nadu,24,18,6,17,65,Pass
Paul Singh,31-08-2005,691740,Tamil Nadu,9,9,21,2,41,Pass
Raj Fernandes,17-12-2004,516415,West Bengal,2,19,16,3,40,Pass
Harjeet Fernandes,04-04-2006,420480,Haryana,2,7,21,11,41,Pass
Kunal Chopra,16-03-2006,905846,Jammu & Kashmir + Ladakh,9,3,14,3,29,Pass
Aryan Reddy,05-01-2006,829872,Kerala,16,24,2,6,48,Fail
Manpreet Khan,05-02-2006,580865,Uttar Pradesh,8,20,0,2,30,Pass
Raj Chopra,07-01-2006,750568,Tamil Nadu,22,3,22,14,61,Pass
Krishna Reddy,12-12-2004,817559,Assam,13,22,21,22,78,Pass
Peter Mehta,03-05-2005,489330,Odisha,21,2,12,19,54,Pass
Balbir Khan,21-01-2005,801046,West Bengal,9,9,24,0,42,Pass
Kunal Sharma,18-12-2004,155162,Chhattisgarh,14,0,15,5,34,Pass
Yash D'Souza,03-06-2005,798967,Andhra Pradesh,22,0,18,5,45,Pass
Yash D'Souza,02-03-2005,908371,Jharkhand,17,13,0,14,44,Pass
Paul Verma,20-02-2005,939280,Tamil Nadu,8,18,7,3,36,Pass
Aryan D'Souza,30-05-2005,513378,Punjab,8,19,13,13,53,Pass
Sukhwinder Fernandes,09-12-2005,429561,Jammu & Kashmir + Ladakh,8,23,9,22,62,Pass
Vivaan Reddy,23-05-2005,399080,West Bengal,16,22,9,2,49,Pass
Aditya Verma,14-04-2005,879961,Telangana,23,18,23,0,64,Fail
Vivaan Chopra,15-10-2005,618208,Punjab,7,11,0,22,40,Pass
Kunal D'Souza,17-03-2005,380363,Rajasthan,18,24,23,9,74,Pass
Krishna Singh,04-11-2005,878461,Haryana,22,10,16,7,55,Pass
Kunal D'Souza,20-11-2005,811696,Rajasthan,18,18,23,18,77,Pass
Vivaan Khan,08-09-2005,596816,Chhattisgarh,23,19,14,3,59,Pass
Vivaan Reddy,03-03-2005,113718,Assam,10,9,18,4,41,Pass
Raj Fernandes,30-01-2005,510086,Haryana,10,4,1,14,29,Pass
Aditya Khan,31-12-2004,388254,Punjab,3,15,21,1,40,Pass
Yash Pillai,01-05-2005,208106,Kerala,19,12,13,2,46,Fail
Raj Singh,08-03-2005,544864,Telangana,10,16,24,9,59,Pass
Kunal Khan,12-04-2005,848126,Maharashtra,11,14,14,2,41,Pass
Harjeet D'Souza,16-04-2006,933325,Tripura,7,10,3,22,42,Pass
Rohan D'Souza,15-03-2006,472448,Madhya Pradesh,23,24,0,0,47,Pass
Vivaan Mehta,26-06-2005,296127,West Bengal,10,21,4,6,41,Pass
Rohan Khan,03-08-2005,988604,West Bengal,15,13,6,18,52,Pass
Krishna Mehta,19-10-2005,377811,Rajasthan,4,20,22,14,60,Pass
Balbir Verma,20-02-2005,553613,Rajasthan,15,21,4,2,42,Pass
Peter Khan,15-11-2004,870805,Madhya Pradesh,22,22,3,12,59,Pass
Yash Fernandes,16-03-2006,589157,Karnataka,13,23,1,5,42,Pass
Mathew Khan,02-05-2006,772938,Uttar Pradesh,6,15,4,19,44,Pass
Raj Reddy,15-04-2005,365259,West Bengal,4,12,20,15,51,Pass
Ishaan Verma,30-11-2004,291544,Uttar Pradesh,24,13,2,4,43,Pass
Krishna Reddy,11-01-2005,331333,Uttar Pradesh,15,5,0,16,36,Pass
Kunal D'Souza,05-02-2005,489980,Madhya Pradesh,15,0,15,6,36,Pass
Vivaan Mehta,24-10-2005,785072,Nagaland,3,24,23,5,55,Pass
Kunal Singh,02-03-2006,904203,Andhra Pradesh,11,15,9,20,55,Pass
Kunal Pillai,29-01-2005,201370,Haryana,18,18,14,10,60,Pass
Aryan D'Souza,23-12-2005,962427,Maharashtra,11,12,16,3,42,Pass
Vivaan Chopra,25-04-2005,547099,Bihar,7,16,24,15,62,Pass
Krishna Singh,10-04-2006,810405,West Bengal,3,12,0,24,39,Pass
Peter Sharma,05-03-2006,814288,Punjab,1,5,22,13,41,Pass
John Verma,13-03-2005,545820,West Bengal,1,0,20,20,41,Pass
Vivaan Reddy,01-11-2005,671323,West Bengal,6,1,21,7,35,Pass
Kunal Singh,07-01-2006,967466,Rajasthan,19,18,9,18,64,Pass
Aditya Sharma,07-10-2005,297119,Tamil Nadu,0,10,11,16,37,Pass
Imran Pillai,21-11-2005,297587,Gujarat,17,2,10,17,46,Fail
Peter Khan,06-12-2004,261244,Rajasthan,15,24,14,15,68,Pass
Aryan Sharma,05-10-2005,442942,Arunachal Pradesh,4,3,22,15,44,Pass
Vivaan Pillai,22-02-2006,735393,Uttar Pradesh,2,8,7,6,23,Pass
Aarav Reddy,20-11-2005,434933,Himachal Pradesh,10,7,15,12,44,Pass
Krishna Verma,17-04-2005,566830,Tamil Nadu,6,14,23,22,65,Pass
Balbir Fernandes,27-06-2005,833818,Tamil Nadu,2,20,8,18,48,Pass
Rohan Sharma,29-01-2006,306233,Bihar,0,18,3,15,36,Pass
Krishna D'Souza,05-12-2004,339032,Odisha,16,22,4,24,66,Pass
Kunal Mehta,20-02-2006,889279,Punjab,0,24,3,19,46,Pass
Krishna Fernandes,09-08-2005,546414,Punjab,2,15,0,12,29,Pass
Raj D'Souza,16-02-2005,109179,Tamil Nadu,18,24,5,7,54,Pass
Yash Mehta,22-12-2005,357322,Bihar,23,8,21,15,67,Pass
Kunal Mehta,27-12-2005,389866,Rajasthan,17,21,15,9,62,Pass
Aryan Singh,14-09-2005,171664,Bihar,20,0,9,14,43,Pass
Raj Mehta,05-01-2006,925730,Assam,7,15,13,10,45,Pass
Vivaan Khan,17-04-2006,331155,Uttarakhand,0,13,3,10,26,Pass
Krishna D'Souza,06-07-2005,767639,Nagaland,9,6,10,5,30,Pass
Manpreet Verma,26-01-2005,660005,Uttar Pradesh,4,4,12,15,35,Pass
Krishna Mehta,11-10-2005,107743,Goa,8,13,22,17,60,Fail
Aarav Singh,10-02-2005,793196,Maharashtra,15,20,21,3,59,Pass
Aditya Mehta,19-06-2005,527422,Haryana,19,23,1,4,47,Pass
Aarav Singh,30-12-2005,122199,Telangana,19,12,14,3,48,Pass
Ishaan D'Souza,16-03-2005,318614,Uttar Pradesh,18,7,14,22,61,Pass
Kunal Fernandes,20-01-2005,185017,Madhya Pradesh,11,18,3,10,42,Pass
Aryan Pillai,18-06-2005,953120,Telangana,21,17,3,14,55,Fail
Kunal Sharma,11-02-2005,636907,Maharashtra,8,17,4,7,36,Pass
Gurpreet Singh,06-05-2005,396363,Punjab,11,21,2,8,42,Pass
Harjeet Mehta,14-02-2006,344954,Madhya Pradesh,2,14,16,10,42,Pass
Aditya Reddy,10-03-2005,541407,Haryana,23,8,22,3,56,Pass
Aarav D'Souza,24-01-2005,350184,Punjab,7,16,24,20,67,Pass
Krishna Verma,22-01-2005,758215,Uttar Pradesh,8,5,5,20,38,Pass
Ishaan Singh,20-11-2005,623302,Madhya Pradesh,6,0,5,8,19,Pass
Paul Sharma,17-05-2005,695793,Haryana,21,21,20,0,62,Pass
Krishna Fernandes,18-05-2005,692280,Tamil Nadu,11,17,23,13,64,Pass
Sukhwinder Sharma,23-12-2005,582469,Haryana,1,10,22,12,45,Pass
Gurpreet Mehta,15-12-2005,163270,Kerala,1,21,5,6,33,Fail
Vivaan Mehta,01-02-2006,246033,Andhra Pradesh,14,9,8,20,51,Pass
Ishaan Verma,02-05-2006,704606,Punjab,20,14,11,3,48,Pass
Vivaan Fernandes,31-12-2005,363298,Haryana,6,23,1,14,44,Pass
Kunal Fernandes,18-01-2006,638767,Rajasthan,14,13,5,1,33,Pass
Raj D'Souza,19-06-2005,155939,Maharashtra,14,7,20,6,47,Pass
Rohan Chopra,23-11-2004,427967,Odisha,22,16,24,13,75,Pass
Harjeet Pillai,17-11-2005,559485,Tamil Nadu,20,15,7,24,66,Pass
Vivaan Verma,20-04-2006,841160,Delhi,6,24,16,1,47,Pass
John Singh,29-05-2005,282416,Haryana,2,2,6,19,29,Pass
Yash Fernandes,11-11-2005,956212,Haryana,22,15,7,24,68,Pass
Krishna D'Souza,07-10-2005,799705,Uttar Pradesh,19,21,5,6,51,Pass
Yash Singh,02-02-2006,627131,Andhra Pradesh,2,11,6,0,19,Pass
Aditya Singh,10-02-2005,335032,Tamil Nadu,19,9,5,22,55,Pass
David Chopra,16-07-2005,251391,Gujarat,11,18,23,9,61,Fail
Raj Sharma,14-02-2006,617599,Uttar Pradesh,11,3,5,20,39,Pass
Rohan Fernandes,06-06-2005,454154,Madhya Pradesh,17,6,6,16,45,Pass
Aryan Chopra,04-01-2006,315256,Rajasthan,13,5,2,21,41,Pass
Harjeet Khan,02-04-2005,481134,West Bengal,12,7,1,21,41,Pass
Rohan Khan,30-07-2005,504664,Haryana,13,7,12,20,52,Pass
Aryan Khan,09-12-2004,209481,Maharashtra,4,22,9,0,35,Pass
Aditya Chopra,09-06-2005,354009,Karnataka,12,10,5,13,40,Pass
Gurpreet Khan,19-05-2005,203255,Gujarat,7,21,1,20,49,Fail
Manpreet Fernandes,07-10-2005,290234,Rajasthan,18,15,5,0,38,Pass
Krishna Sharma,26-01-2006,120444,Telangana,16,23,12,17,68,Fail
Gurpreet D'Souza,27-09-2005,794069,Bihar,14,15,22,22,73,Pass
Yash Chopra,28-11-2005,126243,Himachal Pradesh,18,19,0,9,46,Pass
Peter Sharma,29-03-2006,783935,Bihar,0,24,21,8,53,Pass
Rehan Chopra,14-11-2004,503207,Bihar,0,6,9,16,31,Pass
Harjeet Fernandes,16-03-2005,753471,Punjab,15,19,12,4,50,Pass
Ayaan Verma,12-10-2005,139550,Karnataka,6,13,21,7,47,Pass
Aditya Mehta,16-09-2005,820639,Bihar,3,2,4,16,25,Pass
Gurpreet Reddy,08-03-2005,157356,Delhi,15,5,4,24,48,Pass
Yash Fernandes,10-03-2006,818100,Gujarat,14,20,24,16,74,Fail
Aditya Singh,15-04-2005,247013,Tamil Nadu,3,7,6,22,38,Pass
Aditya Reddy,28-11-2005,984756,Assam,23,16,1,23,63,Pass
Harjeet Pillai,11-01-2006,764781,Maharashtra,4,20,24,3,51,Pass
Manpreet Fernandes,07-03-2006,138059,Madhya Pradesh,15,16,18,6,55,Pass
Rohan Mehta,24-12-2005,533224,Uttar Pradesh,24,3,22,16,65,Pass
Aditya Reddy,02-08-2005,707002,Odisha,19,14,23,4,60,Pass
Krishna Pillai,25-09-2005,614774,Odisha,2,4,18,17,41,Pass
Ishaan Khan,09-09-2005,545369,Telangana,3,23,24,3,53,Pass
Harjeet Singh,15-02-2006,557332,Tripura,1,15,21,15,52,Pass
Balbir Pillai,03-04-2006,410255,Bihar,17,15,21,17,70,Pass
Aarav Verma,25-02-2005,744621,Bihar,2,12,13,17,44,Pass
Vivaan Fernandes,23-05-2005,791587,Gujarat,8,18,7,11,44,Fail
Yash Khan,16-01-2006,301702,Uttar Pradesh,14,12,6,22,54,Pass
Aryan Mehta,22-07-2005,538529,Bihar,8,21,17,23,69,Pass
Balbir Verma,05-11-2005,989243,Chhattisgarh,7,12,3,10,32,Pass
Farhan Singh,26-11-2005,271629,Uttar Pradesh,17,17,7,10,51,Pass
Paul Sharma,23-12-2004,731526,Uttar Pradesh,17,6,14,18,55,Pass
Kunal Chopra,03-07-2005,982740,Haryana,20,21,12,12,65,Pass
Krishna Verma,14-02-2006,219192,Bihar,6,21,18,24,69,Pass
Raj Khan,05-12-2004,111009,Jharkhand,5,17,7,11,40,Pass
Imran Chopra,24-06-2005,581208,Rajasthan,13,16,17,15,61,Pass
Ishaan Khan,05-07-2005,472893,Assam,7,14,17,2,40,Pass
Harjeet D'Souza,06-12-2004,630799,Uttar Pradesh,8,1,13,21,43,Pass
Krishna Singh,12-02-2005,596246,Madhya Pradesh,1,1,2,13,17,Pass
Vivaan Pillai,20-12-2004,766937,Daman & Diu / D&N Haveli,17,0,7,7,31,Fail
Zaid Khan,21-02-2006,353246,Rajasthan,15,14,20,20,69,Pass
Aryan Fernandes,04-05-2005,939051,Kerala,0,11,0,5,16,Fail
Aryan Khan,17-06-2005,977252,Bihar,23,17,10,19,69,Pass
Rohan Pillai,02-04-2005,311549,Bihar,17,3,9,3,32,Pass
Rohan Verma,12-09-2005,290498,Rajasthan,13,10,22,2,47,Pass
Rohan Singh,12-10-2005,127904,Tripura,20,12,11,9,52,Pass
Harjeet Reddy,06-09-2005,892729,Bihar,20,8,8,11,47,Pass
Rohan Singh,30-11-2004,128562,Rajasthan,3,18,21,1,43,Pass
Peter Khan,01-02-2006,288493,Jharkhand,6,3,12,2,23,Pass
Rohan Khan,26-02-2005,434430,Odisha,24,4,23,2,53,Pass
Paul Mehta,14-01-2005,826079,Maharashtra,12,24,20,3,59,Pass
Mathew D'Souza,28-03-2005,612426,Punjab,0,0,13,11,24,Pass
Rohan Singh,19-10-2005,579242,Uttar Pradesh,20,21,7,0,48,Pass
Rohan Verma,25-06-2005,205870,Telangana,18,8,6,11,43,Pass
Yash Fernandes,07-01-2005,720409,Madhya Pradesh,3,5,20,6,34,Pass
Kunal D'Souza,02-06-2005,851976,West Bengal,3,13,22,6,44,Pass
Raj D'Souza,31-10-2005,175724,Kerala,24,5,23,11,63,Fail
Mathew Mehta,30-01-2005,816829,Bihar,24,15,18,23,80,Pass
Krishna Verma,02-01-2005,546185,Haryana,24,19,16,0,59,Pass
Harjeet Pillai,03-11-2005,358408,Delhi,6,0,24,0,30,Pass
Kunal Khan,15-03-2006,535885,Assam,5,3,22,1,31,Pass
Manpreet Mehta,20-06-2005,252529,Telangana,13,8,10,24,55,Fail
Ishaan Singh,16-09-2005,790882,Rajasthan,7,4,12,2,25,Pass
Peter Sharma,26-06-2005,966022,Chhattisgarh,6,22,16,10,54,Pass
Aarav Reddy,29-12-2004,298073,Madhya Pradesh,8,11,2,12,33,Pass
Aryan Singh,01-11-2005,772894,Punjab,17,1,17,0,35,Pass
Sukhwinder Khan,02-01-2006,198187,Punjab,2,13,22,11,48,Pass
Rohan Chopra,27-07-2005,657833,Maharashtra,12,9,22,3,46,Pass
Manpreet D'Souza,22-06-2005,883274,Punjab,23,17,24,13,77,Pass
Aditya Fernandes,20-08-2005,253945,Maharashtra,2,11,24,0,37,Pass
Krishna Khan,13-11-2004,817842,Madhya Pradesh,19,1,8,8,36,Pass
Raj Mehta,24-08-2005,510046,Odisha,17,22,2,18,59,Pass
Peter Pillai,08-04-2005,886607,Madhya Pradesh,20,14,1,9,44,Pass
Aryan Sharma,22-02-2006,188948,Telangana,12,10,16,0,38,Pass
Yash Khan,17-11-2004,872469,Bihar,2,19,10,15,46,Pass
Rohan Fernandes,10-12-2005,708592,Odisha,17,15,6,9,47,Pass
Mathew D'Souza,20-01-2005,285033,Maharashtra,19,2,3,13,37,Pass
Rohan Reddy,21-11-2005,605547,Haryana,2,16,23,22,63,Pass
Aarav D'Souza,20-07-2005,710631,West Bengal,21,6,1,7,35,Pass
Ishaan Verma,18-12-2005,865886,Assam,2,17,1,3,23,Pass
Balbir Khan,11-05-2005,226325,Uttar Pradesh,4,22,23,12,61,Pass
Krishna Mehta,11-03-2006,318632,Andhra Pradesh,5,17,18,1,41,Pass
Aditya Fernandes,28-04-2006,191646,Maharashtra,18,1,0,5,24,Pass
Aditya Singh,14-08-2005,542109,Karnataka,13,9,2,14,38,Pass
Yash Verma,22-09-2005,720992,Maharashtra,1,8,2,23,34,Pass
Vivaan Singh,20-07-2005,292415,Rajasthan,13,23,7,16,59,Pass
Aryan Verma,04-01-2006,756758,Madhya Pradesh,14,10,17,9,50,Pass
Yash Pillai,30-07-2005,375804,Gujarat,16,11,9,7,43,Fail
Vivaan Khan,11-12-2005,650020,Madhya Pradesh,13,24,13,5,55,Pass
Aditya Verma,12-05-2005,143645,Madhya Pradesh,20,6,19,4,49,Pass
Aryan Fernandes,15-04-2006,195765,Bihar,21,24,17,19,81,Pass
Raj Chopra,28-08-2005,525370,Rajasthan,12,14,24,2,52,Pass
Yash Fernandes,04-05-2005,320986,Gujarat,23,11,11,6,51,Fail
Aarav Mehta,01-10-2005,367293,Jammu & Kashmir + Ladakh,18,8,0,1,27,Pass
Raj Fernandes,05-06-2005,434316,Andhra Pradesh,3,5,1,3,12,Pass
Gurpreet Fernandes,25-11-2005,985646,Andhra Pradesh,16,13,1,21,51,Pass
Rehan Verma,10-07-2005,395717,Tamil Nadu,22,7,5,23,57,Pass
Aryan Fernandes,01-07-2005,978265,Punjab,11,8,11,4,34,Pass
Mathew Khan,01-06-2005,670928,Rajasthan,19,21,22,4,66,Pass
Vivaan Pillai,18-10-2005,378147,Uttar Pradesh,18,20,3,16,57,Pass
Gurpreet Verma,29-07-2005,882356,Karnataka,17,16,13,18,64,Pass
Paul Khan,16-11-2004,357137,Punjab,1,21,4,23,49,Pass
Balbir Singh,05-03-2006,217130,Madhya Pradesh,18,20,3,9,50,Pass
David Fernandes,09-03-2005,871210,Tamil Nadu,13,22,6,24,65,Pass
Paul Fernandes,18-07-2005,680484,Bihar,19,23,1,18,61,Pass
Yash Khan,24-05-2005,679826,Uttar Pradesh,16,18,4,20,58,Pass
Aditya Mehta,28-03-2005,258175,Maharashtra,5,8,8,20,41,Pass
Krishna Mehta,25-02-2005,447978,Odisha,5,5,21,20,51,Pass
Yash Singh,14-09-2005,476307,Andhra Pradesh,11,18,9,4,42,Pass
Yash Reddy,15-11-2004,216546,Assam,20,24,5,9,58,Pass
Gurpreet Reddy,11-02-2005,652311,West Bengal,10,22,3,15,50,Pass
Kunal Verma,17-03-2005,233857,Gujarat,15,24,16,3,58,Fail
Aryan Mehta,15-09-2005,242000,Bihar,15,1,0,6,22,Pass
Vivaan Singh,10-03-2005,964075,Andhra Pradesh,12,11,21,5,49,Pass
Rohan Fernandes,22-04-2005,628607,Madhya Pradesh,1,15,8,17,41,Pass
Balbir Mehta,02-03-2006,575540,Uttar Pradesh,12,15,17,14,58,Pass
Aarav Pillai,09-02-2005,996167,Andhra Pradesh,6,11,1,6,24,Pass
Aryan Verma,01-12-2004,287400,Manipur,14,3,20,14,51,Pass
Aryan Reddy,16-05-2005,257733,Tamil Nadu,16,9,18,9,52,Pass
Kunal D'Souza,16-04-2006,316406,Rajasthan,10,0,8,23,41,Pass
Aditya D'Souza,26-09-2005,517576,West Bengal,1,13,19,10,43,Pass
Vivaan Sharma,11-11-2004,127285,Assam,6,8,6,7,27,Pass
Yash Mehta,16-04-2006,725130,Andhra Pradesh,21,5,6,18,50,Pass
David Khan,10-06-2005,565260,Odisha,20,1,9,23,53,Pass
John Pillai,17-02-2006,246444,Maharashtra,14,19,20,3,56,Pass
Ishaan Mehta,25-08-2005,434661,Karnataka,9,7,18,0,34,Pass
Vivaan Reddy,07-11-2005,863728,Bihar,20,2,17,12,51,Pass
Rohan Chopra,25-11-2005,887628,Uttar Pradesh,21,13,22,10,66,Pass
Ishaan Verma,13-01-2006,130306,West Bengal,1,15,4,16,36,Pass
John Singh,04-01-2005,707757,Maharashtra,11,23,23,3,60,Pass
John Mehta,28-07-2005,310763,Jammu & Kashmir + Ladakh,2,8,7,16,33,Pass
Yash Singh,18-08-2005,825315,Karnataka,19,22,4,12,57,Pass
Aditya Pillai,06-09-2005,879908,Andhra Pradesh,20,21,12,7,60,Pass
Raj Reddy,10-02-2006,164723,West Bengal,3,19,19,17,58,Pass
Paul D'Souza,12-12-2004,657187,Maharashtra,3,4,8,6,21,Pass
Aryan Pillai,03-04-2006,361046,Rajasthan,10,17,0,18,45,Pass
Rohan Pillai,11-09-2005,628032,Gujarat,19,16,2,11,48,Fail
Manpreet Reddy,15-03-2005,217659,Kerala,7,19,0,24,50,Fail
Farhan Mehta,01-10-2005,984830,Maharashtra,10,8,18,10,46,Pass
Aditya Pillai,12-07-2005,458396,West Bengal,4,15,17,12,48,Pass
Balbir Mehta,24-11-2004,396434,Bihar,23,7,11,16,57,Pass
Aarav Pillai,08-10-2005,561715,West Bengal,3,21,2,18,44,Pass
Sukhwinder Mehta,19-11-2005,763455,West Bengal,3,11,21,23,58,Pass
Ishaan Khan,17-02-2005,470723,Odisha,1,18,15,1,35,Pass
Aditya D'Souza,31-07-2005,372698,Andhra Pradesh,5,8,15,5,33,Pass
Aryan Reddy,25-12-2005,443870,Assam,8,13,16,8,45,Pass
Krishna Pillai,04-04-2006,620303,West Bengal,3,5,24,5,37,Pass
Mathew Sharma,08-11-2005,824105,Gujarat,14,16,17,14,61,Fail
Zaid Singh,07-08-2005,461739,Uttar Pradesh,10,19,15,21,65,Pass
Manpreet Khan,12-03-2005,409759,Rajasthan,20,17,23,10,70,Pass
Kunal D'Souza,12-02-2005,203379,Karnataka,5,6,11,0,22,Pass
Balbir Verma,10-12-2005,993711,Bihar,9,19,20,4,52,Pass
Harjeet Verma,10-01-2006,370906,Uttarakhand,21,24,3,9,57,Pass
Yash Khan,15-08-2005,742370,Andhra Pradesh,14,4,11,2,31,Pass
Vivaan Mehta,05-12-2004,221774,Uttar Pradesh,16,19,19,8,62,Pass
Raj D'Souza,15-09-2005,202321,Rajasthan,0,15,8,7,30,Pass
Ishaan Sharma,21-07-2005,309991,Himachal Pradesh,12,10,12,13,47,Pass
Aarav Khan,22-06-2005,225195,Odisha,3,18,7,20,48,Pass
Balbir Pillai,23-01-2006,316917,Bihar,11,1,18,2,32,Pass
Rohan Fernandes,15-12-2004,367097,Punjab,24,0,4,14,42,Pass
Krishna Pillai,20-08-2005,217292,Odisha,10,2,20,2,34,Pass
Ishaan Pillai,26-12-2004,564244,Maharashtra,10,16,9,7,42,Pass
David D'Souza,01-06-2005,478457,Tamil Nadu,16,20,12,0,48,Pass
Rohan Fernandes,26-04-2006,322255,Madhya Pradesh,17,8,23,7,55,Pass
Yash Pillai,10-07-2005,642181,Uttar Pradesh,17,3,20,20,60,Pass
Aarav Khan,09-02-2005,818029,Maharashtra,16,22,5,3,46,Pass
Aarav Chopra,03-08-2005,620626,Bihar,11,1,5,12,29,Pass
Gurpreet Singh,10-11-2004,734966,Uttar Pradesh,19,6,24,19,68,Pass
Sukhwinder Singh,27-02-2006,931013,Haryana,15,7,14,18,54,Pass
Harjeet Verma,16-12-2004,827998,Himachal Pradesh,23,21,17,8,69,Fail
Peter Chopra,05-01-2005,207252,Jharkhand,19,9,12,17,57,Pass
Raj Chopra,02-02-2006,586927,Bihar,10,7,5,8,30,Pass
Gurpreet Fernandes,08-02-2006,925814,Maharashtra,19,18,1,5,43,Pass
Yash Reddy,24-12-2004,292546,Rajasthan,20,4,2,1,27,Pass
Sukhwinder Reddy,30-12-2004,685783,Tamil Nadu,7,3,8,14,32,Pass
Krishna D'Souza,21-11-2005,149568,Nagaland,6,7,7,6,26,Pass
David Sharma,16-07-2005,866550,Haryana,17,10,10,2,39,Pass
Rehan Singh,02-01-2005,285215,Chhattisgarh,19,23,15,14,71,Pass
Balbir Pillai,01-07-2005,900825,Maharashtra,1,7,5,5,18,Pass
Rohan Pillai,10-05-2005,580662,West Bengal,6,11,22,7,46,Pass
Paul Pillai,23-06-2005,783563,Odisha,18,20,1,14,53,Pass
Rohan Singh,17-12-2004,553940,Uttar Pradesh,7,4,13,3,27,Pass
Raj D'Souza,07-12-2005,417385,Karnataka,23,2,1,23,49,Pass
Yash Khan,16-02-2006,282925,Delhi,14,23,20,22,79,Pass
Yash Pillai,07-07-2005,464585,Bihar,21,23,16,20,80,Pass
Rehan Verma,23-01-2006,594097,Karnataka,17,8,5,19,49,Pass
Krishna Sharma,18-01-2006,951221,Jharkhand,3,2,15,18,38,Pass
Zaid Reddy,03-06-2005,495666,Jammu & Kashmir + Ladakh,9,6,4,2,21,Pass
Krishna Verma,25-12-2005,751148,Andhra Pradesh,12,13,6,19,50,Pass
Aarav Khan,23-02-2006,436598,Maharashtra,23,6,22,3,54,Pass
Ishaan Pillai,31-01-2005,740701,Jharkhand,16,22,18,3,59,Pass
John Verma,02-03-2006,564861,Madhya Pradesh,15,4,4,12,35,Pass
Krishna Pillai,21-09-2005,288352,Uttarakhand,2,9,0,11,22,Pass
Yash Chopra,15-09-2005,832292,Punjab,14,6,20,23,63,Pass
Aditya Verma,31-12-2005,274171,Maharashtra,7,6,19,3,35,Pass
Rohan Verma,12-02-2005,550973,Bihar,23,9,0,20,52,Pass
Ishaan Sharma,18-12-2004,233948,Gujarat,6,7,19,9,41,Fail
Manpreet Singh,30-04-2005,139512,Jharkhand,6,14,1,11,32,Pass
Rohan Chopra,24-07-2005,810211,Odisha,18,10,20,19,67,Pass
Rohan Verma,04-10-2005,443232,Maharashtra,15,3,24,5,47,Pass
Ayaan Khan,27-05-2005,565295,Uttar Pradesh,8,9,3,14,34,Pass
Gurpreet Khan,15-12-2004,753979,Uttar Pradesh,14,14,12,5,45,Pass
Raj Khan,27-12-2005,805671,Tamil Nadu,24,12,18,5,59,Pass
Yash Singh,16-08-2005,975967,Bihar,2,23,14,6,45,Pass
Harjeet Reddy,06-10-2005,824594,Assam,2,4,17,13,36,Pass
Manpreet Fernandes,30-01-2005,650872,Tamil Nadu,24,10,23,0,57,Pass
Vivaan Mehta,19-12-2004,812827,Madhya Pradesh,13,8,19,12,52,Pass
Aditya Fernandes,28-05-2005,319257,Madhya Pradesh,16,18,0,16,50,Pass
David Singh,27-11-2004,894360,Punjab,16,13,6,2,37,Pass
Harjeet D'Souza,26-03-2006,807574,Bihar,13,23,16,18,70,Pass
Yash Chopra,22-07-2005,874808,Maharashtra,7,17,10,3,37,Pass
Rohan Khan,28-08-2005,554728,Maharashtra,8,1,9,13,31,Pass
Harjeet Pillai,16-10-2005,830594,Delhi,13,21,9,19,62,Pass
Harjeet Reddy,28-11-2005,901656,Andhra Pradesh,10,9,4,7,30,Pass
Ishaan Sharma,21-07-2005,167884,Kerala,4,5,20,0,29,Fail
Krishna Pillai,03-04-2006,780318,Bihar,5,21,24,1,51,Pass
Raj Sharma,05-09-2005,378545,Uttar Pradesh,23,10,23,5,61,Pass
Mathew Pillai,10-03-2006,733332,Andhra Pradesh,16,19,11,21,67,Pass
Raj Mehta,12-03-2005,947775,Andhra Pradesh,3,12,2,7,24,Pass
Manpreet D'Souza,04-10-2005,110541,Uttar Pradesh,18,22,15,16,71,Pass
Kunal Pillai,02-11-2005,797715,Punjab,0,4,2,9,15,Pass
Yash Fernandes,26-05-2005,387721,Maharashtra,16,5,20,3,44,Pass
Ishaan Singh,11-12-2005,539681,Tamil Nadu,21,13,18,4,56,Pass
Imran Reddy,22-12-2004,409020,Rajasthan,9,12,22,20,63,Pass
Ishaan D'Souza,12-05-2005,644194,Uttar Pradesh,4,24,5,15,48,Pass
Rohan Khan,25-10-2005,592270,Bihar,1,11,18,20,50,Pass
Rohan D'Souza,13-07-2005,666892,Assam,1,16,22,13,52,Pass
Vivaan Reddy,01-05-2006,400950,Uttar Pradesh,15,14,18,20,67,Pass
Aarav Verma,01-01-2006,470390,Telangana,14,5,22,7,48,Pass
Krishna Mehta,12-03-2006,700140,Jharkhand,21,12,3,23,59,Pass
Aarav Pillai,03-07-2005,667535,Uttar Pradesh,2,17,0,20,39,Pass
Aarav Khan,31-03-2006,766372,Karnataka,13,8,6,18,45,Pass
Aryan Sharma,22-11-2005,456008,Tripura,12,17,18,17,64,Pass
Raj Mehta,15-06-2005,673692,Karnataka,9,17,3,19,48,Pass
Gurpreet Reddy,18-10-2005,398729,Karnataka,2,12,10,9,33,Pass
John Khan,11-02-2006,754027,Manipur,1,5,12,2,20,Pass
Aryan Khan,01-03-2005,556099,Haryana,13,7,18,17,55,Pass
Aarav Sharma,21-10-2005,931784,Gujarat,6,5,3,9,23,Fail
Aarav Sharma,30-06-2005,115694,Chhattisgarh,6,1,14,20,41,Pass
Paul Sharma,03-11-2005,314259,Chhattisgarh,17,6,4,13,40,Pass
Manpreet Fernandes,19-12-2004,250236,Uttar Pradesh,5,11,8,1,25,Pass
Aarav Pillai,23-02-2006,644099,West Bengal,24,9,2,17,52,Pass
Aryan Singh,12-08-2005,980814,Maharashtra,16,17,8,3,44,Pass
Sukhwinder Singh,20-02-2006,399191,Maharashtra,2,19,1,23,45,Pass
Aarav D'Souza,14-03-2006,930738,West Bengal,3,18,10,23,54,Pass
Yash Chopra,20-04-2006,473895,Jharkhand,21,5,3,13,42,Pass
Sukhwinder Pillai,01-09-2005,675138,Tamil Nadu,3,19,23,24,69,Pass
Harjeet Fernandes,25-04-2006,946161,Punjab,14,14,0,14,42,Pass
Krishna Verma,08-12-2004,655622,Uttar Pradesh,10,14,11,22,57,Pass
Krishna Singh,27-12-2004,238115,Madhya Pradesh,7,24,12,3,46,Pass
Aarav Verma,01-05-2006,685945,Madhya Pradesh,23,16,3,19,61,Pass
Ayaan Pillai,09-01-2006,808060,Rajasthan,11,24,4,22,61,Pass
Aryan Pillai,01-02-2006,667352,Rajasthan,16,7,14,8,45,Pass
Raj Pillai,10-02-2006,170552,Rajasthan,19,4,16,18,57,Pass
Aryan Chopra,15-05-2005,214565,West Bengal,9,16,0,19,44,Pass
Aryan D'Souza,12-10-2005,787355,Madhya Pradesh,8,0,14,17,39,Pass
Sukhwinder Chopra,27-02-2006,684240,Bihar,15,23,22,7,67,Pass
Raj Pillai,23-01-2006,114696,West Bengal,0,12,0,14,26,Pass
John Mehta,24-05-2005,412641,Haryana,3,0,5,3,11,Pass
John Reddy,13-01-2006,671521,Telangana,2,21,22,2,47,Pass
Aditya Fernandes,30-10-2005,359694,West Bengal,6,5,9,8,28,Pass
Paul D'Souza,19-12-2004,182975,Maharashtra,19,23,19,3,64,Pass
Kunal Verma,16-11-2004,731637,Rajasthan,1,8,0,19,28,Pass
Krishna Fernandes,17-04-2006,414427,Uttar Pradesh,19,1,12,7,39,Pass
Paul Pillai,29-04-2005,274923,West Bengal,23,2,24,3,52,Pass
Aryan Pillai,22-11-2004,673893,Madhya Pradesh,3,6,12,11,32,Pass
Aarav Mehta,26-09-2005,600152,Punjab,1,3,13,21,38,Pass
Ishaan Chopra,24-04-2005,667317,Rajasthan,18,16,3,14,51,Pass
Ishaan Mehta,06-02-2005,404196,Maharashtra,4,3,12,24,43,Pass
Aditya Khan,05-08-2005,164073,Andhra Pradesh,5,0,11,0,16,Pass
Aarav D'Souza,26-03-2005,835873,Tamil Nadu,3,9,12,5,29,Pass
Ishaan Verma,05-05-2006,359900,Punjab,10,7,11,16,44,Pass
Gurpreet Mehta,20-09-2005,376466,Jharkhand,19,6,7,17,49,Pass
Krishna Chopra,01-05-2005,750783,Rajasthan,3,15,20,2,40,Pass
Raj Sharma,06-04-2005,477948,Uttar Pradesh,13,21,13,20,67,Pass
Gurpreet D'Souza,20-04-2006,189975,Karnataka,15,7,5,20,47,Pass
Imran Sharma,22-01-2006,355375,Uttar Pradesh,0,3,3,11,17,Pass
Balbir Verma,06-01-2005,118754,Odisha,1,4,13,5,23,Pass
Aarav Sharma,14-01-2005,327115,Uttar Pradesh,2,7,21,9,39,Pass
Manpreet Chopra,19-09-2005,810824,Haryana,11,15,20,14,60,Pass
Harjeet Fernandes,11-07-2005,814561,Uttar Pradesh,20,7,2,6,35,Pass
Ishaan Chopra,22-01-2005,702444,Gujarat,4,10,11,4,29,Fail
Yash Fernandes,10-08-2005,674755,Punjab,5,8,11,20,44,Pass
Manpreet Fernandes,11-08-2005,379868,Telangana,9,12,22,15,58,Fail
Aryan D'Souza,09-02-2006,581217,Jammu & Kashmir + Ladakh,0,12,4,20,36,Pass
Yash Reddy,23-04-2005,257959,Tamil Nadu,17,0,24,23,64,Pass
Aryan Pillai,30-04-2006,340751,Madhya Pradesh,23,6,3,19,51,Pass
Kunal Singh,20-03-2005,635975,Uttar Pradesh,24,10,10,0,44,Pass
Farhan Verma,03-09-2005,540663,Odisha,7,18,20,5,50,Pass
Aarav D'Souza,02-06-2005,337654,West Bengal,10,20,5,1,36,Pass
David Fernandes,17-01-2005,407601,West Bengal,3,22,14,2,41,Pass
Aryan D'Souza,09-06-2005,914086,Maharashtra,18,13,24,3,58,Pass
Krishna Chopra,26-08-2005,950713,Telangana,9,12,11,21,53,Fail
Sukhwinder Singh,22-10-2005,728151,Manipur,20,3,18,0,41,Pass
Harjeet Khan,10-11-2004,927594,Bihar,21,24,10,22,77,Pass
Vivaan Reddy,16-10-2005,144457,Madhya Pradesh,20,2,1,9,32,Pass
Rohan Sharma,25-02-2006,274582,Jharkhand,23,1,18,0,42,Pass
Krishna Chopra,06-07-2005,760675,Bihar,12,15,9,4,40,Pass
Rehan Chopra,28-05-2005,597095,Andhra Pradesh,6,0,16,12,34,Pass
Aarav Pillai,16-04-2005,377698,Uttar Pradesh,12,7,2,3,24,Pass
Ishaan Reddy,24-02-2005,845322,Punjab,17,5,24,24,70,Pass
Rohan Chopra,04-03-2005,461344,Rajasthan,23,6,19,12,60,Pass
David Pillai,30-01-2005,509783,Rajasthan,0,8,9,8,25,Pass
Aarav Verma,28-04-2006,666789,Bihar,18,2,21,12,53,Pass
Manpreet Reddy,01-04-2005,626449,Tamil Nadu,12,13,21,18,64,Pass
Kunal Singh,21-06-2005,212898,Maharashtra,0,21,14,1,36,Pass
Ishaan Mehta,21-12-2005,592961,Rajasthan,10,4,7,9,30,Pass
Kunal Sharma,03-03-2005,219384,Uttar Pradesh,22,0,5,8,35,Pass
Krishna Pillai,04-05-2005,219690,Uttar Pradesh,5,15,16,5,41,Pass
Harjeet Khan,29-12-2005,575525,Bihar,21,1,12,14,48,Pass
Raj Chopra,07-04-2006,252138,Odisha,1,19,13,20,53,Pass
Krishna Khan,25-12-2005,615326,Jammu & Kashmir + Ladakh,21,7,5,5,38,Pass
Krishna Fernandes,14-01-2005,418772,Jharkhand,15,7,5,0,27,Pass
Sukhwinder Sharma,13-09-2005,331733,Bihar,17,8,6,23,54,Pass
Sukhwinder Chopra,23-07-2005,497836,Uttar Pradesh,15,1,7,17,40,Pass
Manpreet Pillai,17-10-2005,512790,Uttar Pradesh,3,14,15,2,34,Pass
John Singh,17-08-2005,277997,Punjab,2,18,14,20,54,Pass
Rohan D'Souza,07-12-2005,676905,Andhra Pradesh,4,6,5,13,28,Pass
Harjeet Sharma,07-05-2005,220539,Kerala,6,3,19,21,49,Fail
Kunal Reddy,08-05-2005,400939,Karnataka,8,24,7,4,43,Pass
Aryan D'Souza,16-12-2005,908903,Andhra Pradesh,15,4,6,18,43,Pass
Gurpreet Singh,18-06-2005,347806,Haryana,12,0,6,22,40,Pass
Peter Khan,15-03-2006,131206,Bihar,20,16,24,16,76,Pass
Kunal Pillai,23-05-2005,629690,Karnataka,13,11,0,23,47,Pass
Rohan D'Souza,08-03-2005,546141,Nagaland,6,5,5,7,23,Pass
Aryan Reddy,27-12-2004,863481,West Bengal,6,11,22,4,43,Pass
Aryan Chopra,04-04-2006,586576,Jharkhand,9,20,14,22,65,Pass
Vivaan Khan,07-09-2005,962425,Jharkhand,5,21,4,17,47,Pass
Sukhwinder Khan,30-10-2005,930755,Rajasthan,9,15,19,3,46,Pass
Rohan Chopra,08-06-2005,907744,Bihar,0,2,13,7,22,Pass
Gurpreet Mehta,27-09-2005,349860,Uttar Pradesh,17,0,11,19,47,Pass
Mathew Pillai,24-02-2006,325649,Manipur,5,8,20,14,47,Pass
Raj Pillai,25-05-2005,436599,Uttar Pradesh,0,8,18,21,47,Pass
Kunal D'Souza,28-07-2005,347003,Jharkhand,9,6,2,24,41,Pass
Aryan Pillai,19-01-2005,101147,Bihar,14,19,5,7,45,Pass
Raj Fernandes,08-05-2006,831619,Punjab,21,24,20,20,85,Pass
Paul Sharma,28-11-2004,848791,West Bengal,14,4,16,6,40,Pass
Ishaan Singh,02-12-2005,331189,Tripura,21,15,9,4,49,Pass
Aditya Pillai,03-01-2006,921826,Rajasthan,3,18,15,7,43,Pass
Gurpreet Fernandes,29-04-2006,210954,Rajasthan,4,15,17,13,49,Pass
Balbir Reddy,28-04-2005,874029,Rajasthan,11,18,2,1,32,Pass
Aryan Pillai,12-10-2005,385252,Uttar Pradesh,8,19,24,19,70,Pass
Kunal Sharma,08-05-2006,456514,Bihar,4,3,6,3,16,Pass
Yash Reddy,04-09-2005,563911,Madhya Pradesh,24,14,4,14,56,Pass
Aditya Singh,05-01-2005,422813,Haryana,11,5,12,22,50,Pass
Kunal Reddy,30-12-2005,392039,Maharashtra,22,18,21,3,64,Pass
Peter Sharma,29-12-2004,699594,Andhra Pradesh,19,23,8,6,56,Pass
Kunal Reddy,13-12-2005,855145,Assam,1,22,10,6,39,Pass
Aryan Sharma,26-07-2005,683877,Madhya Pradesh,5,21,20,3,49,Pass
Manpreet Verma,02-10-2005,397861,Gujarat,19,23,23,6,71,Fail
Aditya Sharma,13-05-2005,139857,Karnataka,12,7,15,2,36,Pass
Rohan D'Souza,22-02-2006,803001,Madhya Pradesh,10,11,17,13,51,Pass
Aryan Pillai,11-02-2005,345865,Manipur,22,2,1,0,25,Pass
Vivaan Singh,04-08-2005,375321,Telangana,12,9,24,3,48,Pass
Ishaan Singh,06-10-2005,779641,Uttar Pradesh,13,8,17,6,44,Pass
Aryan Mehta,27-02-2005,149271,Bihar,9,4,23,9,45,Pass
Balbir Verma,18-10-2005,756423,West Bengal,3,20,15,22,60,Pass
Rohan Chopra,01-09-2005,260361,Rajasthan,7,4,0,9,20,Pass
Ishaan Mehta,10-04-2006,605990,Kerala,13,23,21,23,80,Fail
Rohan Pillai,13-02-2005,597201,Telangana,3,4,22,18,47,Pass
John D'Souza,02-04-2005,206918,Maharashtra,19,19,16,3,57,Pass
Ishaan Mehta,16-01-2005,682983,Madhya Pradesh,5,14,4,7,30,Pass
Ishaan Mehta,04-01-2005,107786,Bihar,12,18,16,17,63,Pass
Aarav Chopra,01-01-2005,716818,Gujarat,12,4,0,4,20,Fail
Aryan Verma,28-05-2005,832094,Maharashtra,4,1,23,19,47,Pass
Raj D'Souza,28-03-2006,709635,Rajasthan,14,8,3,9,34,Pass
Aarav Verma,21-08-2005,310423,Punjab,4,9,21,15,49,Pass
Manpreet D'Souza,03-12-2005,341955,Uttarakhand,24,0,3,23,50,Pass
Krishna Khan,04-02-2006,237967,Bihar,16,7,10,3,36,Pass
Rohan Khan,23-08-2005,206159,Uttar Pradesh,4,9,8,9,30,Pass
Krishna Fernandes,13-04-2006,509217,Tamil Nadu,9,10,18,2,39,Pass
Kunal Verma,07-04-2006,903342,West Bengal,10,7,14,0,31,Pass
Kunal Khan,06-12-2005,243286,Gujarat,7,22,24,10,63,Fail
Aryan Chopra,30-01-2006,170029,Madhya Pradesh,15,23,3,9,50,Pass
Aditya Fernandes,27-02-2006,205963,Rajasthan,23,6,21,16,66,Pass
Aryan Mehta,19-01-2005,540820,Jharkhand,4,9,14,21,48,Pass
David Singh,29-07-2005,895402,Himachal Pradesh,13,19,16,8,56,Pass
Kunal Chopra,12-03-2005,274995,Madhya Pradesh,7,12,17,15,51,Pass
Aarav Mehta,21-01-2006,191775,Kerala,11,6,16,10,43,Fail
Aarav Sharma,24-02-2006,533933,Rajasthan,0,12,5,19,36,Pass
Vivaan Fernandes,30-10-2005,667437,Bihar,18,1,23,12,54,Pass
Kunal Sharma,07-01-2005,669836,Odisha,5,11,8,9,33,Pass
Aditya Verma,26-03-2006,813195,Gujarat,0,5,12,15,32,Fail
Rohan Sharma,22-02-2005,245901,West Bengal,3,22,7,20,52,Pass
Peter Pillai,24-07-2005,596393,Bihar,22,6,14,15,57,Pass
Imran Reddy,12-03-2006,508600,Jharkhand,16,23,5,12,56,Pass
Rohan Singh,15-06-2005,110574,Uttar Pradesh,3,4,15,3,25,Pass
Aarav D'Souza,18-02-2005,887931,Rajasthan,23,11,10,1,45,Pass
Raj Chopra,20-11-2004,119864,Punjab,14,0,20,12,46,Pass
Krishna Sharma,06-04-2006,251861,Gujarat,3,20,23,17,63,Fail
Kunal Mehta,23-06-2005,764967,Haryana,7,20,24,19,70,Pass
Rohan Singh,22-02-2006,266437,Uttar Pradesh,18,11,5,22,56,Pass
David Chopra,25-02-2006,106407,Punjab,8,10,13,21,52,Pass
Peter Mehta,04-12-2004,840123,Assam,15,12,12,3,42,Pass
Yash Khan,16-11-2004,419362,Tripura,20,12,23,23,78,Pass
Paul Mehta,03-03-2006,538662,Bihar,16,21,12,4,53,Pass
Gurpreet Verma,02-03-2005,278530,Tamil Nadu,20,5,2,17,44,Pass
Raj Khan,27-08-2005,118079,Andhra Pradesh,4,21,8,12,45,Pass
Vivaan Verma,09-11-2004,265609,Maharashtra,1,24,22,3,50,Pass
Aryan D'Souza,24-12-2005,600299,Odisha,5,2,3,21,31,Pass
David Pillai,10-08-2005,727994,Madhya Pradesh,6,10,8,15,39,Pass
Imran Pillai,16-04-2006,476449,Uttar Pradesh,11,7,17,4,39,Pass
Yash Sharma,04-02-2005,200380,Meghalaya,2,13,20,18,53,Pass
Kunal Reddy,18-09-2005,137722,Uttar Pradesh,17,3,24,16,60,Pass
Kunal Fernandes,06-03-2006,325221,Tamil Nadu,21,7,18,11,57,Pass
Rohan Chopra,23-10-2005,112221,Maharashtra,14,5,13,3,35,Pass
Ishaan Khan,07-04-2006,955463,Maharashtra,16,0,19,12,47,Pass
Kunal Sharma,26-02-2005,792894,Kerala,15,4,24,10,53,Fail
Ayaan Khan,22-07-2005,469625,West Bengal,11,21,2,2,36,Pass
Balbir D'Souza,06-03-2005,315941,Bihar,9,8,0,9,26,Pass
Raj Verma,04-03-2006,173917,Telangana,5,11,3,18,37,Pass
Yash Reddy,29-12-2005,223597,West Bengal,0,22,2,4,28,Pass
Aditya Reddy,27-03-2005,646793,Chhattisgarh,15,9,21,13,58,Pass
Zaid Verma,21-12-2005,309006,Tamil Nadu,6,15,18,0,39,Pass
Aryan Pillai,27-02-2006,378700,Kerala,12,19,8,21,60,Fail
Krishna Sharma,30-12-2005,856335,Himachal Pradesh,0,7,15,15,37,Pass
Harjeet Verma,15-02-2006,566431,Karnataka,4,3,15,4,26,Pass
Sukhwinder Sharma,01-07-2005,370635,Madhya Pradesh,4,11,9,23,47,Pass
Aarav Mehta,31-07-2005,726646,Tamil Nadu,18,8,20,22,68,Pass
Harjeet Khan,24-11-2005,585274,Maharashtra,2,20,23,3,48,Pass
Rohan D'Souza,06-10-2005,977261,Maharashtra,19,21,17,3,60,Pass
Aarav Chopra,05-03-2006,772208,Uttarakhand,7,24,6,5,42,Pass
Kunal Mehta,16-07-2005,165152,Telangana,9,5,8,4,26,Pass
Balbir Khan,07-01-2006,518628,Jharkhand,4,11,10,1,26,Pass
Peter Verma,21-11-2004,208045,Madhya Pradesh,0,14,22,2,38,Pass
Kunal Reddy,17-10-2005,720937,Maharashtra,24,0,9,3,36,Pass
Raj Mehta,17-01-2005,921674,Tamil Nadu,8,3,0,20,31,Pass
Raj Sharma,16-04-2006,619261,Maharashtra,6,18,5,2,31,Pass
Aryan D'Souza,30-03-2005,737492,Andhra Pradesh,9,24,23,3,59,Pass
Aditya Singh,12-08-2005,101036,Karnataka,13,12,12,9,46,Pass
Vivaan Mehta,15-10-2005,102853,Rajasthan,19,9,19,8,55,Pass
Gurpreet Sharma,05-11-2005,643578,Tamil Nadu,8,15,24,15,62,Pass
Kunal Chopra,16-04-2005,584402,Rajasthan,4,9,22,18,53,Pass
John Verma,26-05-2005,886412,Bihar,21,23,11,22,77,Pass
John Chopra,01-11-2005,908596,Haryana,5,21,18,0,44,Pass
Ishaan Mehta,14-02-2006,449491,Karnataka,18,8,4,8,38,Pass
Rohan Khan,14-02-2006,921223,Punjab,24,4,16,11,55,Pass
Paul Singh,26-02-2006,418569,Bihar,14,13,21,7,55,Pass
Aditya Khan,14-05-2005,509647,Assam,22,0,15,19,56,Pass
Raj Mehta,11-01-2005,520044,Uttar Pradesh,6,17,15,24,62,Pass
Raj Singh,28-04-2005,508466,Bihar,16,1,13,16,46,Pass
Aditya Sharma,12-12-2004,560903,Rajasthan,22,2,8,3,35,Pass
Sukhwinder Sharma,21-01-2005,848137,Karnataka,16,7,14,14,51,Pass
Aditya Reddy,15-12-2005,715579,Haryana,5,12,18,22,57,Pass
Sukhwinder Verma,12-05-2005,681006,Uttar Pradesh,23,5,2,12,42,Pass
Vivaan Mehta,16-02-2006,750308,Tamil Nadu,22,8,11,22,63,Pass
Paul Sharma,23-04-2005,934328,Uttar Pradesh,20,8,1,6,35,Pass
Aarav Fernandes,25-07-2005,187509,Tamil Nadu,12,16,17,1,46,Pass
Krishna Reddy,28-11-2004,614410,Uttarakhand,18,3,3,22,46,Pass
Krishna Khan,15-10-2005,909830,Gujarat,18,14,24,15,71,Fail
Krishna Sharma,19-12-2004,212217,Maharashtra,20,14,21,3,58,Pass
Kunal Singh,14-10-2005,134240,Tamil Nadu,24,2,2,13,41,Pass
Balbir Sharma,02-05-2006,939123,Delhi,24,2,20,1,47,Pass
Imran Pillai,04-04-2005,885760,Punjab,10,2,11,24,47,Pass
Krishna Chopra,24-05-2005,409806,Maharashtra,10,9,24,3,46,Pass
Raj Khan,29-11-2004,666873,West Bengal,4,9,19,15,47,Pass
Kunal D'Souza,13-11-2004,599557,Bihar,2,7,0,14,23,Pass
John Pillai,19-11-2005,359102,Assam,9,9,3,2,23,Pass
Krishna Fernandes,21-11-2005,235921,Haryana,2,1,3,24,30,Pass
Raj Fernandes,28-12-2005,201760,Tamil Nadu,11,4,1,12,28,Pass
Rohan Chopra,15-10-2005,819739,West Bengal,8,6,9,2,25,Pass
Aryan D'Souza,06-09-2005,571980,Madhya Pradesh,0,24,19,11,54,Pass
Aryan Fernandes,18-02-2005,743448,Uttar Pradesh,11,6,6,19,42,Pass
Aryan Chopra,27-12-2005,889585,Punjab,5,0,14,21,40,Pass
Ishaan Pillai,16-06-2005,782139,Rajasthan,14,23,24,5,66,Pass
Aditya D'Souza,03-10-2005,224366,West Bengal,16,7,16,10,49,Pass
Rohan Chopra,09-12-2005,835580,Uttar Pradesh,22,3,23,16,64,Pass
Aditya Chopra,28-11-2004,256220,Uttar Pradesh,11,6,9,5,31,Pass
Krishna Verma,14-06-2005,295136,Andhra Pradesh,24,11,21,0,56,Pass
Vivaan Singh,09-08-2005,495173,Rajasthan,8,23,7,1,39,Pass
David Reddy,31-01-2005,156181,Assam,12,8,7,21,48,Pass
Vivaan Sharma,15-05-2005,631830,Maharashtra,6,23,23,3,55,Pass
Rohan Verma,07-12-2005,817267,Punjab,10,10,9,21,50,Pass
Raj D'Souza,08-02-2005,633300,Punjab,9,17,0,1,27,Pass
John D'Souza,05-02-2006,145311,West Bengal,13,23,1,7,44,Pass
Balbir Chopra,24-04-2006,784305,Gujarat,7,21,17,16,61,Fail
Aditya Reddy,15-04-2006,585885,Rajasthan,22,1,12,14,49,Pass
Vivaan Chopra,06-01-2006,800436,Madhya Pradesh,1,10,8,3,22,Pass
Aarav Chopra,21-09-2005,972549,West Bengal,3,21,2,20,46,Pass
Aarav Mehta,05-02-2005,361325,Assam,6,8,21,0,35,Pass
Rohan Reddy,29-03-2006,306954,Haryana,24,21,18,17,80,Pass
Balbir Singh,18-04-2005,980582,Tamil Nadu,9,3,8,15,35,Pass
Imran Chopra,01-01-2006,989820,Maharashtra,19,13,19,3,54,Pass
Ayaan Pillai,03-05-2005,650752,Telangana,2,5,3,23,33,Pass
Yash Singh,24-03-2005,986214,Delhi,8,17,6,23,54,Pass
Manpreet Fernandes,27-04-2005,148976,Punjab,5,22,8,18,53,Pass
Krishna Pillai,05-01-2006,992320,Bihar,24,21,22,19,86,Pass
Manpreet Singh,22-07-2005,531803,Andhra Pradesh,4,2,1,12,19,Pass
Aryan Fernandes,23-07-2005,574888,Madhya Pradesh,3,6,1,24,34,Pass
Ishaan Pillai,20-01-2005,350927,Madhya Pradesh,22,10,3,11,46,Pass
Rohan Verma,25-12-2005,904461,Andhra Pradesh,18,24,7,7,56,Pass
Kunal D'Souza,12-03-2006,857711,Himachal Pradesh,17,6,3,15,41,Pass
John Singh,25-03-2006,263389,Gujarat,8,13,16,14,51,Fail
Ishaan Khan,16-06-2005,339527,Tamil Nadu,2,14,2,8,26,Pass
Harjeet D'Souza,10-03-2006,799537,Assam,6,4,16,18,44,Pass
Aarav Verma,14-10-2005,896814,West Bengal,21,13,3,0,37,Pass
Yash Reddy,28-09-2005,881029,Karnataka,10,0,0,6,16,Pass
Mathew Reddy,09-11-2005,381763,Uttar Pradesh,7,22,13,4,46,Pass
Yash Singh,19-11-2005,988634,Telangana,6,23,21,1,51,Pass
Ishaan Fernandes,05-12-2004,520060,Rajasthan,22,13,22,5,62,Pass
Krishna Fernandes,19-12-2005,817968,Assam,23,0,0,14,37,Pass
Raj Chopra,18-12-2005,529597,Uttarakhand,6,0,1,15,22,Pass
Raj Reddy,28-10-2005,763557,Rajasthan,10,6,23,22,61,Pass
Aarav Chopra,30-04-2006,955458,Maharashtra,5,15,12,3,35,Pass
Krishna Pillai,05-02-2006,208271,Assam,19,18,14,5,56,Pass
Raj Pillai,24-07-2005,181767,Karnataka,14,5,17,13,49,Pass
Kunal Singh,10-02-2006,947309,Bihar,3,23,21,22,69,Pass
Harjeet Chopra,28-11-2004,121958,Tamil Nadu,9,14,8,23,54,Pass
Aryan Fernandes,30-03-2006,486200,West Bengal,3,22,16,12,53,Pass
Kunal Khan,16-02-2005,580349,Maharashtra,4,4,10,14,32,Pass
David Reddy,23-11-2005,388973,West Bengal,16,13,10,4,43,Pass
Kunal Fernandes,04-01-2006,759125,West Bengal,1,5,7,9,22,Pass
Balbir Mehta,06-05-2005,435311,West Bengal,22,16,8,1,47,Pass
Gurpreet Mehta,22-02-2005,629691,Haryana,21,11,3,22,57,Pass
David Khan,03-12-2004,454176,Chhattisgarh,7,14,0,22,43,Pass
Aarav Mehta,20-02-2006,369273,Punjab,4,13,4,24,45,Pass
Gurpreet Reddy,30-04-2006,871287,Andaman & Nicobar,5,20,0,5,30,Pass
Krishna Verma,11-01-2006,933173,Uttar Pradesh,20,4,8,2,34,Pass
Manpreet D'Souza,18-02-2006,103605,Maharashtra,14,9,18,4,45,Pass
Rohan Verma,21-04-2005,318098,Assam,2,10,11,7,30,Pass
Yash Khan,31-08-2005,370406,Manipur,7,3,24,11,45,Pass
Balbir Singh,28-02-2006,320267,Bihar,19,8,18,10,55,Pass
Gurpreet Chopra,11-05-2005,123178,Haryana,0,21,7,6,34,Pass
Kunal Chopra,09-03-2006,710668,West Bengal,3,18,10,9,40,Pass
Gurpreet Pillai,06-02-2005,357997,Uttar Pradesh,10,14,10,0,34,Pass
Aryan D'Souza,17-02-2006,149544,Jharkhand,15,5,7,19,46,Pass
Yash Reddy,14-05-2005,613615,Rajasthan,0,7,11,21,39,Pass
Ishaan Khan,09-11-2004,603799,Rajasthan,13,19,8,23,63,Pass
Paul D'Souza,25-10-2005,104717,Karnataka,2,12,7,14,35,Pass
Kunal Chopra,01-04-2005,744587,Haryana,8,9,12,3,32,Pass
Aditya Fernandes,09-03-2006,401911,Rajasthan,5,8,18,15,46,Pass
Rohan Chopra,05-09-2005,310009,Assam,6,18,10,18,52,Pass
Raj Sharma,30-04-2005,551556,Punjab,12,11,19,22,64,Pass
Aditya Fernandes,15-11-2005,560392,West Bengal,13,11,14,14,52,Pass
Aarav Verma,22-08-2005,840890,Gujarat,18,5,12,7,42,Fail
Yash Fernandes,09-02-2006,537931,Uttar Pradesh,14,22,2,10,48,Pass
Gurpreet Singh,27-08-2005,506490,Madhya Pradesh,0,13,6,7,26,Pass
Krishna Fernandes,11-03-2006,103053,Chhattisgarh,8,8,20,1,37,Pass
Paul Verma,23-04-2005,323496,Telangana,24,17,24,3,68,Pass
John Khan,30-06-2005,120178,Haryana,9,13,1,21,44,Pass
Peter Sharma,25-02-2005,630940,Rajasthan,8,13,15,7,43,Pass
Krishna Sharma,28-02-2006,368430,Andhra Pradesh,0,12,18,21,51,Pass
Vivaan Chopra,16-12-2005,438120,Gujarat,3,14,19,21,57,Fail
Harjeet Verma,09-06-2005,871437,Rajasthan,13,2,12,10,37,Pass
Krishna Mehta,06-12-2004,844731,Bihar,23,5,7,16,51,Pass
Yash D'Souza,29-04-2005,777734,Maharashtra,15,12,23,3,53,Pass
Yash Khan,03-03-2006,854987,Gujarat,12,22,6,14,54,Fail
Krishna Pillai,07-07-2005,771936,Uttar Pradesh,17,9,16,17,59,Pass
Gurpreet Sharma,05-11-2005,872865,Uttar Pradesh,14,3,18,23,58,Pass
David Verma,28-02-2006,444758,Madhya Pradesh,5,12,3,8,28,Pass
Gurpreet Chopra,22-07-2005,662849,Haryana,11,15,15,8,49,Pass
Krishna Khan,24-09-2005,639081,Maharashtra,6,17,5,10,38,Pass
Gurpreet Singh,27-01-2005,834993,Maharashtra,2,13,0,3,18,Pass
Rohan Fernandes,20-10-2005,669804,West Bengal,15,1,24,13,53,Pass
Krishna Fernandes,06-03-2005,881657,Madhya Pradesh,4,12,13,9,38,Pass
Aditya Fernandes,08-03-2006,739695,Mizoram,1,16,24,6,47,Fail
Aditya D'Souza,03-08-2005,469820,Jharkhand,14,1,6,20,41,Pass
Yash Singh,26-03-2006,412744,Tamil Nadu,17,7,1,23,48,Pass
John Pillai,13-06-2005,325281,West Bengal,10,10,15,3,38,Pass
Manpreet Singh,29-03-2005,292083,Telangana,16,7,4,9,36,Pass
Balbir Verma,26-04-2006,483007,Rajasthan,13,15,9,20,57,Pass
Yash Chopra,15-08-2005,735475,Uttar Pradesh,18,3,20,12,53,Pass
Harjeet Fernandes,10-04-2005,993383,Gujarat,24,0,17,15,56,Fail
Krishna Chopra,09-06-2005,678408,Chhattisgarh,21,17,9,9,56,Pass
Rohan Khan,21-05-2005,301353,Rajasthan,1,13,17,13,44,Pass
Yash Sharma,30-11-2005,201317,Rajasthan,11,20,17,0,48,Pass
Ishaan Khan,05-06-2005,320445,Uttar Pradesh,24,3,20,20,67,Pass
Krishna Chopra,05-04-2005,164126,West Bengal,10,10,9,24,53,Pass
John Reddy,20-04-2005,345422,Himachal Pradesh,14,8,9,14,45,Pass
Kunal Khan,02-02-2006,507496,Rajasthan,14,15,10,22,61,Pass
Aryan Khan,03-05-2006,989406,Bihar,6,1,21,11,39,Pass
Aryan Pillai,06-01-2005,626574,Andhra Pradesh,14,5,4,6,29,Pass
Rehan D'Souza,02-02-2006,590871,Rajasthan,11,20,6,6,43,Pass
Vivaan Fernandes,29-11-2005,137890,Meghalaya,1,21,2,3,27,Pass
Kunal Khan,11-06-2005,556154,Madhya Pradesh,6,21,1,23,51,Pass
Manpreet Mehta,01-03-2006,679743,West Bengal,2,14,1,18,35,Pass
Ishaan Pillai,14-11-2005,823368,Haryana,19,9,7,5,40,Pass
Aryan Khan,27-01-2006,169784,Tamil Nadu,9,19,10,15,53,Pass
Ishaan Chopra,12-12-2005,935254,Uttar Pradesh,12,17,5,8,42,Pass
Balbir Sharma,25-02-2005,711974,Uttar Pradesh,20,13,0,20,53,Pass
Ishaan Chopra,06-06-2005,736411,Uttar Pradesh,19,16,14,20,69,Pass
Peter Fernandes,28-02-2005,918787,Bihar,22,11,21,0,54,Pass
Rohan Fernandes,19-12-2005,198589,Uttar Pradesh,21,1,6,21,49,Pass
Rohan Singh,03-02-2006,125784,Telangana,18,14,4,21,57,Pass
Vivaan Reddy,18-03-2006,183311,Tamil Nadu,23,5,16,8,52,Pass
Vivaan Sharma,26-08-2005,246024,Rajasthan,12,18,18,3,51,Pass
Farhan Mehta,20-11-2005,116107,Telangana,17,24,11,3,55,Pass
Aditya Khan,28-09-2005,605578,Madhya Pradesh,19,11,3,14,47,Pass
Aryan Sharma,19-11-2004,265865,Madhya Pradesh,9,8,20,3,40,Pass
Kunal Verma,02-04-2006,507961,Gujarat,23,23,7,23,76,Fail
Ishaan Pillai,22-11-2005,830176,Bihar,8,14,2,13,37,Pass
Yash Pillai,31-05-2005,148003,Delhi,8,15,10,6,39,Pass
Balbir Singh,05-03-2006,609055,Chhattisgarh,4,6,9,6,25,Pass
Krishna D'Souza,08-08-2005,835965,Haryana,13,1,9,2,25,Pass
Aditya Singh,20-11-2005,241609,Bihar,11,6,7,19,43,Pass
Kunal Singh,18-02-2005,666696,Jharkhand,22,17,4,11,54,Pass
Krishna Chopra,16-06-2005,109398,Tamil Nadu,9,19,16,8,52,Pass
Vivaan Fernandes,15-04-2006,619122,West Bengal,3,24,23,10,60,Pass
Vivaan Singh,14-11-2005,701361,Andhra Pradesh,22,7,3,13,45,Pass
Gurpreet Chopra,13-11-2005,552897,Gujarat,22,16,19,10,67,Fail
Sukhwinder Fernandes,31-07-2005,391850,Uttar Pradesh,7,19,18,16,60,Pass
Kunal Verma,27-04-2006,277546,West Bengal,21,8,12,12,53,Pass
Krishna D'Souza,29-11-2005,643098,Tamil Nadu,0,14,3,21,38,Pass
Rehan Pillai,09-12-2005,575824,Punjab,20,20,7,0,47,Pass
Krishna Mehta,24-02-2005,179962,Chhattisgarh,17,16,10,13,56,Pass
Krishna Sharma,18-10-2005,389845,Karnataka,12,15,1,17,45,Pass
Aryan Pillai,27-03-2005,568592,Chhattisgarh,23,6,24,0,53,Pass
Yash Sharma,02-03-2005,462245,Assam,4,15,22,3,44,Pass
Vivaan Fernandes,24-12-2005,349532,Uttarakhand,21,19,3,21,64,Pass
Aditya Sharma,04-09-2005,387190,Uttar Pradesh,6,6,1,18,31,Pass
Rohan D'Souza,05-10-2005,695345,Maharashtra,14,23,14,3,54,Pass
Kunal Chopra,27-04-2005,840526,Meghalaya,6,14,21,18,59,Pass
Rohan D'Souza,05-04-2006,498588,Bihar,18,21,15,18,72,Pass
Kunal Verma,13-12-2005,511109,Uttar Pradesh,6,0,19,19,44,Pass
Raj Mehta,14-12-2004,737283,Rajasthan,1,4,21,2,28,Pass
Ishaan Chopra,18-01-2006,344964,Bihar,20,0,10,13,43,Pass
Ishaan Chopra,21-07-2005,985207,Tamil Nadu,5,3,14,7,29,Pass
Aarav D'Souza,15-11-2005,969125,Bihar,19,24,2,14,59,Pass
Yash Chopra,29-06-2005,628045,Kerala,20,16,5,8,49,Fail
Raj Khan,13-01-2005,960907,Jharkhand,17,15,16,19,67,Pass
Vivaan Pillai,29-09-2005,380963,Madhya Pradesh,8,13,16,12,49,Pass
Raj Khan,26-06-2005,409691,Chhattisgarh,8,11,19,14,52,Pass
Yash Pillai,12-03-2006,407837,Bihar,11,14,8,5,38,Pass
Balbir Pillai,14-11-2005,200450,Rajasthan,13,13,13,10,49,Pass
Harjeet Reddy,19-11-2004,715020,Punjab,15,7,23,3,48,Pass
Yash Chopra,27-11-2005,589095,Bihar,8,9,11,19,47,Pass
Balbir Sharma,02-07-2005,180006,Gujarat,6,12,8,19,45,Fail
Yash Reddy,21-08-2005,170916,Gujarat,16,5,0,18,39,Fail
Sukhwinder D'Souza,23-12-2005,311562,Maharashtra,10,19,20,0,49,Pass
Yash D'Souza,31-12-2005,561921,Rajasthan,13,14,20,9,56,Pass
Rohan Pillai,21-11-2005,402972,Maharashtra,10,6,21,3,40,Pass
Aarav Chopra,29-11-2005,901205,Andhra Pradesh,13,10,14,7,44,Pass
David Fernandes,13-01-2005,642899,Madhya Pradesh,23,23,3,6,55,Pass
Gurpreet Reddy,12-11-2004,599105,Tamil Nadu,11,7,1,4,23,Pass
Rehan Fernandes,07-11-2005,594995,Andhra Pradesh,20,9,21,13,63,Pass
Aryan Khan,18-01-2006,221197,West Bengal,3,14,24,4,45,Pass
Rohan Reddy,29-08-2005,522801,Uttar Pradesh,7,21,10,4,42,Pass
Balbir Khan,31-01-2006,805132,Tamil Nadu,19,15,17,14,65,Pass
Krishna Chopra,28-07-2005,643700,Telangana,2,18,20,7,47,Pass
Sukhwinder Mehta,27-12-2005,883113,West Bengal,12,14,8,13,47,Pass
Ishaan Reddy,22-12-2005,755994,Uttar Pradesh,14,23,10,17,64,Pass
Aryan Fernandes,24-04-2005,780881,Haryana,23,20,5,18,66,Pass
Yash Fernandes,04-12-2005,658362,Haryana,16,2,19,24,61,Pass
Aditya Verma,09-07-2005,755154,Bihar,18,2,3,19,42,Pass
Gurpreet Fernandes,07-04-2006,571333,Rajasthan,23,17,10,13,63,Pass
Aryan Chopra,31-03-2006,703074,Punjab,10,21,21,5,57,Pass
Ishaan Khan,05-12-2004,970164,Bihar,11,23,17,4,55,Pass
Balbir Sharma,24-11-2004,144141,Karnataka,17,18,6,4,45,Pass
Vivaan Verma,26-03-2006,450517,Tamil Nadu,11,0,14,8,33,Pass
Raj Fernandes,04-04-2006,561576,Andhra Pradesh,5,5,13,16,39,Pass
Sukhwinder Sharma,24-04-2005,277508,Maharashtra,18,16,4,3,41,Pass
Sukhwinder Chopra,18-10-2005,928105,Uttar Pradesh,16,23,22,6,67,Pass
Rohan Verma,10-12-2004,784750,Uttar Pradesh,22,3,14,4,43,Pass
Aryan Verma,01-01-2005,303173,Bihar,21,1,2,15,39,Pass
Vivaan Verma,11-06-2005,351336,Maharashtra,3,21,11,3,38,Pass
Krishna Chopra,04-03-2006,675246,Gujarat,18,19,4,12,53,Fail
Raj D'Souza,11-03-2005,302050,Andhra Pradesh,0,5,9,24,38,Pass
Vivaan Reddy,25-02-2006,499546,Haryana,3,14,14,12,43,Pass
Peter D'Souza,21-11-2005,644815,Chhattisgarh,14,6,3,6,29,Pass
Ishaan Reddy,07-04-2005,976971,Punjab,22,15,24,3,64,Pass
Sukhwinder Mehta,30-10-2005,594160,West Bengal,18,8,2,19,47,Pass
Aarav Mehta,09-01-2005,405107,Andhra Pradesh,5,22,5,3,35,Pass
Raj Khan,05-03-2006,178316,Haryana,8,18,0,18,44,Pass
Rehan Sharma,28-01-2006,420197,Andhra Pradesh,7,20,12,0,39,Pass
Aarav Verma,22-11-2005,503132,Rajasthan,2,13,20,16,51,Pass
Yash Chopra,18-09-2005,259243,Andhra Pradesh,17,10,6,8,41,Pass
Gurpreet Khan,08-07-2005,337318,Uttarakhand,0,15,6,1,22,Pass
Kunal Sharma,12-11-2005,690980,Jharkhand,12,12,6,19,49,Pass
Rohan Chopra,05-11-2005,228196,Assam,6,1,13,15,35,Pass
Raj Khan,24-11-2004,656563,Kerala,16,11,16,7,50,Fail
Aditya Singh,18-02-2006,970305,Rajasthan,2,8,20,2,32,Pass
Aryan Fernandes,26-02-2005,893405,Rajasthan,6,0,4,21,31,Pass
Kunal D'Souza,04-03-2005,426532,Uttar Pradesh,21,14,10,13,58,Pass
Peter Verma,07-04-2005,381704,Madhya Pradesh,10,21,3,20,54,Pass
Yash Fernandes,12-09-2005,504313,Bihar,1,23,13,16,53,Pass
Balbir Fernandes,18-04-2006,213823,Sikkim,21,23,5,3,52,Pass
Ishaan Chopra,14-04-2005,166331,Uttar Pradesh,17,13,22,0,52,Pass
Farhan Sharma,01-05-2005,964628,Punjab,16,19,4,13,52,Pass
Aarav Reddy,05-02-2005,348707,Jharkhand,24,3,17,17,61,Pass
Aryan Pillai,13-02-2006,436044,Maharashtra,13,5,21,4,43,Pass
Vivaan Fernandes,25-03-2006,785065,Bihar,15,10,3,18,46,Pass
Mathew Reddy,29-09-2005,970087,Bihar,13,6,15,10,44,Pass
Manpreet Pillai,19-12-2005,555867,Haryana,20,4,9,23,56,Pass
Aryan Reddy,08-09-2005,728124,West Bengal,3,23,22,16,64,Pass
Vivaan D'Souza,03-02-2006,363419,Andhra Pradesh,24,0,16,19,59,Pass
Sukhwinder Verma,22-07-2005,427838,Punjab,20,13,6,10,49,Pass
Kunal Singh,17-07-2005,919116,Telangana,21,9,8,13,51,Pass
Rohan Verma,20-02-2005,744532,West Bengal,10,6,18,9,43,Pass
Aryan Mehta,11-01-2006,721353,Andhra Pradesh,6,11,16,23,56,Pass
Aryan Chopra,17-11-2005,461531,Bihar,2,2,4,18,26,Pass
Krishna Verma,17-04-2005,849624,Assam,5,19,0,22,46,Pass
Raj Sharma,08-12-2004,418850,Bihar,20,11,6,18,55,Pass
Aryan Sharma,18-03-2005,404031,Karnataka,5,13,3,10,31,Pass
Raj Singh,06-06-2005,480058,Haryana,12,3,5,4,24,Pass
Yash Singh,22-04-2006,543021,Rajasthan,17,19,11,19,66,Pass
Aditya D'Souza,03-05-2005,391564,Uttar Pradesh,13,2,12,9,36,Pass
Paul Mehta,15-08-2005,526926,Maharashtra,8,1,14,11,34,Pass
Kunal Chopra,18-02-2006,806219,Rajasthan,10,15,1,17,43,Pass
John Mehta,15-05-2005,560984,Uttar Pradesh,4,7,12,19,42,Pass
Mathew Mehta,14-05-2005,815735,Madhya Pradesh,16,14,3,23,56,Pass
Aryan Reddy,10-01-2006,102052,Kerala,24,10,10,6,50,Fail
Krishna Khan,14-10-2005,539889,Rajasthan,15,9,20,6,50,Pass
Aditya Fernandes,10-04-2006,851774,Rajasthan,20,18,11,22,71,Pass
Rohan Pillai,05-01-2006,242117,Rajasthan,18,4,13,20,55,Pass
Aarav Singh,17-02-2006,631462,Madhya Pradesh,6,3,6,6,21,Pass
Ayaan Reddy,27-12-2004,273179,Rajasthan,5,0,5,1,11,Pass
Yash Reddy,13-12-2005,899307,Chhattisgarh,20,0,9,14,43,Pass
Gurpreet Reddy,15-10-2005,855763,Uttar Pradesh,20,9,24,8,61,Pass
Rohan D'Souza,20-10-2005,414533,Gujarat,11,13,0,17,41,Fail
Yash Verma,02-06-2005,115061,Uttar Pradesh,19,5,4,11,39,Pass
Peter Pillai,14-06-2005,568563,Bihar,13,15,7,9,44,Pass
Farhan Singh,23-12-2004,334545,Haryana,0,4,6,4,14,Pass
Aryan Chopra,28-06-2005,216981,Bihar,21,1,22,19,63,Pass
Mathew Chopra,27-02-2005,227424,Karnataka,18,3,9,11,41,Pass
Gurpreet Pillai,23-11-2004,403799,Tamil Nadu,1,8,11,5,25,Pass
Krishna Reddy,08-04-2005,154456,Andhra Pradesh,13,15,4,19,51,Pass
John Reddy,23-02-2006,907753,Bihar,9,17,11,1,38,Pass
John Singh,10-01-2005,731081,Madhya Pradesh,2,8,12,2,24,Pass
Aarav Chopra,29-10-2005,194807,Punjab,12,23,9,13,57,Pass
Vivaan D'Souza,01-07-2005,715281,Telangana,13,16,23,9,61,Pass
Vivaan Reddy,27-03-2006,219109,Odisha,20,17,9,8,54,Pass
Aryan Fernandes,18-06-2005,675136,Uttarakhand,2,3,3,23,31,Pass
Vivaan Pillai,25-09-2005,612221,Uttar Pradesh,0,8,2,16,26,Pass
Aarav Pillai,22-11-2005,622986,Tripura,21,24,11,16,72,Pass
Balbir Chopra,03-05-2006,560142,West Bengal,3,23,18,22,66,Pass
Aarav Mehta,08-09-2005,983776,Andhra Pradesh,19,20,7,5,51,Pass
Aarav D'Souza,17-02-2005,927198,Uttar Pradesh,23,1,0,16,40,Pass
John Fernandes,29-07-2005,398601,Rajasthan,0,0,9,24,33,Pass
Gurpreet Reddy,27-04-2005,310482,Jammu & Kashmir + Ladakh,12,7,19,15,53,Pass
Aditya Chopra,28-05-2005,653854,Uttar Pradesh,9,16,4,10,39,Pass
Raj Reddy,05-09-2005,144245,Haryana,6,2,23,17,48,Pass
Ishaan Chopra,09-08-2005,725917,Punjab,23,5,2,22,52,Pass
Ishaan Pillai,18-06-2005,274343,Bihar,23,8,23,16,70,Pass
Ishaan Khan,13-11-2004,630872,Delhi,15,18,12,6,51,Pass
Ishaan Fernandes,03-12-2004,340947,Tamil Nadu,7,8,7,22,44,Pass
Raj Verma,26-04-2006,509241,West Bengal,3,2,16,24,45,Pass
John Reddy,27-03-2006,243884,Punjab,12,4,13,2,31,Pass
Aryan Mehta,08-02-2006,116741,Gujarat,10,20,20,10,60,Fail
Vivaan Khan,14-12-2004,995576,Andhra Pradesh,12,23,1,23,59,Pass
Rohan Fernandes,20-12-2004,739249,Rajasthan,10,12,7,2,31,Pass
Ishaan Singh,15-07-2005,755026,Bihar,15,20,9,19,63,Pass
Farhan Reddy,29-09-2005,847371,Bihar,5,9,22,8,44,Pass
Rohan Pillai,06-12-2005,274726,Uttar Pradesh,3,8,24,10,45,Pass
Rohan Chopra,18-05-2005,807528,Jammu & Kashmir + Ladakh,17,24,3,9,53,Pass
Balbir Pillai,25-03-2005,192108,Uttar Pradesh,13,21,15,22,71,Pass
Ishaan Fernandes,12-11-2005,762095,Bihar,1,24,2,22,49,Pass
Kunal Sharma,08-06-2005,363091,Delhi,3,16,23,13,55,Pass
Yash Chopra,30-03-2005,487062,Chhattisgarh,21,18,20,10,69,Pass
Ishaan Chopra,13-12-2005,269347,Sikkim,0,12,22,15,49,Pass
Ayaan Mehta,27-01-2005,868175,Odisha,1,13,14,9,37,Pass
Aarav Khan,22-06-2005,715385,Andhra Pradesh,11,13,8,8,40,Pass
Gurpreet Fernandes,31-12-2005,912939,Bihar,14,4,2,21,41,Pass
Aryan Mehta,02-03-2006,336829,Andhra Pradesh,21,14,17,15,67,Pass
Aditya Singh,30-03-2005,303368,Rajasthan,7,8,11,2,28,Pass
Rehan Pillai,30-10-2005,992947,Jharkhand,6,23,11,13,53,Pass
Peter Singh,10-05-2005,251999,Bihar,14,23,12,2,51,Pass
Raj Verma,13-07-2005,560304,Tripura,11,11,6,7,35,Pass
Zaid Reddy,28-07-2005,133623,Madhya Pradesh,9,8,3,4,24,Pass
Krishna Mehta,14-03-2005,570951,Punjab,15,21,9,13,58,Pass
Sukhwinder Chopra,13-12-2005,465233,Andhra Pradesh,14,1,19,22,56,Pass
Ayaan Fernandes,30-01-2005,206091,Uttar Pradesh,21,3,20,19,63,Pass
Kunal D'Souza,09-05-2005,618839,West Bengal,0,6,15,9,30,Pass
Yash D'Souza,30-01-2006,530847,Karnataka,22,15,18,17,72,Fail
Kunal Khan,04-09-2005,985460,Bihar,0,7,8,2,17,Pass
Gurpreet Reddy,12-11-2005,577108,Uttar Pradesh,2,16,21,2,41,Pass
Manpreet Fernandes,08-11-2004,513484,Gujarat,14,5,16,5,40,Fail
Aryan Sharma,12-11-2005,616344,Meghalaya,5,1,23,11,40,Pass
Mathew Verma,21-02-2006,813334,Uttar Pradesh,0,20,15,19,54,Pass
Raj D'Souza,29-10-2005,661920,Rajasthan,9,17,16,3,45,Pass
Raj D'Souza,17-06-2005,296152,Uttar Pradesh,18,22,13,16,69,Pass
Sukhwinder Sharma,20-04-2005,457515,Bihar,1,14,9,19,43,Pass
Aarav Sharma,02-12-2004,876416,Jammu & Kashmir + Ladakh,16,12,2,21,51,Pass
Ishaan Khan,16-12-2004,231567,Punjab,3,13,13,6,35,Pass
Peter Reddy,20-06-2005,584802,Rajasthan,12,21,18,23,74,Pass
Ayaan Chopra,10-01-2006,849411,Uttar Pradesh,5,10,17,19,51,Pass
Vivaan Fernandes,09-12-2005,114334,Bihar,7,1,0,22,30,Pass
David Chopra,16-02-2005,669266,Madhya Pradesh,18,10,13,2,43,Pass
Ishaan Sharma,13-11-2005,672567,Tamil Nadu,1,2,16,14,33,Pass
Ishaan Singh,09-09-2005,426106,Tamil Nadu,6,22,20,19,67,Pass
Rohan Sharma,26-11-2004,837218,Odisha,8,20,17,7,52,Pass
Imran Singh,06-03-2006,419529,Karnataka,8,8,6,16,38,Pass
Krishna Singh,12-04-2006,519412,Bihar,14,12,23,17,66,Pass
Yash Pillai,09-12-2005,508718,Rajasthan,7,0,12,15,34,Pass
Raj Singh,17-12-2005,263046,Arunachal Pradesh,8,8,5,10,31,Fail
David Fernandes,28-04-2005,531772,Gujarat,20,16,17,14,67,Fail
Kunal Reddy,18-06-2005,218310,Uttar Pradesh,22,12,10,19,63,Pass
Krishna Singh,12-02-2006,491258,Maharashtra,23,0,8,12,43,Pass
Aditya Verma,29-05-2005,625594,Odisha,12,1,14,11,38,Pass
Manpreet Reddy,29-12-2004,627490,Maharashtra,9,22,18,3,52,Pass
Gurpreet Fernandes,06-11-2005,816908,West Bengal,3,18,12,22,55,Pass
Krishna Pillai,02-04-2006,344885,Maharashtra,13,10,10,3,36,Pass
Aarav Khan,06-04-2006,858199,Chhattisgarh,10,11,5,18,44,Pass
Kunal Chopra,27-01-2005,717136,Jharkhand,24,13,3,13,53,Pass
Zaid Khan,23-07-2005,767078,Haryana,13,22,21,8,64,Pass
Ishaan Chopra,25-07-2005,499328,Himachal Pradesh,6,21,2,13,42,Pass
Rohan Sharma,11-08-2005,104833,Bihar,9,17,12,1,39,Pass
Raj Fernandes,28-03-2006,187402,Gujarat,21,5,20,0,46,Fail
Mathew Chopra,16-03-2005,639147,Madhya Pradesh,15,22,3,19,59,Pass
Paul Sharma,17-07-2005,674630,Uttar Pradesh,9,19,4,19,51,Pass
Aditya Chopra,19-08-2005,988946,Uttarakhand,24,19,3,7,53,Pass
Rohan Sharma,22-01-2006,170352,Uttarakhand,5,19,3,20,47,Pass
Raj Chopra,18-06-2005,503236,Maharashtra,19,16,12,3,50,Pass
Farhan Mehta,27-08-2005,766044,Odisha,12,13,5,20,50,Pass
Gurpreet Chopra,08-02-2006,570181,Maharashtra,24,20,4,0,48,Pass
Aarav Chopra,07-12-2004,791782,Punjab,13,10,24,9,56,Pass
Vivaan Reddy,23-12-2005,372255,Punjab,15,22,4,10,51,Pass
Raj Khan,06-02-2005,442685,Uttar Pradesh,6,19,11,13,49,Pass
Krishna Chopra,26-12-2004,602486,Madhya Pradesh,7,18,3,12,40,Pass
Kunal Chopra,20-08-2005,835342,Jammu & Kashmir + Ladakh,9,14,19,22,64,Pass
Aryan Verma,18-02-2005,128784,Bihar,21,18,16,17,72,Pass
Krishna Mehta,20-02-2005,186165,Punjab,13,1,16,15,45,Pass
Balbir D'Souza,03-06-2005,232692,Chhattisgarh,0,23,1,1,25,Pass
Imran Pillai,16-01-2005,282904,Manipur,7,15,11,3,36,Pass
Ishaan Singh,22-06-2005,878615,Rajasthan,9,23,8,3,43,Pass
Manpreet D'Souza,29-01-2006,461537,Maharashtra,8,11,3,7,29,Pass
Aditya D'Souza,19-11-2005,162848,Maharashtra,1,2,8,14,25,Pass
Raj Khan,07-03-2006,233154,Uttar Pradesh,7,4,13,4,28,Pass
Yash Pillai,16-08-2005,835996,Tripura,8,18,2,5,33,Pass
Krishna Chopra,15-03-2006,576131,Assam,18,13,3,11,45,Pass
Aarav Fernandes,05-11-2005,126616,Karnataka,23,16,23,23,85,Fail
Aarav Sharma,05-01-2005,895914,Madhya Pradesh,5,2,6,24,37,Pass
Vivaan Chopra,14-06-2005,153810,Uttar Pradesh,9,19,23,20,71,Pass
Yash Pillai,07-06-2005,148159,Bihar,7,16,9,10,42,Pass
Kunal Khan,06-02-2006,107496,West Bengal,7,3,4,0,14,Pass
Manpreet Chopra,27-12-2005,514509,Madhya Pradesh,20,19,14,2,55,Pass
Manpreet Pillai,17-04-2005,553591,West Bengal,10,12,8,22,52,Pass
Kunal Fernandes,22-11-2005,660905,Karnataka,20,9,9,18,56,Pass
Balbir Singh,12-03-2005,709988,Mizoram,4,9,3,6,22,Pass
Aryan Singh,17-10-2005,693119,Haryana,8,12,1,7,28,Pass
Farhan Reddy,03-07-2005,478536,Jammu & Kashmir + Ladakh,0,10,0,20,30,Pass
Rohan D'Souza,21-09-2005,541591,Jharkhand,1,12,19,24,56,Pass
Aarav Sharma,09-04-2006,785127,Assam,17,2,24,23,66,Pass
Krishna Khan,12-12-2005,422828,Madhya Pradesh,22,3,11,17,53,Pass
Gurpreet Chopra,08-06-2005,886841,Uttar Pradesh,18,23,23,2,66,Pass
Harjeet Pillai,26-03-2006,576215,Madhya Pradesh,10,16,3,19,48,Pass
Aditya Reddy,19-05-2005,379233,Uttar Pradesh,10,2,18,23,53,Pass
Vivaan Singh,15-06-2005,772772,Uttar Pradesh,2,5,3,20,30,Pass
Yash D'Souza,17-12-2004,521359,Kerala,11,22,10,1,44,Fail
Kunal Khan,17-03-2006,761919,Assam,9,22,20,3,54,Pass
Gurpreet Fernandes,28-11-2004,239556,Tamil Nadu,4,9,17,16,46,Pass
Aryan Sharma,30-04-2006,719278,Gujarat,3,13,18,21,55,Fail
Aryan Singh,14-03-2006,367003,Telangana,23,15,21,11,70,Fail
Kunal Verma,14-03-2006,242153,Rajasthan,6,3,13,18,40,Pass
Mathew Fernandes,01-08-2005,713424,Himachal Pradesh,16,19,1,20,56,Pass
Aarav Chopra,26-08-2005,230469,Madhya Pradesh,13,6,3,9,31,Pass
Rohan Chopra,18-07-2005,224271,Maharashtra,0,13,3,19,35,Pass
Rohan Chopra,31-03-2006,424973,Uttar Pradesh,20,24,7,3,54,Pass
Raj Fernandes,19-12-2005,754822,Assam,22,1,22,15,60,Pass
Yash Mehta,03-07-2005,557402,West Bengal,3,22,23,6,54,Pass
Ishaan Chopra,13-11-2005,266247,Maharashtra,16,22,23,3,64,Pass
Sukhwinder Fernandes,03-02-2005,386633,Tamil Nadu,12,8,10,13,43,Pass
Kunal Chopra,13-05-2005,817720,Rajasthan,17,13,22,24,76,Pass
Yash Singh,11-08-2005,490465,Tamil Nadu,23,14,20,12,69,Pass
Kunal Verma,22-11-2005,440928,Andhra Pradesh,5,23,0,23,51,Pass
Kunal Verma,30-10-2005,442300,Uttarakhand,0,22,3,24,49,Pass
Manpreet D'Souza,23-06-2005,489296,Rajasthan,21,13,7,0,41,Pass
Balbir Pillai,02-01-2005,690387,West Bengal,15,3,8,20,46,Pass
Aryan Chopra,20-12-2004,718426,Gujarat,19,13,20,20,72,Fail
Aryan Singh,14-08-2005,587154,Gujarat,3,1,2,23,29,Fail
Vivaan Mehta,26-07-2005,401476,Telangana,12,11,23,5,51,Pass
Vivaan Singh,25-10-2005,636561,Uttar Pradesh,24,9,10,5,48,Pass
Kunal Pillai,16-01-2006,936560,Rajasthan,20,23,2,0,45,Pass
Raj Chopra,26-11-2004,384969,Tamil Nadu,6,18,14,17,55,Pass
Krishna Pillai,26-12-2005,620678,West Bengal,19,14,0,1,34,Pass
Raj Singh,07-09-2005,380037,Uttar Pradesh,14,18,9,4,45,Pass
Gurpreet Chopra,14-11-2005,475309,Uttar Pradesh,21,2,5,11,39,Pass
Ishaan Khan,18-03-2006,871156,Gujarat,8,24,0,16,48,Fail
Aryan Pillai,07-05-2006,278116,Rajasthan,3,24,16,6,49,Pass
Yash Mehta,08-02-2006,206191,Punjab,8,0,19,11,38,Pass
Harjeet Khan,20-10-2005,507902,Madhya Pradesh,3,11,13,4,31,Pass
John Singh,15-04-2006,568767,Assam,1,3,12,3,19,Pass
Balbir Khan,22-12-2004,249852,Uttarakhand,15,18,2,13,48,Pass
Ishaan Pillai,26-12-2004,906113,Assam,13,9,4,16,42,Pass
Vivaan Sharma,20-02-2006,303271,Kerala,21,22,14,5,62,Fail
Krishna Fernandes,20-12-2005,323705,Bihar,22,9,7,14,52,Pass
Yash Chopra,15-11-2004,454227,Madhya Pradesh,9,18,21,1,49,Pass
Aarav Mehta,23-11-2005,802475,Telangana,13,13,5,5,36,Pass
Harjeet Chopra,20-01-2006,299472,West Bengal,6,12,5,5,28,Pass
Aryan Pillai,16-12-2004,328684,Maharashtra,17,17,21,3,58,Pass
Harjeet Reddy,31-07-2005,258581,Andaman & Nicobar,12,14,4,1,31,Pass
Krishna Khan,24-02-2005,491912,Uttar Pradesh,8,17,23,15,63,Pass
Sukhwinder Sharma,22-03-2005,723942,Himachal Pradesh,19,5,13,12,49,Pass
Vivaan Chopra,04-04-2005,656068,Madhya Pradesh,11,16,3,16,46,Pass
Gurpreet Chopra,20-01-2006,487784,Daman & Diu / D&N Haveli,1,22,22,21,66,Fail
Krishna Fernandes,22-01-2005,847853,Tamil Nadu,3,8,11,0,22,Pass
Aarav Mehta,28-11-2004,210248,Uttar Pradesh,17,10,17,22,66,Pass
Aryan Fernandes,23-10-2005,313258,Uttar Pradesh,16,3,24,24,67,Pass
Ishaan Reddy,28-02-2005,478796,Daman & Diu / D&N Haveli,4,15,9,3,31,Fail
Ishaan D'Souza,08-05-2006,275249,Telangana,6,6,9,19,40,Pass
Vivaan Pillai,15-02-2006,407137,Bihar,10,19,7,14,50,Pass
Manpreet Khan,05-09-2005,368414,Tamil Nadu,0,14,21,2,37,Pass
Aryan Pillai,09-04-2006,625504,Jammu & Kashmir + Ladakh,5,3,18,22,48,Pass
Raj Chopra,12-02-2005,619213,Uttar Pradesh,22,3,18,12,55,Pass
Ayaan D'Souza,16-11-2005,987937,Maharashtra,6,14,11,5,36,Pass
Raj Khan,15-02-2005,795246,Uttar Pradesh,4,13,12,15,44,Pass
Rohan D'Souza,29-11-2004,976787,West Bengal,18,1,24,11,54,Pass
Ishaan Singh,20-12-2004,112416,Kerala,2,2,1,15,20,Fail
John Fernandes,30-08-2005,470074,Bihar,23,16,16,18,73,Pass
Rohan Mehta,06-08-2005,387683,Odisha,0,0,21,13,34,Pass
John Verma,02-05-2006,902976,Uttar Pradesh,9,2,23,7,41,Pass
Aditya D'Souza,22-02-2006,471461,Jharkhand,17,24,5,16,62,Pass
Manpreet Sharma,26-04-2005,964381,Uttar Pradesh,23,6,2,11,42,Pass
Aditya Reddy,18-11-2004,183959,Madhya Pradesh,17,22,9,1,49,Pass
Aarav D'Souza,27-09-2005,294379,Karnataka,1,22,23,16,62,Pass
Aarav D'Souza,20-04-2005,785308,Haryana,1,3,17,9,30,Pass
Aryan Pillai,07-03-2005,702591,Madhya Pradesh,15,13,7,21,56,Pass
Yash Reddy,27-06-2005,679761,Madhya Pradesh,9,12,3,22,46,Pass
Rohan Verma,21-01-2006,193377,Rajasthan,4,23,22,11,60,Pass
Yash Pillai,01-02-2006,161526,Delhi,5,22,24,8,59,Pass
Gurpreet Singh,28-01-2006,564242,West Bengal,7,4,0,11,22,Pass
Krishna Mehta,07-03-2005,608205,Gujarat,8,3,7,3,21,Fail
Gurpreet D'Souza,14-02-2005,279496,Andhra Pradesh,13,24,6,6,49,Pass
Krishna Khan,08-02-2006,886859,Madhya Pradesh,20,7,8,10,45,Pass
Yash Reddy,27-02-2005,671446,Jharkhand,0,22,12,16,50,Pass
Paul Khan,13-05-2005,696840,Kerala,2,5,17,0,24,Fail
David Khan,11-05-2005,306581,Madhya Pradesh,14,18,12,5,49,Pass
Balbir D'Souza,15-02-2005,457126,Andhra Pradesh,7,6,15,3,31,Pass
Peter Verma,10-07-2005,983254,Gujarat,9,18,4,12,43,Fail
Sukhwinder Fernandes,12-02-2006,829620,West Bengal,6,19,20,9,54,Pass
Kunal Fernandes,01-01-2006,966758,Punjab,14,19,21,12,66,Pass
David Sharma,17-04-2005,473303,Gujarat,20,0,5,7,32,Fail
Imran Verma,05-03-2005,554256,Telangana,4,4,23,14,45,Pass
Balbir Fernandes,17-12-2004,894468,Odisha,24,22,17,18,81,Pass
Vivaan Singh,18-02-2006,816805,Gujarat,15,16,0,19,50,Fail
Raj Pillai,21-11-2004,782402,Uttar Pradesh,7,14,3,7,31,Pass
Vivaan Khan,04-12-2005,360119,Odisha,12,22,6,12,52,Pass
Raj Chopra,30-12-2005,928370,Punjab,16,2,0,11,29,Pass
Aditya Mehta,27-11-2005,738784,Bihar,20,16,24,24,84,Pass
Aditya Chopra,31-12-2004,828775,Rajasthan,20,20,19,23,82,Pass
Aryan Sharma,04-04-2005,398979,Bihar,16,16,11,0,43,Pass
Aryan Mehta,22-01-2005,674927,Uttar Pradesh,13,2,4,17,36,Pass
Gurpreet Pillai,22-05-2005,983841,Punjab,17,18,13,19,67,Pass
Farhan D'Souza,28-09-2005,214251,Maharashtra,23,15,24,3,65,Pass
Vivaan Chopra,16-07-2005,307887,Bihar,7,5,5,21,38,Pass
Krishna Sharma,18-05-2005,936540,Jharkhand,12,8,10,9,39,Pass
Paul Reddy,21-11-2004,203523,Maharashtra,7,19,9,0,35,Pass
Raj Verma,01-11-2005,860393,Tamil Nadu,2,6,6,5,19,Pass
Ishaan Chopra,19-06-2005,272739,Uttar Pradesh,21,5,7,18,51,Pass
Manpreet Pillai,29-08-2005,513325,Andhra Pradesh,1,17,24,18,60,Pass
Raj D'Souza,06-12-2004,977438,Tamil Nadu,13,9,0,12,34,Pass
Balbir Singh,25-03-2006,311261,Jammu & Kashmir + Ladakh,20,6,8,19,53,Pass
Balbir Fernandes,26-03-2005,580630,Himachal Pradesh,4,7,8,4,23,Pass
Balbir Pillai,01-12-2005,945385,Haryana,3,0,1,11,15,Pass
Rohan Khan,10-05-2005,345779,Uttar Pradesh,22,18,19,1,60,Pass
Manpreet Fernandes,10-12-2004,141178,Maharashtra,22,12,21,3,58,Pass
Vivaan Verma,17-12-2005,875103,Madhya Pradesh,7,22,0,11,40,Pass
Aryan Sharma,07-05-2006,990808,Bihar,3,6,17,14,40,Pass
Kunal Pillai,10-04-2006,457279,Maharashtra,18,20,22,3,63,Pass
Kunal Chopra,09-09-2005,817579,Maharashtra,21,8,19,3,51,Pass
Yash Fernandes,02-08-2005,835239,Jharkhand,1,19,1,11,32,Pass
Rohan Chopra,22-12-2005,117522,Punjab,11,0,23,22,56,Pass
Aarav Reddy,25-11-2004,204342,Rajasthan,24,15,7,1,47,Pass
Paul Verma,21-03-2005,136235,Himachal Pradesh,13,4,14,9,40,Pass
Kunal Mehta,11-01-2006,928205,Uttar Pradesh,5,13,8,23,49,Pass
Vivaan Khan,14-02-2006,667224,Haryana,15,3,4,19,41,Pass
Krishna Singh,02-04-2005,206108,Nagaland,0,23,11,6,40,Pass
Aarav D'Souza,04-03-2006,538582,Bihar,14,21,14,22,71,Pass
Vivaan Sharma,12-08-2005,235068,Bihar,14,4,5,0,23,Pass
Aditya Chopra,04-04-2006,404850,West Bengal,3,24,16,15,58,Pass
Rohan Khan,30-12-2004,929918,Bihar,5,10,23,2,40,Pass
Imran Reddy,09-01-2005,357490,Telangana,16,19,4,16,55,Fail
Kunal Reddy,28-11-2005,610700,Uttar Pradesh,3,22,15,20,60,Pass
Aryan Reddy,04-05-2006,200179,Tamil Nadu,6,16,12,22,56,Pass
Ayaan Reddy,31-10-2005,405773,West Bengal,3,9,13,24,49,Pass
Paul Verma,22-08-2005,572894,Puducherry,6,7,12,7,32,Pass
Raj Chopra,08-05-2005,545866,Odisha,9,6,6,10,31,Pass
Sukhwinder Fernandes,26-12-2004,541179,Uttar Pradesh,24,3,18,14,59,Pass
Krishna Fernandes,08-12-2005,699989,Delhi,12,18,17,20,67,Pass
Peter Chopra,04-10-2005,739074,Assam,13,10,14,5,42,Pass
Kunal D'Souza,01-02-2005,169207,Uttar Pradesh,19,18,20,12,69,Pass
Vivaan D'Souza,24-12-2004,670175,Maharashtra,6,11,7,24,48,Pass
Aryan Reddy,06-04-2005,119415,Odisha,2,11,18,11,42,Pass
Aditya Khan,19-11-2005,763356,Uttar Pradesh,23,7,17,0,47,Pass
Rohan Singh,27-12-2005,545093,Punjab,2,18,8,21,49,Pass
Krishna Mehta,27-04-2005,763536,Nagaland,2,5,24,20,51,Pass
Yash Pillai,15-07-2005,436910,West Bengal,3,7,16,19,45,Pass
Raj Sharma,13-05-2005,536417,Haryana,14,10,14,22,60,Pass
Rehan Mehta,24-01-2005,193318,Telangana,23,12,12,16,63,Fail
Vivaan Verma,25-03-2005,196042,West Bengal,7,4,19,9,39,Pass
Aryan Fernandes,16-01-2006,804662,Madhya Pradesh,11,7,3,2,23,Pass
Kunal Chopra,29-11-2005,918754,Sikkim,8,3,5,0,16,Pass
Krishna Verma,19-03-2005,328966,Rajasthan,7,18,1,13,39,Pass
Balbir Chopra,17-06-2005,849143,Daman & Diu / D&N Haveli,24,9,13,19,65,Fail
Vivaan Reddy,07-03-2006,776618,Haryana,10,1,23,6,40,Pass
Raj Singh,06-03-2005,109643,Uttarakhand,20,17,9,0,46,Pass
Yash Sharma,22-11-2005,462599,Uttarakhand,3,1,5,22,31,Pass
Krishna Pillai,05-06-2005,301100,Telangana,9,6,18,15,48,Pass
Peter Singh,14-11-2005,174698,Madhya Pradesh,0,24,1,12,37,Pass
Rohan Verma,08-07-2005,937978,Kerala,21,12,15,9,57,Fail
Imran Khan,19-10-2005,906564,Haryana,5,12,3,3,23,Pass
Krishna D'Souza,20-03-2006,419847,Uttar Pradesh,9,11,13,4,37,Pass
Yash D'Souza,17-03-2005,342462,West Bengal,3,15,22,20,60,Pass
Ishaan Khan,04-12-2005,254918,Rajasthan,2,6,8,3,19,Pass
Aryan Fernandes,22-03-2006,425572,Haryana,14,6,2,4,26,Pass
Kunal Sharma,06-08-2005,281824,Punjab,17,3,22,20,62,Pass
Raj Singh,04-11-2005,991694,Uttarakhand,6,23,8,3,40,Pass
Yash Fernandes,30-03-2006,823177,Rajasthan,2,12,8,0,22,Pass
Paul Chopra,06-12-2005,550130,Maharashtra,3,9,24,11,47,Pass
Yash Reddy,14-09-2005,144875,Bihar,14,19,23,0,56,Pass
Rohan Reddy,01-08-2005,934497,Gujarat,10,5,3,24,42,Fail
Rohan Chopra,25-02-2005,349360,Madhya Pradesh,3,3,20,18,44,Pass
Vivaan Sharma,13-10-2005,438180,Andhra Pradesh,4,21,2,7,34,Pass
Ishaan Verma,12-04-2006,814919,Tamil Nadu,9,15,16,5,45,Pass
Kunal Fernandes,30-06-2005,642232,Delhi,10,2,14,10,36,Pass
Kunal Reddy,12-12-2004,898449,Madhya Pradesh,3,16,9,4,32,Pass
David Verma,14-04-2005,365985,Himachal Pradesh,9,13,10,20,52,Pass
Vivaan Singh,25-03-2006,124839,West Bengal,8,7,20,4,39,Pass
Rohan Chopra,08-06-2005,149710,Madhya Pradesh,18,2,12,11,43,Pass
Aryan Mehta,14-10-2005,230396,Maharashtra,14,21,24,3,62,Pass
Gurpreet Reddy,20-08-2005,120937,West Bengal,13,11,23,0,47,Pass
Vivaan Mehta,10-11-2005,677916,Chhattisgarh,21,4,0,6,31,Pass
Rohan Pillai,13-10-2005,765325,Uttar Pradesh,9,7,14,6,36,Pass
Aryan Mehta,27-02-2006,159619,West Bengal,14,18,21,1,54,Pass
Kunal Chopra,27-12-2005,413176,Bihar,2,20,24,15,61,Pass
Balbir Reddy,31-10-2005,558247,Uttar Pradesh,7,16,23,10,56,Pass
Aryan Verma,10-03-2005,169608,Andhra Pradesh,3,20,24,10,57,Pass
Ishaan Sharma,03-05-2006,469605,Tamil Nadu,20,17,16,18,71,Pass
Raj Chopra,11-04-2005,478135,Bihar,17,2,17,8,44,Pass
Ishaan Fernandes,12-10-2005,196995,Bihar,13,22,14,19,68,Pass
Sukhwinder Mehta,30-04-2006,432984,Chhattisgarh,8,6,1,17,32,Pass
Ayaan Fernandes,03-02-2005,186016,Uttar Pradesh,11,13,0,4,28,Pass
Aryan Mehta,02-07-2005,480445,Bihar,0,16,3,8,27,Pass
John D'Souza,30-01-2006,635941,Uttar Pradesh,4,10,2,5,21,Pass
Aryan Singh,07-12-2004,523975,Andhra Pradesh,2,13,19,7,41,Pass
Rehan Reddy,30-12-2005,773711,West Bengal,3,21,22,17,63,Pass
Vivaan Fernandes,30-04-2005,460180,Karnataka,22,16,1,17,56,Pass
Aditya D'Souza,20-01-2006,812038,Tamil Nadu,21,18,23,16,78,Pass
Farhan Fernandes,18-02-2006,372653,Odisha,15,23,17,16,71,Pass
Krishna Reddy,15-11-2005,514761,Jharkhand,9,9,6,12,36,Pass
Aarav Mehta,06-12-2005,658598,Punjab,10,23,23,18,74,Pass
Yash Mehta,31-05-2005,424641,Rajasthan,5,13,12,18,48,Pass
Rohan D'Souza,23-01-2005,366336,Telangana,2,11,2,6,21,Pass
Aryan Chopra,11-01-2005,974776,Himachal Pradesh,11,5,17,13,46,Pass
Vivaan Singh,07-04-2006,337827,Punjab,1,16,12,7,36,Pass
Rohan Khan,16-04-2005,770716,Uttar Pradesh,4,19,0,1,24,Pass
Harjeet Khan,11-02-2005,320666,Bihar,0,21,5,20,46,Pass
Raj Sharma,11-01-2006,517983,Uttar Pradesh,11,4,22,23,60,Pass
Rohan Pillai,06-03-2005,166265,Rajasthan,13,17,23,24,77,Pass
Aditya Pillai,21-03-2005,696003,Telangana,14,17,6,9,46,Pass
Yash Singh,29-07-2005,771716,West Bengal,3,14,8,17,42,Pass
David Pillai,15-09-2005,745810,Rajasthan,22,5,5,20,52,Pass
Peter Sharma,09-04-2006,863112,Madhya Pradesh,18,22,3,11,54,Pass
Ishaan Pillai,13-11-2005,653199,Tamil Nadu,6,12,8,12,38,Pass
Krishna Verma,25-05-2005,619857,Madhya Pradesh,11,21,3,9,44,Pass
Aarav Reddy,15-02-2006,795495,Andhra Pradesh,6,18,23,9,56,Pass
Ishaan Chopra,23-01-2005,443903,Haryana,3,3,3,8,17,Pass
Kunal Fernandes,29-10-2005,219536,Uttar Pradesh,17,13,0,12,42,Pass
Yash Sharma,20-05-2005,635712,Odisha,4,20,3,11,38,Pass
Kunal Reddy,24-12-2004,696635,Delhi,19,9,9,13,50,Pass
Aditya Pillai,20-04-2005,489887,Punjab,15,2,0,22,39,Pass
Aarav Singh,24-03-2005,435769,Punjab,22,22,11,18,73,Pass
Sukhwinder Verma,08-04-2006,910234,Madhya Pradesh,16,6,11,11,44,Pass
Ishaan Verma,28-04-2005,652432,Andhra Pradesh,0,2,13,22,37,Pass
Krishna Chopra,02-05-2006,652421,Gujarat,11,15,5,5,36,Fail
Krishna Khan,24-08-2005,748618,Rajasthan,2,10,14,3,29,Pass
Ishaan Khan,08-12-2004,380942,Madhya Pradesh,17,21,7,2,47,Pass
Aarav Khan,04-02-2005,896165,West Bengal,21,9,2,3,35,Pass
David Mehta,09-10-2005,631651,Madhya Pradesh,24,13,3,0,40,Pass
Kunal Khan,21-11-2004,793672,Goa,7,11,3,22,43,Fail
Rohan Mehta,21-02-2006,665801,Telangana,21,6,14,14,55,Fail
John Verma,22-08-2005,328953,Punjab,19,22,8,1,50,Pass
Aarav Pillai,20-04-2005,319964,Gujarat,15,20,2,17,54,Fail
Raj Khan,09-04-2005,974457,Haryana,21,21,3,10,55,Pass
Kunal Reddy,19-02-2005,610108,Maharashtra,10,22,8,3,43,Pass
Krishna Pillai,14-02-2006,793389,West Bengal,8,0,9,20,37,Pass
Zaid Mehta,24-12-2004,583933,Jharkhand,7,9,18,11,45,Pass
Kunal Pillai,18-04-2006,984002,Rajasthan,16,18,1,21,56,Pass
Mathew Mehta,10-07-2005,650117,Uttar Pradesh,5,17,0,5,27,Pass
Yash Khan,26-03-2005,611243,West Bengal,20,4,6,9,39,Pass
Yash Pillai,25-04-2006,922981,Maharashtra,7,10,19,10,46,Pass
Yash Fernandes,15-11-2004,518652,Uttarakhand,15,1,3,15,34,Pass
Peter Khan,21-03-2006,763261,Kerala,7,13,15,7,42,Fail
Harjeet Sharma,04-10-2005,776313,Odisha,22,0,20,3,45,Pass
Mathew Chopra,08-04-2006,741500,Karnataka,4,13,17,23,57,Pass
Ishaan Khan,16-01-2005,198811,Himachal Pradesh,12,16,10,13,51,Pass
Paul Reddy,01-06-2005,210066,Madhya Pradesh,8,2,19,13,42,Pass
Rohan Sharma,26-12-2004,964424,Odisha,5,10,9,23,47,Pass
Kunal Fernandes,15-12-2005,239764,Uttar Pradesh,6,12,6,12,36,Pass
Raj Pillai,16-10-2005,810943,Punjab,12,12,8,20,52,Pass
Krishna Sharma,12-04-2005,117699,Rajasthan,14,14,6,0,34,Pass
Gurpreet Singh,20-07-2005,229364,Punjab,22,1,10,19,52,Pass
Peter Reddy,09-10-2005,807421,Delhi,13,21,1,13,48,Pass
Ishaan Singh,01-02-2006,891764,Bihar,0,8,0,20,28,Pass
Aarav D'Souza,10-03-2005,286435,Andhra Pradesh,21,14,0,16,51,Pass
Peter Sharma,09-02-2006,692664,Punjab,11,9,18,23,61,Pass
Imran Pillai,17-11-2004,850491,Punjab,21,15,4,4,44,Pass
Kunal Singh,04-07-2005,783606,Maharashtra,22,11,19,3,55,Pass
Rohan Reddy,21-03-2005,397883,Madhya Pradesh,23,19,3,21,66,Pass
Kunal Sharma,08-11-2005,159006,Andhra Pradesh,22,23,4,1,50,Pass
Peter Verma,31-01-2005,428481,Jammu & Kashmir + Ladakh,18,21,9,13,61,Pass
Manpreet D'Souza,26-12-2004,239893,Bihar,10,22,14,24,70,Pass
Krishna Singh,29-04-2006,293422,Tamil Nadu,0,18,0,16,34,Pass
Yash Khan,24-11-2004,719618,Andhra Pradesh,9,16,13,12,50,Pass
Aryan Mehta,23-12-2004,342205,Tamil Nadu,3,20,5,4,32,Pass
Krishna Khan,10-10-2005,143395,Delhi,9,0,3,20,32,Pass
Vivaan Verma,06-07-2005,680391,Punjab,3,24,14,13,54,Pass
Aryan Reddy,01-03-2006,447955,Rajasthan,22,11,6,6,45,Pass
Peter Fernandes,28-09-2005,330473,Assam,4,17,0,2,23,Pass
Aditya Singh,15-07-2005,261393,Maharashtra,13,19,21,3,56,Pass
Aarav Verma,07-04-2005,116657,Karnataka,3,14,3,18,38,Pass
Ishaan Reddy,04-01-2005,155531,Maharashtra,22,13,15,3,53,Pass
Rohan Fernandes,22-12-2004,389987,Bihar,4,24,14,14,56,Pass
Gurpreet Sharma,09-05-2005,484563,Uttar Pradesh,1,2,22,0,25,Pass
Aryan Singh,06-02-2005,486187,Maharashtra,17,16,21,3,57,Pass
Harjeet D'Souza,31-10-2005,992419,Telangana,7,10,2,15,34,Pass
Aryan Mehta,07-01-2005,552733,Chhattisgarh,13,8,8,5,34,Pass
Aditya Chopra,09-02-2006,184101,Andhra Pradesh,5,18,15,14,52,Pass
Aryan Khan,03-02-2005,796470,Chhattisgarh,22,11,21,22,76,Pass
Ayaan Sharma,13-04-2005,313069,Uttar Pradesh,18,4,21,13,56,Pass
Peter Chopra,06-06-2005,728876,Gujarat,6,21,5,14,46,Fail
Aditya Sharma,26-01-2006,300406,Uttarakhand,22,7,10,3,42,Pass
Aarav Khan,18-04-2005,284081,Andhra Pradesh,18,23,24,19,84,Pass
Ishaan Khan,10-12-2005,724522,Uttar Pradesh,9,0,20,1,30,Pass
Kunal Pillai,04-05-2006,386358,Assam,6,22,3,24,55,Pass
Raj Reddy,21-02-2005,490973,Haryana,20,0,21,4,45,Pass
Aryan Khan,10-11-2004,277004,Bihar,15,20,8,10,53,Pass
Krishna Singh,22-01-2006,750049,Meghalaya,5,23,20,12,60,Pass
Krishna D'Souza,22-12-2004,255965,Madhya Pradesh,7,18,3,21,49,Pass
Aryan Mehta,18-12-2005,213394,Rajasthan,2,13,19,6,40,Pass
Kunal Sharma,13-02-2006,563601,Karnataka,9,13,13,1,36,Pass
Yash Pillai,05-12-2004,776126,Maharashtra,20,8,13,3,44,Pass
Raj Fernandes,03-03-2006,386813,Karnataka,5,16,20,20,61,Pass
Manpreet Khan,07-08-2005,869537,Odisha,21,20,10,18,69,Pass
Mathew Fernandes,26-12-2005,274016,Tamil Nadu,3,4,14,8,29,Pass
Aryan Fernandes,01-12-2004,999351,Jammu & Kashmir + Ladakh,5,6,7,8,26,Pass
Yash Fernandes,18-01-2006,910448,Jharkhand,5,19,6,13,43,Pass
Krishna Verma,26-02-2006,840059,Uttar Pradesh,18,17,14,2,51,Pass
Aarav Verma,26-04-2006,671165,Tamil Nadu,24,18,18,4,64,Pass
Kunal Chopra,16-03-2005,162595,Tamil Nadu,19,7,10,19,55,Pass
Krishna Khan,13-08-2005,154194,Assam,5,19,5,12,41,Pass
Aarav Pillai,28-12-2004,963677,Assam,15,19,20,7,61,Pass
Paul Sharma,17-02-2005,283075,Andhra Pradesh,12,0,9,0,21,Pass
Sukhwinder Singh,10-10-2005,958831,Haryana,15,7,0,15,37,Pass
Krishna Mehta,13-06-2005,632318,Assam,6,8,6,4,24,Pass
John D'Souza,28-06-2005,391483,Odisha,3,15,14,12,44,Pass
Yash Khan,02-09-2005,517227,Telangana,15,19,10,1,45,Pass
Yash Sharma,02-01-2006,748961,Bihar,21,16,5,16,58,Pass
Harjeet Sharma,14-06-2005,224489,Haryana,17,14,2,4,37,Pass
Vivaan Fernandes,11-11-2004,467174,Madhya Pradesh,3,9,13,7,32,Pass
Sukhwinder Singh,28-02-2006,191614,Karnataka,15,14,17,12,58,Pass
Aryan Mehta,20-09-2005,514434,Tamil Nadu,11,12,11,16,50,Pass
Aditya Verma,26-11-2004,783480,Manipur,21,19,6,2,48,Pass
Kunal Khan,05-03-2006,949004,Bihar,12,18,12,23,65,Pass
Aarav Singh,02-01-2005,858687,Uttar Pradesh,17,2,6,16,41,Pass
Raj Pillai,07-11-2005,490932,Rajasthan,12,21,2,6,41,Pass
Raj Mehta,09-04-2006,745870,Maharashtra,9,0,9,11,29,Pass
Ishaan Mehta,18-07-2005,419665,Punjab,23,17,3,7,50,Pass
David Singh,27-12-2005,130875,Punjab,24,18,6,0,48,Pass
David Khan,24-12-2005,937280,Maharashtra,2,2,0,17,21,Pass
Krishna Fernandes,11-01-2006,686565,Punjab,22,2,21,24,69,Pass
Aditya Reddy,15-07-2005,167708,Haryana,9,20,21,3,53,Pass
Ishaan Mehta,20-03-2006,540897,Odisha,6,12,16,19,53,Pass
Gurpreet Chopra,16-03-2005,642513,Odisha,21,15,12,21,69,Pass
Yash Fernandes,03-09-2005,999898,Bihar,15,14,5,4,38,Pass
Aarav Reddy,06-05-2005,169545,Madhya Pradesh,18,20,3,7,48,Pass
Kunal Verma,03-10-2005,343914,Madhya Pradesh,11,16,14,4,45,Pass
Aryan Fernandes,14-12-2004,824662,Madhya Pradesh,17,7,3,21,48,Pass
Balbir Chopra,12-01-2006,540177,Rajasthan,22,4,23,12,61,Pass
Ishaan D'Souza,16-03-2005,321690,Uttar Pradesh,16,2,8,20,46,Pass
Kunal Khan,08-07-2005,909640,Karnataka,5,1,19,5,30,Pass
Rehan Pillai,14-01-2005,974256,Rajasthan,22,19,7,10,58,Pass
Kunal Reddy,08-01-2006,851776,Rajasthan,19,4,23,22,68,Pass
Manpreet Reddy,03-10-2005,508097,West Bengal,6,14,22,9,51,Pass
David Reddy,16-12-2005,340811,Uttarakhand,17,12,3,24,56,Pass
Aarav Mehta,04-10-2005,763179,Andhra Pradesh,17,15,10,24,66,Pass
Raj Khan,04-03-2006,182487,Haryana,12,24,23,5,64,Pass
Aryan Singh,19-07-2005,359983,Rajasthan,23,4,13,20,60,Pass
Krishna Verma,24-06-2005,763885,Manipur,0,13,9,16,38,Pass
Gurpreet Reddy,16-06-2005,638326,Himachal Pradesh,5,12,22,14,53,Pass
Zaid Fernandes,17-02-2005,557514,Uttar Pradesh,21,0,3,24,48,Pass
Kunal Reddy,29-04-2006,620483,Odisha,4,12,2,22,40,Pass
Rohan D'Souza,19-12-2005,111324,Maharashtra,22,14,18,3,57,Pass
Harjeet Khan,11-08-2005,547001,Andhra Pradesh,19,22,1,18,60,Pass
Ishaan Reddy,13-12-2005,943214,Punjab,23,6,12,2,43,Pass
Raj Reddy,21-07-2005,889704,Maharashtra,6,18,0,11,35,Pass
Aarav Pillai,27-02-2005,791646,West Bengal,2,16,2,8,28,Pass
Raj Sharma,27-03-2005,330150,Bihar,24,23,17,13,77,Pass
Yash Sharma,01-08-2005,369205,West Bengal,6,24,1,11,42,Pass
Rohan Khan,22-11-2004,463539,Bihar,2,14,2,1,19,Pass
Rohan Reddy,01-12-2005,260899,Uttar Pradesh,9,21,20,5,55,Pass
Raj Singh,16-11-2005,318921,Maharashtra,15,4,20,2,41,Pass
Rohan Sharma,16-12-2004,257900,West Bengal,4,9,7,24,44,Pass
Aarav Chopra,09-12-2004,827290,Rajasthan,16,7,15,3,41,Pass
Krishna Sharma,24-06-2005,314731,Rajasthan,3,3,19,24,49,Pass
Aditya Sharma,31-10-2005,924771,Madhya Pradesh,22,10,3,9,44,Pass
Kunal Mehta,07-05-2006,162990,Karnataka,21,5,20,8,54,Pass
Ishaan Pillai,13-03-2006,470760,Madhya Pradesh,24,24,1,1,50,Pass
Vivaan Reddy,18-10-2005,162391,Telangana,11,3,18,20,52,Fail
Krishna Khan,01-03-2005,730123,Daman & Diu / D&N Haveli,22,7,8,17,54,Fail
Yash Mehta,04-01-2006,929873,Jharkhand,4,16,10,10,40,Pass
Balbir D'Souza,08-07-2005,435421,Mizoram,17,2,4,19,42,Pass
Kunal Verma,11-08-2005,700466,Uttar Pradesh,9,17,3,17,46,Pass
Raj Verma,19-10-2005,944274,Maharashtra,11,10,6,1,28,Pass
Zaid Mehta,09-02-2006,352344,Andhra Pradesh,4,18,1,15,38,Pass
Paul Sharma,06-02-2006,936111,Telangana,10,12,11,7,40,Pass
Krishna Mehta,22-03-2006,296712,Bihar,17,24,4,11,56,Pass
Yash Pillai,17-02-2006,141283,Uttar Pradesh,18,4,6,15,43,Pass
Vivaan Singh,25-12-2005,804269,Punjab,4,6,15,12,37,Pass
Krishna Mehta,18-08-2005,635562,Gujarat,1,15,13,14,43,Fail
Vivaan Khan,27-04-2006,890065,Assam,3,14,24,13,54,Pass
Aditya Chopra,07-01-2005,888684,Andhra Pradesh,23,23,16,7,69,Pass
Harjeet Sharma,29-03-2006,369100,Bihar,23,7,15,18,63,Pass
Aditya D'Souza,14-01-2006,470816,Maharashtra,9,9,22,3,43,Pass
Aditya Reddy,18-06-2005,213647,Andhra Pradesh,9,18,11,14,52,Pass
Aditya Chopra,08-04-2006,698399,Jharkhand,23,21,24,1,69,Fail
Yash Sharma,11-06-2005,354318,Uttar Pradesh,19,3,0,13,35,Pass
Yash Pillai,24-12-2004,253875,Madhya Pradesh,16,6,0,18,40,Pass
Yash Sharma,17-10-2005,307465,Andhra Pradesh,4,8,23,22,57,Pass
Harjeet Mehta,01-10-2005,975044,Gujarat,20,19,12,16,67,Fail
Rehan Mehta,14-12-2005,590771,Punjab,9,18,18,8,53,Pass
Manpreet Chopra,20-03-2006,479226,Telangana,18,3,14,14,49,Pass
Rohan Sharma,22-12-2005,617515,Bihar,2,20,13,6,41,Pass
Aditya Reddy,24-03-2006,641514,Bihar,2,4,15,4,25,Pass
Aarav Fernandes,09-05-2005,269540,Telangana,3,12,19,17,51,Pass
Yash Reddy,28-12-2005,790543,West Bengal,3,15,6,22,46,Pass
Balbir Reddy,27-08-2005,100680,Uttar Pradesh,23,16,22,2,63,Pass
Rohan Pillai,08-07-2005,990601,Uttar Pradesh,10,16,23,1,50,Pass
Vivaan Fernandes,05-06-2005,679231,Maharashtra,7,22,14,3,46,Pass
Zaid Chopra,12-01-2006,584070,Uttar Pradesh,5,16,21,9,51,Pass
Kunal Mehta,13-03-2005,767930,West Bengal,13,11,8,16,48,Pass
Rohan Pillai,06-10-2005,863650,West Bengal,1,10,18,16,45,Pass
Imran Verma,11-09-2005,926331,Kerala,3,6,11,4,24,Fail
Harjeet Khan,06-05-2005,871966,Tamil Nadu,16,19,10,20,65,Pass
Kunal Chopra,08-11-2005,885620,Jharkhand,19,12,20,13,64,Pass
Farhan Reddy,30-07-2005,843004,Uttar Pradesh,16,11,1,2,30,Pass
Gurpreet Sharma,19-02-2006,118380,Delhi,12,14,15,0,41,Pass
Manpreet D'Souza,07-03-2006,638678,Mizoram,22,8,16,11,57,Fail
Vivaan Fernandes,04-12-2004,621139,Bihar,11,1,23,8,43,Pass
David Fernandes,25-02-2006,985001,Himachal Pradesh,3,14,4,8,29,Pass
Zaid Reddy,31-08-2005,870642,Bihar,16,22,15,0,53,Pass
Raj Fernandes,07-01-2006,668890,Bihar,7,10,2,5,24,Pass
Harjeet Sharma,01-03-2005,830047,Punjab,16,16,21,10,63,Pass
Yash D'Souza,02-01-2006,798545,Tamil Nadu,12,16,24,24,76,Pass
Aryan Khan,31-12-2004,746167,Uttar Pradesh,19,7,22,16,64,Pass
Krishna Verma,08-04-2006,657316,Madhya Pradesh,24,3,17,2,46,Pass
Ishaan Pillai,28-09-2005,181277,Kerala,0,11,18,11,40,Fail
Aditya Reddy,16-05-2005,115711,Telangana,10,21,9,18,58,Fail
Rohan Pillai,18-02-2006,367745,Rajasthan,21,13,7,2,43,Pass
Ishaan Sharma,06-02-2005,602960,Bihar,7,9,0,24,40,Pass
Balbir Singh,13-08-2005,891930,Uttar Pradesh,4,24,16,23,67,Pass
Rohan Khan,09-12-2005,153747,Madhya Pradesh,24,10,3,17,54,Pass
Aryan Mehta,22-03-2005,243865,Tamil Nadu,24,10,21,7,62,Pass
Kunal Verma,05-09-2005,419321,Rajasthan,22,8,4,22,56,Pass
Aditya Reddy,29-03-2006,445503,Bihar,21,16,7,3,47,Pass
Harjeet Khan,10-11-2004,446787,West Bengal,3,17,9,7,36,Pass
Aarav Chopra,20-08-2005,305510,Punjab,5,14,13,13,45,Pass
Aryan Reddy,18-11-2004,159432,Bihar,12,14,24,13,63,Pass
Raj Fernandes,19-03-2006,337210,Bihar,24,8,4,11,47,Pass
Yash Pillai,27-01-2006,230330,Uttar Pradesh,8,21,12,18,59,Pass
Aditya D'Souza,09-10-2005,257755,Madhya Pradesh,11,24,3,9,47,Pass
Rehan Sharma,18-06-2005,582950,Telangana,15,21,5,11,52,Fail
Kunal Fernandes,30-03-2005,575336,Kerala,22,20,20,4,66,Fail
Kunal Verma,23-02-2005,438079,Andhra Pradesh,12,1,0,19,32,Pass
Yash Sharma,16-12-2004,863936,Assam,18,20,7,12,57,Pass
Aditya Singh,10-05-2005,830465,Odisha,24,16,3,22,65,Pass
Rohan Verma,18-12-2005,498751,Delhi,4,1,24,16,45,Pass
Ishaan Verma,20-11-2004,374826,Uttar Pradesh,13,13,19,2,47,Pass
Vivaan Fernandes,29-07-2005,705804,Bihar,16,13,16,14,59,Pass
Rohan Reddy,01-12-2004,689286,Uttar Pradesh,4,6,23,16,49,Pass
Rohan D'Souza,12-04-2006,818493,Haryana,7,17,23,12,59,Pass
John Khan,17-04-2005,189033,Gujarat,5,15,20,2,42,Fail
Aarav Chopra,26-06-2005,657957,Madhya Pradesh,3,7,0,17,27,Pass
Aryan Singh,21-01-2005,341932,Uttar Pradesh,21,7,5,0,33,Pass
Gurpreet Sharma,23-01-2006,294087,Uttar Pradesh,21,4,12,17,54,Pass
Raj Reddy,29-12-2004,975404,Madhya Pradesh,3,0,24,10,37,Pass
Vivaan Singh,04-02-2005,752450,Maharashtra,15,14,16,3,48,Pass
Raj Fernandes,21-01-2006,242935,Jammu & Kashmir + Ladakh,21,7,19,9,56,Pass
Ishaan Mehta,30-04-2005,242698,Rajasthan,2,2,22,21,47,Pass
Ishaan Singh,23-01-2006,202148,Bihar,17,17,4,9,47,Pass
Kunal Reddy,15-01-2006,971173,Gujarat,24,4,7,2,37,Fail
Raj D'Souza,12-03-2006,394409,Maharashtra,17,12,0,5,34,Pass
Yash Reddy,09-12-2005,374062,Rajasthan,22,21,2,22,67,Pass
Kunal Fernandes,28-04-2005,558272,Assam,2,17,4,20,43,Pass
Aditya Chopra,07-05-2006,680716,Tamil Nadu,7,24,2,9,42,Pass
Gurpreet Mehta,04-01-2005,376439,Telangana,8,8,6,0,22,Pass
Kunal Reddy,17-11-2005,875746,Punjab,21,10,24,15,70,Pass
Aditya Reddy,25-12-2005,567777,Chhattisgarh,1,22,5,9,37,Pass
Krishna Chopra,02-09-2005,851105,Bihar,7,23,2,7,39,Pass
Yash Singh,29-06-2005,172458,Bihar,14,18,7,11,50,Pass
David Mehta,07-03-2005,184871,Chhattisgarh,19,0,3,23,45,Pass
Rohan Verma,15-04-2005,882750,Rajasthan,13,10,2,10,35,Pass
Vivaan Reddy,14-08-2005,695474,Haryana,6,20,0,3,29,Pass
Aditya Khan,11-07-2005,204445,Uttarakhand,5,6,3,22,36,Pass
Rohan D'Souza,24-10-2005,557744,Rajasthan,20,16,8,2,46,Pass
Ishaan D'Souza,02-01-2006,226081,West Bengal,3,4,19,20,46,Pass
Aditya Verma,29-12-2004,305925,Bihar,17,1,18,0,36,Pass
Balbir Chopra,02-04-2006,876964,Rajasthan,11,16,4,6,37,Pass
Ishaan Verma,11-06-2005,583009,Bihar,12,6,9,24,51,Pass
Ishaan Khan,02-05-2005,215727,Tamil Nadu,0,20,3,11,34,Pass
Krishna Chopra,17-07-2005,471711,Uttar Pradesh,7,2,7,11,27,Pass
Sukhwinder Pillai,04-12-2005,424915,Haryana,11,7,21,3,42,Pass
Vivaan Sharma,19-01-2006,149402,Andhra Pradesh,10,10,18,13,51,Pass
Raj D'Souza,10-10-2005,511500,Andaman & Nicobar,18,18,4,17,57,Pass
Aryan D'Souza,19-03-2006,778424,Bihar,22,11,3,6,42,Pass
Krishna Reddy,09-01-2005,963828,Tamil Nadu,24,24,6,16,70,Pass
Aryan Khan,17-01-2005,924100,Madhya Pradesh,0,1,21,9,31,Pass
Yash Fernandes,18-09-2005,842420,Madhya Pradesh,10,2,19,12,43,Pass
Aditya Khan,21-03-2006,587836,Maharashtra,21,10,0,3,34,Pass
Aryan Fernandes,26-01-2006,131650,Bihar,4,0,5,4,13,Pass
Kunal Singh,19-02-2006,622053,Assam,19,4,7,21,51,Pass
Raj D'Souza,25-06-2005,519169,Rajasthan,4,3,13,9,29,Pass
John D'Souza,17-07-2005,168302,Andhra Pradesh,18,24,17,15,74,Pass
Yash Mehta,07-03-2006,200478,Punjab,19,11,16,12,58,Pass
Yash Chopra,11-11-2004,353370,Bihar,1,5,3,10,19,Pass
Krishna Khan,13-08-2005,490363,Gujarat,15,4,10,18,47,Fail
Harjeet Chopra,09-01-2006,532853,Tamil Nadu,20,16,2,5,43,Pass
Kunal Sharma,01-03-2005,812274,Rajasthan,11,17,24,20,72,Pass
Yash Pillai,26-08-2005,583180,Haryana,16,1,10,1,28,Pass
Rohan Chopra,03-12-2005,408286,Haryana,12,2,0,20,34,Pass
Aryan Chopra,22-01-2006,153623,Kerala,18,1,20,22,61,Fail
Ishaan Reddy,07-02-2006,472224,Uttarakhand,18,0,3,5,26,Pass
Balbir Khan,30-12-2004,819906,West Bengal,19,9,3,4,35,Pass
Rohan Chopra,02-09-2005,141655,Andhra Pradesh,8,3,5,9,25,Pass
Harjeet Pillai,19-02-2006,549878,Assam,2,9,15,7,33,Pass
Ishaan Sharma,26-11-2004,285384,Madhya Pradesh,4,18,3,13,38,Pass
Balbir Singh,22-04-2006,308877,Bihar,13,5,16,13,47,Pass
Raj Mehta,21-01-2006,556842,West Bengal,7,14,24,4,49,Pass
Raj D'Souza,14-02-2006,550731,Tamil Nadu,3,20,10,16,49,Pass
Manpreet Mehta,26-02-2005,249694,Odisha,13,23,4,4,44,Pass
Manpreet Sharma,14-02-2006,771844,Delhi,7,0,10,0,17,Pass
Rohan Reddy,22-12-2004,625672,Bihar,7,13,7,1,28,Pass
Yash Singh,04-02-2005,818030,Jharkhand,6,10,9,20,45,Pass
Krishna Sharma,03-08-2005,316829,Chhattisgarh,2,3,18,12,35,Pass
Rohan Verma,24-04-2005,585955,Bihar,18,1,8,22,49,Pass
Yash Singh,15-01-2006,764203,Maharashtra,17,7,6,1,31,Pass
Ishaan Pillai,22-03-2006,885020,Madhya Pradesh,15,17,3,4,39,Pass
Ishaan Fernandes,02-10-2005,205841,Haryana,2,11,21,4,38,Pass
Yash Mehta,27-02-2005,690031,Punjab,4,11,1,17,33,Pass
Aarav Reddy,12-10-2005,383756,Uttar Pradesh,23,19,6,17,65,Pass
Aarav Reddy,19-08-2005,829544,Gujarat,23,20,19,3,65,Fail
David Khan,01-12-2004,714270,Telangana,20,10,14,18,62,Pass
Kunal Khan,16-11-2004,854278,Uttar Pradesh,24,3,19,21,67,Pass
Yash D'Souza,08-04-2006,809376,Assam,13,16,15,18,62,Pass
Ishaan Verma,19-08-2005,739927,Bihar,18,8,18,20,64,Pass
Manpreet Mehta,11-11-2004,980366,Maharashtra,17,18,10,3,48,Pass
Kunal Khan,13-12-2004,985370,Assam,9,15,15,6,45,Pass
Balbir Reddy,27-03-2005,209734,Telangana,7,2,13,8,30,Pass
Ishaan Pillai,14-04-2006,182667,Karnataka,23,22,11,9,65,Pass
Ayaan Reddy,07-12-2005,975011,Andhra Pradesh,10,15,22,15,62,Pass
Aryan D'Souza,07-08-2005,782283,Gujarat,12,13,0,11,36,Fail
Kunal Chopra,05-03-2006,167589,Tamil Nadu,5,0,7,11,23,Pass
Farhan Khan,04-06-2005,162184,Assam,19,14,19,17,69,Pass
Mathew D'Souza,24-08-2005,427662,Assam,2,13,2,18,35,Pass
Aditya Chopra,05-08-2005,292372,Andhra Pradesh,13,12,11,8,44,Pass
Kunal Khan,23-08-2005,397833,Uttar Pradesh,6,16,11,15,48,Pass
Raj Chopra,05-01-2006,587504,Maharashtra,11,5,4,24,44,Pass
Gurpreet Fernandes,20-07-2005,121871,Uttarakhand,3,10,4,24,41,Pass
Ishaan D'Souza,24-03-2006,711714,Haryana,24,4,0,23,51,Pass
Aryan Singh,09-09-2005,280437,Telangana,0,0,20,18,38,Pass
Mathew Pillai,17-04-2005,575342,Rajasthan,7,1,23,22,53,Pass
Aditya Sharma,30-05-2005,707745,Maharashtra,17,11,18,3,49,Pass
Raj Pillai,20-04-2005,591532,Madhya Pradesh,15,20,4,4,43,Pass
Vivaan Verma,02-01-2006,761140,Manipur,12,2,15,8,37,Pass
Mathew Khan,11-08-2005,376816,Assam,8,0,22,22,52,Pass
Aditya Singh,08-12-2005,636647,Gujarat,11,18,1,14,44,Fail
Vivaan Chopra,03-05-2006,305567,Uttar Pradesh,16,19,11,21,67,Pass
Krishna Fernandes,13-03-2006,675007,Uttar Pradesh,8,0,9,11,28,Pass
Krishna Khan,18-04-2005,612816,Tamil Nadu,0,0,18,10,28,Pass
Yash Fernandes,07-08-2005,923264,Telangana,23,3,23,23,72,Pass
Aarav Sharma,07-06-2005,524777,Bihar,15,12,15,0,42,Pass
Rohan Verma,06-01-2005,758423,Odisha,23,11,3,17,54,Pass
Vivaan D'Souza,17-04-2006,141814,Punjab,9,18,11,16,54,Pass
Krishna Reddy,07-01-2005,924178,Bihar,3,17,3,7,30,Pass
Raj Fernandes,21-06-2005,975443,Assam,6,9,23,13,51,Pass
Ishaan Chopra,14-03-2006,628579,Rajasthan,11,18,11,12,52,Pass
Mathew Khan,10-06-2005,478865,Tamil Nadu,5,1,14,4,24,Pass
Gurpreet Chopra,11-04-2006,540288,Andhra Pradesh,18,15,0,13,46,Pass
Aditya Reddy,25-03-2006,942986,Punjab,23,9,15,15,62,Pass
Aditya Mehta,25-10-2005,965765,Bihar,5,15,15,17,52,Pass
David Khan,15-07-2005,481862,Jammu & Kashmir + Ladakh,22,9,0,20,51,Pass
Harjeet Singh,25-04-2005,505893,Haryana,4,12,19,9,44,Pass
Paul Verma,30-08-2005,981744,Madhya Pradesh,20,12,13,10,55,Pass
Mathew Reddy,20-06-2005,903519,Bihar,5,8,20,3,36,Pass
Aditya Verma,07-08-2005,378067,Bihar,14,14,13,4,45,Pass
Aarav D'Souza,06-01-2006,994095,Tamil Nadu,8,2,23,8,41,Pass
Sukhwinder Pillai,29-06-2005,120418,Bihar,0,20,6,20,46,Pass
Raj Khan,06-02-2005,491005,Nagaland,3,16,3,10,32,Pass
Rehan Reddy,04-05-2005,131175,Maharashtra,13,10,5,4,32,Pass
Mathew D'Souza,02-04-2006,157783,Tamil Nadu,3,6,23,2,34,Pass
Rehan Fernandes,06-12-2004,130778,Madhya Pradesh,19,10,6,3,38,Pass
Kunal Khan,22-05-2005,314039,Haryana,6,8,4,19,37,Pass
Gurpreet Khan,27-01-2005,369503,Chhattisgarh,12,1,16,4,33,Pass
Ishaan Singh,25-05-2005,597143,Jharkhand,10,1,13,12,36,Pass
Aarav Chopra,11-05-2005,995988,Jharkhand,5,7,21,21,54,Pass
Rohan Sharma,28-05-2005,437142,Madhya Pradesh,24,0,13,12,49,Pass
Ishaan Verma,09-02-2005,640446,Haryana,24,14,5,6,49,Pass
Aditya Singh,15-12-2005,884442,Manipur,21,3,15,24,63,Fail
Rehan D'Souza,18-03-2005,337958,Bihar,23,20,22,20,85,Pass
John Mehta,02-05-2006,200108,Jammu & Kashmir + Ladakh,21,24,17,4,66,Pass
Ishaan Chopra,06-10-2005,704150,Manipur,16,3,6,22,47,Fail
Rohan Reddy,16-03-2005,530570,Andhra Pradesh,24,5,0,11,40,Pass
David Fernandes,19-04-2005,841116,Punjab,14,7,20,22,63,Pass
Krishna Verma,21-03-2006,730860,Tamil Nadu,24,3,6,14,47,Pass
Krishna Reddy,05-06-2005,948676,Maharashtra,11,2,4,8,25,Pass
Sukhwinder Singh,11-01-2006,813838,Rajasthan,4,19,3,1,27,Pass
Aryan Fernandes,30-03-2005,240431,Maharashtra,8,12,0,10,30,Pass
Krishna Verma,27-04-2006,612562,Telangana,17,20,14,11,62,Pass
Aditya Pillai,22-12-2005,463715,Bihar,10,9,2,18,39,Pass
Kunal Verma,05-12-2005,692836,Tamil Nadu,0,18,0,6,24,Pass
Balbir Sharma,07-06-2005,650392,Tamil Nadu,8,13,16,14,51,Pass
Raj Sharma,03-01-2005,656662,Madhya Pradesh,7,17,9,22,55,Pass
Aditya Khan,06-03-2005,879403,Andhra Pradesh,14,9,23,16,62,Pass
Gurpreet Sharma,27-10-2005,290944,Bihar,20,13,4,0,37,Pass
Yash Singh,05-02-2006,457185,Madhya Pradesh,20,19,3,14,56,Pass
Manpreet Singh,19-07-2005,959597,Punjab,6,20,15,1,42,Pass
Aditya Chopra,08-02-2006,257956,Assam,7,23,4,21,55,Pass
Sukhwinder Reddy,27-10-2005,403098,Rajasthan,20,5,15,15,55,Pass
Aryan Verma,30-05-2005,979883,Maharashtra,13,10,23,3,49,Pass
Harjeet Verma,27-03-2005,933566,Haryana,19,6,8,21,54,Pass
Manpreet Reddy,01-07-2005,247869,Madhya Pradesh,9,5,3,6,23,Pass
Sukhwinder Verma,14-01-2005,875222,Maharashtra,11,6,3,11,31,Pass
Harjeet Singh,03-05-2005,446898,Andhra Pradesh,2,13,7,4,26,Pass
Vivaan Fernandes,01-03-2006,755633,Rajasthan,5,22,5,13,45,Pass
Aryan Verma,17-02-2005,232322,Uttar Pradesh,13,8,18,10,49,Pass
Gurpreet Reddy,24-09-2005,352538,Uttarakhand,12,13,23,2,50,Pass
Ayaan Reddy,21-02-2005,967689,Haryana,14,5,15,21,55,Pass
Balbir Khan,26-02-2006,952065,Uttar Pradesh,21,17,17,6,61,Pass
Aarav Reddy,25-11-2005,585208,Uttar Pradesh,17,8,23,6,54,Pass
Rohan D'Souza,04-04-2005,209041,Uttar Pradesh,23,3,12,22,60,Pass
Ishaan Fernandes,21-04-2005,107747,Chhattisgarh,15,2,12,11,40,Pass
Vivaan Fernandes,25-04-2006,514117,West Bengal,24,0,1,19,44,Pass
Aryan D'Souza,29-10-2005,976255,Maharashtra,24,0,18,3,45,Pass
Harjeet Chopra,28-04-2006,857590,Daman & Diu / D&N Haveli,1,15,8,5,29,Fail
Aryan Singh,14-03-2006,444376,Punjab,0,19,0,0,19,Pass
Kunal Mehta,02-12-2005,712327,Punjab,1,17,1,8,27,Pass
Balbir Singh,14-11-2005,609885,Punjab,9,15,9,3,36,Pass
Yash Mehta,11-12-2004,481277,Odisha,2,0,0,19,21,Pass
Raj Khan,01-12-2004,290665,Madhya Pradesh,20,2,21,8,51,Pass
Paul Pillai,04-12-2004,412951,Maharashtra,15,1,7,16,39,Pass
Ishaan D'Souza,13-04-2006,739585,Uttar Pradesh,11,18,20,6,55,Pass
John Fernandes,20-08-2005,316937,Rajasthan,10,8,1,6,25,Pass
Ishaan D'Souza,07-09-2005,749041,Chhattisgarh,7,3,19,11,40,Pass
Kunal Verma,14-07-2005,919391,Punjab,21,2,2,21,46,Pass
Rohan Reddy,02-05-2006,488767,Kerala,18,21,13,8,60,Fail
Manpreet Mehta,17-02-2006,708280,Tamil Nadu,22,19,18,0,59,Pass
Harjeet Singh,21-01-2005,316720,Uttar Pradesh,20,3,10,17,50,Pass
Balbir Singh,23-05-2005,318854,Rajasthan,15,17,24,15,71,Pass
Aryan Fernandes,11-11-2004,195928,Maharashtra,24,16,21,3,64,Pass
Kunal D'Souza,07-11-2005,364438,Gujarat,0,14,14,12,40,Fail
Balbir Sharma,21-04-2005,791859,Tamil Nadu,11,11,3,2,27,Pass
David Singh,06-05-2005,645153,Rajasthan,14,12,24,16,66,Pass
Krishna Khan,23-02-2005,347777,Tamil Nadu,23,7,16,7,53,Pass
Raj Pillai,23-04-2005,514124,Uttarakhand,9,13,3,11,36,Pass
Raj Reddy,02-05-2005,517469,Madhya Pradesh,5,8,16,11,40,Pass
Rohan Singh,09-08-2005,342616,Manipur,12,18,13,0,43,Fail
Imran Khan,19-08-2005,344058,Delhi,22,13,20,1,56,Pass
Krishna Mehta,16-04-2005,889797,Andhra Pradesh,1,9,19,19,48,Pass
Raj Khan,29-11-2005,884804,Andhra Pradesh,24,20,6,7,57,Pass
Gurpreet D'Souza,30-11-2004,803803,Jharkhand,23,22,7,10,62,Pass
Aditya Mehta,18-04-2005,203331,Maharashtra,3,17,1,11,32,Pass
Yash Pillai,23-08-2005,538481,Delhi,14,24,10,19,67,Pass
Manpreet Sharma,10-04-2006,371390,Gujarat,1,4,24,16,45,Fail
Vivaan Reddy,16-03-2006,927822,Andhra Pradesh,24,23,8,1,56,Pass
Vivaan Singh,09-02-2005,387867,Bihar,24,10,8,3,45,Pass
Yash Verma,28-02-2006,887388,Uttar Pradesh,1,10,18,0,29,Pass
Harjeet Mehta,12-04-2006,797371,Jharkhand,4,20,12,20,56,Fail
Aarav Chopra,29-03-2006,117358,Madhya Pradesh,10,6,1,6,23,Pass
Vivaan Chopra,06-05-2006,317497,Jammu & Kashmir + Ladakh,16,20,24,13,73,Fail
Kunal D'Souza,30-03-2005,943773,Maharashtra,21,17,4,3,45,Pass
Gurpreet Chopra,09-07-2005,807523,Bihar,8,21,19,5,53,Pass
Raj Verma,13-02-2006,279101,Bihar,11,17,10,21,59,Pass
Harjeet Sharma,04-06-2005,754111,Punjab,6,8,19,18,51,Pass
Rohan Fernandes,27-04-2006,111270,Uttar Pradesh,9,21,12,19,61,Pass
Raj D'Souza,23-03-2006,343484,Uttar Pradesh,18,2,20,9,49,Pass
Rohan Singh,07-06-2005,699635,Haryana,7,8,6,22,43,Pass
Mathew Verma,01-10-2005,240693,Uttar Pradesh,16,14,13,16,59,Pass
Kunal Verma,16-03-2005,488879,Bihar,1,17,12,1,31,Pass
Aarav Chopra,02-12-2005,713258,Uttarakhand,21,0,16,1,38,Pass
Gurpreet Reddy,15-10-2005,204102,Jammu & Kashmir + Ladakh,24,22,9,4,59,Pass
Kunal Khan,04-06-2005,548723,Maharashtra,11,2,3,0,16,Pass
John Sharma,06-09-2005,420304,Karnataka,6,7,17,22,52,Pass
Raj Pillai,09-07-2005,542883,Punjab,9,19,2,20,50,Pass
Paul Singh,30-03-2006,374266,Haryana,2,1,23,18,44,Pass
Aryan D'Souza,30-04-2005,407691,West Bengal,3,21,17,24,65,Pass
Vivaan D'Souza,16-12-2005,194790,Assam,10,9,23,24,66,Pass
Krishna Sharma,16-12-2004,882031,Punjab,6,0,1,3,10,Pass
Raj Sharma,30-08-2005,237086,West Bengal,6,18,16,14,54,Pass
John Fernandes,16-04-2005,340034,Madhya Pradesh,22,3,3,21,49,Pass
Krishna Singh,13-09-2005,634893,Uttar Pradesh,0,0,23,5,28,Pass
Sukhwinder Reddy,27-08-2005,694970,Tamil Nadu,20,22,3,19,64,Pass
Harjeet Khan,09-06-2005,421987,Madhya Pradesh,3,2,11,23,39,Pass
Aditya Reddy,15-11-2005,714730,Odisha,17,7,23,19,66,Pass
Krishna Singh,30-12-2005,851477,Telangana,9,22,17,9,57,Pass
Gurpreet Khan,04-05-2005,200038,Gujarat,22,16,10,18,66,Fail
Ayaan Singh,12-11-2004,222740,Rajasthan,7,24,18,23,72,Pass
Vivaan Pillai,05-01-2005,795540,Uttar Pradesh,19,0,16,11,46,Pass
Rohan Sharma,28-10-2005,395422,Uttar Pradesh,23,21,17,4,65,Pass
Aditya Mehta,29-05-2005,689204,Odisha,21,1,3,1,26,Pass
Aditya Chopra,05-08-2005,886937,Maharashtra,21,9,10,3,43,Pass
Raj Chopra,05-01-2005,746673,Uttar Pradesh,16,22,17,7,62,Pass
Yash Reddy,14-05-2005,782594,Maharashtra,11,15,21,3,50,Pass
Kunal Reddy,26-07-2005,138897,Punjab,8,20,8,9,45,Pass
Raj Pillai,26-02-2006,990186,Punjab,16,19,11,23,69,Pass
Raj Reddy,21-02-2005,848487,Tamil Nadu,24,10,4,1,39,Pass
Yash Pillai,28-11-2005,160146,Tamil Nadu,5,0,18,1,24,Pass
David Pillai,05-07-2005,689543,Daman & Diu / D&N Haveli,18,0,13,0,31,Fail
Imran Reddy,01-12-2005,717629,Andhra Pradesh,0,21,3,4,28,Pass
Zaid Reddy,29-08-2005,416079,Telangana,6,1,5,1,13,Pass
Yash Fernandes,24-01-2005,740487,Rajasthan,0,20,1,7,28,Pass
Kunal Pillai,07-02-2006,726769,Madhya Pradesh,12,19,3,15,49,Pass
Raj Reddy,26-04-2006,172873,Rajasthan,23,13,24,4,64,Pass
Aryan Chopra,13-03-2006,301949,Jharkhand,1,13,0,17,31,Pass
Raj Reddy,22-09-2005,136810,Punjab,4,21,8,17,50,Pass
Manpreet Chopra,10-11-2005,786685,Meghalaya,21,5,11,13,50,Pass
Aditya Pillai,22-08-2005,541364,Tamil Nadu,21,13,23,6,63,Pass
Raj Reddy,23-08-2005,990775,Telangana,24,24,3,17,68,Pass
Aarav Reddy,22-09-2005,327377,Andhra Pradesh,24,1,3,21,49,Pass
Krishna Sharma,20-03-2005,534484,Tamil Nadu,3,16,24,23,66,Pass
Balbir Mehta,30-12-2004,743916,Andhra Pradesh,20,4,10,23,57,Pass
Aryan Verma,11-05-2005,993778,Odisha,16,21,2,11,50,Pass
Krishna Mehta,16-08-2005,554840,Odisha,21,14,1,17,53,Pass
David D'Souza,17-03-2005,404767,Bihar,17,17,20,19,73,Pass
Harjeet Khan,08-07-2005,150815,Uttar Pradesh,9,9,11,1,30,Pass
Balbir Verma,18-05-2005,994081,Bihar,17,17,20,6,60,Pass
Yash Reddy,03-04-2006,894260,Tamil Nadu,3,0,8,13,24,Pass
Balbir Verma,13-03-2006,198870,Uttar Pradesh,8,15,22,21,66,Pass
Aarav Reddy,01-12-2004,594773,Rajasthan,13,12,14,9,48,Pass
Aarav Verma,08-11-2005,770596,Bihar,5,3,11,23,42,Pass
David D'Souza,11-06-2005,172962,Uttar Pradesh,1,8,8,12,29,Pass
Balbir Fernandes,02-03-2005,810042,Bihar,5,10,3,15,33,Pass
Aryan Chopra,26-10-2005,787192,Punjab,17,19,13,10,59,Pass
Sukhwinder Fernandes,03-10-2005,963531,Andhra Pradesh,5,23,5,22,55,Pass
John Khan,03-12-2004,820958,Odisha,8,2,3,5,18,Pass
Imran Verma,06-09-2005,591105,Andhra Pradesh,8,6,11,15,40,Pass
Aditya Sharma,23-12-2004,266696,Rajasthan,9,16,4,18,47,Pass
Aryan Reddy,09-03-2005,953350,West Bengal,23,1,1,6,31,Pass
Raj Fernandes,11-12-2004,500178,Maharashtra,14,0,21,3,38,Pass
Yash Mehta,21-08-2005,624201,Tamil Nadu,6,8,6,3,23,Pass
Aditya Sharma,12-04-2005,611743,Assam,21,18,0,18,57,Pass
Kunal Singh,21-08-2005,851624,Andhra Pradesh,20,12,24,5,61,Pass
Aryan Verma,12-12-2005,458699,Delhi,11,20,11,23,65,Pass
Yash D'Souza,18-01-2005,509460,Uttar Pradesh,5,17,8,6,36,Pass
Aryan Singh,01-01-2006,350227,Maharashtra,20,6,24,3,53,Pass
Aditya Verma,27-04-2005,575208,Haryana,12,6,21,0,39,Pass
Aditya Pillai,03-12-2005,614847,Madhya Pradesh,13,23,3,16,55,Pass
Vivaan Reddy,06-04-2006,944031,Andhra Pradesh,15,17,1,8,41,Pass
Harjeet Chopra,27-12-2004,762091,Madhya Pradesh,14,19,2,17,52,Pass
Balbir D'Souza,15-03-2006,180022,Uttarakhand,24,8,3,24,59,Pass
Harjeet Pillai,17-08-2005,330218,Goa,2,24,22,18,66,Fail
Harjeet Fernandes,09-05-2006,807181,Bihar,18,1,10,1,30,Pass
Gurpreet Chopra,11-04-2006,115698,Uttarakhand,7,8,4,19,38,Pass
Peter Sharma,31-05-2005,622235,Haryana,3,7,1,3,14,Pass
Aarav Khan,07-04-2006,767128,Rajasthan,20,14,6,24,64,Pass
Kunal Reddy,24-02-2005,215782,West Bengal,20,6,11,13,50,Pass
Vivaan Sharma,11-02-2005,738330,Uttarakhand,16,9,3,17,45,Pass
Peter Sharma,06-12-2004,805038,Tamil Nadu,23,9,1,22,55,Pass
David Sharma,20-03-2006,293073,Bihar,15,11,2,6,34,Pass
Krishna Singh,21-05-2005,955134,Odisha,11,19,5,10,45,Pass
Kunal Sharma,11-04-2005,756760,Gujarat,16,19,12,17,64,Fail
Krishna Verma,14-12-2004,263657,Uttar Pradesh,24,3,21,9,57,Pass
Aryan Mehta,03-05-2005,977026,Jharkhand,14,9,14,7,44,Pass
Harjeet Chopra,19-01-2005,557062,Madhya Pradesh,8,19,3,19,49,Pass
Krishna Chopra,26-11-2004,185817,Uttar Pradesh,18,3,19,18,58,Pass
Rohan Fernandes,17-04-2005,221074,Uttar Pradesh,13,11,20,2,46,Pass
Sukhwinder D'Souza,16-03-2005,832816,West Bengal,23,2,8,3,36,Pass
Krishna Chopra,15-12-2005,379554,Rajasthan,5,17,12,12,46,Pass
Harjeet Singh,13-12-2004,727228,Rajasthan,10,19,7,7,43,Pass
Krishna Khan,19-04-2005,320104,Punjab,8,8,5,4,25,Pass
Raj Verma,17-05-2005,585900,Jharkhand,16,2,5,24,47,Pass
Krishna Sharma,26-01-2005,311907,Haryana,10,24,23,10,67,Pass
Rohan Reddy,21-04-2006,553050,Punjab,8,22,22,15,67,Pass
Krishna D'Souza,08-02-2006,522630,Rajasthan,20,15,10,24,69,Pass
Krishna Verma,16-05-2005,906895,Telangana,8,20,19,9,56,Pass
Aditya Khan,14-12-2004,261721,Assam,21,6,15,17,59,Pass
David Chopra,27-01-2005,622763,West Bengal,3,10,18,3,34,Pass
Sukhwinder Singh,31-07-2005,100930,Jammu & Kashmir + Ladakh,9,18,4,10,41,Pass
Paul Sharma,10-04-2006,117316,Odisha,13,16,14,11,54,Pass
Rohan Chopra,09-07-2005,440043,Punjab,21,21,9,1,52,Pass
Raj Verma,10-01-2006,215430,Uttar Pradesh,18,3,21,23,65,Pass
David D'Souza,28-11-2004,722104,Madhya Pradesh,0,3,20,10,33,Pass
Raj Reddy,09-03-2005,731122,Maharashtra,1,3,8,21,33,Pass
Kunal Verma,16-12-2004,851305,Rajasthan,21,18,4,9,52,Pass
Paul Pillai,20-08-2005,157984,Punjab,3,5,2,4,14,Pass
Kunal Pillai,14-04-2006,173898,Rajasthan,13,1,13,9,36,Pass
Yash Verma,04-02-2005,128737,West Bengal,3,21,15,17,56,Pass
Gurpreet Pillai,27-06-2005,866544,Odisha,4,3,0,18,25,Pass
Kunal Pillai,27-09-2005,121471,Punjab,11,22,23,14,70,Pass
Krishna Mehta,20-10-2005,423636,Jharkhand,0,5,1,5,11,Pass
Ishaan Reddy,26-11-2004,155719,Bihar,15,0,11,11,37,Pass
Raj Pillai,14-02-2006,875121,Uttar Pradesh,17,14,17,8,56,Pass
Kunal Mehta,23-12-2005,935821,West Bengal,5,14,22,7,48,Pass
Raj Chopra,20-11-2004,630383,Bihar,8,11,20,12,51,Pass
Sukhwinder Singh,27-01-2005,894006,Madhya Pradesh,24,14,3,24,65,Pass
Ishaan Pillai,01-11-2005,730055,West Bengal,3,23,16,2,44,Pass
Peter Pillai,22-12-2005,354849,Maharashtra,0,24,6,15,45,Pass
Raj Singh,19-11-2005,774634,Uttar Pradesh,9,16,10,11,46,Pass
Raj Singh,06-10-2005,223152,Jharkhand,10,9,19,22,60,Pass
Yash Chopra,28-02-2005,398237,Maharashtra,10,17,1,10,38,Pass
Aarav Verma,22-10-2005,490359,Delhi,1,1,2,11,15,Pass
Mathew Verma,12-05-2005,660088,Rajasthan,0,5,21,23,49,Pass
Krishna Singh,15-08-2005,527299,Rajasthan,12,23,15,22,72,Pass
Ishaan Pillai,04-01-2006,958253,Meghalaya,13,11,13,15,52,Pass
Krishna Chopra,28-03-2005,801566,Maharashtra,18,13,16,3,50,Pass
Vivaan Khan,11-05-2005,731352,Haryana,23,20,4,7,54,Pass
Rohan D'Souza,27-01-2006,454293,Uttar Pradesh,6,7,12,10,35,Pass
Gurpreet Chopra,01-02-2006,341781,Karnataka,9,16,22,7,54,Pass
Aarav Mehta,11-01-2006,960545,Chhattisgarh,18,19,3,18,58,Pass
John Pillai,05-12-2004,456540,Rajasthan,2,2,15,19,38,Pass
Gurpreet Mehta,15-02-2006,888161,Andhra Pradesh,18,22,7,1,48,Pass
Peter D'Souza,02-03-2006,962907,Uttar Pradesh,8,15,1,8,32,Pass
Ishaan Verma,20-11-2004,954170,Madhya Pradesh,2,20,1,6,29,Pass
Krishna Chopra,20-04-2005,447564,Andhra Pradesh,15,3,11,24,53,Pass
Raj D'Souza,01-02-2005,238156,Uttar Pradesh,14,14,3,12,43,Pass
Aryan Pillai,01-04-2006,232663,Bihar,6,22,12,14,54,Pass
Yash Verma,19-07-2005,527116,Meghalaya,4,13,7,12,36,Pass
Paul Khan,06-05-2005,669997,Uttar Pradesh,3,8,3,20,34,Pass
Aarav Reddy,21-06-2005,985306,Tamil Nadu,3,12,6,10,31,Pass
Farhan Sharma,01-08-2005,347511,Bihar,24,22,3,0,49,Pass
Raj Singh,10-08-2005,703283,Jammu & Kashmir + Ladakh,2,24,18,8,52,Pass
Kunal Verma,18-08-2005,686661,Manipur,16,18,5,3,42,Fail
David Khan,29-12-2004,781093,Meghalaya,8,17,1,16,42,Pass
Aarav D'Souza,29-12-2004,871272,Rajasthan,2,16,21,18,57,Pass
Krishna Chopra,20-02-2006,520280,West Bengal,1,8,0,10,19,Pass
Aryan Chopra,27-11-2005,389456,Delhi,12,17,8,19,56,Pass
Aryan Sharma,11-06-2005,543243,Tamil Nadu,6,11,7,2,26,Pass
Aditya Singh,30-04-2006,760657,Tamil Nadu,11,11,3,13,38,Pass
Balbir D'Souza,28-05-2005,699850,Uttar Pradesh,6,3,19,13,41,Pass
Kunal Pillai,12-02-2006,598506,Maharashtra,13,23,15,3,54,Pass
Vivaan Fernandes,10-03-2005,727941,Himachal Pradesh,9,19,22,0,50,Pass
Rohan Verma,04-04-2006,931272,Rajasthan,3,5,24,5,37,Pass
Kunal Verma,30-11-2004,333191,Maharashtra,10,8,5,14,37,Pass
Rohan Mehta,07-01-2005,302117,Madhya Pradesh,13,5,17,1,36,Pass
Mathew Reddy,15-06-2005,728525,Andhra Pradesh,20,6,21,13,60,Pass
Aarav Chopra,08-11-2005,684382,Uttar Pradesh,24,5,13,8,50,Pass
Gurpreet Sharma,09-11-2004,804499,Telangana,14,3,8,4,29,Pass
Raj Reddy,28-02-2005,259559,Karnataka,0,2,9,19,30,Pass
Harjeet Chopra,29-11-2005,262250,Kerala,12,21,11,10,54,Fail
Raj Mehta,07-09-2005,597437,Haryana,11,14,24,19,68,Pass
Aarav Mehta,17-12-2004,224329,West Bengal,0,19,17,18,54,Pass
Ishaan Mehta,07-03-2005,496449,Uttar Pradesh,3,6,23,13,45,Pass
Imran Chopra,21-08-2005,718265,Uttarakhand,5,19,4,18,46,Pass
Ishaan Pillai,13-11-2004,155617,Rajasthan,13,1,20,17,51,Pass
Kunal Khan,11-04-2005,332099,Uttar Pradesh,11,19,23,16,69,Pass
Aditya Fernandes,08-03-2006,961864,Arunachal Pradesh,4,1,24,20,49,Fail
Vivaan D'Souza,25-12-2005,742316,Maharashtra,21,16,12,3,52,Pass
Raj Mehta,23-02-2006,835375,Bihar,14,19,16,19,68,Pass
Farhan Sharma,23-08-2005,882308,Uttar Pradesh,5,20,4,9,38,Pass
Manpreet Sharma,03-05-2006,589910,Bihar,2,18,3,10,33,Pass
Harjeet Pillai,10-08-2005,968946,Maharashtra,6,16,15,3,40,Pass
Aarav Sharma,16-11-2005,257322,Punjab,13,23,7,9,52,Pass
Yash Sharma,13-12-2004,547725,Bihar,12,11,0,9,32,Pass
Rohan Fernandes,23-03-2006,348145,Madhya Pradesh,18,22,3,3,46,Pass
Harjeet Reddy,20-12-2004,497039,Gujarat,14,1,13,19,47,Fail
Aditya Singh,16-03-2005,652942,Jharkhand,14,6,17,2,39,Pass
Kunal D'Souza,20-07-2005,848771,West Bengal,22,6,10,0,38,Pass
Kunal Sharma,04-03-2005,805200,West Bengal,2,12,5,24,43,Pass
John Khan,12-12-2005,337686,Maharashtra,24,8,15,3,50,Pass
Yash Sharma,17-01-2005,582899,Uttar Pradesh,23,1,19,2,45,Pass
Raj Pillai,14-11-2004,684192,West Bengal,9,13,14,16,52,Pass
Vivaan Mehta,31-12-2004,210928,Punjab,0,22,10,23,55,Pass
Aryan Fernandes,29-01-2005,545474,Maharashtra,10,12,14,8,44,Pass
Aryan Mehta,09-04-2005,693220,West Bengal,2,1,20,4,27,Pass
Aryan Khan,02-12-2004,456623,Tamil Nadu,1,1,10,5,17,Pass
Yash Sharma,14-11-2005,817301,Andhra Pradesh,17,15,9,11,52,Pass
Balbir Sharma,21-06-2005,786800,Uttar Pradesh,9,10,18,2,39,Pass
Aditya Chopra,08-01-2006,890018,Jharkhand,19,23,4,18,64,Pass
Kunal Singh,09-09-2005,311554,Rajasthan,4,6,3,19,32,Pass
Yash Pillai,03-09-2005,279681,Sikkim,22,20,6,10,58,Pass
Rehan Chopra,27-09-2005,392813,Tamil Nadu,4,1,4,8,17,Pass
Raj Khan,07-03-2005,246906,Chhattisgarh,12,12,11,21,56,Pass
Aditya Khan,24-01-2006,422441,Jharkhand,13,10,14,8,45,Pass
Sukhwinder Pillai,06-04-2006,109015,Uttar Pradesh,8,12,15,9,44,Pass
Paul Khan,22-05-2005,765145,Rajasthan,3,10,11,5,29,Pass
Aarav D'Souza,12-12-2005,453508,Rajasthan,5,24,3,8,40,Pass
John Fernandes,19-07-2005,600186,Mizoram,8,11,17,7,43,Pass
Balbir D'Souza,15-01-2006,738720,Uttarakhand,21,13,3,2,39,Pass
Raj Reddy,25-12-2004,627974,Himachal Pradesh,18,20,3,14,55,Pass
Mathew Reddy,12-01-2006,987213,Bihar,12,7,23,5,47,Pass
Aarav Fernandes,30-12-2005,217795,Maharashtra,16,17,3,3,39,Pass
Aditya Verma,31-07-2005,290580,Maharashtra,6,11,14,8,39,Pass
Raj Sharma,30-12-2005,797532,Delhi,5,0,8,12,25,Pass
Zaid Singh,28-07-2005,450509,Uttar Pradesh,2,17,3,16,38,Pass
Gurpreet Mehta,03-11-2005,929579,Uttar Pradesh,10,13,18,7,48,Pass
Raj Singh,10-12-2004,186785,Rajasthan,24,1,2,1,28,Pass
Aditya Fernandes,15-07-2005,106161,Punjab,6,18,8,8,40,Pass
Krishna Mehta,19-03-2006,382967,Uttar Pradesh,11,1,23,22,57,Pass
Aditya Sharma,01-01-2006,294276,Andhra Pradesh,24,10,18,17,69,Pass
Aarav Khan,31-07-2005,448280,Bihar,9,7,6,0,22,Pass
Ishaan Reddy,30-08-2005,260533,Bihar,0,22,7,7,36,Pass
Aryan Chopra,18-12-2004,428398,Rajasthan,10,0,6,5,21,Pass
Sukhwinder D'Souza,05-03-2006,694906,Punjab,13,13,6,19,51,Pass
John Khan,19-11-2005,123390,Punjab,9,13,15,13,50,Pass
Farhan Chopra,11-01-2006,310232,Uttar Pradesh,0,17,8,16,41,Pass
Peter Singh,12-05-2005,756618,Rajasthan,21,15,22,11,69,Pass
Aarav D'Souza,10-03-2006,508305,Maharashtra,4,17,1,18,40,Pass
Aditya Singh,12-11-2005,712604,Jharkhand,8,3,15,19,45,Pass
Manpreet Sharma,09-03-2006,838718,Maharashtra,5,23,21,3,52,Pass
Zaid Fernandes,22-11-2004,379049,Bihar,3,5,24,24,56,Pass
Peter Chopra,06-09-2005,691083,Madhya Pradesh,11,2,13,23,49,Pass
Rohan Verma,07-06-2005,919312,Bihar,2,2,7,8,19,Pass
Harjeet Mehta,15-03-2005,349440,Haryana,9,3,8,10,30,Pass
Aditya Singh,30-06-2005,364031,Uttar Pradesh,2,11,9,9,31,Pass
Aryan Singh,27-09-2005,778950,Haryana,13,22,18,19,72,Pass
Manpreet Khan,21-01-2005,919560,West Bengal,3,12,18,11,44,Pass
Krishna Sharma,15-05-2005,911454,Jharkhand,0,14,20,5,39,Pass
Aarav Reddy,11-11-2005,369640,Gujarat,22,19,18,19,78,Fail
Aditya D'Souza,15-02-2006,699382,Odisha,1,21,14,3,39,Pass
Krishna Khan,24-01-2006,825756,Odisha,3,24,4,12,43,Pass
Raj Verma,20-11-2005,966653,Bihar,10,9,17,8,44,Pass
Yash Singh,20-04-2005,434643,Bihar,11,7,13,15,46,Pass
Kunal D'Souza,08-11-2005,187038,Uttarakhand,8,7,3,18,36,Pass
Yash Chopra,12-12-2004,236553,Bihar,24,18,16,18,76,Pass
Krishna Khan,18-12-2004,641140,Chhattisgarh,19,2,12,17,50,Pass
Kunal Verma,17-11-2004,245382,Uttar Pradesh,18,3,22,22,65,Pass
Sukhwinder Sharma,18-07-2005,533577,Rajasthan,6,14,3,15,38,Pass
Yash Mehta,06-02-2006,987934,Maharashtra,14,7,9,15,45,Pass
Aryan Sharma,16-06-2005,814250,Telangana,17,5,21,22,65,Pass
Aditya Fernandes,07-02-2005,405169,Tripura,5,15,3,15,38,Pass
Yash Reddy,06-12-2005,791480,Rajasthan,20,1,13,6,40,Pass
Kunal Reddy,24-02-2005,311879,Madhya Pradesh,9,5,11,5,30,Pass
Aditya Singh,08-04-2006,346833,Gujarat,0,14,19,13,46,Fail
Sukhwinder Reddy,26-06-2005,415312,Rajasthan,17,5,2,22,46,Pass
Raj Verma,24-11-2004,227688,Gujarat,5,24,9,17,55,Fail
Ishaan Pillai,04-04-2005,840426,Haryana,20,0,12,22,54,Pass
John D'Souza,15-02-2006,884111,West Bengal,19,1,7,4,31,Pass
Imran Mehta,30-11-2004,750204,Odisha,3,12,18,22,55,Pass
Imran Chopra,13-01-2005,290238,Punjab,1,5,20,0,26,Pass
Manpreet Sharma,04-05-2006,981690,Uttar Pradesh,17,7,21,15,60,Pass
Aryan Mehta,26-11-2004,643359,Uttar Pradesh,7,16,0,14,37,Pass
Raj Sharma,05-03-2005,617644,Madhya Pradesh,9,12,3,4,28,Pass
Kunal Pillai,06-04-2006,250789,Haryana,24,24,8,19,75,Pass
Raj Sharma,18-04-2006,853087,Odisha,19,16,24,20,79,Pass
Aryan Chopra,14-04-2005,968804,Bihar,11,24,2,12,49,Pass
Aryan Mehta,17-05-2005,150771,Himachal Pradesh,17,2,8,6,33,Pass
Ishaan Singh,12-10-2005,531170,Rajasthan,18,21,2,2,43,Pass
Yash Singh,01-04-2005,419593,Telangana,11,3,20,17,51,Pass
Balbir D'Souza,12-04-2006,138815,Tamil Nadu,13,17,7,16,53,Pass
Ishaan Mehta,22-05-2005,890702,Madhya Pradesh,8,2,6,4,20,Pass
Peter Chopra,20-12-2005,615004,Uttarakhand,9,13,3,22,47,Pass
Krishna Verma,27-06-2005,783798,Bihar,5,24,24,18,71,Pass
Ishaan Khan,05-09-2005,321860,Bihar,2,18,18,23,61,Pass
Raj Pillai,25-12-2004,250489,Punjab,3,17,21,12,53,Pass
Raj Mehta,02-05-2006,864519,Odisha,16,19,2,7,44,Pass
Mathew Reddy,08-03-2006,226539,Punjab,16,5,11,24,56,Pass
Kunal Sharma,14-11-2004,123956,Uttar Pradesh,8,10,5,9,32,Pass
Rohan Sharma,21-12-2005,191786,West Bengal,3,23,23,15,64,Pass
Aditya Khan,05-03-2005,817237,Punjab,4,6,4,4,18,Pass
Vivaan D'Souza,04-03-2006,857541,Uttar Pradesh,9,12,23,8,52,Pass
Paul Verma,26-12-2004,616435,Maharashtra,22,3,3,4,32,Pass
Krishna Pillai,14-07-2005,840704,Himachal Pradesh,21,6,22,3,52,Pass
Aryan Pillai,12-12-2005,953440,Jharkhand,17,6,22,19,64,Pass
Kunal D'Souza,23-11-2004,480720,Bihar,16,20,24,9,69,Pass
Vivaan Reddy,13-03-2006,181107,Uttar Pradesh,2,10,13,22,47,Pass
Aryan Pillai,10-02-2005,423375,Jharkhand,11,15,9,2,37,Pass
Paul Singh,02-12-2005,268209,Uttarakhand,14,0,3,21,38,Pass
Vivaan Sharma,16-11-2004,753321,Uttar Pradesh,11,12,1,10,34,Pass
Zaid Mehta,23-04-2005,649050,Rajasthan,22,20,8,10,60,Pass
Aryan Pillai,11-10-2005,655468,Andhra Pradesh,10,14,8,0,32,Pass
Aarav Mehta,12-04-2005,163040,Gujarat,12,3,8,15,38,Fail
Gurpreet Fernandes,17-03-2005,356921,Uttar Pradesh,5,5,4,20,34,Pass
Rohan Singh,11-03-2006,299560,Telangana,6,1,6,13,26,Pass
Aryan Verma,18-06-2005,234028,Delhi,0,1,21,5,27,Pass
Ishaan Mehta,13-04-2006,294558,Bihar,19,8,8,13,48,Pass
Krishna Khan,03-02-2006,809842,Maharashtra,12,21,19,3,55,Pass
Aryan Khan,13-04-2006,451943,Jammu & Kashmir + Ladakh,15,0,16,16,47,Pass
Peter Sharma,11-12-2005,155415,Telangana,0,13,24,14,51,Pass
Sukhwinder Sharma,14-06-2005,370970,Uttar Pradesh,12,14,9,18,53,Pass
Paul Verma,12-04-2005,706224,Uttarakhand,12,12,3,9,36,Pass
Vivaan Chopra,20-08-2005,268159,Maharashtra,2,1,3,0,6,Pass
Mathew Singh,09-11-2005,233053,Andhra Pradesh,10,4,15,8,37,Pass
Aryan Reddy,15-12-2004,544980,Madhya Pradesh,16,8,3,22,49,Pass
Vivaan Chopra,04-06-2005,998079,Madhya Pradesh,6,22,3,21,52,Pass
Raj Singh,28-06-2005,306127,Uttar Pradesh,15,13,0,6,34,Pass
Ishaan Khan,14-07-2005,809398,Assam,6,22,3,17,48,Pass
Balbir Mehta,01-10-2005,524527,Jharkhand,18,2,9,8,37,Pass
Yash D'Souza,06-09-2005,195541,Rajasthan,5,22,4,7,38,Pass
Sukhwinder Reddy,13-04-2006,453007,Uttarakhand,17,15,8,10,50,Pass
Raj Pillai,03-05-2006,241281,Uttar Pradesh,18,0,10,23,51,Pass
Sukhwinder Sharma,10-12-2004,756446,Delhi,2,24,23,3,52,Pass
Yash Sharma,28-01-2006,752525,Maharashtra,1,5,11,19,36,Pass
Ishaan Chopra,23-01-2006,692374,West Bengal,3,13,23,14,53,Pass
Aditya Khan,19-07-2005,562758,Bihar,21,2,8,15,46,Pass
Ishaan Pillai,05-01-2005,316713,Maharashtra,16,10,15,3,44,Pass
Gurpreet Verma,09-04-2005,428575,Manipur,5,12,8,20,45,Fail
Krishna Fernandes,22-12-2004,728556,Chhattisgarh,15,9,17,22,63,Pass
Raj Sharma,28-03-2006,525108,Kerala,24,5,1,12,42,Fail
Kunal Verma,15-01-2005,644067,Kerala,14,14,7,11,46,Fail
Aryan Mehta,18-02-2005,457760,Madhya Pradesh,23,6,3,22,54,Pass
Aarav Verma,05-02-2005,181265,Rajasthan,21,11,6,10,48,Pass
Kunal Chopra,24-12-2004,568737,Uttarakhand,16,14,3,18,51,Pass
Aarav Fernandes,08-12-2005,318095,Maharashtra,8,20,24,3,55,Pass
Yash D'Souza,16-01-2005,423484,Haryana,18,13,22,11,64,Pass
Aarav Sharma,13-03-2006,749050,Maharashtra,0,15,8,5,28,Pass
Rehan Reddy,11-03-2005,193263,Delhi,11,16,13,5,45,Pass
Vivaan Reddy,02-01-2005,207378,West Bengal,2,18,3,17,40,Pass
Rehan Fernandes,18-01-2006,699887,Haryana,7,3,5,15,30,Pass
Aryan Sharma,12-01-2005,340120,Telangana,13,17,24,3,57,Pass
Raj Khan,10-01-2006,884930,Madhya Pradesh,8,2,6,15,31,Pass
Rohan Reddy,21-11-2004,484945,Assam,17,23,6,4,50,Pass
Rohan Khan,17-10-2005,697130,Puducherry,15,6,1,1,23,Pass
Harjeet Reddy,09-09-2005,104563,Rajasthan,21,23,24,11,79,Pass
Aditya Fernandes,05-04-2005,449846,Maharashtra,10,19,6,3,38,Pass
Balbir Sharma,04-04-2006,330161,Rajasthan,17,7,3,4,31,Pass
Sukhwinder Pillai,30-05-2005,275247,Uttarakhand,5,8,13,1,27,Pass
Farhan Sharma,01-09-2005,226773,Maharashtra,15,11,1,22,49,Pass
Rohan Chopra,05-12-2005,796510,Tamil Nadu,2,13,17,3,35,Pass
Kunal Verma,16-01-2006,464722,Haryana,14,6,21,10,51,Pass
Yash Reddy,10-12-2005,616807,Uttar Pradesh,22,6,22,18,68,Pass
Kunal Chopra,08-01-2006,748848,Rajasthan,18,7,11,0,36,Pass
Aditya Mehta,22-12-2004,195081,Gujarat,12,5,11,13,41,Fail
Rohan D'Souza,19-12-2004,656728,Gujarat,9,18,21,1,49,Fail
John Khan,15-03-2006,595867,Andhra Pradesh,24,9,1,1,35,Pass
Yash Singh,12-02-2005,834256,Assam,10,21,7,21,59,Pass
Krishna Singh,30-06-2005,787214,Assam,24,24,9,16,73,Pass
Harjeet Pillai,11-05-2005,171785,Uttar Pradesh,15,10,4,24,53,Pass
Aarav Fernandes,05-05-2006,760266,Haryana,7,21,18,17,63,Pass
Imran Fernandes,05-03-2005,274990,Punjab,4,16,1,22,43,Pass
Imran Singh,09-10-2005,390876,Uttarakhand,8,1,1,15,25,Pass
Vivaan Sharma,15-12-2004,837685,West Bengal,1,6,14,15,36,Pass
Kunal Fernandes,06-03-2006,812795,Telangana,6,22,7,8,43,Pass
Aryan Singh,19-06-2005,730791,West Bengal,7,22,2,9,40,Pass
Ishaan Pillai,09-05-2006,890820,Bihar,8,16,0,19,43,Pass
Harjeet D'Souza,30-01-2006,301163,Andhra Pradesh,9,18,20,18,65,Pass
Gurpreet Mehta,03-02-2006,954467,Uttar Pradesh,16,8,14,18,56,Pass
Raj Singh,31-05-2005,785287,Maharashtra,5,11,1,20,37,Pass
Aarav Chopra,19-11-2004,794520,Delhi,4,12,23,14,53,Pass
Yash Khan,23-09-2005,624895,Rajasthan,17,19,19,7,62,Pass
Raj Khan,26-03-2006,342966,Tamil Nadu,2,8,19,2,31,Pass
David Sharma,21-08-2005,527688,Tamil Nadu,15,9,5,14,43,Pass
Aarav Pillai,29-11-2004,649120,West Bengal,21,17,0,12,50,Pass
John Pillai,03-01-2006,267269,Assam,6,11,3,6,26,Pass
Raj Reddy,27-10-2005,822367,Uttar Pradesh,11,1,12,4,28,Pass
Zaid Singh,19-04-2005,550606,Madhya Pradesh,19,18,3,19,59,Pass
Krishna Khan,07-04-2006,492331,Andhra Pradesh,22,10,4,2,38,Pass
Ishaan Khan,27-04-2005,268225,Arunachal Pradesh,5,5,5,23,38,Fail
Aarav Chopra,24-02-2006,651717,Punjab,5,17,0,1,23,Pass
Imran Reddy,18-02-2005,494882,Telangana,15,18,23,0,56,Pass
Aarav Fernandes,26-04-2005,989120,Rajasthan,24,12,16,0,52,Pass
Raj Khan,23-06-2005,397478,Maharashtra,15,17,5,3,40,Pass
Yash Sharma,21-10-2005,409766,Haryana,2,23,11,1,37,Pass
Harjeet Sharma,09-11-2005,387949,Jharkhand,0,13,4,7,24,Pass
Rehan Fernandes,27-01-2005,468959,Telangana,1,13,4,5,23,Pass
Ishaan Sharma,04-08-2005,445123,Telangana,14,4,4,11,33,Pass
Krishna Fernandes,30-06-2005,352345,Maharashtra,4,5,19,14,42,Pass
Ayaan Chopra,19-10-2005,259686,Rajasthan,10,9,6,16,41,Pass
Aditya Chopra,29-07-2005,629474,Chhattisgarh,0,6,12,19,37,Pass
Aarav Pillai,27-01-2005,175013,Punjab,3,10,22,10,45,Pass
Aryan Fernandes,11-11-2005,400655,Uttar Pradesh,6,10,21,21,58,Pass
Aryan Sharma,25-11-2005,592416,Uttar Pradesh,5,1,11,8,25,Pass
Zaid Verma,25-04-2005,916995,Andhra Pradesh,17,18,13,21,69,Pass
Aryan D'Souza,21-11-2005,862541,Jharkhand,6,24,5,23,58,Pass
Krishna Pillai,11-06-2005,559011,Odisha,7,3,19,23,52,Pass
Aarav Fernandes,17-11-2005,909105,Tamil Nadu,15,10,8,1,34,Pass
Raj Verma,13-12-2005,230509,Tamil Nadu,21,8,8,20,57,Pass
Vivaan Singh,03-07-2005,489125,Madhya Pradesh,24,5,3,18,50,Pass
Peter Singh,06-01-2006,349839,Uttar Pradesh,17,10,14,19,60,Pass
Yash Fernandes,09-11-2005,147803,Gujarat,6,6,4,2,18,Fail
Paul Mehta,23-03-2005,828287,Delhi,0,1,23,19,43,Pass
Harjeet Khan,01-02-2005,131256,Uttar Pradesh,15,12,6,23,56,Pass
Aditya D'Souza,30-04-2005,844265,Rajasthan,11,22,1,17,51,Pass
Rehan Singh,02-07-2005,609754,Gujarat,0,19,14,16,49,Fail
Krishna Chopra,26-11-2005,388663,Rajasthan,6,20,1,22,49,Pass
Aditya Pillai,05-01-2005,755048,Odisha,14,2,2,12,30,Pass
Raj Sharma,19-01-2005,319825,Telangana,23,22,0,8,53,Fail
Aditya Khan,13-12-2005,321378,Maharashtra,4,6,12,12,34,Pass
Rohan Sharma,17-04-2005,148126,Uttar Pradesh,18,1,11,6,36,Pass
Peter Sharma,09-11-2004,483948,Jharkhand,3,1,8,22,34,Pass
Aryan Khan,29-07-2005,399285,Kerala,23,15,15,3,56,Fail
Zaid Sharma,27-02-2006,198840,Madhya Pradesh,8,7,0,1,16,Pass
Vivaan Fernandes,22-03-2005,486805,Bihar,2,1,7,10,20,Pass
Aarav Verma,28-04-2005,914521,Karnataka,19,23,21,21,84,Pass
Aarav Singh,14-01-2006,699782,Bihar,24,16,1,13,54,Pass
Ishaan Verma,13-09-2005,382540,Tamil Nadu,23,1,2,6,32,Pass
Aryan Reddy,12-09-2005,522461,West Bengal,3,16,11,9,39,Pass
Aryan Mehta,29-06-2005,828507,Haryana,2,8,0,2,12,Pass
Vivaan Fernandes,07-08-2005,425038,Madhya Pradesh,12,18,3,19,52,Pass
Aditya Khan,16-09-2005,299124,Haryana,16,12,24,11,63,Pass
Paul D'Souza,11-12-2004,988907,Punjab,10,18,18,6,52,Pass
Rohan Singh,25-03-2006,238978,Meghalaya,24,7,15,15,61,Pass
Rohan Sharma,06-04-2005,475137,Maharashtra,8,0,19,19,46,Pass
Vivaan D'Souza,16-07-2005,477866,Karnataka,3,23,18,5,49,Pass
Sukhwinder Singh,29-01-2005,816965,Uttarakhand,10,1,8,7,26,Pass
Vivaan Mehta,08-07-2005,629213,West Bengal,3,10,22,20,55,Pass
Ishaan Pillai,13-11-2004,944217,Rajasthan,23,4,3,2,32,Pass
Raj D'Souza,17-02-2006,104680,Rajasthan,16,6,12,2,36,Pass
Kunal Khan,22-01-2006,919397,Bihar,14,14,21,4,53,Pass
John D'Souza,28-03-2006,641333,Odisha,15,11,19,24,69,Pass
Krishna Verma,24-03-2006,452976,Uttar Pradesh,17,21,8,8,54,Pass
Raj D'Souza,10-04-2006,274773,Madhya Pradesh,2,7,3,13,25,Pass
Yash Fernandes,25-05-2005,896105,Haryana,3,8,6,15,32,Pass
Raj Verma,10-09-2005,991946,Uttar Pradesh,17,18,11,16,62,Pass
Rehan Mehta,15-11-2004,948091,Gujarat,13,22,21,19,75,Fail
Yash Reddy,08-07-2005,268434,Madhya Pradesh,17,24,3,10,54,Pass
Aarav Verma,07-09-2005,666242,Tamil Nadu,9,9,21,7,46,Pass
Aditya Verma,17-03-2005,489991,Jammu & Kashmir + Ladakh,4,20,1,13,38,Pass
Aditya Chopra,18-01-2005,843691,Haryana,10,16,11,24,61,Pass
Aditya Chopra,17-01-2006,492780,Uttar Pradesh,2,0,19,24,45,Pass
David Pillai,27-06-2005,857582,Puducherry,5,23,0,9,37,Pass
Aditya Mehta,03-05-2006,944539,West Bengal,3,21,18,12,54,Pass
Rohan Pillai,17-02-2005,220871,Karnataka,15,6,4,12,37,Pass
Krishna Singh,12-12-2005,934688,Madhya Pradesh,12,18,0,10,40,Pass
Vivaan Sharma,23-09-2005,566506,Madhya Pradesh,14,13,9,3,39,Pass
Rehan Khan,29-08-2005,607012,Bihar,10,13,10,20,53,Pass
Aditya Khan,14-01-2005,974668,West Bengal,3,10,0,4,17,Pass
Ishaan Mehta,27-03-2005,639603,West Bengal,3,15,23,24,65,Pass
Ishaan Singh,29-12-2005,815425,Uttar Pradesh,23,13,2,9,47,Pass
Rohan Pillai,09-02-2006,963771,West Bengal,13,3,1,14,31,Pass
Mathew Reddy,01-01-2006,796071,Uttar Pradesh,8,0,8,4,20,Pass
Aarav D'Souza,13-05-2005,691488,Tamil Nadu,13,4,18,23,58,Pass
Gurpreet Reddy,11-10-2005,612086,Tripura,15,11,3,19,48,Pass
Sukhwinder Reddy,27-07-2005,355923,Maharashtra,14,13,9,3,39,Pass
Krishna Mehta,04-03-2005,552255,Nagaland,3,0,16,19,38,Pass
Kunal Mehta,24-09-2005,707684,Uttar Pradesh,20,7,23,0,50,Pass
Ishaan Mehta,13-03-2005,821510,West Bengal,5,18,24,3,50,Pass
Sukhwinder Reddy,13-11-2004,826767,Puducherry,16,24,7,11,58,Pass
Sukhwinder Mehta,03-05-2005,798813,Chhattisgarh,22,11,21,20,74,Pass
Raj Khan,12-09-2005,313542,Madhya Pradesh,14,6,12,0,32,Pass
Ishaan Reddy,20-10-2005,371894,Uttar Pradesh,18,0,4,17,39,Pass
Vivaan Reddy,06-05-2005,672469,Uttar Pradesh,13,13,15,0,41,Pass
Raj Verma,09-01-2006,819926,Uttar Pradesh,14,4,7,16,41,Pass
Krishna Chopra,21-07-2005,368063,West Bengal,3,21,14,20,58,Pass
Raj Sharma,12-08-2005,416155,Uttar Pradesh,7,0,1,15,23,Pass
Aryan Sharma,08-11-2005,195078,Kerala,6,24,8,18,56,Fail
Rehan Reddy,23-11-2005,117530,Madhya Pradesh,12,20,3,12,47,Pass
Harjeet Singh,28-12-2005,757541,Uttar Pradesh,14,16,19,19,68,Pass
Balbir Singh,13-01-2006,957729,Karnataka,15,20,14,11,60,Pass
Aarav D'Souza,07-05-2005,710658,Bihar,15,13,6,4,38,Pass
Kunal Sharma,29-11-2005,322081,Haryana,9,21,13,8,51,Pass
Kunal Verma,08-06-2005,373356,Haryana,15,14,18,22,69,Pass
Aryan Pillai,06-04-2006,734869,Rajasthan,1,6,14,5,26,Pass
Rohan D'Souza,19-02-2005,503811,Kerala,22,15,15,24,76,Fail
Krishna Reddy,10-11-2005,219535,Madhya Pradesh,3,17,17,7,44,Pass
Rohan Verma,21-11-2005,852749,Uttarakhand,14,17,3,24,58,Pass
Manpreet Pillai,25-08-2005,266316,Assam,5,18,17,2,42,Pass
Gurpreet Reddy,18-01-2005,107442,Uttar Pradesh,2,14,19,3,38,Pass
Ayaan Reddy,07-02-2006,269583,Madhya Pradesh,20,6,3,22,51,Pass
Balbir Chopra,15-01-2005,641856,Telangana,16,10,21,19,66,Pass
Raj Reddy,10-05-2005,472228,Bihar,22,11,8,19,60,Pass
Kunal Pillai,06-11-2005,123974,Punjab,18,3,13,18,52,Pass
Krishna Fernandes,04-01-2005,595366,Gujarat,13,2,3,8,26,Fail
Balbir Fernandes,02-11-2005,334995,Uttarakhand,21,5,3,20,49,Pass
Vivaan Mehta,13-12-2005,164995,Uttar Pradesh,22,5,3,20,50,Pass
Aarav Pillai,01-11-2005,633263,Himachal Pradesh,6,16,19,16,57,Pass
Ishaan Reddy,03-08-2005,741023,Andhra Pradesh,11,13,6,8,38,Pass
Aditya Verma,01-02-2005,109946,West Bengal,7,1,2,11,21,Pass
Gurpreet D'Souza,28-12-2004,494054,Andhra Pradesh,19,13,14,11,57,Pass
Raj Reddy,01-05-2005,918021,Rajasthan,19,9,10,22,60,Pass
Yash Sharma,15-01-2006,519037,Uttar Pradesh,13,23,10,16,62,Pass
Vivaan Singh,04-04-2006,341619,Jharkhand,13,15,0,12,40,Pass
Zaid Fernandes,07-07-2005,938495,Karnataka,22,12,17,12,63,Pass
Aryan Reddy,16-12-2004,396067,Uttar Pradesh,11,4,10,1,26,Pass
Paul Khan,27-01-2006,724129,Uttar Pradesh,5,3,23,24,55,Pass
Gurpreet Mehta,18-11-2004,290341,Himachal Pradesh,13,14,15,19,61,Pass
Aarav Reddy,01-09-2005,223649,Haryana,15,4,16,16,51,Pass
Balbir Sharma,01-01-2006,418956,West Bengal,11,10,4,6,31,Pass
Sukhwinder Reddy,31-05-2005,650335,Bihar,4,15,0,11,30,Pass
Vivaan Mehta,18-12-2004,935509,Kerala,18,23,3,9,53,Fail
Kunal Sharma,14-11-2005,461042,Jharkhand,15,1,1,6,23,Pass
Yash Fernandes,24-02-2005,371862,West Bengal,3,21,13,10,47,Pass
Kunal Reddy,30-06-2005,980848,Tamil Nadu,22,20,19,11,72,Pass
Imran Chopra,06-10-2005,115390,Uttar Pradesh,5,22,12,1,40,Pass
Raj Singh,24-09-2005,162795,Uttar Pradesh,11,20,18,22,71,Pass
Ishaan Mehta,09-07-2005,525736,Haryana,10,5,22,17,54,Pass
Ayaan Singh,07-03-2005,696177,Maharashtra,8,22,17,3,50,Pass
Imran Singh,10-05-2005,529923,Tamil Nadu,2,8,1,6,17,Pass
Aryan Singh,20-04-2006,141463,Tamil Nadu,19,18,13,23,73,Pass
Gurpreet Singh,10-11-2004,707845,Madhya Pradesh,8,23,3,22,56,Pass
Rohan Reddy,02-03-2005,271658,Rajasthan,21,7,14,5,47,Pass
Aarav Reddy,10-10-2005,474433,Uttar Pradesh,16,11,18,24,69,Pass
Vivaan Pillai,23-04-2006,479273,Uttarakhand,20,16,3,21,60,Pass
Aditya Fernandes,22-11-2004,656747,Madhya Pradesh,6,16,2,21,45,Pass
Aryan Fernandes,15-04-2005,107268,Bihar,20,20,6,9,55,Pass
Aarav Fernandes,28-03-2006,470743,Gujarat,9,13,17,20,59,Fail
Krishna Pillai,07-04-2005,743501,Bihar,7,1,20,19,47,Pass
Kunal Chopra,09-03-2006,685135,Rajasthan,12,2,1,17,32,Pass
Krishna D'Souza,10-03-2006,504731,Karnataka,6,11,23,11,51,Pass
Kunal D'Souza,23-09-2005,449047,Haryana,13,20,11,5,49,Pass
Rohan Verma,11-11-2005,393193,Telangana,2,20,14,15,51,Pass
Kunal Singh,07-03-2005,341856,Telangana,5,3,21,9,38,Pass
Sukhwinder Fernandes,23-02-2005,907804,Madhya Pradesh,10,17,23,6,56,Pass
Ayaan Pillai,03-02-2006,430345,Bihar,22,4,17,21,64,Pass
Manpreet Fernandes,24-07-2005,573112,Karnataka,13,11,5,23,52,Pass
Harjeet Mehta,18-11-2005,466094,Madhya Pradesh,18,8,10,18,54,Pass
Balbir Mehta,28-12-2005,824086,Punjab,5,24,13,1,43,Pass
Kunal Singh,06-04-2006,804542,Bihar,11,8,13,9,41,Pass
Rehan Verma,10-03-2006,362831,Tamil Nadu,10,22,7,24,63,Pass
Vivaan Verma,22-10-2005,910111,West Bengal,16,21,1,1,39,Pass
Aditya Khan,08-11-2004,563396,Assam,20,22,8,3,53,Pass
Krishna Verma,27-10-2005,525080,Uttarakhand,13,1,18,6,38,Pass
Yash Khan,04-02-2006,530537,Uttar Pradesh,18,6,19,16,59,Pass
Mathew Pillai,18-09-2005,506659,Tamil Nadu,20,9,9,22,60,Pass
Vivaan Mehta,25-05-2005,146802,Karnataka,1,10,0,15,26,Pass
Raj Fernandes,01-03-2005,304014,Maharashtra,5,12,16,2,35,Pass
Sukhwinder Mehta,10-01-2006,534189,Himachal Pradesh,3,6,2,17,28,Pass
Ishaan Chopra,07-06-2005,888587,Rajasthan,1,22,1,3,27,Pass
Rohan Sharma,20-06-2005,202859,Odisha,8,1,23,2,34,Pass
Raj D'Souza,07-08-2005,495763,Bihar,3,0,19,14,36,Pass
Yash D'Souza,20-07-2005,810966,West Bengal,8,11,19,3,41,Pass
Aditya Sharma,08-12-2005,891636,Uttarakhand,0,21,7,8,36,Pass
Zaid Khan,16-12-2005,956667,Maharashtra,17,11,1,8,37,Pass
Yash Verma,06-05-2006,976791,Rajasthan,13,7,24,1,45,Pass
Aryan Khan,23-10-2005,161939,Madhya Pradesh,24,9,8,4,45,Pass
Sukhwinder Pillai,24-07-2005,270167,Andhra Pradesh,15,13,20,19,67,Pass
Aarav D'Souza,31-01-2006,872021,Maharashtra,11,9,5,15,40,Pass
Aryan Sharma,10-01-2006,487193,Maharashtra,20,16,9,3,48,Pass
Raj Sharma,10-09-2005,374401,Rajasthan,20,1,18,9,48,Pass
Kunal D'Souza,26-03-2006,686772,Jharkhand,12,18,24,24,78,Fail
Farhan Sharma,26-03-2005,568377,Maharashtra,12,9,8,3,32,Pass
Aarav Sharma,06-12-2005,488559,Chhattisgarh,14,18,8,21,61,Pass
Aditya Chopra,24-04-2006,830785,Madhya Pradesh,2,15,24,15,56,Pass
Ishaan Fernandes,10-01-2006,374583,Uttar Pradesh,19,22,6,4,51,Pass
Yash Sharma,09-10-2005,890234,Uttar Pradesh,2,8,14,9,33,Pass
Aryan Singh,22-11-2005,439052,Gujarat,2,9,24,15,50,Fail
Balbir Khan,20-04-2006,578840,Madhya Pradesh,22,3,21,0,46,Pass
Rehan Sharma,05-01-2006,524023,Maharashtra,21,23,14,3,61,Pass
Krishna Reddy,17-10-2005,775913,Rajasthan,24,22,4,15,65,Pass
Rohan Sharma,03-09-2005,819968,Gujarat,20,11,9,4,44,Fail
Aryan Sharma,28-07-2005,299029,Uttar Pradesh,24,3,23,7,57,Pass
Harjeet Singh,06-10-2005,921593,Bihar,21,22,16,9,68,Pass
Kunal Sharma,08-11-2004,619993,Tamil Nadu,14,22,12,5,53,Pass
Aryan Chopra,17-03-2006,277097,Bihar,0,4,21,14,39,Pass
Yash Fernandes,11-09-2005,447633,Karnataka,24,16,12,2,54,Pass
Aditya Reddy,29-07-2005,644489,Madhya Pradesh,3,1,20,12,36,Pass
Yash Sharma,26-07-2005,699033,Uttar Pradesh,12,22,0,8,42,Pass
Raj Chopra,05-03-2006,928226,Andhra Pradesh,14,15,17,16,62,Pass
Ishaan Sharma,09-01-2006,218190,West Bengal,13,8,11,14,46,Pass
Aarav Fernandes,06-07-2005,805242,Telangana,7,7,23,4,41,Pass
Yash Pillai,11-06-2005,221170,Bihar,22,24,11,16,73,Pass
Yash Reddy,16-05-2005,462438,Uttarakhand,0,2,18,0,20,Pass
Aditya Fernandes,03-05-2005,567635,Uttar Pradesh,17,8,11,16,52,Pass
Balbir Khan,03-08-2005,990160,Telangana,0,22,24,17,63,Fail
Sukhwinder Fernandes,30-07-2005,315994,Bihar,24,12,2,9,47,Pass
Ayaan Khan,23-05-2005,501649,Chhattisgarh,8,3,6,17,34,Pass
Aryan Sharma,18-02-2005,390637,Tamil Nadu,18,8,11,12,49,Pass
Sukhwinder Verma,02-02-2005,922155,Uttar Pradesh,19,9,10,18,56,Pass
Aditya D'Souza,22-06-2005,845419,Karnataka,21,16,19,13,69,Fail
Paul Verma,22-11-2005,723989,Chhattisgarh,3,13,5,4,25,Pass
Ishaan Reddy,03-05-2005,654746,Gujarat,15,3,9,20,47,Fail
Peter Pillai,09-02-2005,107634,Madhya Pradesh,23,1,3,18,45,Pass
Balbir Pillai,07-12-2004,404846,Bihar,11,19,9,20,59,Pass
Rohan Khan,25-02-2006,212043,Jharkhand,3,2,15,8,28,Pass
Ayaan Mehta,09-03-2005,959904,Jammu & Kashmir + Ladakh,18,13,22,23,76,Fail
Paul Pillai,24-05-2005,829835,Madhya Pradesh,9,5,19,7,40,Pass
Ishaan Verma,08-04-2005,162111,Karnataka,21,24,11,19,75,Fail
Mathew Singh,04-06-2005,803954,Gujarat,4,10,16,23,53,Fail
Aryan Reddy,11-02-2006,884512,West Bengal,3,16,1,20,40,Pass
Sukhwinder Khan,17-02-2005,956905,Haryana,5,22,8,24,59,Pass
Krishna Chopra,10-06-2005,938632,Tamil Nadu,1,14,20,0,35,Pass
Ishaan D'Souza,28-04-2006,978501,Rajasthan,23,2,8,16,49,Pass
Aryan Khan,27-05-2005,759495,Andhra Pradesh,17,16,20,1,54,Pass
Rehan Pillai,22-04-2006,101523,Andhra Pradesh,1,10,16,21,48,Pass
Vivaan Singh,14-04-2005,635282,Jammu & Kashmir + Ladakh,21,9,23,7,60,Pass
Kunal Sharma,24-07-2005,711771,Uttar Pradesh,0,23,6,16,45,Pass
Krishna Mehta,06-05-2006,635829,Jharkhand,19,15,2,24,60,Pass
Ayaan Chopra,11-06-2005,646398,Assam,6,11,10,14,41,Pass
Imran Pillai,16-01-2006,747653,Haryana,12,3,7,21,43,Pass
Raj Fernandes,15-07-2005,851217,Haryana,8,21,2,22,53,Pass
Vivaan Mehta,23-04-2006,233195,West Bengal,0,0,2,10,12,Pass
Yash Singh,21-11-2004,497791,Jharkhand,17,21,5,16,59,Pass
Paul Mehta,23-07-2005,474605,Bihar,6,0,8,18,32,Pass
Yash Chopra,16-08-2005,584489,West Bengal,16,18,6,8,48,Pass
Peter Fernandes,03-05-2005,364330,Maharashtra,8,0,9,14,31,Pass
Paul Fernandes,21-11-2004,221595,Bihar,10,16,12,2,40,Pass
Raj D'Souza,29-04-2006,659547,Tamil Nadu,3,23,6,18,50,Pass
Yash Fernandes,01-03-2006,740630,Rajasthan,18,22,11,3,54,Pass
Harjeet Sharma,20-03-2006,689376,Bihar,4,22,22,4,52,Pass
Ishaan Reddy,03-09-2005,388865,Delhi,3,11,17,5,36,Pass
Sukhwinder Mehta,03-12-2004,287197,Himachal Pradesh,10,8,20,16,54,Pass
Aditya Singh,07-02-2006,648447,Rajasthan,19,0,1,12,32,Pass
Rohan Chopra,31-05-2005,477949,Gujarat,8,4,21,20,53,Fail
Kunal Sharma,10-05-2005,688831,Tamil Nadu,20,16,4,23,63,Pass
Aditya Mehta,19-01-2005,898730,Gujarat,20,19,18,10,67,Fail
Aarav Khan,27-11-2004,372045,Maharashtra,4,23,17,3,47,Pass
Aarav Pillai,05-11-2005,765616,Bihar,8,17,19,9,53,Pass
Aarav D'Souza,13-10-2005,529794,Rajasthan,20,8,13,17,58,Pass
Zaid Singh,03-10-2005,843621,Bihar,9,6,1,12,28,Pass
Ayaan Khan,03-01-2006,770184,Maharashtra,0,18,5,23,46,Pass
Ishaan Fernandes,09-07-2005,744483,Bihar,21,3,23,24,71,Pass
Paul Fernandes,26-12-2004,253528,West Bengal,10,1,2,9,22,Pass
Balbir Fernandes,30-03-2006,520805,Uttar Pradesh,10,0,14,6,30,Pass
Balbir Verma,04-04-2006,706114,Bihar,16,12,22,18,68,Pass
Sukhwinder Singh,30-01-2005,790275,Himachal Pradesh,23,19,14,21,77,Fail
Ishaan Fernandes,13-03-2005,353369,Odisha,4,17,0,9,30,Pass
Ishaan Mehta,05-02-2005,662701,Uttar Pradesh,7,21,15,2,45,Pass
Imran Pillai,27-05-2005,826576,Madhya Pradesh,14,4,13,16,47,Pass
Vivaan Fernandes,23-06-2005,603714,Uttar Pradesh,14,13,20,18,65,Pass
Manpreet Khan,01-09-2005,926850,Bihar,11,14,21,21,67,Pass
Krishna Reddy,03-07-2005,747995,Bihar,13,21,20,22,76,Pass
Raj D'Souza,31-01-2006,492031,Haryana,14,17,23,9,63,Pass
David Pillai,09-06-2005,284751,Rajasthan,24,16,10,15,65,Pass
Yash Fernandes,24-10-2005,720898,Kerala,9,11,15,19,54,Fail
Balbir Sharma,24-12-2004,605992,Uttar Pradesh,20,11,6,10,47,Pass
Rohan Pillai,28-04-2005,655279,Bihar,17,12,9,18,56,Pass
Raj Reddy,11-05-2005,820890,Maharashtra,8,4,14,9,35,Pass
Harjeet Singh,22-12-2005,846576,Punjab,13,13,21,3,50,Pass
Yash Fernandes,14-12-2005,116823,Maharashtra,5,0,1,11,17,Pass
Aryan Pillai,11-12-2005,716937,Haryana,18,2,20,2,42,Pass
Aditya Fernandes,21-06-2005,344479,Rajasthan,18,6,1,16,41,Pass
Aditya Sharma,12-08-2005,799653,Tamil Nadu,4,1,13,1,19,Pass
Rohan Khan,20-06-2005,445868,Bihar,10,12,19,10,51,Pass
Imran Fernandes,25-06-2005,801506,Karnataka,8,18,8,3,37,Pass
Rohan Chopra,29-08-2005,380639,Madhya Pradesh,4,8,24,16,52,Pass
Krishna Verma,22-07-2005,353937,Maharashtra,6,9,9,21,45,Pass
Kunal Singh,30-11-2005,686356,Chhattisgarh,1,12,15,21,49,Pass
Vivaan D'Souza,18-04-2005,678240,Assam,24,14,3,0,41,Pass
Ayaan D'Souza,18-11-2005,423771,West Bengal,3,17,21,24,65,Pass
Aryan Reddy,01-02-2006,305450,Punjab,4,17,16,14,51,Pass
Harjeet Chopra,24-04-2006,551786,Kerala,12,9,3,19,43,Fail
Aryan Khan,07-11-2005,703702,Bihar,0,16,10,3,29,Pass
Krishna Reddy,01-02-2006,215802,Rajasthan,10,14,3,10,37,Pass
Manpreet Chopra,17-03-2005,496843,Bihar,4,8,3,13,28,Pass
Aryan Pillai,09-02-2006,665313,Manipur,14,6,15,16,51,Fail
Peter D'Souza,06-05-2005,647002,Karnataka,11,7,19,15,52,Pass
Krishna Chopra,30-11-2004,873341,Uttar Pradesh,19,12,7,12,50,Pass
Aarav Singh,08-11-2005,386005,Madhya Pradesh,8,23,2,10,43,Pass
Aditya Reddy,12-02-2005,484135,Karnataka,5,2,5,11,23,Pass
Kunal Singh,09-04-2005,866087,Bihar,3,11,15,20,49,Pass
Farhan Fernandes,09-10-2005,220096,Chhattisgarh,1,17,2,23,43,Pass
Yash Sharma,01-09-2005,906607,Andhra Pradesh,15,17,0,5,37,Pass
Vivaan Verma,09-08-2005,760443,Rajasthan,21,12,14,19,66,Pass
Ishaan Pillai,30-05-2005,530563,Andhra Pradesh,7,20,19,20,66,Pass
Kunal Khan,26-06-2005,394811,Tamil Nadu,1,18,24,18,61,Pass
Gurpreet Pillai,22-05-2005,431206,Jharkhand,6,9,6,14,35,Pass
Raj Singh,14-10-2005,187172,Rajasthan,22,17,0,20,59,Pass
Aarav Pillai,14-02-2006,373545,Uttar Pradesh,6,14,14,3,37,Pass
Vivaan Verma,07-08-2005,443471,Andhra Pradesh,3,3,3,4,13,Pass
Balbir Verma,27-08-2005,118608,Gujarat,19,7,6,9,41,Fail
Sukhwinder Mehta,03-12-2005,587913,Meghalaya,15,11,1,23,50,Pass
Kunal Pillai,10-04-2006,873617,Uttar Pradesh,9,17,24,18,68,Pass
Ishaan Chopra,01-10-2005,217137,Maharashtra,8,14,23,3,48,Pass
Aarav Reddy,20-11-2005,832769,Uttar Pradesh,11,14,21,23,69,Pass
Aditya Mehta,09-05-2005,570418,Bihar,11,12,18,22,63,Pass
Ishaan Verma,06-03-2006,833114,Uttar Pradesh,4,2,16,14,36,Pass
Kunal Chopra,26-04-2006,153944,Madhya Pradesh,17,16,8,0,41,Pass
Kunal Fernandes,17-01-2006,665052,Delhi,11,15,10,16,52,Pass
Gurpreet Sharma,07-12-2005,287530,Telangana,20,6,14,23,63,Fail
Imran Sharma,10-09-2005,933026,Rajasthan,6,8,11,0,25,Pass
Gurpreet Pillai,16-03-2006,830747,West Bengal,3,14,24,7,48,Pass
Aarav Verma,04-01-2006,383592,Punjab,23,22,20,19,84,Pass
David Singh,20-04-2005,866893,Punjab,24,10,15,3,52,Pass
Kunal Pillai,17-10-2005,730506,Odisha,9,3,13,8,33,Pass
Vivaan Sharma,03-12-2005,852194,Gujarat,16,5,21,14,56,Fail
Zaid Mehta,17-12-2005,274949,Assam,13,24,12,13,62,Pass
Aryan Chopra,05-02-2006,871440,Uttar Pradesh,14,20,15,0,49,Pass
Yash Singh,13-11-2005,271395,Maharashtra,18,3,6,2,29,Pass
Aarav Fernandes,16-10-2005,954005,Maharashtra,8,15,11,6,40,Pass
Ishaan Khan,18-07-2005,164734,Bihar,24,5,5,24,58,Pass
Gurpreet Mehta,01-02-2005,261923,Karnataka,19,3,22,14,58,Pass
Yash Fernandes,13-01-2006,231658,Gujarat,17,13,17,14,61,Fail
Sukhwinder Pillai,04-09-2005,117687,Maharashtra,17,18,18,3,56,Pass
Manpreet Chopra,31-03-2006,258731,Tamil Nadu,6,23,15,12,56,Pass
Raj Sharma,18-12-2005,882497,Andhra Pradesh,13,0,4,12,29,Pass
Peter Khan,31-08-2005,431776,Punjab,16,23,11,3,53,Pass
Aryan Reddy,09-04-2005,733268,Andhra Pradesh,6,10,17,17,50,Pass
Farhan Khan,19-11-2004,540086,Madhya Pradesh,18,9,4,3,34,Pass
Rohan Khan,05-09-2005,394570,Gujarat,13,3,21,6,43,Fail
Harjeet Pillai,06-07-2005,960958,Punjab,18,19,11,24,72,Pass
Kunal Khan,21-04-2006,281086,Maharashtra,8,19,21,3,51,Pass
Zaid Reddy,08-08-2005,462259,Jammu & Kashmir + Ladakh,10,23,5,4,42,Pass
Manpreet Chopra,21-05-2005,172710,Gujarat,3,15,13,5,36,Fail
Kunal Fernandes,25-11-2004,987111,Maharashtra,1,21,4,9,35,Pass
Aditya Singh,30-04-2006,351299,Uttar Pradesh,19,23,3,24,69,Pass
Ayaan Singh,28-03-2006,769011,Gujarat,10,8,5,0,23,Fail
Aryan Reddy,12-02-2005,733643,Rajasthan,10,6,5,10,31,Pass
Raj Reddy,05-11-2005,204571,Uttarakhand,6,6,1,16,29,Pass
Balbir Mehta,28-10-2005,464828,Uttarakhand,14,21,3,22,60,Pass
David D'Souza,06-02-2006,508096,Karnataka,16,15,18,19,68,Fail
Raj Sharma,03-06-2005,563200,Uttar Pradesh,4,4,6,23,37,Pass
Balbir Khan,15-12-2005,502233,West Bengal,12,10,4,7,33,Pass
Manpreet Pillai,22-02-2006,617504,Telangana,1,18,11,4,34,Pass
Vivaan Fernandes,02-03-2006,906823,Bihar,8,14,5,9,36,Pass
Manpreet Mehta,22-08-2005,888520,Bihar,8,12,3,11,34,Pass
Sukhwinder Khan,06-04-2005,171221,Bihar,15,7,0,22,44,Pass
Zaid Sharma,21-03-2005,656470,Karnataka,4,14,9,20,47,Pass
Yash Pillai,21-11-2004,981515,Telangana,10,8,17,19,54,Fail
Vivaan Chopra,12-04-2006,208552,Telangana,3,10,21,21,55,Fail
Aarav Pillai,10-07-2005,445719,Rajasthan,22,4,22,7,55,Pass
Rohan Fernandes,20-01-2005,388558,Delhi,4,0,4,2,10,Pass
Kunal Khan,15-07-2005,318647,Haryana,22,21,13,10,66,Pass
Yash Verma,13-03-2006,972828,Gujarat,6,13,20,6,45,Fail
Vivaan Reddy,29-01-2005,121498,Tamil Nadu,17,21,6,8,52,Pass
Rehan Khan,26-05-2005,674980,Bihar,21,22,15,24,82,Pass
Mathew D'Souza,18-11-2005,946266,Uttar Pradesh,6,20,8,19,53,Pass
Kunal D'Souza,30-12-2005,828296,Punjab,0,1,8,19,28,Pass
Raj Pillai,21-02-2006,641787,Uttar Pradesh,17,7,6,23,53,Pass
John Sharma,06-03-2005,222145,Tamil Nadu,2,24,20,16,62,Pass
Mathew Sharma,30-03-2005,685604,Bihar,24,22,9,13,68,Pass
Ishaan Pillai,23-04-2005,940087,Madhya Pradesh,3,21,8,18,50,Pass
Aditya Sharma,16-04-2005,826469,Assam,16,15,14,22,67,Pass
Krishna Pillai,15-07-2005,661889,Haryana,3,3,13,7,26,Pass
Aditya Verma,13-01-2006,463556,Rajasthan,2,19,2,17,40,Pass
Vivaan Singh,19-02-2005,510716,Delhi,23,22,5,3,53,Pass
Rohan Reddy,13-08-2005,596790,Rajasthan,10,6,16,23,55,Pass
Aditya Mehta,30-12-2005,675499,Tamil Nadu,5,10,22,10,47,Pass
Kunal D'Souza,26-09-2005,491856,Telangana,4,23,10,6,43,Pass
Aarav Singh,25-06-2005,981772,Rajasthan,1,19,2,20,42,Pass
Raj Reddy,11-07-2005,364092,Haryana,12,2,4,19,37,Pass
Yash Verma,09-04-2005,622267,Uttar Pradesh,12,6,24,18,60,Pass
Imran Singh,19-03-2005,282216,Madhya Pradesh,24,6,14,1,45,Pass
Aditya Verma,25-07-2005,747924,Punjab,21,10,9,8,48,Pass
Yash Singh,28-05-2005,617300,Karnataka,14,10,6,2,32,Pass
Rohan Fernandes,03-02-2006,227311,Odisha,15,6,23,12,56,Pass
Vivaan D'Souza,28-04-2005,975859,Andhra Pradesh,10,13,21,16,60,Pass
Aarav Khan,30-01-2006,179788,Arunachal Pradesh,3,5,18,16,42,Pass
Aditya Sharma,31-01-2005,230567,Bihar,8,3,12,22,45,Pass
Rohan Pillai,12-02-2005,559642,Maharashtra,24,18,18,3,63,Pass
Rehan Khan,05-02-2006,442113,Uttar Pradesh,8,6,0,13,27,Pass
Harjeet D'Souza,11-11-2005,180083,Madhya Pradesh,16,9,12,10,47,Pass
Aryan Chopra,24-02-2005,872240,Karnataka,21,11,17,24,73,Fail
Vivaan Fernandes,28-03-2005,787819,Jharkhand,5,16,3,13,37,Pass
Ishaan Khan,29-03-2006,625255,Maharashtra,19,19,13,3,54,Pass
Ayaan Singh,29-04-2006,363887,Andhra Pradesh,12,22,21,17,72,Pass
Kunal Sharma,13-08-2005,948321,Telangana,0,5,0,24,29,Pass
Raj D'Souza,07-11-2004,291933,Delhi,19,12,19,24,74,Pass
Krishna Pillai,06-05-2005,811487,Karnataka,24,11,9,19,63,Pass
Manpreet Chopra,19-04-2006,998853,Maharashtra,21,22,13,3,59,Pass
Zaid Singh,08-01-2005,238835,Andhra Pradesh,2,10,4,24,40,Pass
Manpreet Pillai,09-11-2004,840299,Bihar,11,15,6,0,32,Pass
Vivaan Chopra,04-01-2005,587558,Maharashtra,10,21,12,3,46,Pass
Harjeet Pillai,15-01-2005,818823,Karnataka,3,10,0,4,17,Pass
Vivaan Mehta,18-10-2005,518687,Andhra Pradesh,10,0,14,21,45,Pass
Paul Fernandes,11-11-2005,131759,Uttar Pradesh,16,14,8,11,49,Pass
Ishaan Singh,13-07-2005,725895,Uttar Pradesh,1,3,8,14,26,Pass
Ishaan Pillai,12-12-2004,859649,Uttarakhand,20,12,3,21,56,Pass
Raj Khan,07-12-2005,528947,Punjab,18,1,4,15,38,Pass
Kunal Mehta,20-03-2006,962125,Punjab,18,1,20,19,58,Pass
Sukhwinder Sharma,16-10-2005,334213,Uttar Pradesh,24,3,23,17,67,Pass
Aryan Fernandes,02-02-2005,828435,Haryana,2,6,14,12,34,Pass
Ishaan Fernandes,25-04-2005,682745,Delhi,5,14,9,24,52,Pass
Raj D'Souza,02-03-2006,744962,Rajasthan,20,12,10,0,42,Pass
Yash D'Souza,20-11-2004,965337,Tripura,14,12,11,22,59,Pass
Ishaan Mehta,11-08-2005,929372,Haryana,21,24,13,5,63,Pass
Vivaan Sharma,17-09-2005,264181,Rajasthan,7,21,13,4,45,Pass
Aditya Chopra,27-01-2006,969658,Bihar,9,24,2,15,50,Pass
John Fernandes,10-11-2005,340280,Bihar,19,9,6,12,46,Pass
Yash Reddy,23-12-2005,720982,Maharashtra,22,6,13,3,44,Pass
Ishaan Chopra,08-06-2005,196466,Andhra Pradesh,4,21,10,19,54,Pass
Raj D'Souza,04-02-2005,285725,Gujarat,15,14,7,9,45,Fail
Manpreet Sharma,18-07-2005,436959,Punjab,7,14,19,23,63,Pass
Mathew Khan,17-04-2006,560741,Jammu & Kashmir + Ladakh,12,12,14,13,51,Pass
Raj D'Souza,30-07-2005,451079,Tamil Nadu,22,14,22,19,77,Pass
Krishna Pillai,11-07-2005,529678,Tamil Nadu,9,14,15,7,45,Pass
Rohan Mehta,06-01-2005,321621,Madhya Pradesh,8,14,3,18,43,Pass
Aarav Singh,01-07-2005,150820,Rajasthan,0,21,7,3,31,Pass
Krishna Singh,27-03-2005,173173,Jharkhand,22,12,11,13,58,Pass
Aditya Singh,25-01-2006,568052,Odisha,7,5,6,4,22,Pass
Harjeet Pillai,26-08-2005,500937,Madhya Pradesh,8,5,17,14,44,Pass
Kunal Fernandes,22-02-2006,280748,Madhya Pradesh,24,17,3,16,60,Pass
Aarav Khan,26-06-2005,347088,Uttarakhand,18,22,3,15,58,Pass
Imran Verma,23-01-2006,419221,Mizoram,19,9,7,21,56,Fail
Aarav Reddy,08-05-2006,815063,Maharashtra,1,24,8,3,36,Pass
Aryan Verma,02-03-2006,870894,Tamil Nadu,4,19,18,15,56,Pass
Raj Verma,04-01-2005,852060,Uttarakhand,17,23,3,12,55,Pass
Mathew Khan,31-12-2004,882718,Telangana,2,10,3,21,36,Pass
Ishaan D'Souza,08-02-2006,948589,Uttar Pradesh,16,12,21,15,64,Pass
Aryan Khan,05-01-2006,746988,Punjab,3,14,24,19,60,Pass
Aarav Chopra,02-01-2006,351883,Kerala,1,3,5,16,25,Fail
Gurpreet Chopra,08-12-2005,220126,Uttar Pradesh,20,18,3,13,54,Pass
Aarav Mehta,27-06-2005,834911,Maharashtra,18,22,4,3,47,Pass
Aditya Singh,19-04-2006,747965,Haryana,11,5,8,9,33,Pass
Aryan Chopra,26-10-2005,599449,Rajasthan,10,4,14,21,49,Pass
Kunal D'Souza,07-12-2004,885582,Gujarat,23,23,3,13,62,Fail
Gurpreet Fernandes,26-02-2005,543930,West Bengal,18,9,10,11,48,Pass
Aryan Chopra,11-04-2006,526220,Bihar,13,14,19,22,68,Pass
Balbir Mehta,23-01-2005,435045,Rajasthan,10,23,24,23,80,Pass
Balbir Khan,12-12-2004,520268,Gujarat,20,17,0,17,54,Fail
Aarav Reddy,13-12-2005,332851,Maharashtra,6,3,2,21,32,Pass
Vivaan Sharma,09-09-2005,105290,Madhya Pradesh,16,14,3,9,42,Pass
Yash Reddy,13-01-2005,758982,Rajasthan,16,15,13,7,51,Pass
Aryan D'Souza,03-11-2005,254650,Kerala,14,12,1,1,28,Fail
Ishaan Mehta,03-05-2006,794869,Madhya Pradesh,1,22,18,12,53,Pass
Zaid Mehta,14-02-2006,787367,Telangana,15,16,17,4,52,Fail
Vivaan Reddy,05-11-2005,952368,Madhya Pradesh,17,10,10,3,40,Pass
Aarav Khan,16-11-2005,845778,West Bengal,3,14,22,24,63,Pass
David Sharma,07-10-2005,415750,Punjab,18,2,16,7,43,Pass
Aryan Pillai,28-02-2005,365911,Rajasthan,24,11,0,19,54,Pass
Balbir Fernandes,01-04-2006,144068,Andhra Pradesh,22,18,9,5,54,Pass
Gurpreet Khan,02-05-2006,755488,Uttar Pradesh,14,24,2,0,40,Pass
Raj Sharma,27-07-2005,262795,Tamil Nadu,8,0,8,7,23,Pass
Rohan Verma,29-03-2006,363655,Chhattisgarh,14,11,18,9,52,Pass
Mathew D'Souza,22-11-2004,773576,Rajasthan,2,0,18,7,27,Pass
Aditya D'Souza,06-01-2006,843497,Madhya Pradesh,22,10,3,12,47,Pass
Raj Singh,07-02-2006,211323,Telangana,13,6,0,21,40,Pass
Sukhwinder Chopra,19-09-2005,627828,West Bengal,9,21,7,7,44,Pass
Aarav Khan,05-07-2005,500058,Maharashtra,11,23,16,3,53,Pass
Yash Verma,12-12-2004,119075,Bihar,9,11,20,0,40,Pass
Peter Reddy,14-03-2006,148756,Haryana,21,15,23,11,70,Pass
Yash Khan,22-02-2005,212837,Andhra Pradesh,11,0,3,3,17,Pass
Krishna Singh,09-03-2006,443696,Jammu & Kashmir + Ladakh,5,8,23,4,40,Pass
Krishna Sharma,13-10-2005,240900,Karnataka,13,14,8,15,50,Pass
Aditya Sharma,20-02-2006,233316,Chhattisgarh,16,11,13,23,63,Pass
Raj Chopra,07-02-2006,169191,Chhattisgarh,16,20,15,6,57,Pass
Vivaan Pillai,12-03-2006,507440,Rajasthan,5,1,12,6,24,Pass
Raj Singh,27-11-2004,914758,Karnataka,14,24,24,2,64,Pass
Paul Chopra,18-05-2005,407982,Jharkhand,12,16,1,7,36,Pass
Manpreet Singh,19-12-2004,635198,Gujarat,24,8,0,0,32,Fail
Gurpreet Sharma,31-01-2006,108341,Maharashtra,12,1,5,24,42,Pass
David Fernandes,15-01-2005,399419,Punjab,14,24,5,10,53,Pass
Aryan Reddy,13-02-2006,700185,West Bengal,14,7,9,16,46,Pass
Ishaan Fernandes,17-04-2006,817878,Bihar,20,0,11,17,48,Pass
Krishna Fernandes,09-04-2006,169732,Odisha,12,23,8,1,44,Pass
Aditya Verma,05-03-2006,487820,Andhra Pradesh,3,13,23,21,60,Pass
Gurpreet Pillai,27-12-2004,478386,Nagaland,13,17,19,18,67,Fail
Aditya Pillai,03-02-2006,688058,Himachal Pradesh,20,18,11,4,53,Pass
Vivaan Sharma,19-09-2005,837953,Bihar,15,5,19,3,42,Pass
Kunal Reddy,30-11-2004,766869,Uttar Pradesh,16,10,1,9,36,Pass
Aarav Chopra,26-04-2005,844905,Rajasthan,4,18,7,17,46,Pass
Imran Reddy,10-03-2005,342933,Gujarat,8,23,24,12,67,Fail
Vivaan Khan,16-04-2006,354032,Gujarat,18,2,4,23,47,Fail
Yash Pillai,17-01-2006,525792,Andhra Pradesh,2,8,9,4,23,Pass
Aditya Verma,03-02-2006,102679,Assam,13,10,17,23,63,Pass
Gurpreet Singh,12-09-2005,177515,Haryana,20,4,19,23,66,Pass
Balbir Khan,14-07-2005,481350,West Bengal,2,7,15,15,39,Pass
Yash Sharma,27-01-2005,393270,Gujarat,9,22,7,18,56,Fail
Raj Sharma,10-12-2004,947392,Mizoram,22,1,3,3,29,Pass
Yash Reddy,11-01-2005,606884,Telangana,14,16,7,19,56,Pass
Rohan Khan,10-01-2006,703888,Maharashtra,13,12,19,3,47,Pass
Vivaan Khan,13-09-2005,939264,Telangana,19,0,18,0,37,Pass
Aarav Pillai,24-12-2004,706998,Bihar,9,0,13,0,22,Pass
Vivaan Pillai,06-07-2005,221084,Telangana,23,20,23,0,66,Pass
Aryan Sharma,15-12-2004,319886,Odisha,15,7,10,24,56,Pass
Aryan D'Souza,21-08-2005,430407,Odisha,2,20,9,1,32,Pass
Aryan Verma,21-11-2004,160396,Madhya Pradesh,13,7,20,6,46,Pass
Yash Pillai,05-06-2005,447838,Andhra Pradesh,5,1,3,7,16,Pass
Yash Reddy,16-11-2004,827958,Uttar Pradesh,13,15,19,21,68,Pass
Raj Sharma,14-12-2004,992545,Maharashtra,1,10,2,16,29,Pass
Yash Sharma,17-01-2005,476719,Maharashtra,17,16,10,3,46,Pass
Balbir D'Souza,03-12-2004,657398,Tamil Nadu,8,2,8,17,35,Pass
Aarav Verma,09-07-2005,461446,Assam,3,14,14,18,49,Pass
Aryan Pillai,04-12-2005,522220,Karnataka,12,7,15,3,37,Pass
Aditya Chopra,03-12-2004,771639,Haryana,8,20,16,12,56,Pass
Aryan Khan,05-05-2005,757838,Punjab,16,24,15,9,64,Pass
Raj Chopra,02-08-2005,316160,Jammu & Kashmir + Ladakh,0,20,22,0,42,Pass
Aryan Pillai,15-07-2005,126002,Uttar Pradesh,17,7,20,7,51,Pass
Raj Fernandes,11-02-2005,398715,Karnataka,0,10,15,2,27,Pass
Paul Khan,08-05-2006,905350,Manipur,13,24,9,3,49,Fail
Zaid D'Souza,02-05-2006,521758,Uttar Pradesh,1,17,18,14,50,Pass
Sukhwinder D'Souza,10-01-2006,372748,Bihar,16,18,1,17,52,Pass
Raj Khan,05-12-2005,117150,Himachal Pradesh,24,13,24,0,61,Pass
Krishna Pillai,21-03-2006,158720,Uttar Pradesh,11,5,1,3,20,Pass
Ishaan Mehta,22-12-2005,133640,Odisha,22,14,23,19,78,Pass
Aryan Fernandes,11-11-2005,330781,West Bengal,2,21,10,15,48,Pass
Krishna Khan,08-10-2005,868643,Bihar,11,22,18,16,67,Pass
Yash Singh,30-12-2004,164764,Rajasthan,17,8,20,5,50,Pass
Ishaan Chopra,05-11-2005,762104,Haryana,0,13,4,18,35,Pass
Ayaan Reddy,14-12-2004,242760,Bihar,11,8,18,24,61,Pass
Ishaan Mehta,18-06-2005,265766,Karnataka,11,12,11,22,56,Pass
Yash D'Souza,20-09-2005,452483,Andhra Pradesh,8,4,15,23,50,Pass
Sukhwinder Pillai,16-01-2006,929146,Tamil Nadu,7,5,23,18,53,Pass
Gurpreet Pillai,24-01-2005,442860,Punjab,6,5,13,3,27,Pass
Raj Singh,03-12-2005,135932,Madhya Pradesh,10,14,7,21,52,Pass
Paul Khan,23-08-2005,703819,Tamil Nadu,14,23,6,4,47,Pass
Krishna Singh,01-11-2005,642114,Andhra Pradesh,19,9,15,10,53,Pass
Vivaan Sharma,21-11-2005,492247,Bihar,23,12,1,9,45,Pass
Ishaan Fernandes,23-07-2005,352467,Jharkhand,13,19,12,20,64,Pass
Vivaan Verma,23-11-2005,223790,Uttar Pradesh,11,14,6,11,42,Pass
Raj D'Souza,16-03-2005,610610,Madhya Pradesh,22,5,3,19,49,Pass
Rohan Khan,06-09-2005,470104,Punjab,21,21,24,2,68,Pass
Ishaan Khan,07-02-2005,299927,Assam,4,8,8,16,36,Pass
Paul Mehta,12-02-2006,726596,Tamil Nadu,16,8,10,6,40,Pass
Krishna Verma,03-03-2006,970624,Madhya Pradesh,19,12,9,11,51,Pass
Mathew Fernandes,06-10-2005,265172,Bihar,3,14,22,6,45,Pass
Ishaan Singh,19-12-2005,277627,Nagaland,9,15,9,8,41,Pass
Rehan Fernandes,02-01-2005,540691,Uttarakhand,21,2,3,10,36,Pass
Ishaan Singh,18-02-2006,566954,Uttar Pradesh,24,3,14,14,55,Pass
Vivaan Pillai,26-03-2005,412132,Gujarat,22,2,20,21,65,Fail
Ishaan Reddy,27-04-2005,414779,Maharashtra,16,14,2,3,35,Pass
Kunal Pillai,30-08-2005,846291,Haryana,1,8,9,7,25,Pass
Kunal Fernandes,15-12-2004,214044,Bihar,5,0,12,19,36,Pass
Farhan Reddy,08-07-2005,822176,Andhra Pradesh,12,24,1,24,61,Pass
Yash D'Souza,31-08-2005,652746,Uttar Pradesh,22,0,2,23,47,Pass
Aryan Mehta,11-03-2005,364525,Andhra Pradesh,14,19,0,10,43,Pass
Paul Chopra,26-05-2005,192572,Madhya Pradesh,17,18,3,19,57,Pass
Gurpreet D'Souza,24-06-2005,214771,Karnataka,16,13,12,1,42,Pass
Raj Sharma,20-02-2005,803910,Himachal Pradesh,21,21,18,20,80,Fail
Raj Khan,11-06-2005,988803,Assam,0,2,8,17,27,Pass
Aarav Reddy,23-03-2005,801945,Himachal Pradesh,4,16,2,8,30,Pass
Zaid Fernandes,29-03-2006,996983,Sikkim,22,19,5,12,58,Pass
Raj Pillai,25-02-2005,165592,Andhra Pradesh,2,0,6,3,11,Pass
Harjeet Verma,21-04-2006,968803,Rajasthan,18,16,11,22,67,Pass
Yash D'Souza,12-03-2005,728012,Bihar,14,9,10,23,56,Pass
Aryan Chopra,30-11-2005,475095,West Bengal,11,4,6,9,30,Pass
Harjeet Verma,27-06-2005,722400,Bihar,4,23,9,2,38,Pass
Rohan Mehta,20-11-2004,110134,Rajasthan,15,17,2,21,55,Pass
Aryan Fernandes,30-05-2005,570057,Chhattisgarh,11,23,9,1,44,Pass
Farhan Sharma,21-03-2006,801352,Madhya Pradesh,5,12,3,23,43,Pass
Aryan D'Souza,13-06-2005,276220,Madhya Pradesh,12,9,22,6,49,Pass
Ishaan Khan,28-04-2005,890629,Rajasthan,13,13,17,9,52,Pass
Farhan Fernandes,06-07-2005,895958,Rajasthan,6,1,19,5,31,Pass
Rohan D'Souza,10-04-2006,239729,Haryana,3,23,9,12,47,Pass
Sukhwinder Fernandes,27-12-2004,340759,Odisha,4,7,13,24,48,Pass
Rohan Verma,28-05-2005,482255,Rajasthan,16,6,4,10,36,Pass
Kunal Fernandes,26-10-2005,660533,Puducherry,16,12,18,7,53,Pass
Manpreet Sharma,27-11-2005,654907,Madhya Pradesh,15,14,3,23,55,Pass
Harjeet Sharma,28-07-2005,680795,Jharkhand,21,16,23,22,82,Fail
Vivaan Sharma,08-12-2004,357581,Uttar Pradesh,22,4,7,17,50,Pass
Gurpreet Reddy,14-08-2005,587492,Bihar,15,16,14,14,59,Pass
Aarav Fernandes,27-04-2005,775585,Jharkhand,0,5,4,18,27,Pass
Aryan Reddy,09-10-2005,824510,Jammu & Kashmir + Ladakh,19,5,8,22,54,Pass
Raj Khan,23-02-2006,705516,Gujarat,21,13,16,7,57,Fail
Rohan Khan,25-11-2005,344958,Andhra Pradesh,11,10,19,15,55,Pass
Sukhwinder Fernandes,16-11-2005,177303,Punjab,18,16,1,9,44,Pass
Krishna Verma,08-02-2006,825936,Haryana,8,16,11,18,53,Pass
Rohan Pillai,04-01-2005,409816,Delhi,5,15,11,22,53,Pass
Ishaan Chopra,02-06-2005,690682,Chhattisgarh,5,0,14,15,34,Pass
Vivaan Khan,09-11-2005,962134,Rajasthan,7,15,2,20,44,Pass
Vivaan Pillai,15-01-2006,950003,Punjab,24,8,9,19,60,Pass
Krishna Sharma,21-07-2005,486499,Punjab,11,13,13,0,37,Pass
Sukhwinder Fernandes,14-11-2005,606191,Rajasthan,2,19,1,8,30,Pass
Aditya Mehta,24-02-2006,203839,Punjab,23,8,1,14,46,Pass
Yash Chopra,23-08-2005,467885,Uttar Pradesh,24,10,9,18,61,Pass
Ayaan D'Souza,27-04-2006,995147,Haryana,22,9,2,4,37,Pass
Krishna Singh,26-11-2005,715804,Odisha,15,2,13,3,33,Pass
Rohan Singh,03-02-2006,538420,Uttar Pradesh,8,0,16,18,42,Pass
Sukhwinder Singh,10-10-2005,720439,Chhattisgarh,14,17,21,21,73,Pass
Vivaan Fernandes,02-04-2006,199339,Chhattisgarh,2,22,18,15,57,Pass
Manpreet Chopra,12-11-2005,147889,Tamil Nadu,1,5,0,24,30,Pass
Peter Chopra,23-10-2005,565519,Uttar Pradesh,7,16,17,10,50,Pass
Yash Chopra,23-02-2005,625205,Maharashtra,1,20,15,7,43,Pass
Harjeet Khan,24-01-2006,954069,Madhya Pradesh,2,20,7,2,31,Pass
Zaid Singh,28-01-2005,920507,Uttar Pradesh,12,16,0,13,41,Pass
Aditya Fernandes,12-02-2006,535250,Andhra Pradesh,20,22,16,22,80,Pass
Gurpreet D'Souza,02-04-2005,822012,Bihar,1,18,14,10,43,Pass
Krishna Reddy,14-02-2006,308259,Himachal Pradesh,1,9,9,20,39,Pass
Aditya Khan,05-10-2005,631781,Chhattisgarh,14,7,23,16,60,Pass
Manpreet Chopra,05-08-2005,977031,Uttar Pradesh,6,16,24,1,47,Pass
Sukhwinder Mehta,18-11-2004,225711,Andhra Pradesh,20,2,16,21,59,Pass
Peter Khan,22-02-2006,405526,Madhya Pradesh,2,6,13,9,30,Pass
Aditya Pillai,11-12-2005,140406,Bihar,18,5,9,16,48,Pass
Ishaan Singh,24-02-2006,416875,Rajasthan,16,16,0,9,41,Pass
Aarav D'Souza,11-08-2005,420045,Assam,20,24,15,11,70,Pass
Aarav Pillai,20-04-2005,922000,Telangana,4,18,23,8,53,Fail
Aryan Verma,13-11-2004,437188,Andhra Pradesh,18,17,8,21,64,Pass
Balbir Khan,09-02-2006,361019,Uttar Pradesh,17,0,10,19,46,Pass
Vivaan D'Souza,11-04-2006,202844,Jharkhand,18,22,21,5,66,Pass
Ishaan Mehta,11-03-2005,727172,Tamil Nadu,0,5,12,7,24,Pass
Yash Singh,24-11-2004,687462,Bihar,0,11,12,14,37,Pass
Kunal Mehta,29-07-2005,861437,Tamil Nadu,11,18,6,19,54,Pass
David D'Souza,08-09-2005,767201,Chhattisgarh,18,3,21,16,58,Pass
Kunal Pillai,24-04-2006,301621,Telangana,8,17,0,2,27,Pass
Aryan Verma,18-03-2006,302118,Haryana,19,18,24,22,83,Pass
Harjeet Mehta,21-04-2006,123055,West Bengal,9,24,0,14,47,Pass
Krishna D'Souza,12-07-2005,568305,Gujarat,5,0,21,12,38,Fail
Mathew Khan,17-03-2005,126007,Uttar Pradesh,1,0,23,8,32,Pass
Vivaan Mehta,22-07-2005,507884,Gujarat,0,0,16,15,31,Fail
Harjeet Sharma,05-03-2005,276668,Uttar Pradesh,1,23,23,2,49,Pass
Farhan Chopra,10-06-2005,383032,Madhya Pradesh,12,21,3,5,41,Pass
Aarav Singh,30-04-2005,137473,Telangana,2,7,13,23,45,Pass
Aarav Singh,26-04-2006,634826,Haryana,11,15,22,1,49,Pass
Sukhwinder Singh,15-04-2005,262962,Jharkhand,23,18,21,2,64,Pass
Gurpreet Verma,03-01-2006,605509,Maharashtra,7,9,8,9,33,Pass
Aarav Fernandes,30-03-2005,629816,Tamil Nadu,12,17,10,7,46,Pass
Raj Chopra,21-01-2006,175720,Madhya Pradesh,3,14,20,19,56,Pass
Krishna Khan,13-12-2004,800370,Bihar,13,17,2,3,35,Pass
Vivaan Singh,12-03-2005,670101,Rajasthan,6,6,0,23,35,Pass
Rohan Fernandes,02-01-2005,118030,Uttar Pradesh,23,15,22,6,66,Pass
Raj D'Souza,01-09-2005,894523,West Bengal,3,21,14,10,48,Pass
Rohan Mehta,29-01-2006,915764,Bihar,20,0,1,4,25,Pass
Rohan D'Souza,05-06-2005,859509,Bihar,14,14,24,23,75,Pass
Raj D'Souza,30-11-2004,782243,Jharkhand,0,4,21,14,39,Pass
Ishaan Chopra,21-04-2006,829295,Odisha,11,15,1,9,36,Pass
Sukhwinder Singh,09-11-2005,701687,Tamil Nadu,19,24,22,4,69,Pass
Peter D'Souza,06-12-2004,235703,Andhra Pradesh,2,1,21,10,34,Pass
Harjeet Fernandes,22-02-2005,997738,Jharkhand,4,24,11,24,63,Fail
Balbir Pillai,05-02-2006,770575,Bihar,7,14,23,23,67,Pass
Gurpreet Pillai,18-10-2005,627238,West Bengal,2,4,12,14,32,Pass
Aarav Khan,10-04-2006,134674,Madhya Pradesh,16,20,3,10,49,Pass
Aditya Pillai,29-05-2005,593746,Rajasthan,4,10,1,17,32,Pass
Sukhwinder Pillai,10-03-2005,789393,Madhya Pradesh,15,7,5,22,49,Pass
Ishaan Sharma,12-01-2005,925425,Telangana,9,12,20,13,54,Fail
Balbir Khan,06-08-2005,246020,Goa,9,22,20,20,71,Fail
Krishna D'Souza,08-12-2004,644859,Tamil Nadu,23,18,18,15,74,Pass
Raj D'Souza,01-05-2006,546975,Chhattisgarh,17,15,14,5,51,Pass
Kunal D'Souza,10-06-2005,650453,Tamil Nadu,4,13,8,2,27,Pass
Yash Khan,24-11-2005,585637,Andhra Pradesh,15,3,22,24,64,Pass
Raj Verma,13-05-2005,366938,Rajasthan,1,24,13,3,41,Pass
Aarav Mehta,20-05-2005,748437,Uttar Pradesh,6,21,7,14,48,Pass
Yash Mehta,21-04-2006,827735,Maharashtra,15,22,21,3,61,Pass
Aditya Mehta,31-03-2006,807229,Tamil Nadu,4,22,12,15,53,Pass
Manpreet Khan,01-02-2005,273087,Chhattisgarh,22,18,6,8,54,Pass
Vivaan Fernandes,16-12-2005,510489,Rajasthan,10,4,21,7,42,Pass
Yash Reddy,20-01-2005,921232,Punjab,6,9,11,6,32,Pass
Balbir Chopra,08-09-2005,830602,Tamil Nadu,21,6,24,16,67,Pass
Vivaan D'Souza,16-11-2005,191663,Bihar,10,20,5,0,35,Pass
Ishaan Singh,09-03-2006,321301,Uttar Pradesh,11,19,8,6,44,Pass
Mathew Pillai,22-02-2005,727616,Tamil Nadu,8,19,1,2,30,Pass
Yash Singh,17-01-2005,563684,Tamil Nadu,0,3,3,2,8,Pass
Aarav Singh,06-08-2005,327047,Bihar,12,12,18,24,66,Pass
Aarav Fernandes,21-09-2005,474884,Bihar,2,19,16,23,60,Pass
Ishaan Chopra,22-04-2006,331531,Gujarat,21,0,3,2,26,Fail
David Reddy,25-08-2005,204279,Haryana,14,16,9,0,39,Pass
Vivaan D'Souza,20-01-2005,260881,Bihar,17,14,16,16,63,Pass
Vivaan Khan,03-04-2005,396364,Assam,13,12,16,8,49,Pass
Vivaan D'Souza,24-02-2006,155646,Punjab,22,24,21,15,82,Pass
Vivaan Verma,15-01-2005,414804,Maharashtra,21,7,8,0,36,Pass
Yash Pillai,08-06-2005,997267,Jharkhand,13,10,0,13,36,Pass
Sukhwinder Pillai,27-10-2005,584100,Andhra Pradesh,5,8,17,2,32,Pass
Aarav Sharma,29-04-2006,995100,Andhra Pradesh,6,18,6,9,39,Pass
Balbir Singh,28-02-2006,286728,Uttar Pradesh,14,7,19,6,46,Pass
Balbir Chopra,11-05-2005,292808,West Bengal,1,3,9,23,36,Pass
Manpreet Pillai,02-07-2005,252531,Madhya Pradesh,3,23,3,13,42,Pass
Rohan Verma,29-01-2006,188155,Karnataka,1,12,16,20,49,Pass
Aarav D'Souza,14-05-2005,298510,Gujarat,15,22,9,7,53,Fail
Imran Khan,08-12-2004,845287,Tamil Nadu,15,23,18,4,60,Pass
Aarav Khan,21-06-2005,947799,Andhra Pradesh,22,12,1,14,49,Pass
Rohan Khan,29-10-2005,187122,Karnataka,6,14,9,16,45,Pass
Harjeet Sharma,17-02-2006,614654,Bihar,16,22,14,11,63,Pass
Kunal Reddy,23-01-2005,452769,Rajasthan,20,7,8,1,36,Pass
Raj Reddy,10-04-2006,230258,Haryana,1,0,16,16,33,Pass
Rohan D'Souza,28-02-2005,783426,Bihar,21,9,7,22,59,Pass
Aditya Chopra,16-09-2005,246001,West Bengal,3,24,20,10,57,Pass
Aryan Chopra,14-03-2006,100639,Uttar Pradesh,21,19,13,2,55,Pass
Manpreet Verma,15-05-2005,929758,Maharashtra,15,16,13,3,47,Pass
Yash Chopra,01-01-2006,863376,Madhya Pradesh,16,21,15,2,54,Pass
Vivaan Khan,07-11-2005,775489,Delhi,17,17,23,15,72,Pass
Rohan Khan,01-01-2006,397125,Assam,1,21,22,10,54,Pass
Farhan Pillai,30-10-2005,717549,Uttar Pradesh,19,12,4,1,36,Pass
Raj Verma,18-03-2006,531309,Bihar,21,7,22,1,51,Pass
Vivaan Reddy,15-11-2004,377188,Odisha,9,15,7,18,49,Pass
Vivaan Pillai,02-01-2005,205833,Maharashtra,5,6,23,3,37,Pass
Aryan Fernandes,09-06-2005,377291,Karnataka,23,9,0,11,43,Pass
Rohan Khan,03-04-2005,649901,Jharkhand,3,9,24,22,58,Pass
David Reddy,29-03-2005,677814,Bihar,11,7,11,4,33,Pass
Ayaan Chopra,30-11-2004,115836,Andhra Pradesh,1,17,21,17,56,Pass
Harjeet Singh,18-04-2005,204115,Rajasthan,18,19,9,2,48,Pass
Sukhwinder Singh,12-04-2006,464526,Maharashtra,11,17,8,3,39,Pass
Aarav D'Souza,26-12-2004,839530,West Bengal,24,6,2,18,50,Pass
Kunal Reddy,04-07-2005,745781,Telangana,12,15,18,6,51,Pass
Gurpreet Singh,13-02-2005,639245,Odisha,11,8,20,17,56,Pass
Harjeet Khan,09-08-2005,635898,Uttar Pradesh,19,3,24,10,56,Pass
Raj Mehta,25-03-2006,499566,Telangana,5,9,12,3,29,Pass
Aarav Reddy,11-01-2005,421491,Odisha,12,23,12,20,67,Pass
Aryan Verma,20-11-2005,508728,West Bengal,24,3,9,6,42,Pass
Yash Mehta,22-11-2004,598475,Haryana,1,23,10,19,53,Pass
Aarav Singh,13-12-2005,403132,Haryana,7,13,14,9,43,Pass
Yash Singh,22-12-2005,844638,Madhya Pradesh,15,23,3,12,53,Pass
Aryan Reddy,18-03-2006,638319,Uttarakhand,7,7,10,11,35,Pass
Aditya Verma,14-02-2005,946154,Delhi,24,18,8,0,50,Pass
Raj Pillai,29-03-2005,333780,Tamil Nadu,22,21,9,24,76,Pass
Aryan Mehta,05-10-2005,926108,Goa,3,6,21,11,41,Fail
Peter Pillai,19-12-2004,422367,Bihar,3,8,18,15,44,Pass
Gurpreet Fernandes,20-11-2005,967129,Himachal Pradesh,22,2,17,23,64,Pass
Peter Reddy,28-11-2004,706205,Madhya Pradesh,23,24,3,7,57,Pass
Rohan Singh,24-07-2005,451957,Madhya Pradesh,17,13,3,20,53,Pass
Raj Pillai,21-04-2005,615296,Tamil Nadu,16,8,12,8,44,Pass
Kunal Singh,06-03-2005,243513,Punjab,9,14,12,22,57,Pass
Aryan Pillai,09-05-2005,714811,Uttar Pradesh,2,4,7,18,31,Pass
Kunal Chopra,16-08-2005,405282,Odisha,21,13,20,2,56,Pass
Raj Sharma,04-12-2005,141571,West Bengal,3,10,18,13,44,Pass
Krishna Mehta,12-01-2005,214308,Bihar,8,4,5,1,18,Pass
Kunal Mehta,25-03-2005,954976,Uttar Pradesh,18,13,15,19,65,Pass
Aryan Singh,06-04-2006,173437,Gujarat,15,8,11,1,35,Fail
Rohan Singh,29-03-2005,799390,Punjab,2,3,6,16,27,Pass
Vivaan Sharma,14-11-2004,375808,Telangana,21,6,14,22,63,Fail
Aarav Chopra,06-07-2005,910282,Andhra Pradesh,18,15,14,0,47,Pass
Gurpreet Reddy,19-12-2005,630293,Bihar,11,14,16,6,47,Pass
Aarav Sharma,04-12-2005,262921,Uttar Pradesh,21,17,21,3,62,Pass
Vivaan D'Souza,05-10-2005,196546,West Bengal,7,10,17,3,37,Pass
Manpreet Sharma,27-08-2005,684976,Bihar,1,5,12,6,24,Pass
Vivaan Pillai,26-02-2006,892959,Bihar,9,21,7,22,59,Pass
Raj Sharma,16-10-2005,206492,Gujarat,2,6,23,1,32,Fail
Aryan Singh,12-06-2005,329780,Haryana,16,14,12,17,59,Pass
Aditya Mehta,31-01-2005,307032,West Bengal,3,20,16,18,57,Pass
Gurpreet Pillai,09-04-2005,920774,Haryana,13,9,9,16,47,Pass
Yash Pillai,23-01-2005,211277,Uttar Pradesh,21,21,4,11,57,Pass
Aryan Khan,28-11-2005,996510,Maharashtra,15,16,12,3,46,Pass
Yash Reddy,30-03-2006,173856,West Bengal,5,6,19,19,49,Pass
Vivaan Reddy,08-01-2005,971102,West Bengal,17,12,7,11,47,Pass
Balbir Pillai,24-05-2005,721937,Bihar,0,7,20,8,35,Pass
Ishaan Fernandes,03-04-2006,699641,West Bengal,4,14,1,18,37,Pass
Krishna Sharma,21-04-2006,857349,Gujarat,10,12,13,1,36,Fail
Vivaan D'Souza,07-08-2005,413012,West Bengal,11,24,2,14,51,Pass
Harjeet Khan,15-04-2005,266551,Uttar Pradesh,3,19,15,14,51,Pass
Harjeet Pillai,05-12-2004,882270,Tamil Nadu,17,23,10,2,52,Pass
Krishna Sharma,22-02-2005,483927,Rajasthan,2,1,3,23,29,Pass
Aarav D'Souza,17-07-2005,133054,Gujarat,23,22,2,19,66,Fail
Ishaan Verma,19-03-2005,636385,Rajasthan,5,9,20,9,43,Pass
Aryan Khan,20-02-2006,775601,Meghalaya,24,21,5,5,55,Pass
Yash Verma,26-06-2005,814317,Jammu & Kashmir + Ladakh,6,21,22,17,66,Pass
Mathew Mehta,25-01-2006,363048,Rajasthan,24,16,10,1,51,Pass
Rohan Reddy,07-11-2004,364170,Haryana,6,22,21,23,72,Pass
Manpreet Reddy,20-04-2005,165481,Bihar,2,6,4,13,25,Pass
Zaid Pillai,01-04-2005,961292,Uttar Pradesh,12,18,9,15,54,Pass
Aarav D'Souza,26-11-2004,383319,Jharkhand,2,7,18,18,45,Pass
Raj Khan,29-04-2006,466330,Haryana,16,5,1,9,31,Pass
Raj Singh,26-01-2006,788313,Maharashtra,22,16,23,3,64,Pass
Aryan D'Souza,28-12-2004,720696,Rajasthan,19,22,9,6,56,Pass
Krishna Mehta,16-12-2005,696682,Uttar Pradesh,12,8,21,15,56,Pass
Vivaan Singh,28-07-2005,794733,Tamil Nadu,21,20,12,17,70,Pass
Yash Chopra,01-02-2006,668100,Assam,9,16,4,0,29,Pass
Aryan Khan,07-08-2005,551968,Maharashtra,24,13,24,3,64,Pass
Kunal Khan,16-03-2005,466441,Gujarat,3,20,2,12,37,Fail
Mathew Sharma,15-05-2005,291007,Telangana,13,7,12,14,46,Pass
Vivaan Pillai,10-11-2005,744339,Telangana,16,17,11,0,44,Pass
Zaid Verma,04-09-2005,117349,Madhya Pradesh,18,23,3,9,53,Pass
Vivaan Fernandes,19-09-2005,894133,Uttar Pradesh,1,16,1,21,39,Pass
Rohan D'Souza,13-03-2006,483001,Tamil Nadu,7,20,20,7,54,Pass
Imran Fernandes,18-10-2005,596691,West Bengal,19,9,7,9,44,Pass
Kunal D'Souza,08-05-2005,809869,Meghalaya,4,7,16,6,33,Pass
Aarav Reddy,10-05-2005,438852,West Bengal,3,24,23,21,71,Pass
Kunal Khan,14-03-2006,255922,Andhra Pradesh,23,11,7,19,60,Pass
Sukhwinder Singh,26-05-2005,781672,Telangana,10,11,8,21,50,Fail
Yash Reddy,28-05-2005,865136,Maharashtra,20,19,9,3,51,Pass
Aarav Chopra,18-04-2006,262913,Gujarat,5,13,20,14,52,Fail
Rohan Mehta,12-02-2006,635142,Telangana,14,1,1,14,30,Pass
Zaid Fernandes,04-06-2005,673965,Telangana,12,0,2,22,36,Pass
Rohan Mehta,06-11-2005,405640,Tamil Nadu,1,23,14,17,55,Pass
Paul Singh,10-04-2006,450292,Madhya Pradesh,4,4,5,9,22,Pass
Aditya Fernandes,01-04-2006,398806,Bihar,20,9,13,18,60,Pass
Gurpreet Verma,25-02-2005,546486,Assam,14,17,5,17,53,Pass
Aditya Chopra,27-12-2005,387738,Uttar Pradesh,0,4,3,4,11,Pass
Kunal Sharma,01-05-2006,125981,Uttar Pradesh,4,3,20,19,46,Pass
Harjeet Chopra,10-04-2006,646273,Odisha,12,9,20,7,48,Pass
Aarav Reddy,22-08-2005,842077,Punjab,24,7,17,7,55,Pass
Harjeet D'Souza,24-11-2005,524394,Rajasthan,14,19,11,4,48,Pass
Yash D'Souza,05-11-2005,668731,Punjab,8,4,18,10,40,Pass
Aryan Mehta,25-12-2004,841823,Madhya Pradesh,12,9,5,15,41,Pass
Yash Verma,01-09-2005,710676,Assam,2,2,14,4,22,Pass
Mathew Khan,20-12-2004,609567,Uttar Pradesh,10,20,11,18,59,Pass
Gurpreet Khan,16-12-2005,406345,Bihar,20,3,23,10,56,Pass
Aarav Chopra,28-07-2005,820965,Punjab,6,22,16,23,67,Pass
Rohan Verma,02-09-2005,331591,Uttar Pradesh,9,1,17,4,31,Pass
Ishaan D'Souza,08-03-2006,128405,Madhya Pradesh,3,20,21,9,53,Pass
Krishna Chopra,02-12-2005,618330,Uttar Pradesh,3,16,6,12,37,Pass
Rohan Singh,10-12-2005,868915,Bihar,7,18,22,20,67,Pass
Raj Verma,25-02-2005,875462,Maharashtra,24,3,9,3,39,Pass
Manpreet Mehta,30-10-2005,215286,Chhattisgarh,18,0,24,20,62,Pass
Raj Sharma,05-07-2005,142991,Madhya Pradesh,24,7,13,3,47,Pass
Vivaan Fernandes,10-04-2006,758485,Rajasthan,13,23,6,11,53,Pass
Krishna Fernandes,03-12-2004,939357,Punjab,22,2,5,10,39,Pass
Manpreet D'Souza,10-04-2006,228508,Tamil Nadu,7,16,9,16,48,Pass
Gurpreet D'Souza,24-02-2005,237529,Bihar,14,6,10,1,31,Pass
Manpreet Khan,26-12-2005,826190,Uttar Pradesh,6,10,14,7,37,Pass
Rehan Sharma,16-11-2005,535360,Karnataka,7,5,9,20,41,Pass
Aditya Singh,04-01-2006,219175,Karnataka,13,11,20,21,65,Pass
Rohan Singh,08-05-2005,109261,Gujarat,18,1,18,20,57,Fail
Balbir Fernandes,03-04-2005,661696,Karnataka,12,9,13,8,42,Pass
Aarav Fernandes,20-10-2005,446081,Odisha,10,0,24,18,52,Pass
Aryan Verma,23-05-2005,221448,Delhi,4,15,24,16,59,Pass
Rohan D'Souza,03-05-2006,643521,Tamil Nadu,24,22,7,7,60,Pass
Vivaan Singh,15-04-2006,746852,Jharkhand,24,1,0,22,47,Pass
Peter Chopra,30-11-2005,405621,West Bengal,3,20,0,22,45,Pass
Krishna Mehta,15-03-2005,392518,Maharashtra,2,13,10,9,34,Pass
Aditya D'Souza,03-06-2005,958501,Rajasthan,7,19,20,4,50,Pass
Aditya Chopra,03-12-2005,678061,Tamil Nadu,10,3,0,19,32,Pass
Aditya Fernandes,18-06-2005,919414,Odisha,22,10,8,24,64,Pass
Ishaan Chopra,21-03-2005,385268,Uttar Pradesh,2,14,14,1,31,Pass
Gurpreet Khan,28-12-2005,384436,Tamil Nadu,20,4,5,11,40,Pass
Raj Singh,01-12-2005,579908,Rajasthan,6,22,16,21,65,Pass
Rohan D'Souza,08-01-2005,238368,Telangana,6,2,1,3,12,Pass
Krishna Singh,24-11-2004,997211,Uttar Pradesh,22,6,10,9,47,Pass
Raj Singh,01-06-2005,554579,Uttar Pradesh,3,23,1,23,50,Pass
Krishna Fernandes,12-09-2005,579672,Haryana,7,19,11,16,53,Pass
Kunal Sharma,22-02-2006,305738,Arunachal Pradesh,9,2,2,5,18,Pass
Paul Khan,13-01-2006,559884,Punjab,13,6,2,4,25,Pass
Ishaan Khan,09-11-2005,510358,Rajasthan,13,0,19,11,43,Pass
Harjeet Singh,16-08-2005,772348,Assam,22,9,24,0,55,Pass
Krishna D'Souza,12-01-2006,973794,Punjab,4,1,15,10,30,Pass
Raj Verma,31-03-2006,273322,Tamil Nadu,15,19,9,17,60,Pass
Yash Singh,22-03-2006,765292,Bihar,23,20,4,14,61,Pass
Krishna Chopra,09-03-2005,433968,Karnataka,23,4,14,18,59,Pass
Aarav D'Souza,18-04-2005,467835,Tamil Nadu,2,1,0,21,24,Pass
Ishaan Chopra,15-11-2004,255807,Uttar Pradesh,5,9,19,3,36,Pass
Manpreet Reddy,11-12-2005,874809,Madhya Pradesh,4,6,8,23,41,Pass
Kunal Sharma,01-11-2005,273168,Bihar,12,22,6,18,58,Pass
Krishna Khan,02-05-2006,263468,Haryana,4,1,9,3,17,Pass
Aarav Pillai,22-03-2006,401935,Chhattisgarh,6,6,19,1,32,Pass
John Khan,03-02-2006,231662,Uttar Pradesh,10,17,0,5,32,Pass
Raj Pillai,04-05-2005,929487,Andhra Pradesh,2,5,3,0,10,Pass
Vivaan Chopra,08-02-2006,193343,Punjab,14,3,4,16,37,Pass
Gurpreet Singh,16-09-2005,685112,Uttarakhand,14,12,3,22,51,Pass
Kunal Verma,27-11-2004,440622,Madhya Pradesh,24,24,3,6,57,Pass
Raj Pillai,24-02-2006,693809,Uttar Pradesh,21,6,24,10,61,Pass
Rohan Pillai,03-04-2006,568728,Madhya Pradesh,6,12,11,16,45,Pass
Zaid D'Souza,16-05-2005,633527,Jammu & Kashmir + Ladakh,4,2,16,13,35,Pass
John Sharma,04-03-2006,411594,Rajasthan,4,12,9,17,42,Pass
Manpreet Chopra,30-06-2005,609987,Tamil Nadu,5,6,24,0,35,Pass
Aarav Verma,11-02-2006,506949,Bihar,2,14,22,13,51,Pass
Manpreet Verma,21-01-2006,689042,Maharashtra,15,6,5,12,38,Pass
Vivaan Verma,19-04-2006,962686,Gujarat,11,5,5,18,39,Fail
David Mehta,24-03-2005,964140,Uttar Pradesh,19,16,3,4,42,Pass
Kunal Singh,13-07-2005,111133,Mizoram,22,8,23,13,66,Fail
Harjeet Singh,19-05-2005,750876,Tamil Nadu,8,14,10,17,49,Pass
Vivaan Sharma,16-11-2005,559147,Assam,8,12,3,24,47,Pass
Krishna Khan,22-09-2005,460738,Arunachal Pradesh,6,8,13,20,47,Pass
Harjeet Khan,17-12-2005,890825,Himachal Pradesh,18,2,8,22,50,Pass
Rohan Chopra,11-02-2005,931633,Bihar,11,22,18,14,65,Pass
Vivaan Pillai,10-12-2005,923951,West Bengal,6,7,0,2,15,Pass
Aarav Singh,11-03-2005,215605,Bihar,14,24,22,24,84,Pass
Aditya Fernandes,01-07-2005,641369,West Bengal,8,15,7,3,33,Pass
John Chopra,30-06-2005,111976,Haryana,2,22,16,16,56,Pass
Yash Khan,27-12-2005,290125,Kerala,12,1,20,15,48,Fail
Yash Verma,24-02-2006,968639,West Bengal,16,23,3,0,42,Pass
Ishaan Khan,06-05-2005,641671,Rajasthan,3,14,13,2,32,Pass
Aarav Chopra,13-12-2004,117498,Delhi,17,8,16,24,65,Pass
Raj D'Souza,21-06-2005,630532,Odisha,11,1,6,8,26,Pass
Aditya Khan,30-09-2005,439345,Andhra Pradesh,9,20,9,4,42,Pass
Aarav Mehta,12-02-2006,635929,Uttar Pradesh,22,10,6,18,56,Pass
Peter Sharma,17-05-2005,655151,Tamil Nadu,19,24,22,17,82,Pass
Vivaan Mehta,27-03-2005,836770,Madhya Pradesh,5,11,9,19,44,Pass
Aryan Pillai,21-03-2005,784388,Maharashtra,14,9,6,1,30,Pass
Yash Fernandes,16-10-2005,483802,Uttar Pradesh,6,13,2,3,24,Pass
Balbir Reddy,25-11-2005,972312,Mizoram,12,8,9,24,53,Fail
Aryan Sharma,25-09-2005,716091,Telangana,24,21,4,21,70,Fail
Aarav Singh,11-01-2005,911285,Uttarakhand,8,0,10,12,30,Pass
Vivaan D'Souza,25-03-2005,391888,West Bengal,4,16,17,8,45,Pass
Sukhwinder D'Souza,10-10-2005,230834,Andhra Pradesh,6,22,7,18,53,Pass
Vivaan D'Souza,08-03-2006,923561,Delhi,16,20,14,19,69,Pass
Kunal Singh,04-09-2005,525861,Bihar,3,6,4,15,28,Pass
Aditya D'Souza,28-07-2005,967034,Uttar Pradesh,3,4,6,13,26,Pass
Ayaan Pillai,11-10-2005,613318,Tamil Nadu,14,3,22,4,43,Pass
Aarav Sharma,25-04-2006,320761,Jharkhand,11,9,23,8,51,Pass
Aarav Sharma,02-05-2006,272672,Tamil Nadu,0,3,5,19,27,Pass
Paul Mehta,11-03-2005,541254,Bihar,12,9,22,4,47,Pass
Gurpreet Pillai,07-09-2005,346707,Madhya Pradesh,23,4,3,18,48,Pass
Vivaan Singh,20-12-2005,163086,Bihar,6,7,15,3,31,Pass
David Singh,26-02-2006,362431,Haryana,19,17,11,13,60,Pass
Raj Verma,06-12-2004,689379,Haryana,17,20,8,16,61,Pass
Aditya Khan,29-08-2005,772417,Maharashtra,8,2,2,12,24,Pass
Kunal Khan,08-10-2005,678163,Gujarat,15,14,9,9,47,Fail
Aditya D'Souza,04-03-2006,424088,Jharkhand,10,13,22,0,45,Pass
Rohan Reddy,02-01-2006,740047,Assam,6,22,19,1,48,Pass
Yash Sharma,18-11-2005,421301,Haryana,6,17,11,8,42,Pass
Aarav Pillai,18-05-2005,275476,Madhya Pradesh,12,21,3,20,56,Pass
Rohan Chopra,26-06-2005,962446,Tamil Nadu,16,18,13,20,67,Pass
Gurpreet Khan,06-05-2005,384214,Odisha,13,23,16,6,58,Pass
Mathew Fernandes,28-11-2005,182378,Bihar,15,24,6,22,67,Pass
Aarav Mehta,02-09-2005,941893,Haryana,24,18,21,8,71,Pass
Yash Chopra,17-03-2005,952318,Uttar Pradesh,9,10,21,2,42,Pass
David Fernandes,27-07-2005,902147,Jammu & Kashmir + Ladakh,1,23,10,17,51,Pass
Imran Pillai,09-01-2005,282818,Tamil Nadu,10,22,12,9,53,Pass
Krishna Chopra,19-03-2005,405500,Uttarakhand,1,2,22,9,34,Pass
Vivaan Chopra,01-11-2005,349619,Punjab,11,20,24,10,65,Pass
Balbir D'Souza,02-07-2005,725971,Maharashtra,23,13,3,3,42,Pass
Vivaan Khan,30-11-2005,864866,Karnataka,23,24,6,0,53,Pass
Ishaan D'Souza,16-01-2005,109110,Haryana,15,9,14,21,59,Pass
Yash D'Souza,13-12-2004,567356,Mizoram,13,4,1,4,22,Pass
Aditya Fernandes,04-03-2006,678196,Haryana,23,11,16,20,70,Pass
Mathew Verma,06-02-2006,417790,Bihar,15,0,0,17,32,Pass
Mathew Sharma,13-12-2005,688813,Chhattisgarh,5,24,4,20,53,Pass
Vivaan Mehta,30-04-2005,661767,Madhya Pradesh,13,23,3,21,60,Pass
Aarav D'Souza,13-12-2005,426696,Rajasthan,2,18,16,7,43,Pass
Aarav Reddy,14-10-2005,793444,Himachal Pradesh,1,8,19,16,44,Pass
Vivaan Fernandes,10-02-2005,961516,Tamil Nadu,8,7,5,21,41,Pass
Krishna D'Souza,11-07-2005,246205,Bihar,12,22,22,2,58,Pass
Aryan Reddy,27-12-2005,713979,Jammu & Kashmir + Ladakh,19,7,12,10,48,Pass
Vivaan Sharma,07-06-2005,727064,Rajasthan,21,15,6,12,54,Pass
Mathew Chopra,16-11-2004,664266,Kerala,19,20,0,6,45,Fail
Aarav Singh,28-04-2005,244509,Chhattisgarh,12,1,24,10,47,Pass
Yash Fernandes,11-01-2005,765621,Madhya Pradesh,19,18,3,20,60,Pass
Harjeet Reddy,23-02-2006,792322,Chhattisgarh,14,12,1,19,46,Pass
Rohan Khan,23-03-2005,685299,Uttar Pradesh,1,23,14,16,54,Pass
Yash Fernandes,30-01-2006,260637,Madhya Pradesh,17,24,10,2,53,Pass
Balbir Sharma,18-10-2005,444424,Maharashtra,12,1,18,15,46,Pass
David Fernandes,20-02-2005,987985,Andhra Pradesh,23,11,12,3,49,Pass
Peter Singh,20-01-2005,479294,Manipur,8,6,1,17,32,Fail
Paul Verma,09-04-2005,355969,Karnataka,11,16,2,22,51,Pass
Vivaan Pillai,05-11-2005,700046,Assam,13,21,12,1,47,Pass
Sukhwinder Mehta,03-12-2004,421823,Bihar,0,14,7,7,28,Pass
Krishna Fernandes,19-04-2006,643314,Uttar Pradesh,5,13,24,22,64,Pass
Rohan Mehta,06-10-2005,589752,Maharashtra,4,19,15,1,39,Pass
Aryan Fernandes,05-05-2005,450630,Tamil Nadu,10,17,9,16,52,Pass
Yash Reddy,01-05-2005,895557,Uttarakhand,12,17,7,6,42,Pass
Peter Khan,06-04-2005,679539,Andhra Pradesh,22,5,22,7,56,Pass
Yash Chopra,25-02-2006,515578,Uttar Pradesh,2,11,2,20,35,Pass
Krishna Reddy,16-02-2006,489329,Madhya Pradesh,8,20,24,3,55,Pass
Harjeet Mehta,15-04-2006,962294,Uttar Pradesh,20,16,15,17,68,Pass
Rohan Chopra,28-07-2005,930852,Bihar,15,20,22,0,57,Pass
Harjeet Reddy,30-12-2005,410898,Rajasthan,1,0,6,3,10,Pass
Yash Fernandes,03-03-2005,804636,Jammu & Kashmir + Ladakh,16,12,3,4,35,Pass
Rohan Khan,30-11-2005,810635,Andhra Pradesh,23,11,0,19,53,Pass
Vivaan Pillai,12-12-2005,919737,Odisha,8,1,14,20,43,Pass
Sukhwinder Sharma,14-02-2006,701410,Haryana,2,7,5,16,30,Pass
Mathew Fernandes,24-01-2005,378218,Rajasthan,7,1,12,2,22,Pass
John Pillai,05-07-2005,293292,Karnataka,8,21,11,7,47,Pass
Kunal Khan,05-11-2005,688463,Assam,16,0,2,11,29,Pass
Kunal Singh,01-07-2005,228371,Odisha,12,15,13,17,57,Pass
John Sharma,13-07-2005,277559,Rajasthan,2,8,9,7,26,Pass
Aarav Sharma,20-08-2005,450555,Meghalaya,1,16,10,7,34,Pass
Kunal Chopra,10-03-2005,617996,Maharashtra,2,19,20,3,44,Pass
Raj Fernandes,20-01-2005,484899,West Bengal,3,16,21,13,53,Pass
Rohan Khan,26-04-2005,443136,Rajasthan,18,17,3,23,61,Pass
Krishna Singh,27-02-2005,787688,Tamil Nadu,1,9,15,1,26,Pass
Rohan Khan,18-12-2004,488814,Maharashtra,12,8,5,23,48,Pass
Manpreet Verma,31-03-2006,986961,Arunachal Pradesh,14,6,6,22,48,Fail
Aryan D'Souza,01-02-2006,939168,Jharkhand,13,5,17,10,45,Pass
Raj Chopra,07-04-2005,261659,West Bengal,6,11,24,12,53,Pass
Aditya Chopra,12-04-2005,584298,Bihar,14,5,3,14,36,Pass
Aryan Mehta,01-12-2005,816576,Assam,13,15,0,9,37,Pass
Krishna Fernandes,10-10-2005,991351,Punjab,22,24,12,7,65,Pass
Rohan Mehta,09-10-2005,575548,Bihar,1,22,1,14,38,Pass
Yash Pillai,28-02-2006,654704,Uttar Pradesh,14,8,8,19,49,Pass
Aryan Sharma,29-10-2005,263694,Jammu & Kashmir + Ladakh,0,10,21,17,48,Pass
Manpreet Khan,26-04-2005,553511,Punjab,1,6,7,7,21,Pass
Manpreet Chopra,15-01-2006,540790,Maharashtra,5,14,13,3,35,Pass
Yash Chopra,16-08-2005,704465,Uttar Pradesh,4,13,14,6,37,Pass
Rohan Mehta,11-11-2005,144315,Madhya Pradesh,4,8,2,2,16,Pass
Raj Fernandes,22-10-2005,649905,Bihar,3,9,4,17,33,Pass
Harjeet Singh,22-01-2005,184178,West Bengal,8,9,3,5,25,Pass
Kunal Fernandes,27-04-2005,894648,Bihar,10,3,4,7,24,Pass
Ishaan Chopra,02-02-2006,806840,Rajasthan,16,20,6,19,61,Pass
Krishna Reddy,17-01-2005,390386,Rajasthan,23,15,7,16,61,Pass
Kunal Sharma,23-02-2005,298355,Uttarakhand,9,14,6,4,33,Pass
Manpreet Singh,15-11-2005,472945,Nagaland,19,14,12,9,54,Fail
Raj Singh,03-10-2005,825313,Karnataka,18,9,8,4,39,Pass
Manpreet Pillai,08-12-2005,463015,Rajasthan,10,11,19,11,51,Pass
Rohan Sharma,30-04-2005,633265,Uttar Pradesh,1,15,13,8,37,Pass
Zaid Mehta,29-01-2005,864135,Uttar Pradesh,22,11,4,6,43,Pass
Aditya Singh,01-01-2006,976189,Maharashtra,10,17,4,3,34,Pass
Balbir Pillai,02-08-2005,171062,Bihar,22,13,21,0,56,Pass
Aditya D'Souza,14-02-2006,198957,Andhra Pradesh,3,10,8,7,28,Pass
Raj D'Souza,29-05-2005,323068,Bihar,17,12,15,2,46,Pass
Krishna Chopra,24-03-2005,930951,Madhya Pradesh,2,12,3,24,41,Pass
Rehan Sharma,14-04-2005,492320,Rajasthan,9,16,17,1,43,Pass
Aditya Singh,01-08-2005,593123,Arunachal Pradesh,3,22,6,1,32,Fail
Kunal Mehta,20-11-2004,495473,Rajasthan,22,3,16,18,59,Pass
Ishaan Reddy,24-03-2005,869672,West Bengal,13,24,6,1,44,Pass
Yash Sharma,09-01-2006,551107,Uttar Pradesh,12,9,5,0,26,Pass
Paul Verma,07-10-2005,200437,Jharkhand,11,5,19,3,38,Pass
Peter Sharma,19-01-2006,255472,Jharkhand,0,4,10,0,14,Pass
Kunal Verma,09-12-2005,253013,Tamil Nadu,17,24,20,22,83,Pass
Kunal D'Souza,04-10-2005,253602,Maharashtra,12,15,23,3,53,Pass
Vivaan Fernandes,27-01-2005,931367,Bihar,22,23,5,15,65,Pass
David Fernandes,01-03-2006,866725,Maharashtra,1,22,21,3,47,Pass
Manpreet Sharma,12-09-2005,960624,Bihar,17,13,2,14,46,Pass
Krishna Mehta,07-08-2005,864099,West Bengal,3,15,17,3,38,Pass
Kunal Fernandes,03-10-2005,687536,Bihar,21,10,9,17,57,Pass
Rehan Singh,26-11-2004,825376,Haryana,20,4,20,0,44,Pass
Gurpreet Pillai,02-06-2005,386934,Delhi,0,9,5,20,34,Pass
David Mehta,22-04-2005,652718,Assam,1,17,8,22,48,Pass
Vivaan Chopra,08-03-2005,764811,Rajasthan,8,19,4,5,36,Pass
Gurpreet Khan,13-01-2005,851753,Maharashtra,1,11,9,2,23,Pass
Aarav Khan,23-12-2005,511817,Bihar,19,11,1,8,39,Pass
Kunal Chopra,23-04-2006,396702,Andhra Pradesh,13,23,10,2,48,Pass
Rohan Reddy,01-01-2006,480724,Jharkhand,4,22,3,15,44,Pass
Rehan Mehta,26-10-2005,112704,Uttarakhand,22,16,3,23,64,Pass
Aarav D'Souza,18-03-2005,439903,Rajasthan,6,22,23,6,57,Pass
Krishna Sharma,09-08-2005,243936,Rajasthan,8,15,11,22,56,Pass
Kunal Khan,20-10-2005,642537,Meghalaya,5,20,2,11,38,Pass
Vivaan Reddy,20-01-2006,842759,Maharashtra,22,13,18,3,56,Pass
Yash Singh,15-08-2005,968764,Gujarat,19,12,4,20,55,Fail
Sukhwinder Fernandes,27-10-2005,822026,Odisha,11,22,0,23,56,Pass
Krishna Singh,16-01-2005,341257,Bihar,3,22,8,3,36,Pass
Yash Reddy,26-06-2005,546983,Madhya Pradesh,4,24,3,21,52,Pass
Farhan Khan,10-12-2004,402444,Himachal Pradesh,22,6,7,11,46,Pass
Manpreet Khan,02-05-2005,846866,Telangana,6,14,18,23,61,Pass
Balbir Pillai,07-12-2005,912322,Punjab,19,7,13,20,59,Pass
Rehan Verma,04-01-2005,151365,Bihar,24,17,17,13,71,Pass
Gurpreet Verma,30-03-2005,330193,Rajasthan,24,9,17,1,51,Pass
Mathew D'Souza,10-07-2005,446951,Uttar Pradesh,11,7,20,15,53,Pass
Aryan Verma,08-11-2004,229420,Karnataka,0,11,13,12,36,Pass
Rohan Singh,07-07-2005,959650,Punjab,24,6,4,23,57,Pass
Mathew Reddy,04-05-2006,572308,Madhya Pradesh,5,9,13,12,39,Pass
Krishna Chopra,29-04-2005,649200,Maharashtra,17,12,16,3,48,Pass
Kunal Fernandes,10-01-2005,667091,Meghalaya,2,10,20,20,52,Pass
Aryan Khan,08-02-2005,547045,Gujarat,14,3,7,2,26,Fail
John Verma,06-04-2005,679221,Rajasthan,17,12,9,12,50,Pass
Krishna Pillai,27-02-2006,150940,Madhya Pradesh,17,0,23,9,49,Pass
Aditya Chopra,29-10-2005,902718,Madhya Pradesh,23,12,6,11,52,Pass
Peter Fernandes,22-11-2004,890849,Telangana,4,18,12,3,37,Pass
Imran Chopra,11-11-2004,235334,West Bengal,3,15,16,17,51,Pass
Rohan Reddy,27-06-2005,404929,West Bengal,24,15,0,4,43,Pass
Aarav Pillai,13-09-2005,996637,Uttar Pradesh,17,16,23,5,61,Pass
Aarav D'Souza,12-01-2006,702366,Odisha,12,0,15,16,43,Pass
Ishaan Reddy,06-10-2005,647482,Rajasthan,15,7,0,8,30,Pass
Imran Singh,21-04-2006,602611,Uttar Pradesh,6,1,24,14,45,Pass
Kunal Khan,26-11-2004,604933,Uttar Pradesh,0,18,18,11,47,Pass
Aditya Chopra,28-09-2005,503839,Madhya Pradesh,6,8,14,15,43,Pass
Krishna Khan,23-01-2005,666117,Uttar Pradesh,10,10,16,23,59,Pass
Ishaan Fernandes,31-08-2005,522030,Gujarat,1,22,5,20,48,Fail
Raj D'Souza,18-09-2005,723725,Rajasthan,18,10,1,15,44,Pass
Manpreet Mehta,27-07-2005,340887,Telangana,3,20,13,1,37,Pass
Krishna Chopra,11-11-2005,530679,Jharkhand,19,8,17,14,58,Pass
Balbir Fernandes,19-06-2005,302462,Manipur,20,3,12,20,55,Fail
Imran Reddy,17-09-2005,438277,West Bengal,3,2,13,7,25,Pass
Raj Pillai,18-06-2005,380388,Gujarat,12,10,0,20,42,Fail
Yash Khan,16-04-2005,790319,Bihar,17,23,15,4,59,Pass
Harjeet Khan,27-07-2005,765982,Haryana,10,8,12,20,50,Pass
Farhan Chopra,20-03-2006,676058,Rajasthan,20,15,4,11,50,Pass
Sukhwinder Khan,17-05-2005,523718,Haryana,3,14,5,15,37,Pass
Raj D'Souza,14-12-2005,280075,Uttar Pradesh,17,8,12,19,56,Pass
Rohan Chopra,04-10-2005,798807,Uttar Pradesh,4,10,9,1,24,Pass
Raj Verma,22-02-2005,843683,Madhya Pradesh,22,21,3,16,62,Pass
Ishaan Singh,29-01-2006,703279,Madhya Pradesh,2,0,3,1,6,Pass
Vivaan Singh,28-02-2005,870856,West Bengal,3,4,22,21,50,Pass
Ishaan Khan,20-12-2005,323501,Bihar,3,7,22,10,42,Pass
David Khan,04-02-2005,866327,Uttar Pradesh,12,4,8,19,43,Pass
Gurpreet D'Souza,08-12-2004,984097,Uttar Pradesh,24,4,10,20,58,Pass
Imran Verma,17-02-2006,127250,Gujarat,13,20,13,12,58,Fail
Ishaan D'Souza,30-05-2005,203759,Maharashtra,10,18,2,3,33,Pass
Aryan Sharma,18-12-2004,481482,Uttarakhand,19,7,12,5,43,Pass
Gurpreet Chopra,26-01-2005,836876,Rajasthan,8,21,19,15,63,Pass
Vivaan Pillai,08-04-2006,176784,Bihar,5,3,23,4,35,Pass
Aryan Verma,03-06-2005,908681,Madhya Pradesh,18,14,0,10,42,Pass
Yash Mehta,18-03-2005,588706,West Bengal,8,2,5,8,23,Pass
Vivaan Mehta,18-04-2006,532554,Uttarakhand,7,1,14,6,28,Pass
Rohan Singh,03-07-2005,518077,Tamil Nadu,20,22,23,14,79,Pass
Yash Pillai,12-11-2005,229950,Tamil Nadu,19,11,21,18,69,Pass
Harjeet Reddy,21-04-2006,710983,Tamil Nadu,2,10,0,6,18,Pass
Harjeet Pillai,23-04-2005,739212,Rajasthan,0,11,24,20,55,Pass
Rohan Chopra,01-05-2005,602109,Andhra Pradesh,7,13,6,2,28,Pass
Gurpreet Mehta,19-10-2005,918581,Haryana,17,15,22,0,54,Pass
Rohan Fernandes,30-03-2006,763743,Punjab,9,0,20,19,48,Pass
Sukhwinder D'Souza,15-02-2005,254961,Haryana,12,12,20,22,66,Pass
Kunal Khan,11-12-2004,374232,Punjab,11,2,10,24,47,Pass
Raj Mehta,02-07-2005,323523,Chhattisgarh,7,14,14,23,58,Pass
Peter Fernandes,29-03-2005,510998,Haryana,7,11,11,9,38,Pass
Yash Chopra,20-11-2004,805798,Haryana,9,10,1,15,35,Pass
Balbir Pillai,15-01-2005,591251,Kerala,5,22,0,15,42,Fail
Rohan Singh,11-11-2005,855325,Jharkhand,8,12,8,3,31,Pass
Kunal D'Souza,08-08-2005,608183,Rajasthan,4,16,8,14,42,Pass
Balbir Khan,20-01-2006,349093,Maharashtra,1,8,18,8,35,Pass
Rohan Fernandes,31-12-2004,659064,Telangana,1,24,12,21,58,Fail
Rehan D'Souza,02-01-2006,792872,Himachal Pradesh,14,9,24,11,58,Pass
Harjeet Khan,19-07-2005,616359,Kerala,24,15,3,20,62,Fail
Aditya Singh,14-02-2006,321431,Telangana,21,5,0,16,42,Pass
Yash Fernandes,18-06-2005,366993,Himachal Pradesh,16,15,11,12,54,Pass
Sukhwinder Mehta,20-12-2005,652477,Uttar Pradesh,6,10,19,21,56,Pass
Rohan Sharma,12-11-2005,452003,Rajasthan,5,3,13,4,25,Pass
David Chopra,19-05-2005,868446,Bihar,0,1,21,0,22,Pass
David Mehta,08-08-2005,563283,Andhra Pradesh,11,12,6,23,52,Pass
Kunal Khan,06-01-2005,619690,Bihar,13,8,19,20,60,Pass
Aarav Verma,24-02-2006,393532,West Bengal,13,16,16,1,46,Pass
Balbir Reddy,10-08-2005,231483,Tamil Nadu,6,1,9,12,28,Pass
Aryan Reddy,09-01-2006,876665,Himachal Pradesh,7,4,4,10,25,Pass
Krishna Khan,26-07-2005,505924,Himachal Pradesh,20,14,1,0,35,Pass
Aditya Khan,26-02-2005,514449,Tamil Nadu,12,0,6,24,42,Pass
Aarav Reddy,07-03-2005,806343,Himachal Pradesh,5,6,15,7,33,Pass
Raj D'Souza,21-01-2006,985269,Uttar Pradesh,8,20,23,7,58,Pass
Farhan Reddy,13-05-2005,996279,Tamil Nadu,5,2,24,3,34,Pass
Aarav D'Souza,21-03-2006,682325,Bihar,19,6,19,18,62,Pass
Raj Reddy,12-10-2005,217202,Tamil Nadu,22,6,0,13,41,Pass
Yash Mehta,03-12-2004,854786,Maharashtra,9,1,17,13,40,Pass
Vivaan Reddy,30-04-2005,867975,Haryana,24,9,24,7,64,Pass
Raj Khan,23-01-2005,807905,Rajasthan,1,11,17,23,52,Pass
Gurpreet D'Souza,15-12-2005,909570,Daman & Diu / D&N Haveli,19,7,4,23,53,Fail
Gurpreet Mehta,24-03-2005,452175,Bihar,10,6,21,4,41,Pass
Vivaan Pillai,10-04-2006,358696,Andhra Pradesh,23,22,3,14,62,Pass
Peter Chopra,01-07-2005,541004,Uttar Pradesh,21,3,14,24,62,Pass
Aryan Mehta,12-06-2005,129119,Tamil Nadu,12,21,12,5,50,Pass
Kunal Singh,12-05-2005,423204,Uttar Pradesh,17,15,23,3,58,Pass
Aditya Chopra,12-04-2005,934082,Maharashtra,20,1,8,2,31,Pass
Raj Khan,23-04-2006,999853,Andhra Pradesh,16,14,17,10,57,Pass
Kunal Sharma,03-07-2005,912521,Haryana,0,21,13,14,48,Pass
Aryan Mehta,18-03-2005,336615,Tamil Nadu,8,2,7,17,34,Pass
Ishaan Sharma,18-12-2004,938477,West Bengal,4,20,14,1,39,Pass
Yash Reddy,30-10-2005,579963,Himachal Pradesh,8,11,11,1,31,Pass
Kunal Fernandes,27-03-2006,955556,Maharashtra,9,2,4,1,16,Pass
Gurpreet Pillai,30-12-2005,245508,Madhya Pradesh,21,19,3,17,60,Pass
Vivaan Khan,21-03-2005,952324,Tamil Nadu,20,2,22,7,51,Pass
Aryan Fernandes,03-05-2006,782452,Uttar Pradesh,8,24,13,7,52,Pass
Raj D'Souza,02-01-2006,127819,Bihar,1,11,0,20,32,Pass
Kunal Singh,08-11-2004,833866,Maharashtra,24,11,3,3,41,Pass
Sukhwinder Pillai,23-02-2006,936976,Assam,21,24,18,19,82,Pass
David Fernandes,26-12-2004,514242,Tamil Nadu,10,12,23,13,58,Pass
Vivaan Verma,13-10-2005,317390,Maharashtra,10,2,4,1,17,Pass
Rohan Verma,26-11-2005,634757,Uttar Pradesh,19,0,2,22,43,Pass
Farhan Khan,23-05-2005,376857,Punjab,15,24,9,0,48,Pass
Aditya Fernandes,16-11-2004,980927,Madhya Pradesh,23,11,3,13,50,Pass
Rohan D'Souza,16-11-2005,865844,Jammu & Kashmir + Ladakh,17,21,1,13,52,Pass
Ishaan Pillai,06-03-2005,811357,Madhya Pradesh,19,23,3,18,63,Pass
Aditya Sharma,23-01-2005,662372,Rajasthan,18,22,15,24,79,Pass
Krishna Mehta,14-01-2006,621434,Jharkhand,3,4,13,13,33,Pass
Kunal Reddy,02-04-2006,270060,Rajasthan,13,2,11,16,42,Pass
Mathew Khan,27-07-2005,133424,Himachal Pradesh,16,11,11,2,40,Pass
Krishna Sharma,17-12-2004,429236,Uttar Pradesh,24,7,16,6,53,Pass
Raj D'Souza,07-12-2004,873947,Andhra Pradesh,16,2,12,17,47,Pass
Paul Mehta,12-04-2005,828751,Bihar,0,5,10,13,28,Pass
Mathew Sharma,30-03-2006,357945,Telangana,17,2,4,23,46,Pass
Krishna Verma,04-06-2005,784409,Madhya Pradesh,21,5,1,4,31,Pass
Aryan D'Souza,04-03-2006,840956,Rajasthan,22,9,1,19,51,Pass
Aditya Khan,23-09-2005,144589,Telangana,24,11,14,0,49,Pass
Yash Fernandes,29-04-2005,160283,Haryana,8,6,16,18,48,Pass
Raj Pillai,27-10-2005,467191,Maharashtra,24,20,20,3,67,Pass
Aditya Mehta,05-08-2005,617109,Rajasthan,7,9,19,2,37,Pass
Yash Singh,01-01-2006,184477,Gujarat,13,14,2,0,29,Fail
Raj Singh,15-10-2005,404995,Telangana,16,5,11,22,54,Fail
Aryan D'Souza,26-08-2005,131960,Uttar Pradesh,8,15,14,11,48,Pass
Rehan Mehta,20-03-2005,444165,Rajasthan,12,9,10,19,50,Pass
Yash Mehta,27-08-2005,330492,Chhattisgarh,24,8,6,21,59,Pass
Krishna Chopra,08-07-2005,221284,Uttarakhand,20,11,10,7,48,Pass
Aarav Fernandes,03-10-2005,180634,Maharashtra,7,5,1,13,26,Pass
Ishaan Reddy,19-11-2004,870270,Telangana,3,10,4,8,25,Pass
Zaid Fernandes,07-05-2005,235501,Tamil Nadu,1,23,13,3,40,Pass
Krishna Singh,01-01-2006,591579,West Bengal,16,1,11,4,32,Pass
Aditya Singh,18-04-2005,668512,Meghalaya,3,23,11,15,52,Pass
Aryan Verma,28-10-2005,807293,Haryana,12,11,18,22,63,Pass
Aditya Pillai,08-08-2005,974677,Maharashtra,1,23,11,8,43,Pass
David Reddy,30-04-2005,574362,Madhya Pradesh,19,19,0,2,40,Pass
Vivaan Singh,07-05-2006,923040,Kerala,8,17,7,5,37,Fail
Vivaan Singh,11-03-2006,809356,Andhra Pradesh,2,10,16,7,35,Pass
Rohan Chopra,15-12-2004,733861,Madhya Pradesh,12,5,18,14,49,Pass
Aditya Singh,07-05-2005,201647,Odisha,3,15,14,14,46,Pass
Ishaan Chopra,25-01-2005,522237,Madhya Pradesh,7,11,13,19,50,Pass
Yash Sharma,31-12-2005,181815,Bihar,20,8,23,18,69,Pass
Mathew Verma,03-12-2004,311590,Tamil Nadu,6,20,13,17,56,Pass
Krishna Mehta,16-04-2006,691006,Meghalaya,3,15,8,19,45,Pass
Mathew D'Souza,22-04-2006,273238,Bihar,6,15,5,8,34,Pass
John Pillai,13-11-2005,703998,Uttar Pradesh,13,14,21,14,62,Pass
Aditya Mehta,10-02-2005,148608,Tamil Nadu,21,6,11,6,44,Pass
David Verma,03-02-2006,177932,Tripura,21,4,7,6,38,Pass
Raj Fernandes,07-02-2005,618551,Haryana,6,14,19,6,45,Pass
Vivaan Chopra,03-08-2005,286515,Haryana,22,13,11,13,59,Pass
Aryan Singh,12-09-2005,894192,Sikkim,18,1,11,10,40,Pass
Aryan Reddy,28-12-2005,406596,Assam,19,13,4,19,55,Pass
Vivaan Fernandes,06-09-2005,762243,Telangana,9,15,20,18,62,Pass
Manpreet Chopra,31-03-2005,657762,Rajasthan,5,20,16,7,48,Pass
Mathew D'Souza,05-01-2006,144513,Karnataka,3,9,4,22,38,Pass
Aarav Reddy,01-05-2006,352573,Haryana,13,22,19,18,72,Pass
Aarav Reddy,29-05-2005,197816,Tamil Nadu,14,0,17,21,52,Pass
Ishaan Mehta,03-03-2006,281093,Nagaland,5,24,6,20,55,Fail
Aditya Reddy,08-05-2005,371430,Uttar Pradesh,12,4,4,18,38,Pass
Krishna Khan,21-11-2005,565592,Telangana,0,11,23,5,39,Pass
Sukhwinder Verma,07-03-2005,262073,Uttar Pradesh,15,4,13,14,46,Pass
Kunal Reddy,05-01-2006,848035,Haryana,17,16,13,24,70,Pass
Rehan Sharma,07-02-2005,442258,Maharashtra,17,18,3,3,41,Pass
Farhan Verma,25-01-2005,181971,Andhra Pradesh,8,11,5,21,45,Pass
Aarav Mehta,12-03-2006,699774,Uttar Pradesh,15,19,8,20,62,Pass
Raj Chopra,12-11-2005,667601,Tamil Nadu,1,3,24,12,40,Pass
Aryan Chopra,19-04-2006,282584,Uttarakhand,7,20,8,11,46,Pass
Rohan Sharma,20-04-2005,509230,West Bengal,23,13,0,8,44,Pass
Harjeet Chopra,01-05-2006,711489,Manipur,20,3,9,12,44,Fail
Vivaan Reddy,03-04-2005,869429,Jharkhand,0,8,9,15,32,Pass
Krishna Pillai,26-04-2006,331265,Rajasthan,3,2,5,14,24,Pass
Mathew Verma,04-12-2005,860024,Tamil Nadu,13,17,2,14,46,Pass
Aryan Pillai,25-11-2004,345856,Bihar,13,10,9,5,37,Pass
Raj Singh,04-02-2006,738038,Tamil Nadu,18,17,11,13,59,Pass
Harjeet Khan,28-02-2006,790865,Andhra Pradesh,3,19,11,11,44,Pass
Mathew Singh,14-05-2005,381749,Bihar,24,7,10,12,53,Pass
David Khan,08-12-2005,896807,Gujarat,23,18,12,13,66,Fail
Raj Mehta,08-02-2005,396916,Bihar,13,1,4,19,37,Pass
Aryan Khan,08-02-2006,542628,Madhya Pradesh,7,0,12,13,32,Pass
Yash Reddy,08-04-2005,651778,Bihar,22,14,19,18,73,Pass
Aryan Fernandes,16-05-2005,489510,Haryana,16,14,0,13,43,Pass
Kunal Fernandes,14-03-2005,305902,Kerala,15,20,17,9,61,Fail
Raj Chopra,15-05-2005,326206,Uttar Pradesh,5,3,6,20,34,Pass
Yash Chopra,19-05-2005,644586,Haryana,13,4,21,12,50,Pass
Aryan Mehta,03-08-2005,496053,Uttar Pradesh,9,10,23,4,46,Pass
Aarav Mehta,17-02-2006,729547,Tamil Nadu,12,18,23,18,71,Pass
Manpreet Chopra,22-04-2005,112273,Uttar Pradesh,20,3,11,24,58,Pass
Rohan Pillai,24-01-2006,101740,Maharashtra,2,22,11,5,40,Pass
Krishna Singh,17-02-2006,153160,Uttar Pradesh,1,22,21,14,58,Pass
Krishna Verma,24-10-2005,333848,Tamil Nadu,24,3,21,19,67,Pass
Balbir Fernandes,24-08-2005,708453,Andhra Pradesh,9,3,5,2,19,Pass
Krishna Khan,21-12-2005,302693,Tamil Nadu,3,9,18,12,42,Pass
Mathew Pillai,16-11-2004,326568,Assam,10,21,2,11,44,Pass
Yash Verma,17-10-2005,655249,Karnataka,21,24,15,13,73,Fail
Ishaan Verma,15-11-2005,306543,Punjab,23,14,6,21,64,Pass
Sukhwinder Fernandes,18-07-2005,253199,Jharkhand,7,8,15,8,38,Pass
John Sharma,19-11-2005,665248,Rajasthan,24,16,22,2,64,Pass
Gurpreet Verma,10-02-2005,437921,Punjab,22,8,19,19,68,Pass
Yash Pillai,04-01-2005,706143,Punjab,10,8,6,0,24,Pass
Aditya Reddy,03-03-2005,744362,Andhra Pradesh,0,1,9,22,32,Pass
Ishaan Mehta,15-12-2004,482662,Andhra Pradesh,9,9,10,20,48,Pass
Aarav Verma,26-02-2005,730643,Uttar Pradesh,1,9,10,13,33,Pass
Aarav D'Souza,13-11-2004,759908,Rajasthan,18,23,6,16,63,Pass
Raj Verma,08-01-2005,689319,Uttar Pradesh,12,14,17,3,46,Pass
David Sharma,12-09-2005,653760,Rajasthan,7,7,0,13,27,Pass
Aditya Reddy,01-01-2005,551631,Maharashtra,11,21,22,3,57,Pass
Raj Pillai,21-09-2005,142166,Tamil Nadu,3,22,4,1,30,Pass
Mathew Fernandes,23-07-2005,637414,Rajasthan,7,1,22,14,44,Pass
Balbir Sharma,25-02-2005,929022,Kerala,8,18,11,10,47,Fail
Peter D'Souza,08-04-2006,748878,Gujarat,22,1,4,2,29,Fail
Yash D'Souza,03-03-2006,333388,Punjab,18,0,8,19,45,Pass
Vivaan Reddy,04-10-2005,824113,Madhya Pradesh,21,5,6,23,55,Pass
Peter Chopra,04-02-2006,371924,Kerala,6,9,16,4,35,Fail
Harjeet Reddy,14-01-2005,572960,Odisha,5,12,0,9,26,Pass
Raj Pillai,17-07-2005,200926,Telangana,11,12,10,15,48,Pass
Manpreet Pillai,17-03-2005,137118,Uttar Pradesh,24,5,1,1,31,Pass
John Reddy,22-03-2005,982446,Madhya Pradesh,15,0,1,17,33,Pass
Ishaan Mehta,09-04-2005,945115,Chhattisgarh,22,8,6,8,44,Pass
Manpreet Sharma,22-07-2005,894546,Kerala,14,4,18,13,49,Fail
Rohan Mehta,10-12-2004,881451,Himachal Pradesh,5,9,8,14,36,Pass
Ishaan Reddy,28-04-2005,713352,Assam,11,20,16,0,47,Pass
Krishna Khan,11-04-2005,685256,Madhya Pradesh,17,0,19,0,36,Pass
Aryan Pillai,19-11-2005,457580,Manipur,1,13,0,23,37,Fail
Kunal Verma,21-12-2004,651501,West Bengal,18,17,3,2,40,Pass
Aarav Fernandes,02-02-2005,666543,Uttar Pradesh,21,13,22,9,65,Pass
Rohan Fernandes,12-03-2005,779314,Bihar,12,13,19,19,63,Pass
Aarav Pillai,06-11-2005,147426,Uttar Pradesh,11,20,10,20,61,Pass
Aryan Chopra,19-03-2005,722615,Punjab,9,10,10,1,30,Pass
Aarav Khan,01-05-2005,352611,West Bengal,3,7,4,1,15,Pass
Aryan D'Souza,23-10-2005,845354,Uttar Pradesh,17,3,19,23,62,Pass
Aryan Verma,30-09-2005,392953,Delhi,14,16,20,23,73,Pass
Balbir Reddy,23-09-2005,290649,Madhya Pradesh,17,3,13,14,47,Pass
Aryan Verma,05-03-2005,689548,Karnataka,13,21,1,0,35,Pass
Zaid Sharma,08-12-2005,328705,Rajasthan,23,6,24,14,67,Pass
Ayaan Chopra,25-02-2006,147454,West Bengal,3,24,11,21,59,Pass
Gurpreet Sharma,07-04-2005,623878,Uttar Pradesh,11,4,6,9,30,Pass
Vivaan Reddy,24-01-2005,374488,Assam,1,7,6,0,14,Pass
Imran Sharma,08-11-2004,709375,Haryana,4,10,13,21,48,Pass
Kunal Mehta,23-01-2005,432497,Tamil Nadu,3,24,23,22,72,Pass
Zaid Verma,07-08-2005,944598,Maharashtra,9,9,20,3,41,Pass
Rohan Mehta,30-04-2006,894958,Rajasthan,19,11,20,2,52,Pass
Harjeet Singh,15-01-2006,950920,Rajasthan,13,3,6,12,34,Pass
Gurpreet Khan,27-07-2005,578224,Rajasthan,21,18,7,0,46,Pass
Ishaan D'Souza,28-01-2006,853082,Bihar,10,16,10,15,51,Pass
Aarav Verma,12-11-2004,462015,Uttar Pradesh,2,2,15,12,31,Pass
Raj Mehta,30-04-2005,411603,Rajasthan,23,4,24,7,58,Pass
Yash Mehta,08-03-2005,284940,Kerala,7,17,16,5,45,Fail
Gurpreet Khan,12-05-2005,462547,Gujarat,3,10,4,19,36,Fail
Ishaan Fernandes,17-11-2004,227641,Bihar,22,5,24,9,60,Pass
Kunal Pillai,17-09-2005,163028,Maharashtra,1,11,10,20,42,Pass
Rohan D'Souza,10-03-2006,224869,Bihar,24,7,2,22,55,Pass
Aditya Reddy,19-01-2006,223492,Bihar,4,4,7,13,28,Pass
Raj Pillai,06-08-2005,426064,Andhra Pradesh,21,15,0,3,39,Pass
Harjeet Khan,17-10-2005,289080,Jharkhand,16,23,4,19,62,Pass
Krishna Verma,17-07-2005,249896,Rajasthan,15,21,9,7,52,Pass
Sukhwinder Reddy,03-12-2005,304345,Uttarakhand,9,13,3,23,48,Pass
Aryan Sharma,05-03-2006,370322,Uttar Pradesh,24,15,4,24,67,Pass
Rohan D'Souza,14-09-2005,380109,Rajasthan,8,21,12,19,60,Pass
Sukhwinder Khan,10-11-2005,728035,West Bengal,23,3,13,15,54,Pass
Sukhwinder Khan,08-07-2005,198660,West Bengal,1,7,1,7,16,Pass
Krishna Sharma,24-12-2005,442721,Gujarat,12,10,21,18,61,Fail
Raj Singh,22-04-2006,292811,Uttar Pradesh,12,4,9,3,28,Pass
Aditya Singh,21-02-2005,711213,Madhya Pradesh,13,12,22,5,52,Pass
Vivaan Fernandes,30-03-2006,553405,Gujarat,8,9,0,21,38,Fail
Krishna Chopra,27-05-2005,688849,West Bengal,0,12,7,14,33,Pass
Aditya Pillai,26-03-2005,124604,Rajasthan,12,19,14,0,45,Pass
Krishna Verma,12-02-2006,755971,Madhya Pradesh,12,17,3,13,45,Pass
Aryan Singh,12-12-2004,291581,Telangana,6,8,4,13,31,Pass
Vivaan Sharma,06-07-2005,834772,West Bengal,3,10,12,21,46,Pass
Zaid Fernandes,02-04-2005,483595,Uttar Pradesh,4,1,6,2,13,Pass
Ishaan Chopra,08-07-2005,465707,Punjab,12,1,14,11,38,Pass
Raj Pillai,01-07-2005,328406,Punjab,18,13,1,13,45,Pass
John D'Souza,15-10-2005,344339,Punjab,5,22,21,1,49,Pass
Aditya Reddy,02-12-2004,151571,Rajasthan,20,0,9,21,50,Pass
Raj Reddy,16-09-2005,758596,Telangana,8,20,17,6,51,Pass
Harjeet Pillai,21-04-2006,377080,Uttar Pradesh,14,8,15,17,54,Pass
Aditya Verma,05-06-2005,106146,Telangana,8,13,2,14,37,Pass
Aarav Verma,10-11-2005,421730,Assam,24,8,6,1,39,Pass
Raj Reddy,09-04-2005,971107,Maharashtra,14,4,3,3,24,Pass
Rohan Chopra,28-03-2005,899576,Odisha,9,14,21,7,51,Pass
Raj Singh,12-12-2005,334445,Haryana,5,6,15,18,44,Pass
Rohan D'Souza,10-09-2005,516972,Rajasthan,15,5,0,10,30,Pass
Aditya Reddy,14-09-2005,841074,Maharashtra,22,10,12,3,47,Pass
Aditya Sharma,12-10-2005,428956,Jharkhand,9,1,17,15,42,Pass
Yash Khan,23-01-2005,109927,West Bengal,3,23,5,24,55,Pass
Ishaan D'Souza,19-06-2005,198485,Jammu & Kashmir + Ladakh,8,22,8,19,57,Pass
Aryan Chopra,06-06-2005,473386,Bihar,2,20,3,18,43,Pass
Aditya D'Souza,17-01-2006,442912,Bihar,22,11,1,9,43,Pass
Sukhwinder Mehta,17-04-2005,119425,Himachal Pradesh,0,9,6,0,15,Pass
Rohan Khan,05-06-2005,349259,Bihar,12,7,3,21,43,Pass
Raj Chopra,17-01-2006,104419,Maharashtra,7,18,24,3,52,Pass
Aryan Mehta,19-09-2005,645283,Assam,17,4,13,8,42,Pass
Paul D'Souza,09-08-2005,743653,Bihar,2,0,12,15,29,Pass
Vivaan Mehta,18-07-2005,929139,Karnataka,1,12,24,23,60,Pass
Krishna D'Souza,27-12-2004,498763,Rajasthan,21,23,17,7,68,Pass
Aarav Mehta,14-03-2006,284991,Tamil Nadu,16,8,12,13,49,Pass
Peter Singh,04-12-2005,825430,Karnataka,16,12,1,7,36,Pass
Gurpreet Pillai,02-05-2005,527823,Telangana,11,6,9,23,49,Pass
Zaid Singh,28-09-2005,352746,Bihar,2,11,4,12,29,Pass
Gurpreet Singh,05-11-2005,737206,Madhya Pradesh,8,17,2,17,44,Pass
John Khan,01-01-2005,816983,Madhya Pradesh,1,13,9,10,33,Pass
Aditya Verma,13-12-2005,296366,Bihar,13,13,15,5,46,Pass
Aarav Singh,11-08-2005,738261,Haryana,3,1,23,16,43,Pass
Harjeet D'Souza,20-06-2005,966543,Bihar,11,1,18,4,34,Pass
Yash Verma,14-03-2006,544495,Uttar Pradesh,7,16,1,8,32,Pass
Paul Reddy,07-03-2005,928754,Odisha,1,18,12,19,50,Pass
Rohan Sharma,10-08-2005,818404,Rajasthan,21,18,23,10,72,Pass
Ishaan Khan,24-10-2005,230613,Rajasthan,4,7,13,4,28,Pass
Ishaan Pillai,15-10-2005,578823,Tamil Nadu,4,8,11,22,45,Pass
John Verma,09-01-2006,217848,Daman & Diu / D&N Haveli,8,15,14,10,47,Fail
Aarav Mehta,31-03-2005,442228,Maharashtra,15,3,18,3,39,Pass
Vivaan Khan,15-07-2005,965233,Bihar,21,1,10,2,34,Pass
Ishaan Sharma,26-02-2006,682866,Uttar Pradesh,23,0,23,0,46,Pass
David D'Souza,02-11-2005,359208,Andhra Pradesh,12,15,24,21,72,Pass
Raj Verma,08-11-2005,122118,Punjab,23,13,12,7,55,Pass
David Fernandes,18-02-2005,807398,Assam,8,4,15,24,51,Pass
Manpreet Pillai,21-03-2006,589362,Telangana,5,2,14,15,36,Pass
Ayaan Sharma,31-01-2005,679493,Madhya Pradesh,3,24,1,12,40,Pass
Sukhwinder Sharma,21-09-2005,465448,Uttar Pradesh,13,17,21,18,69,Pass
Aryan Chopra,21-05-2005,235951,Odisha,13,16,11,22,62,Pass
Raj D'Souza,26-07-2005,740998,Rajasthan,12,1,4,14,31,Pass
Krishna Fernandes,17-02-2006,973553,Arunachal Pradesh,8,8,19,14,49,Pass
Ishaan Chopra,19-01-2006,512888,Odisha,8,11,20,6,45,Pass
Aarav Chopra,16-04-2006,742484,Rajasthan,0,21,7,0,28,Pass
Balbir Sharma,29-12-2004,289502,Uttar Pradesh,13,4,20,20,57,Pass
Rehan Singh,11-07-2005,420928,Jharkhand,13,1,6,18,38,Pass
Raj Singh,06-12-2005,244255,Telangana,4,8,24,23,59,Pass
Vivaan Reddy,08-02-2006,576968,Bihar,19,5,19,18,61,Pass
John Pillai,13-08-2005,591299,Rajasthan,24,17,10,0,51,Pass
Balbir Mehta,27-12-2005,827905,Karnataka,8,0,14,1,23,Pass
Aditya Khan,24-01-2005,292827,Chhattisgarh,15,19,3,16,53,Pass
Raj Fernandes,22-08-2005,272688,Bihar,22,23,15,0,60,Pass
Gurpreet Fernandes,09-11-2004,842003,Uttar Pradesh,0,11,11,5,27,Pass
Aditya Pillai,15-02-2005,670520,Uttar Pradesh,24,3,12,22,61,Pass
Krishna Pillai,31-05-2005,595851,Tamil Nadu,13,9,23,12,57,Pass
Rohan Sharma,02-02-2005,802389,Delhi,23,8,15,15,61,Pass
Aditya D'Souza,06-02-2005,489902,Uttar Pradesh,17,0,9,22,48,Pass
Raj Chopra,04-04-2006,581272,Rajasthan,19,8,18,7,52,Pass
Ishaan Pillai,13-11-2004,375847,Haryana,18,1,14,11,44,Pass
Ishaan Chopra,12-03-2006,593898,Tamil Nadu,9,17,9,19,54,Pass
Aarav Sharma,28-01-2006,855669,Odisha,9,4,11,19,43,Pass
Harjeet Pillai,19-08-2005,786485,Tamil Nadu,16,19,2,4,41,Pass
Aryan D'Souza,22-07-2005,157442,Telangana,8,11,23,19,61,Pass
Kunal D'Souza,07-02-2006,813242,Bihar,13,0,19,10,42,Pass
Rohan Chopra,09-11-2005,659433,Maharashtra,1,21,14,8,44,Pass
Mathew Mehta,29-04-2005,799721,Delhi,6,5,10,10,31,Pass
Aarav D'Souza,12-04-2005,139537,Rajasthan,9,17,8,23,57,Pass
Raj Mehta,21-03-2006,782526,Bihar,15,18,15,22,70,Pass
Aryan Pillai,06-09-2005,246923,Rajasthan,10,16,9,6,41,Pass
Zaid Verma,29-04-2006,903843,Karnataka,15,20,5,0,40,Pass
Sukhwinder Verma,22-12-2004,843780,Himachal Pradesh,8,3,20,17,48,Pass
Aryan D'Souza,01-02-2006,400411,Chhattisgarh,10,18,5,7,40,Pass
Rohan D'Souza,08-06-2005,251921,West Bengal,23,4,4,1,32,Pass
Aditya Sharma,27-07-2005,611618,West Bengal,2,4,19,12,37,Pass
Vivaan D'Souza,03-03-2005,143685,Haryana,17,9,13,13,52,Pass
Zaid Fernandes,14-03-2006,963631,Chhattisgarh,1,17,19,11,48,Pass
Kunal Sharma,08-10-2005,263314,Bihar,5,15,10,1,31,Pass
Vivaan Singh,12-03-2005,640196,Jharkhand,6,21,16,23,66,Pass
Gurpreet Khan,04-05-2005,457172,West Bengal,13,18,6,9,46,Pass
Rohan Pillai,27-12-2004,925595,Rajasthan,18,20,2,22,62,Pass
Krishna Khan,02-02-2005,302446,Madhya Pradesh,23,7,3,11,44,Pass
Sukhwinder Mehta,07-03-2006,822456,Uttar Pradesh,21,11,19,7,58,Pass
Paul Reddy,05-01-2006,325532,Bihar,23,21,15,24,83,Pass
Paul D'Souza,25-05-2005,713702,Himachal Pradesh,8,7,4,19,38,Pass
Aditya Chopra,17-01-2005,836959,Gujarat,8,21,2,0,31,Fail
Aryan Pillai,23-09-2005,606112,Jharkhand,21,2,1,15,39,Pass
Raj Verma,16-11-2004,320716,Telangana,4,9,10,8,31,Pass
Ishaan Singh,16-06-2005,806083,Tripura,17,2,3,0,22,Pass
Rohan Fernandes,20-03-2005,930497,Telangana,14,5,7,9,35,Pass
Raj Pillai,20-03-2005,838171,Telangana,12,12,7,1,32,Pass
Ishaan Khan,27-09-2005,989788,Gujarat,1,18,5,21,45,Fail
Mathew Pillai,13-07-2005,302476,Madhya Pradesh,10,15,9,4,38,Pass
Krishna Mehta,16-12-2004,920131,Odisha,8,15,4,19,46,Pass
Aarav Pillai,24-09-2005,531233,Haryana,22,0,14,19,55,Pass
Yash Pillai,02-01-2005,967640,Chhattisgarh,17,15,5,24,61,Pass
Ishaan Sharma,29-03-2005,252683,Madhya Pradesh,22,19,3,10,54,Pass
Krishna Fernandes,11-12-2005,587347,Jharkhand,13,8,13,12,46,Pass
Zaid D'Souza,04-06-2005,970868,Madhya Pradesh,2,4,9,3,18,Pass
Raj Pillai,06-04-2006,644045,Maharashtra,15,10,11,11,47,Pass
John Pillai,31-01-2005,282718,Andhra Pradesh,3,15,15,19,52,Pass
Yash Fernandes,24-01-2006,113126,Gujarat,23,18,6,21,68,Fail
Peter Verma,24-10-2005,207507,Tamil Nadu,7,14,14,4,39,Pass
Mathew Fernandes,06-02-2006,635996,Maharashtra,11,10,0,10,31,Pass
Vivaan Khan,23-01-2006,247167,Maharashtra,3,21,22,3,49,Pass
Ishaan Reddy,15-06-2005,231207,West Bengal,3,19,21,7,50,Pass
Kunal Khan,04-09-2005,291364,Uttarakhand,24,19,3,14,60,Pass
Aditya Pillai,23-01-2005,350841,Himachal Pradesh,19,11,7,6,43,Pass
Manpreet Khan,05-01-2005,380020,Uttarakhand,2,11,20,5,38,Pass
Yash Singh,14-10-2005,650511,Gujarat,3,6,3,3,15,Fail
Vivaan Fernandes,08-06-2005,235638,Telangana,3,23,22,13,61,Pass
Harjeet Reddy,17-07-2005,955377,Tamil Nadu,14,10,5,14,43,Pass
Balbir D'Souza,01-01-2005,306400,Telangana,23,4,3,0,30,Pass
Aryan D'Souza,15-11-2004,699256,Punjab,15,24,20,3,62,Pass
Aarav Verma,06-07-2005,308787,Uttar Pradesh,19,22,6,0,47,Pass
Aditya D'Souza,06-05-2006,976467,Uttar Pradesh,6,0,1,22,29,Pass
Sukhwinder Khan,29-07-2005,409282,Andhra Pradesh,22,22,15,11,70,Pass
Paul Fernandes,01-03-2006,570517,Rajasthan,18,22,10,7,57,Pass
Aarav Fernandes,23-02-2006,665569,Bihar,17,6,16,12,51,Pass
Krishna Khan,13-04-2005,785819,Puducherry,24,5,11,13,53,Pass
Ishaan Sharma,24-01-2006,796180,Andhra Pradesh,11,13,12,19,55,Pass
Peter Khan,01-11-2005,901351,Gujarat,13,17,23,3,56,Fail
Kunal Pillai,01-08-2005,645080,Tamil Nadu,4,4,11,4,23,Pass
Vivaan Verma,18-04-2006,548645,Rajasthan,24,10,2,20,56,Pass
Aarav D'Souza,09-09-2005,325366,Punjab,4,4,21,12,41,Pass
Raj Sharma,04-01-2005,948446,Bihar,5,15,12,0,32,Pass
Raj Sharma,30-11-2005,260676,Telangana,2,19,21,3,45,Pass
Yash Mehta,24-08-2005,950576,Maharashtra,6,23,18,3,50,Pass
Peter Verma,07-03-2005,548520,Assam,17,19,16,17,69,Pass
Ishaan D'Souza,27-06-2005,760121,Jharkhand,10,4,8,24,46,Pass
Vivaan Verma,08-05-2005,603859,Gujarat,5,19,15,11,50,Fail
Peter Sharma,04-12-2004,424556,Odisha,19,20,24,13,76,Pass
Aarav Mehta,05-04-2006,781927,Punjab,2,11,1,2,16,Pass
Vivaan Verma,12-04-2005,988716,Maharashtra,11,16,14,3,44,Pass
John Mehta,12-04-2005,428839,Andhra Pradesh,15,14,5,18,52,Pass
Paul Reddy,29-03-2005,292661,Rajasthan,2,19,13,11,45,Pass
Rohan Verma,14-12-2004,951978,Haryana,14,20,0,6,40,Pass
Rohan Verma,20-11-2005,814144,Uttar Pradesh,24,5,7,12,48,Pass
Ishaan D'Souza,04-02-2006,401073,Madhya Pradesh,22,0,16,2,40,Pass
Aryan Khan,21-07-2005,332445,Jharkhand,13,5,16,15,49,Pass
Balbir Reddy,14-02-2006,220950,Kerala,21,21,18,8,68,Fail
Yash Khan,22-06-2005,182671,Kerala,13,21,12,6,52,Fail
Balbir Khan,12-03-2005,611796,Bihar,5,21,0,2,28,Pass
Aarav D'Souza,01-05-2005,235457,Maharashtra,1,24,24,3,52,Pass
Krishna Chopra,21-11-2004,109096,Bihar,17,8,2,12,39,Pass
Raj Mehta,12-01-2006,699281,Madhya Pradesh,22,13,3,6,44,Pass
Vivaan Mehta,26-02-2006,348464,Uttar Pradesh,12,3,4,19,38,Pass
Aarav Mehta,24-11-2005,931292,Haryana,11,17,24,9,61,Pass
Ishaan Verma,12-12-2005,104867,West Bengal,3,11,23,8,45,Pass
Aryan Reddy,05-04-2006,662960,Uttar Pradesh,0,10,4,18,32,Pass
Yash Sharma,04-02-2005,546614,Uttar Pradesh,19,21,12,14,66,Pass
Aryan D'Souza,03-02-2005,751439,Maharashtra,14,12,20,1,47,Pass
Manpreet Mehta,23-11-2005,687079,Madhya Pradesh,22,1,3,18,44,Pass
Zaid Khan,02-06-2005,806286,Assam,10,3,11,21,45,Pass
Aryan Khan,16-10-2005,508006,Telangana,18,11,11,13,53,Fail
Gurpreet Sharma,19-08-2005,499014,West Bengal,3,22,5,12,42,Pass
Zaid Singh,03-01-2006,327680,Tamil Nadu,9,18,21,24,72,Pass
Aarav Pillai,20-03-2006,184933,Bihar,8,5,5,23,41,Pass
David Singh,22-02-2006,486475,Maharashtra,24,5,9,3,41,Pass
Rohan D'Souza,06-03-2005,654760,West Bengal,3,21,21,8,53,Pass
Mathew Sharma,26-04-2005,132488,Bihar,22,5,24,7,58,Pass
Aryan Pillai,19-12-2004,164845,Tripura,5,0,1,14,20,Pass
Vivaan Reddy,20-12-2005,787745,Bihar,22,9,24,13,68,Pass
Aditya Verma,19-02-2005,777029,Telangana,7,8,10,16,41,Pass
Harjeet Fernandes,06-05-2005,773811,Punjab,14,2,15,18,49,Pass
Harjeet Verma,24-10-2005,878761,Rajasthan,12,3,22,0,37,Pass
Gurpreet Singh,19-11-2004,592511,Maharashtra,1,24,23,3,51,Pass
Vivaan Reddy,02-03-2006,522108,Tamil Nadu,9,14,5,5,33,Pass
Rohan Pillai,25-12-2004,519817,Haryana,13,16,8,13,50,Pass
Rohan Chopra,01-02-2005,260185,Madhya Pradesh,11,3,11,22,47,Pass
Kunal Pillai,12-04-2005,774006,Punjab,13,21,14,5,53,Pass
Vivaan Mehta,26-02-2005,445379,Bihar,3,9,24,23,59,Pass
Manpreet Fernandes,04-04-2006,419807,Maharashtra,22,6,20,3,51,Pass
John Mehta,13-11-2005,249070,Uttar Pradesh,8,6,24,6,44,Pass
Aarav Sharma,14-11-2005,448287,Madhya Pradesh,4,3,15,6,28,Pass
Vivaan Mehta,09-08-2005,931141,Telangana,23,19,10,4,56,Pass
Balbir Sharma,13-02-2006,841473,Madhya Pradesh,20,7,3,24,54,Pass
Mathew Reddy,03-10-2005,793118,Nagaland,18,16,21,13,68,Fail
Yash Singh,13-12-2004,697297,Rajasthan,13,11,2,22,48,Pass
Yash Singh,21-03-2006,866733,Bihar,23,7,0,16,46,Pass
Vivaan Fernandes,25-10-2005,725103,Uttar Pradesh,11,13,14,13,51,Pass
Rohan Reddy,04-08-2005,167807,Rajasthan,14,17,14,8,53,Pass
Ishaan Pillai,09-05-2005,469728,Bihar,2,2,19,5,28,Pass
Aryan Singh,08-02-2005,182992,Haryana,14,12,1,4,31,Pass
John Pillai,09-01-2005,793310,Rajasthan,7,2,13,7,29,Pass
Aryan Chopra,29-07-2005,202516,Punjab,19,2,5,9,35,Pass
Vivaan Khan,20-08-2005,173490,Andhra Pradesh,13,19,12,21,65,Pass
Mathew Mehta,24-08-2005,219462,Uttar Pradesh,15,4,12,20,51,Pass
Vivaan Chopra,16-12-2004,625039,Bihar,15,3,24,2,44,Pass
Aditya Khan,28-01-2005,889248,Karnataka,13,6,21,20,60,Pass
David D'Souza,07-10-2005,305490,Rajasthan,0,13,22,7,42,Pass
Krishna Fernandes,03-12-2005,788614,Bihar,18,1,23,3,45,Pass
Rohan D'Souza,15-02-2006,131235,Maharashtra,24,18,12,3,57,Pass
Krishna Singh,10-08-2005,605876,Rajasthan,13,9,11,20,53,Pass
Kunal Khan,23-01-2005,610248,Haryana,8,24,6,11,49,Pass
Zaid Khan,11-03-2006,860174,Telangana,1,6,10,16,33,Pass
Ishaan Pillai,09-03-2006,147699,Manipur,16,3,16,23,58,Fail
Krishna Chopra,07-11-2005,952547,Maharashtra,12,19,5,2,38,Pass
Yash Pillai,01-12-2004,731236,Madhya Pradesh,10,13,7,7,37,Pass
Yash D'Souza,30-03-2006,689955,Madhya Pradesh,20,16,15,2,53,Pass
Gurpreet Sharma,17-11-2005,128033,Maharashtra,23,13,6,0,42,Pass
Aarav Verma,09-06-2005,645434,Manipur,14,5,17,6,42,Fail
Aditya Verma,26-11-2005,767856,Telangana,8,1,0,15,24,Pass
Aditya Sharma,23-01-2006,249039,Punjab,0,18,7,8,33,Pass
Ishaan Reddy,16-11-2004,558717,Haryana,17,19,17,19,72,Pass
Aryan Verma,10-12-2004,436860,Haryana,9,5,1,1,16,Pass
Aditya Sharma,30-06-2005,300743,Rajasthan,9,8,24,4,45,Pass
Krishna Verma,04-01-2005,606257,West Bengal,3,23,7,6,39,Pass
Ayaan Mehta,20-11-2005,708361,Tripura,14,17,14,0,45,Pass
Aryan Fernandes,17-01-2005,351426,Andhra Pradesh,1,5,23,2,31,Pass
Kunal D'Souza,11-02-2005,819660,Telangana,14,7,19,4,44,Pass
Balbir Chopra,11-07-2005,299153,Daman & Diu / D&N Haveli,2,1,22,3,28,Fail
Kunal Verma,02-10-2005,908188,Bihar,24,21,6,16,67,Pass
Rohan Singh,23-03-2005,389601,Madhya Pradesh,14,4,17,9,44,Pass
Imran Chopra,24-08-2005,387399,Uttar Pradesh,15,23,1,13,52,Pass
Sukhwinder Khan,12-09-2005,378165,Uttar Pradesh,13,6,12,24,55,Pass
Vivaan Singh,03-10-2005,189395,Uttar Pradesh,3,18,5,8,34,Pass
Yash Singh,01-09-2005,756286,Bihar,4,24,4,4,36,Pass
Yash Mehta,04-10-2005,170012,Rajasthan,18,11,13,17,59,Pass
Zaid Singh,02-06-2005,759794,Andhra Pradesh,2,9,21,24,56,Pass
Vivaan Khan,26-06-2005,111624,Maharashtra,8,15,8,0,31,Pass
Kunal Reddy,07-02-2005,793562,Madhya Pradesh,19,22,3,10,54,Pass
Raj Pillai,15-02-2005,527174,Uttar Pradesh,16,6,19,11,52,Pass
Aryan Sharma,14-01-2006,910476,Rajasthan,14,7,15,9,45,Pass
Rohan Khan,25-01-2006,995416,Rajasthan,2,19,1,8,30,Pass
Peter Reddy,14-04-2006,346472,Maharashtra,4,13,18,4,39,Pass
Paul D'Souza,15-02-2006,420195,Tamil Nadu,5,17,9,24,55,Pass
Ishaan Fernandes,22-02-2006,935176,Bihar,7,7,11,24,49,Pass
Harjeet Reddy,06-07-2005,910170,Odisha,8,24,1,9,42,Pass
Zaid Singh,07-03-2005,371408,Madhya Pradesh,16,7,12,17,52,Pass
Ishaan Pillai,06-12-2004,849211,Bihar,6,18,0,20,44,Pass
Vivaan D'Souza,27-07-2005,950298,Maharashtra,20,3,14,0,37,Pass
Raj Pillai,28-11-2004,922899,Kerala,16,9,17,6,48,Fail
Harjeet Mehta,15-11-2004,247246,Uttar Pradesh,7,7,21,16,51,Pass
David Khan,30-07-2005,821144,Andhra Pradesh,0,1,17,11,29,Pass
Kunal Verma,16-06-2005,867190,Rajasthan,24,10,0,15,49,Pass
Ishaan Fernandes,09-08-2005,412543,Maharashtra,12,23,8,3,46,Pass
Yash Mehta,25-12-2005,455312,Tamil Nadu,7,1,1,24,33,Pass
Krishna Verma,31-05-2005,516477,Uttar Pradesh,11,22,12,15,60,Pass
Aarav Verma,19-06-2005,997935,Punjab,8,13,22,3,46,Pass
Zaid Sharma,19-02-2005,787457,Bihar,12,21,5,2,40,Pass
Gurpreet Khan,05-09-2005,409467,Telangana,15,3,5,3,26,Pass
Aarav D'Souza,21-09-2005,592153,Bihar,20,2,14,0,36,Pass
Krishna Mehta,10-04-2005,723737,Rajasthan,17,12,14,19,62,Pass
Kunal Chopra,27-02-2006,265444,Bihar,11,3,10,7,31,Pass
Manpreet Sharma,30-12-2005,403418,Bihar,16,24,3,15,58,Pass
Vivaan Fernandes,31-08-2005,294684,Madhya Pradesh,18,24,3,8,53,Pass
Raj D'Souza,12-06-2005,293379,Andhra Pradesh,21,6,13,3,43,Pass
Rohan Khan,17-07-2005,169519,Bihar,14,22,20,19,75,Pass
Aditya Pillai,26-03-2006,257187,Rajasthan,16,23,7,14,60,Pass
Zaid Mehta,08-12-2004,197458,Telangana,16,9,17,13,55,Fail
Yash Sharma,05-09-2005,994919,Uttar Pradesh,2,2,16,5,25,Pass
Krishna Reddy,06-12-2005,512393,Jharkhand,3,20,20,10,53,Pass
Krishna D'Souza,09-07-2005,482396,Haryana,8,18,9,5,40,Pass
Krishna Mehta,06-12-2004,970049,Uttar Pradesh,23,17,16,1,57,Pass
Rohan Mehta,02-06-2005,266831,Jharkhand,4,14,14,1,33,Pass
Aarav Reddy,06-01-2005,654057,Rajasthan,14,20,23,9,66,Pass
Raj Sharma,01-12-2005,692189,Karnataka,3,22,18,1,44,Pass
Rohan Verma,22-02-2005,670077,Haryana,10,0,4,14,28,Pass
Aryan D'Souza,16-02-2006,548785,Tamil Nadu,9,24,8,16,57,Pass
Peter Khan,22-11-2005,642162,Maharashtra,6,3,10,8,27,Pass
Rohan Singh,06-02-2005,484207,Odisha,2,22,7,11,42,Pass
Ayaan Mehta,04-01-2005,341433,Rajasthan,14,9,12,15,50,Pass
Rohan Verma,04-02-2006,695227,Tamil Nadu,15,18,2,6,41,Pass
Balbir Verma,21-11-2004,209496,West Bengal,3,12,14,16,45,Pass
Yash D'Souza,25-07-2005,188344,Tamil Nadu,10,19,6,9,44,Pass
Peter Khan,28-01-2006,811716,Uttar Pradesh,21,3,24,20,68,Pass
Ishaan D'Souza,02-02-2005,899430,Bihar,6,22,8,16,52,Pass
Raj Khan,16-04-2005,207374,Bihar,16,6,14,24,60,Pass
Yash Pillai,07-02-2005,797050,Bihar,3,12,0,1,16,Pass
Yash Chopra,07-02-2006,910347,Rajasthan,20,12,6,7,45,Pass
Ayaan D'Souza,25-06-2005,435494,West Bengal,12,11,13,9,45,Pass
Aarav Chopra,16-09-2005,895454,Delhi,10,6,0,13,29,Pass
Aryan Fernandes,04-09-2005,887029,Karnataka,3,6,13,8,30,Pass
Aditya Pillai,15-02-2006,503667,Bihar,12,11,16,23,62,Pass
Vivaan Mehta,07-07-2005,175774,Maharashtra,13,3,2,11,29,Pass
Aditya Reddy,11-03-2006,786478,Jharkhand,8,11,2,7,28,Pass
Kunal Chopra,14-12-2004,364441,Rajasthan,0,5,23,17,45,Pass
Aditya D'Souza,17-07-2005,495001,Tamil Nadu,24,3,17,3,47,Pass
Raj Fernandes,03-07-2005,492603,Uttar Pradesh,23,3,19,19,64,Pass
Aryan Fernandes,27-08-2005,134550,Assam,18,7,18,9,52,Pass
Yash Chopra,20-09-2005,963717,Karnataka,5,24,1,7,37,Pass
Rohan Fernandes,08-11-2004,560854,Punjab,21,2,21,16,60,Pass
Aryan Pillai,08-08-2005,936496,Tamil Nadu,23,5,11,2,41,Pass
Yash Verma,25-09-2005,149601,Bihar,14,11,3,8,36,Pass
Aditya Singh,22-03-2006,589416,Delhi,11,18,21,8,58,Pass
Paul Mehta,09-02-2006,659670,Uttar Pradesh,22,15,6,10,53,Pass
Yash Reddy,26-03-2006,424276,Andhra Pradesh,19,8,17,4,48,Pass
Mathew Reddy,27-06-2005,632890,Odisha,11,0,19,20,50,Pass
Manpreet Reddy,08-12-2004,498731,Gujarat,15,22,17,13,67,Fail
Aarav Singh,25-03-2006,110824,Punjab,24,20,6,6,56,Pass
Aditya Khan,12-12-2004,457168,Rajasthan,9,24,4,18,55,Pass
Rohan Pillai,07-03-2006,666933,West Bengal,4,19,8,17,48,Pass
Kunal Sharma,09-05-2005,708643,Bihar,12,16,0,12,40,Pass
Vivaan D'Souza,01-07-2005,597808,Jharkhand,3,16,12,0,31,Pass
Aryan Chopra,20-12-2005,168411,Jharkhand,16,22,1,13,52,Pass
Raj Pillai,14-06-2005,640002,Uttarakhand,24,18,3,14,59,Pass
Vivaan Sharma,02-02-2006,350278,Maharashtra,24,2,17,3,46,Pass
Aarav Reddy,03-12-2005,620979,Maharashtra,11,12,14,3,40,Pass
Mathew D'Souza,20-10-2005,641992,Punjab,18,6,21,9,54,Pass
Zaid Sharma,11-01-2006,158349,Bihar,13,17,15,6,51,Pass
Krishna Verma,11-09-2005,292538,Uttar Pradesh,11,23,18,8,60,Pass
Kunal Mehta,03-05-2005,210615,Rajasthan,21,14,18,17,70,Pass
David Verma,17-12-2005,972121,Assam,14,17,2,20,53,Pass
Kunal Mehta,12-05-2005,248268,Madhya Pradesh,4,19,21,11,55,Pass
Aditya Singh,23-02-2006,430953,Delhi,14,10,19,22,65,Pass
Raj Fernandes,07-07-2005,843539,Uttar Pradesh,17,22,5,22,66,Pass
Manpreet Mehta,01-02-2005,167700,Haryana,7,5,7,12,31,Pass
Kunal Fernandes,13-03-2006,509811,Rajasthan,14,11,4,1,30,Pass
Aditya Mehta,31-05-2005,754922,Bihar,17,19,24,22,82,Pass
Rohan Mehta,07-11-2005,518336,Uttar Pradesh,8,22,1,0,31,Pass
Harjeet Fernandes,17-02-2006,725954,Rajasthan,16,6,21,5,48,Pass
Aarav Sharma,17-09-2005,306028,Arunachal Pradesh,6,6,10,22,44,Fail
Raj Chopra,16-06-2005,300846,Nagaland,21,13,24,13,71,Fail
Rohan Verma,19-12-2005,709122,Gujarat,6,9,5,5,25,Fail
Krishna Mehta,13-08-2005,926166,Chhattisgarh,16,3,14,19,52,Pass
Rohan D'Souza,13-06-2005,181612,Odisha,22,6,5,6,39,Pass
Aditya Sharma,30-01-2006,916557,Haryana,18,19,18,11,66,Pass
Rohan Verma,23-12-2005,994157,Tamil Nadu,5,10,7,11,33,Pass
Vivaan Chopra,11-10-2005,201120,Rajasthan,4,5,21,21,51,Pass
Ishaan Sharma,05-04-2005,355683,Andhra Pradesh,10,1,9,19,39,Pass
Krishna Reddy,19-08-2005,908708,Uttar Pradesh,9,14,8,21,52,Pass
Kunal Pillai,27-12-2004,396716,Haryana,17,4,5,12,38,Pass
Krishna Khan,07-04-2005,230515,Manipur,1,21,0,0,22,Fail
Harjeet Khan,10-07-2005,471657,Odisha,7,22,6,24,59,Pass
Raj Chopra,16-07-2005,608400,Rajasthan,14,15,17,23,69,Pass
John Chopra,25-02-2005,269805,Chhattisgarh,4,10,6,21,41,Pass
Rohan Fernandes,29-01-2006,675395,Gujarat,13,16,11,5,45,Fail
Yash D'Souza,11-12-2004,871230,Andhra Pradesh,7,1,21,6,35,Pass
Zaid Sharma,13-06-2005,718768,Punjab,2,21,13,15,51,Pass
Aryan Reddy,16-01-2006,690362,Maharashtra,7,3,16,8,34,Pass
Peter Fernandes,14-01-2006,995887,Uttar Pradesh,21,2,20,19,62,Pass
Aryan Mehta,25-11-2005,870198,Jharkhand,6,22,19,1,48,Pass
Ishaan D'Souza,22-03-2005,671675,West Bengal,17,9,13,5,44,Pass
Vivaan Pillai,17-10-2005,644625,Andhra Pradesh,4,21,3,12,40,Pass
Krishna Reddy,14-07-2005,996488,Karnataka,11,7,20,24,62,Pass
Sukhwinder Chopra,15-07-2005,573702,Rajasthan,4,16,7,24,51,Pass
Paul D'Souza,22-11-2005,331305,Haryana,20,2,2,5,29,Pass
Ishaan Mehta,22-09-2005,574158,Gujarat,7,11,22,6,46,Fail
Krishna Mehta,20-05-2005,634179,Himachal Pradesh,22,3,15,6,46,Pass
Aryan Mehta,22-05-2005,197699,Meghalaya,6,7,15,5,33,Pass
Krishna Mehta,11-01-2005,519206,Haryana,14,1,11,14,40,Pass
Ishaan Sharma,16-04-2005,579062,Maharashtra,5,16,9,2,32,Pass
Aarav D'Souza,26-11-2004,774512,Odisha,23,14,22,21,80,Pass
Paul Singh,09-06-2005,668484,Assam,23,1,10,20,54,Pass
Aryan Chopra,08-01-2005,487165,West Bengal,12,13,17,5,47,Pass
Aditya Khan,03-02-2006,321850,Maharashtra,14,24,20,3,61,Pass
Imran Mehta,02-02-2006,632994,Rajasthan,4,1,6,20,31,Pass
Vivaan Mehta,30-12-2005,999810,Maharashtra,24,6,20,3,53,Pass
Ishaan Verma,08-04-2006,672392,West Bengal,6,23,13,11,53,Pass
Ishaan Chopra,08-02-2006,405474,Maharashtra,8,4,3,17,32,Pass
Krishna Fernandes,20-04-2006,183094,Bihar,13,15,5,19,52,Pass
Paul Reddy,03-04-2005,229790,Punjab,24,4,21,22,71,Pass
Balbir Chopra,01-03-2006,333432,Gujarat,18,10,5,5,38,Fail
Ishaan Chopra,24-10-2005,866180,Bihar,13,17,15,6,51,Pass
Vivaan Mehta,31-03-2006,628908,Rajasthan,18,9,9,4,40,Pass
Paul Mehta,18-12-2005,827908,Tamil Nadu,2,5,20,16,43,Pass
Ishaan Fernandes,04-02-2005,681644,Telangana,0,18,8,1,27,Pass
David Chopra,07-07-2005,757509,Uttar Pradesh,0,3,3,11,17,Pass
Krishna Mehta,25-01-2006,632478,Tamil Nadu,15,13,10,7,45,Fail
Rohan Khan,30-04-2005,762111,Andhra Pradesh,0,13,15,6,34,Pass
Yash Verma,13-10-2005,952495,Bihar,4,23,15,11,53,Pass
Sukhwinder Verma,20-11-2005,966718,Andhra Pradesh,14,15,2,13,44,Pass
Balbir Chopra,15-01-2005,135313,West Bengal,9,1,10,3,23,Pass
Kunal Fernandes,30-03-2006,878766,Jharkhand,12,23,20,24,79,Fail
Sukhwinder Chopra,11-04-2006,452362,Maharashtra,0,3,12,18,33,Pass
Aarav Chopra,20-08-2005,854950,Uttar Pradesh,8,24,15,12,59,Pass
Raj D'Souza,01-03-2006,522963,Jharkhand,0,10,23,23,56,Pass
Vivaan Reddy,23-10-2005,745065,Madhya Pradesh,23,14,3,11,51,Pass
Raj Reddy,09-04-2005,526360,Maharashtra,21,5,15,3,44,Pass
Aarav Singh,26-04-2006,770536,West Bengal,4,3,6,8,21,Pass
Yash Verma,14-02-2005,611596,West Bengal,3,20,9,9,41,Pass
Kunal Singh,01-05-2006,486997,Tamil Nadu,10,5,22,2,39,Pass
Balbir Sharma,26-01-2005,987343,Maharashtra,9,11,2,0,22,Pass
Kunal Sharma,14-10-2005,379505,Madhya Pradesh,18,15,0,3,36,Pass
Aryan Khan,06-08-2005,364209,Rajasthan,10,21,6,2,39,Pass
Aditya Fernandes,12-05-2005,619212,Jammu & Kashmir + Ladakh,17,0,11,21,49,Pass
Mathew Fernandes,25-03-2006,468032,Bihar,20,4,6,14,44,Pass
Aryan Singh,01-03-2005,896101,Tamil Nadu,15,1,23,2,41,Pass
Yash Reddy,05-11-2005,845087,Andhra Pradesh,3,10,16,19,48,Pass
Aryan Chopra,13-02-2005,614725,Jharkhand,13,0,22,23,58,Pass
Raj Fernandes,29-01-2005,133818,Madhya Pradesh,16,3,22,6,47,Pass
Manpreet Pillai,24-12-2005,639482,Rajasthan,14,3,0,9,26,Pass
Yash Khan,05-04-2005,749082,Kerala,2,15,4,18,39,Fail
Ishaan Khan,23-05-2005,545625,Bihar,8,16,4,0,28,Pass
Aditya Chopra,13-06-2005,253185,West Bengal,3,15,21,0,39,Pass
Manpreet Chopra,17-01-2005,471314,Karnataka,9,8,1,8,26,Pass
Yash Verma,08-04-2006,314922,Assam,8,7,23,15,53,Pass
Zaid Sharma,30-11-2005,888372,Bihar,17,23,13,17,70,Pass
Peter D'Souza,10-04-2005,312574,Bihar,13,2,23,16,54,Pass
Kunal Mehta,19-03-2005,132227,Uttar Pradesh,15,14,0,1,30,Pass
Ishaan Khan,01-01-2005,866467,Uttar Pradesh,16,21,1,20,58,Pass
Vivaan Mehta,31-05-2005,892401,Bihar,21,21,19,12,73,Pass
Raj D'Souza,09-06-2005,348819,Telangana,20,12,2,17,51,Pass
Paul Singh,23-06-2005,427254,Telangana,3,12,10,0,25,Pass
Balbir Mehta,10-09-2005,455171,Rajasthan,17,14,16,19,66,Pass
Krishna Verma,23-04-2006,928036,Odisha,5,23,8,9,45,Pass
Kunal Singh,07-10-2005,840032,Haryana,3,1,21,1,26,Pass
Sukhwinder Singh,25-08-2005,400040,Kerala,8,14,15,0,37,Fail
Krishna Fernandes,13-04-2006,329155,Uttar Pradesh,18,6,18,22,64,Pass
Aarav Pillai,18-12-2004,978080,Andhra Pradesh,11,18,16,20,65,Pass
Yash Sharma,09-09-2005,555491,Karnataka,1,11,16,4,32,Pass
Farhan Verma,10-09-2005,923523,Sikkim,5,19,4,3,31,Pass
Krishna Reddy,08-11-2004,840530,Rajasthan,21,11,13,1,46,Pass
Farhan Fernandes,23-11-2004,613715,Andhra Pradesh,14,0,24,3,41,Pass
Kunal Mehta,23-11-2004,911766,Jharkhand,13,2,8,21,44,Pass
Krishna Pillai,28-02-2005,919086,Jammu & Kashmir + Ladakh,17,16,16,21,70,Fail
Mathew Chopra,13-11-2005,871270,Uttar Pradesh,13,20,15,0,48,Pass
Rohan D'Souza,10-03-2006,959863,Madhya Pradesh,18,23,3,13,57,Pass
Raj Fernandes,09-05-2006,156646,Haryana,10,15,1,9,35,Pass
Vivaan Reddy,14-08-2005,583377,Maharashtra,8,4,12,13,37,Pass
Ishaan Mehta,11-04-2005,677617,Andhra Pradesh,20,22,10,12,64,Pass
Raj Pillai,19-01-2005,590336,Uttar Pradesh,17,2,24,13,56,Pass
Raj Singh,28-01-2005,163707,Rajasthan,14,12,9,3,38,Pass
Yash Mehta,25-08-2005,288373,Haryana,3,11,1,23,38,Pass
Yash Sharma,18-08-2005,304774,Chhattisgarh,17,14,3,5,39,Pass
Ishaan Pillai,02-01-2005,171983,Tripura,22,7,7,20,56,Pass
Ayaan D'Souza,03-11-2005,475659,Assam,3,0,21,16,40,Pass
Aditya Mehta,12-12-2004,968124,West Bengal,9,15,8,1,33,Pass
Aditya Singh,12-12-2004,189604,Arunachal Pradesh,5,11,15,17,48,Fail
Zaid Sharma,19-01-2006,313747,Odisha,12,14,17,14,57,Pass
Raj Verma,03-03-2005,298547,Punjab,14,10,0,1,25,Pass
Aryan Reddy,28-04-2006,805654,Arunachal Pradesh,0,23,6,8,37,Fail
Ishaan Reddy,18-03-2006,115517,Manipur,14,3,19,2,38,Fail
Vivaan Pillai,09-01-2006,108810,Haryana,5,0,19,17,41,Pass
Aryan Chopra,30-03-2006,802101,Rajasthan,2,8,6,8,24,Pass
Manpreet Singh,04-09-2005,527568,Madhya Pradesh,21,19,3,22,65,Pass
Raj Pillai,12-12-2005,155919,West Bengal,14,3,16,18,51,Pass
Ishaan Singh,22-04-2006,375016,Uttar Pradesh,16,18,9,24,67,Pass
Aarav Reddy,07-03-2006,760189,Madhya Pradesh,22,20,3,13,58,Pass
Rohan Reddy,09-01-2005,296056,Karnataka,17,20,2,18,57,Pass
Harjeet Chopra,31-12-2004,676175,Karnataka,15,20,4,19,58,Pass
Kunal Sharma,16-08-2005,383633,Delhi,23,6,12,14,55,Pass
Sukhwinder Chopra,03-02-2006,375881,Bihar,16,0,10,17,43,Pass
Aryan Chopra,02-09-2005,812154,Rajasthan,20,19,12,14,65,Pass
Aryan Reddy,05-04-2005,365986,Madhya Pradesh,5,10,22,1,38,Pass
Vivaan Fernandes,21-02-2006,510566,Maharashtra,8,18,0,23,49,Pass
Balbir Chopra,10-12-2004,625181,Bihar,23,20,2,22,67,Pass
Kunal Khan,17-11-2004,550417,Rajasthan,14,1,7,12,34,Pass
Aarav Khan,20-12-2005,482613,Andhra Pradesh,4,19,0,13,36,Pass
Paul Pillai,07-06-2005,125848,Haryana,16,14,13,16,59,Pass
Peter Khan,04-02-2005,779470,Jharkhand,22,5,7,19,53,Pass
Sukhwinder Sharma,23-01-2006,506241,West Bengal,3,20,13,13,49,Pass
Ishaan Verma,27-01-2005,114917,Haryana,18,12,15,6,51,Pass
Kunal Sharma,17-10-2005,885712,Uttar Pradesh,8,6,12,7,33,Pass
Rohan Verma,17-02-2006,784506,Kerala,4,1,21,20,46,Fail
Kunal Reddy,09-11-2004,151675,Bihar,16,9,9,20,54,Pass
Aarav Mehta,07-05-2005,832502,Madhya Pradesh,15,17,3,18,53,Pass
Aryan Fernandes,26-01-2005,955485,Bihar,6,0,12,3,21,Pass
Kunal Fernandes,02-07-2005,256351,Bihar,20,15,22,13,70,Pass
David Mehta,08-06-2005,553758,Karnataka,21,22,8,16,67,Pass
Rehan Mehta,24-10-2005,421565,Tamil Nadu,13,20,24,4,61,Pass
Aditya D'Souza,09-01-2005,661637,Karnataka,22,18,3,19,62,Pass
Gurpreet Pillai,23-05-2005,117636,Madhya Pradesh,9,4,5,24,42,Pass
Kunal Pillai,15-12-2005,644886,Kerala,4,8,3,24,39,Fail
Yash Fernandes,21-11-2004,374885,Himachal Pradesh,5,18,3,24,50,Pass
Yash Chopra,17-02-2006,901566,West Bengal,2,3,7,7,19,Pass
Ishaan Khan,30-08-2005,309800,West Bengal,22,2,8,11,43,Pass
Raj Fernandes,11-06-2005,947236,Uttar Pradesh,7,1,10,24,42,Pass
Kunal Sharma,13-11-2005,872317,West Bengal,5,15,16,13,49,Pass
Krishna Pillai,26-02-2005,822701,Bihar,3,0,5,2,10,Pass
Harjeet Mehta,20-01-2006,885548,Karnataka,13,20,18,14,65,Pass
Rehan D'Souza,12-06-2005,367417,Jammu & Kashmir + Ladakh,10,5,16,7,38,Pass
Aditya Khan,10-11-2005,443089,Bihar,23,12,3,17,55,Pass
Raj Verma,11-01-2005,889642,Tamil Nadu,21,2,3,12,38,Pass
Aryan Reddy,29-03-2006,449420,Telangana,20,18,19,3,60,Pass
Kunal Chopra,28-04-2006,235492,Punjab,5,13,19,21,58,Pass
Krishna Mehta,21-12-2004,277883,Assam,5,18,19,12,54,Pass
Ishaan Pillai,14-11-2005,694281,Assam,10,5,9,7,31,Pass
Aarav Mehta,16-01-2006,501840,Karnataka,19,23,20,4,66,Pass
Raj Reddy,28-02-2006,522013,Rajasthan,17,0,14,10,41,Pass
Rohan Chopra,05-03-2005,247876,Assam,2,17,4,5,28,Pass
Aarav Sharma,14-07-2005,395135,Rajasthan,4,3,19,11,37,Pass
Aryan Pillai,18-05-2005,777975,Bihar,16,24,7,7,54,Pass
Yash Pillai,11-10-2005,651204,Andhra Pradesh,24,13,11,3,51,Pass
Balbir Fernandes,26-01-2005,816055,Kerala,21,3,24,13,61,Fail
Raj Mehta,26-08-2005,136599,Jharkhand,7,2,2,9,20,Pass
Rohan Mehta,06-10-2005,514868,Tamil Nadu,21,1,3,3,28,Pass
Raj D'Souza,28-09-2005,422689,Bihar,15,24,12,14,65,Pass
Rehan D'Souza,28-08-2005,432676,Jharkhand,17,17,9,3,46,Pass
Aryan Reddy,13-06-2005,555501,Punjab,13,21,0,16,50,Pass
Kunal Chopra,11-11-2004,303513,Assam,4,2,9,2,17,Pass
Vivaan Khan,31-12-2004,918492,Rajasthan,8,7,1,24,40,Pass
Gurpreet Reddy,13-04-2006,850267,Maharashtra,6,7,15,3,31,Pass
Harjeet Verma,12-04-2006,746914,Madhya Pradesh,20,4,15,12,51,Pass
Manpreet D'Souza,31-01-2006,143935,West Bengal,3,9,11,21,44,Pass
Aarav Pillai,01-12-2004,884399,West Bengal,22,4,24,2,52,Pass
Harjeet Khan,12-11-2005,637008,Chhattisgarh,19,0,9,8,36,Pass
Vivaan Mehta,28-06-2005,480177,Bihar,0,5,24,20,49,Pass
Aarav Pillai,28-01-2005,216661,Bihar,11,9,0,16,36,Pass
Raj Chopra,16-11-2005,837097,Uttar Pradesh,3,22,8,23,56,Pass
Krishna Chopra,18-04-2006,811370,Andhra Pradesh,11,1,2,21,35,Pass
Harjeet Mehta,06-12-2005,902737,Bihar,11,22,22,5,60,Pass
Aarav Singh,27-08-2005,224041,Punjab,17,18,21,18,74,Pass
Aryan Singh,18-02-2006,465795,Rajasthan,5,20,10,12,47,Pass
Kunal Chopra,29-10-2005,981250,Delhi,3,17,14,6,40,Pass
Krishna Pillai,07-04-2005,504104,Uttar Pradesh,22,3,15,15,55,Pass
Aryan D'Souza,13-01-2005,260571,West Bengal,21,1,20,9,51,Pass
Yash Sharma,25-01-2006,366220,Haryana,21,9,11,23,64,Pass
Imran Khan,27-12-2004,784443,Uttar Pradesh,22,7,24,1,54,Pass
Vivaan Reddy,30-03-2006,484316,Madhya Pradesh,11,4,16,17,48,Pass
Raj Chopra,08-06-2005,753635,Delhi,8,13,13,23,57,Pass
Aditya Sharma,30-05-2005,388313,Rajasthan,17,1,12,2,32,Pass
Yash D'Souza,16-11-2004,260236,Jharkhand,11,20,13,9,53,Pass
Rohan Sharma,13-03-2006,235548,Uttar Pradesh,7,19,23,16,65,Pass
John Pillai,02-05-2005,471994,Uttar Pradesh,7,0,10,23,40,Pass
Ishaan Singh,27-02-2005,427187,Jammu & Kashmir + Ladakh,22,12,1,19,54,Pass
Aryan Reddy,15-07-2005,608494,Maharashtra,24,20,19,3,66,Pass
Mathew D'Souza,03-03-2006,463252,Karnataka,10,13,9,3,35,Pass
Raj Sharma,15-11-2004,548283,Chhattisgarh,8,9,7,2,26,Pass
Kunal D'Souza,10-06-2005,172958,Telangana,9,23,12,5,49,Pass
Sukhwinder Mehta,17-09-2005,777349,Punjab,22,12,20,1,55,Pass
Ishaan D'Souza,26-11-2005,571295,Tamil Nadu,24,2,3,6,35,Pass
Sukhwinder Singh,13-03-2005,875336,West Bengal,7,20,4,7,38,Pass
Aarav Reddy,25-08-2005,907535,Maharashtra,14,4,19,3,40,Pass
Aarav Pillai,28-12-2004,976098,Andhra Pradesh,14,9,16,6,45,Pass
Vivaan Fernandes,19-06-2005,163532,Andhra Pradesh,24,19,24,23,90,Pass
Krishna Mehta,03-07-2005,610140,Gujarat,3,3,1,18,25,Fail
Balbir Sharma,10-04-2005,911519,Andhra Pradesh,0,12,18,10,40,Pass
Manpreet D'Souza,10-05-2005,784457,Uttar Pradesh,17,17,14,8,56,Pass
Balbir Sharma,26-03-2005,401739,Uttar Pradesh,17,20,17,18,72,Pass
Yash Mehta,08-10-2005,926878,Odisha,1,13,10,1,25,Pass
Aryan Chopra,25-05-2005,810037,Madhya Pradesh,10,4,22,21,57,Pass
Zaid Chopra,21-12-2005,227085,Tamil Nadu,12,12,12,12,48,Fail
Yash Mehta,22-08-2005,803530,Uttar Pradesh,11,3,24,23,61,Pass
Kunal Mehta,10-05-2005,112271,Andhra Pradesh,2,12,17,6,37,Pass
Rohan Pillai,19-05-2005,261271,Maharashtra,23,0,23,3,49,Pass
Ishaan Reddy,04-12-2005,750023,West Bengal,12,5,16,18,51,Pass
Krishna D'Souza,18-09-2005,543252,Andhra Pradesh,12,19,12,23,66,Pass
Aarav D'Souza,19-01-2005,161224,Rajasthan,4,21,24,24,73,Pass
Vivaan Mehta,18-11-2005,875499,Kerala,18,10,8,2,38,Fail
Aditya Chopra,27-10-2005,319208,Kerala,12,13,12,4,41,Fail
Aarav Reddy,21-09-2005,939871,Rajasthan,0,5,1,9,15,Pass
Krishna Khan,23-03-2006,122830,Madhya Pradesh,15,4,7,19,45,Pass
Rohan Singh,17-02-2005,555482,Uttar Pradesh,12,18,22,3,55,Pass
Vivaan D'Souza,13-10-2005,492028,Telangana,22,8,16,6,52,Fail
Peter Chopra,16-10-2005,757970,Karnataka,5,14,11,20,50,Pass
Krishna Khan,27-07-2005,624962,Andhra Pradesh,23,20,9,4,56,Pass
David Chopra,03-08-2005,906054,Andhra Pradesh,2,4,16,12,34,Pass
Rohan Fernandes,26-01-2005,133366,Jharkhand,4,15,10,22,51,Pass
Krishna Fernandes,09-02-2006,256072,Assam,23,24,17,12,76,Pass
Sukhwinder D'Souza,07-11-2005,526618,Uttar Pradesh,12,18,21,14,65,Pass
Raj D'Souza,10-02-2006,689472,Uttar Pradesh,16,2,5,6,29,Pass
Ishaan Pillai,24-11-2004,587321,Bihar,11,5,21,1,38,Pass
Krishna Fernandes,07-05-2006,570720,Maharashtra,18,14,14,3,49,Pass
Rohan D'Souza,10-01-2005,938305,Uttar Pradesh,18,1,15,2,36,Pass
Farhan Mehta,13-06-2005,751634,Madhya Pradesh,10,22,9,3,44,Pass
Yash Chopra,22-03-2006,758572,Haryana,14,6,6,7,33,Pass
Vivaan Fernandes,02-03-2006,932812,Bihar,14,14,3,18,49,Pass
Paul Fernandes,06-05-2005,571165,Rajasthan,10,2,3,6,21,Pass
Aditya Fernandes,06-04-2006,762003,Gujarat,21,17,19,5,62,Fail
Aarav Verma,10-06-2005,850112,Madhya Pradesh,3,20,12,10,45,Pass
Krishna Singh,04-05-2005,372625,Bihar,7,9,15,24,55,Pass
Harjeet Sharma,24-03-2006,775020,Uttar Pradesh,6,3,21,20,50,Pass
Mathew Singh,27-02-2005,217744,Tamil Nadu,0,14,3,4,21,Pass
Rohan Reddy,10-01-2006,771049,Odisha,21,0,6,9,36,Pass
Aarav D'Souza,14-03-2006,185859,Madhya Pradesh,22,7,2,12,43,Pass
Rohan Mehta,19-01-2005,139039,Odisha,0,17,2,21,40,Pass
Balbir Verma,09-03-2005,133881,Madhya Pradesh,8,8,8,7,31,Pass
Aditya Mehta,27-01-2006,363990,Rajasthan,18,4,16,16,54,Pass
Balbir Singh,17-12-2004,813958,Bihar,8,7,2,17,34,Pass
Balbir Chopra,11-12-2004,737788,Andhra Pradesh,2,7,20,18,47,Pass
Peter Fernandes,07-02-2005,870349,Bihar,2,15,20,19,56,Pass
Sukhwinder D'Souza,24-04-2005,604084,Uttar Pradesh,1,24,3,4,32,Pass
Aarav Khan,19-12-2004,911870,Punjab,23,0,21,21,65,Pass
Yash Pillai,08-09-2005,365872,Rajasthan,18,9,2,12,41,Pass
Yash Chopra,20-02-2005,640673,Tamil Nadu,24,9,7,13,53,Fail
Balbir Khan,03-04-2005,106447,Andhra Pradesh,19,11,0,13,43,Pass
Krishna Singh,20-03-2006,225787,Maharashtra,4,11,24,7,46,Pass
Raj D'Souza,10-01-2005,615416,Bihar,24,6,18,16,64,Pass
Balbir D'Souza,26-11-2005,965940,Rajasthan,22,16,5,22,65,Pass
Mathew D'Souza,24-06-2005,812847,Tripura,19,6,5,17,47,Pass
Aditya Pillai,07-02-2006,150420,Punjab,22,19,23,0,64,Pass
Krishna Pillai,27-12-2004,120841,Madhya Pradesh,14,24,2,3,43,Pass
Aditya Sharma,15-09-2005,100921,Punjab,6,3,24,16,49,Pass
Aarav Chopra,25-03-2006,389391,Kerala,8,23,5,9,45,Fail
Imran Singh,17-11-2004,482140,Kerala,18,3,23,21,65,Fail
Paul Singh,20-12-2005,906919,Tripura,10,7,13,20,50,Pass
Farhan Fernandes,01-11-2005,346757,Rajasthan,7,19,15,7,48,Pass
Aryan D'Souza,02-01-2006,407081,Tamil Nadu,0,16,7,9,32,Pass
Vivaan D'Souza,03-11-2005,795168,Rajasthan,3,21,17,2,43,Pass
Yash Sharma,07-09-2005,894240,Bihar,8,5,5,18,36,Pass
Ishaan Singh,06-04-2005,805088,Maharashtra,8,7,17,8,40,Pass
Vivaan Chopra,13-03-2005,965424,Haryana,2,21,22,13,58,Pass
Ishaan Chopra,01-03-2006,903463,West Bengal,3,15,13,24,55,Pass
Harjeet Verma,19-11-2004,323627,Kerala,22,18,1,20,61,Fail
John Mehta,16-11-2004,386179,Himachal Pradesh,23,15,2,21,61,Pass
John Sharma,14-03-2006,239553,Haryana,24,10,4,23,61,Pass
Ishaan Reddy,14-04-2006,658924,Maharashtra,16,24,1,3,44,Pass
Ishaan Chopra,28-02-2006,757741,Madhya Pradesh,18,12,11,7,48,Pass
Ishaan Mehta,15-08-2005,761593,Bihar,24,17,14,0,55,Pass
Raj Verma,19-08-2005,386477,Uttar Pradesh,7,10,20,24,61,Pass
Vivaan Fernandes,31-12-2005,481031,Chhattisgarh,15,22,15,9,61,Pass
Sukhwinder Sharma,22-12-2005,780171,Punjab,19,3,10,10,42,Pass
Gurpreet Khan,25-05-2005,735192,Haryana,6,12,5,0,23,Pass
Ishaan Sharma,03-03-2005,260720,Bihar,18,21,8,4,51,Pass
Harjeet Pillai,23-07-2005,862997,Tamil Nadu,3,1,20,6,30,Pass
Ishaan Sharma,12-07-2005,610763,Uttarakhand,23,21,3,11,58,Pass
Rehan Verma,16-06-2005,818311,Punjab,22,20,12,11,65,Pass
Raj Verma,06-06-2005,970985,Maharashtra,4,6,9,3,22,Pass
Aditya Fernandes,16-02-2006,559731,Tamil Nadu,5,18,21,6,50,Fail
Rohan Fernandes,18-01-2006,209349,Uttar Pradesh,15,21,13,4,53,Pass
Aarav Sharma,03-01-2005,840862,Andhra Pradesh,22,5,14,9,50,Pass
Ishaan Pillai,17-11-2004,561298,Odisha,2,4,13,3,22,Pass
Gurpreet Mehta,31-05-2005,137577,Rajasthan,18,0,14,18,50,Pass
Aryan Fernandes,01-02-2006,780636,Uttar Pradesh,9,4,4,16,33,Pass
Aditya Verma,18-01-2005,307164,Andhra Pradesh,7,3,5,14,29,Pass
Mathew Chopra,07-04-2005,340162,Tamil Nadu,3,4,12,0,19,Pass
Rohan Singh,08-11-2005,562526,Gujarat,1,10,21,14,46,Fail
Raj Sharma,16-10-2005,468483,Haryana,18,24,24,11,77,Pass
Krishna Reddy,03-04-2006,319423,Rajasthan,7,23,3,21,54,Pass
Manpreet Reddy,26-10-2005,652221,Jharkhand,9,22,4,13,48,Pass
Aditya Sharma,24-04-2005,735259,Bihar,4,18,19,24,65,Pass
Kunal Khan,22-09-2005,261473,Punjab,3,11,15,9,38,Pass
Aditya Sharma,17-01-2006,611220,Rajasthan,24,10,21,10,65,Pass
Aryan Reddy,09-04-2006,251548,Rajasthan,14,13,0,21,48,Pass
Aarav Chopra,04-02-2005,224814,Rajasthan,7,0,13,23,43,Pass
Rohan Mehta,21-11-2005,100112,Bihar,3,18,10,8,39,Pass
Kunal Chopra,28-02-2006,590055,Tamil Nadu,5,13,13,2,33,Pass
Harjeet Khan,21-01-2006,793786,Odisha,12,11,8,8,39,Pass
Rohan Singh,03-04-2005,471742,Kerala,1,5,11,19,36,Fail
Aditya D'Souza,17-11-2004,339554,Sikkim,18,5,13,1,37,Pass
Manpreet Verma,12-03-2006,412539,West Bengal,12,5,13,2,32,Pass
Aditya Reddy,29-03-2005,355404,West Bengal,3,19,18,18,58,Pass
Harjeet Reddy,23-04-2006,400041,West Bengal,19,3,2,20,44,Pass
Aryan Khan,08-03-2006,716249,Maharashtra,16,9,18,2,45,Pass
Aarav Reddy,08-11-2005,661763,Telangana,10,5,16,13,44,Pass
Ishaan Singh,03-07-2005,227395,Bihar,9,6,0,6,21,Pass
John Khan,17-03-2006,891846,Chhattisgarh,18,21,2,11,52,Pass
Imran Mehta,02-08-2005,458575,Andhra Pradesh,15,21,2,22,60,Pass
Raj Chopra,22-12-2005,984230,Karnataka,5,0,18,23,46,Pass
Farhan Pillai,27-06-2005,954918,Uttarakhand,24,3,16,0,43,Pass
Raj Reddy,05-06-2005,600404,Rajasthan,0,11,3,5,19,Pass
Mathew Reddy,03-06-2005,607297,Gujarat,15,15,5,5,40,Fail
Krishna Fernandes,14-11-2004,870471,Rajasthan,7,9,1,4,21,Pass
Raj Fernandes,06-10-2005,264758,Gujarat,16,23,14,9,62,Fail
Rohan Mehta,01-04-2005,667225,Andhra Pradesh,24,1,5,4,34,Pass
Krishna D'Souza,11-08-2005,385802,Himachal Pradesh,5,22,22,4,53,Fail
Rohan Sharma,24-11-2004,240872,Madhya Pradesh,24,4,16,17,61,Pass
Aarav D'Souza,21-05-2005,390651,Rajasthan,5,23,16,4,48,Pass
Rohan Khan,15-12-2005,495328,Delhi,2,9,21,2,34,Pass
Rohan Reddy,13-01-2005,511363,Maharashtra,13,20,12,3,48,Pass
Krishna Reddy,04-07-2005,581138,West Bengal,8,3,12,20,43,Pass
Aditya Fernandes,26-07-2005,596382,Uttar Pradesh,10,3,0,21,34,Pass
Yash Reddy,09-11-2005,985550,Andhra Pradesh,0,18,7,18,43,Pass
Peter Fernandes,08-09-2005,825868,Tamil Nadu,13,8,15,23,59,Pass
Manpreet Pillai,31-03-2005,511716,Chhattisgarh,2,16,9,13,40,Pass
Aditya Khan,23-02-2005,837689,Kerala,7,10,7,1,25,Fail
Imran Singh,16-04-2005,340143,Kerala,1,19,8,20,48,Fail
Aarav Sharma,21-12-2004,395268,Kerala,19,12,0,19,50,Fail
Kunal Reddy,13-12-2004,348816,Bihar,8,23,22,8,61,Pass
Balbir Reddy,19-07-2005,670672,Bihar,20,6,6,8,40,Pass
Peter Mehta,12-12-2005,786651,Assam,3,10,0,24,37,Pass
Peter D'Souza,17-12-2005,497814,Chhattisgarh,22,19,23,0,64,Pass
Peter Pillai,02-05-2006,298353,Haryana,10,20,7,5,42,Pass
Krishna Fernandes,12-03-2005,316865,Bihar,13,5,18,22,58,Pass
Sukhwinder D'Souza,04-08-2005,439449,Karnataka,6,24,16,2,48,Pass
Aryan Sharma,20-12-2005,390621,Rajasthan,4,12,1,5,22,Pass
John D'Souza,01-03-2006,766800,Jharkhand,6,21,15,11,53,Pass
Aditya Mehta,10-12-2004,778567,Andhra Pradesh,19,22,22,1,64,Pass
David Fernandes,23-07-2005,785894,Uttar Pradesh,7,6,8,24,45,Pass
Ishaan Fernandes,28-01-2005,586384,Rajasthan,23,8,8,22,61,Pass
Kunal Reddy,21-08-2005,644689,Rajasthan,15,2,12,11,40,Pass
Gurpreet Sharma,25-09-2005,541262,Rajasthan,14,5,14,23,56,Pass
Aarav Khan,06-05-2006,399299,Rajasthan,13,7,6,1,27,Pass
Balbir Chopra,14-01-2006,998283,Assam,20,14,16,9,59,Pass
Aditya Reddy,04-12-2004,218606,Maharashtra,18,21,19,3,61,Pass
Aarav D'Souza,24-12-2005,807113,Telangana,23,3,22,13,61,Pass
Ishaan Sharma,29-12-2005,553262,Uttar Pradesh,2,7,9,11,29,Pass
Aarav Singh,13-08-2005,249572,Uttar Pradesh,14,20,5,10,49,Pass
Sukhwinder Mehta,14-03-2005,625734,Maharashtra,1,12,22,0,35,Pass
Aditya D'Souza,26-06-2005,170090,Uttar Pradesh,24,14,7,10,55,Pass
Rohan Fernandes,31-07-2005,625992,Maharashtra,6,1,10,7,24,Pass
Harjeet Chopra,27-11-2005,959806,Bihar,12,9,16,23,60,Pass
Sukhwinder Sharma,18-12-2004,322129,Bihar,2,21,15,11,49,Pass
Aryan Fernandes,29-01-2006,211151,Gujarat,24,23,16,15,78,Fail
Kunal Mehta,08-07-2005,615093,Kerala,3,14,3,18,38,Fail
Vivaan Khan,22-08-2005,770428,Bihar,19,1,1,12,33,Pass
David Reddy,29-08-2005,577521,Rajasthan,3,16,2,20,41,Pass
Raj Sharma,13-05-2005,167519,Odisha,11,19,2,17,49,Pass
Ishaan Fernandes,10-04-2006,247958,Haryana,19,16,12,22,69,Pass
Manpreet Chopra,18-02-2005,182803,Madhya Pradesh,22,4,23,20,69,Pass
Aditya Khan,29-03-2005,789301,Uttar Pradesh,23,15,0,24,62,Pass
David Mehta,14-11-2004,793776,Punjab,7,4,14,12,37,Pass
Ishaan Singh,20-02-2006,489168,Uttar Pradesh,1,17,10,7,35,Pass
Paul Fernandes,27-09-2005,875388,Chhattisgarh,4,3,21,22,50,Fail
Yash D'Souza,31-08-2005,442131,Rajasthan,18,14,20,0,52,Pass
Rohan Sharma,19-12-2005,930664,Rajasthan,6,8,7,21,42,Pass
Imran Fernandes,08-12-2004,709712,Madhya Pradesh,17,20,1,4,42,Pass
Kunal Khan,08-02-2005,993143,Rajasthan,2,10,2,14,28,Pass
Yash Reddy,04-02-2005,923630,Andaman & Nicobar,5,20,16,10,51,Pass
Yash Singh,23-06-2005,997306,Rajasthan,16,14,1,20,51,Pass
Aryan Reddy,24-01-2006,805960,Nagaland,10,15,19,12,56,Fail
Aryan Pillai,12-07-2005,133631,Goa,8,16,22,24,70,Fail
Aryan D'Souza,10-09-2005,176047,Himachal Pradesh,20,20,15,18,73,Fail
Vivaan Verma,20-08-2005,157180,Uttar Pradesh,12,3,21,3,39,Pass
Raj Khan,10-05-2005,501178,Madhya Pradesh,12,3,9,17,41,Pass
Rohan Khan,08-05-2005,114664,Rajasthan,11,1,8,20,40,Pass
Vivaan Fernandes,27-06-2005,637043,Rajasthan,15,7,15,13,50,Pass
Manpreet Singh,09-02-2005,863816,Rajasthan,9,20,13,5,47,Pass
Sukhwinder Mehta,07-12-2005,724079,Maharashtra,21,7,8,4,40,Pass
Aryan Khan,16-03-2005,786812,Rajasthan,10,10,24,6,50,Pass
Vivaan D'Souza,29-01-2006,848060,Kerala,21,17,23,9,70,Fail
Peter Verma,16-12-2004,369269,Rajasthan,3,13,1,14,31,Pass
Krishna Fernandes,31-01-2005,662360,West Bengal,3,3,17,24,47,Pass
Aditya Sharma,30-01-2005,747977,Uttarakhand,5,17,0,1,23,Pass
Aditya Singh,01-01-2006,417294,West Bengal,21,5,3,16,45,Pass
Ishaan Khan,22-01-2005,503887,Bihar,0,19,8,10,37,Pass
David Singh,18-03-2005,467389,Uttar Pradesh,13,9,13,11,46,Pass
Kunal Mehta,21-04-2006,688618,Rajasthan,14,21,1,10,46,Pass
Kunal Verma,18-07-2005,172686,Himachal Pradesh,1,1,21,20,43,Pass
Kunal D'Souza,09-12-2005,645165,Maharashtra,22,18,13,3,56,Pass
Kunal Sharma,07-09-2005,200492,Rajasthan,19,19,6,19,63,Pass
Manpreet Pillai,12-03-2006,340770,Uttar Pradesh,23,8,5,5,41,Pass
Vivaan Khan,13-06-2005,891527,Assam,13,12,20,2,47,Pass
Harjeet Mehta,15-02-2005,420280,Uttar Pradesh,14,14,0,6,34,Pass
Balbir Singh,27-12-2005,220260,Jharkhand,12,20,19,15,66,Pass
Aarav Sharma,15-06-2005,316208,Rajasthan,0,20,0,11,31,Pass
Mathew Fernandes,08-12-2005,443973,Maharashtra,1,20,16,3,40,Pass
Ishaan Sharma,21-02-2005,224030,Haryana,2,11,13,21,47,Pass
Aarav Verma,20-05-2005,657297,Madhya Pradesh,3,9,15,9,36,Pass
Balbir Reddy,10-08-2005,373100,Uttarakhand,2,2,11,7,22,Pass
Ayaan Mehta,12-03-2006,996418,Karnataka,24,15,11,19,69,Fail
Kunal Mehta,27-01-2006,248880,Rajasthan,18,17,22,23,80,Pass
Aditya Pillai,11-01-2005,410365,Tamil Nadu,7,19,13,9,48,Fail
Krishna Verma,12-12-2004,696707,Uttar Pradesh,23,3,19,22,67,Pass
Rohan D'Souza,15-12-2005,867665,Bihar,22,5,5,6,38,Pass
Kunal Khan,06-05-2006,734051,Odisha,22,22,1,14,59,Pass
Yash Mehta,13-11-2005,667515,Bihar,22,6,1,23,52,Pass
Gurpreet Pillai,11-09-2005,853405,Karnataka,2,10,15,1,28,Pass
Ishaan Mehta,26-06-2005,726888,Kerala,15,12,13,18,58,Fail
Kunal Sharma,24-07-2005,545780,Telangana,15,5,6,14,40,Pass
Ishaan Khan,20-01-2005,109975,Bihar,7,4,0,19,30,Pass
Paul Verma,28-08-2005,603289,Karnataka,19,1,15,19,54,Pass
Aditya Verma,17-03-2006,633704,Bihar,3,22,1,14,40,Pass
Ishaan Sharma,13-12-2005,707631,Rajasthan,16,12,7,18,53,Pass
Farhan Reddy,16-07-2005,157712,Gujarat,11,19,3,11,44,Fail
Imran Khan,08-01-2006,671052,Karnataka,10,1,22,5,38,Pass
Rehan Khan,06-10-2005,345390,Uttar Pradesh,5,8,0,21,34,Pass
Harjeet Fernandes,23-10-2005,641265,Karnataka,11,14,1,3,29,Pass
Aryan Fernandes,21-03-2006,830353,Andhra Pradesh,23,11,20,11,65,Pass
Rohan Sharma,05-09-2005,307377,Bihar,1,4,10,13,28,Pass
Krishna Chopra,29-05-2005,945237,Bihar,23,15,16,10,64,Pass
Aryan Verma,10-04-2006,286682,Uttar Pradesh,4,5,6,24,39,Pass
Rohan Reddy,27-09-2005,492949,Maharashtra,13,12,1,8,34,Pass
Krishna Verma,12-05-2005,176032,Delhi,21,15,17,0,53,Pass
Gurpreet Pillai,06-08-2005,690039,Haryana,12,14,13,2,41,Pass
Raj Fernandes,07-11-2004,716735,Andhra Pradesh,16,3,10,19,48,Pass
Vivaan Fernandes,25-05-2005,572764,Jharkhand,13,23,19,23,78,Fail
Vivaan Singh,07-03-2005,608879,West Bengal,10,8,2,3,23,Pass
Vivaan D'Souza,25-01-2006,906401,Rajasthan,5,4,5,10,24,Pass
Peter Fernandes,16-03-2005,610596,West Bengal,16,1,19,4,40,Pass
Yash Sharma,27-03-2005,236607,Uttar Pradesh,5,12,16,22,55,Pass
Paul Khan,20-04-2005,540516,Haryana,22,14,22,21,79,Pass
Zaid Pillai,14-03-2005,880684,Tripura,0,14,5,12,31,Pass
Krishna Khan,18-03-2005,697412,Bihar,10,24,4,9,47,Pass
Gurpreet Khan,16-01-2005,225690,Uttar Pradesh,15,1,23,11,50,Pass
Vivaan Khan,14-11-2005,761223,West Bengal,5,11,24,8,48,Pass
Ishaan Sharma,18-03-2006,997141,Uttar Pradesh,11,19,19,23,72,Pass
Peter Khan,23-10-2005,923016,Uttar Pradesh,8,22,15,11,56,Pass
Sukhwinder Khan,25-01-2006,233797,Madhya Pradesh,2,4,19,13,38,Pass
Kunal Chopra,28-02-2006,798582,Nagaland,9,7,6,3,25,Pass
Aditya Verma,19-07-2005,647774,Himachal Pradesh,7,4,10,12,33,Pass
Vivaan Reddy,15-12-2005,180908,Rajasthan,22,17,17,10,66,Pass
Aryan Khan,20-11-2004,890493,West Bengal,16,3,4,18,41,Pass
Gurpreet Chopra,01-04-2006,501011,Odisha,3,24,13,4,44,Pass
Paul Mehta,15-05-2005,615197,Uttar Pradesh,2,4,14,16,36,Pass
Rohan Chopra,07-02-2005,710240,Rajasthan,3,4,4,15,26,Pass
Yash Sharma,09-02-2006,675104,Uttar Pradesh,16,4,1,19,40,Pass
Yash Pillai,09-01-2005,726103,Assam,14,12,17,24,67,Pass
Vivaan Khan,01-02-2006,746266,Madhya Pradesh,20,4,10,18,52,Pass
Aditya Verma,13-04-2005,561234,Punjab,20,16,0,18,54,Pass
Ishaan Khan,05-09-2005,416619,Uttarakhand,11,22,3,8,44,Pass
Kunal Khan,10-06-2005,785990,Himachal Pradesh,9,21,1,13,44,Pass
David D'Souza,12-03-2005,238752,Odisha,2,20,17,23,62,Pass
Yash Khan,02-02-2006,923665,Rajasthan,1,13,18,12,44,Pass
Aryan Reddy,10-03-2005,764366,Odisha,21,12,9,9,51,Pass
Ishaan Singh,22-04-2005,114126,Odisha,24,19,12,11,66,Pass
Aditya Singh,26-04-2006,190880,Karnataka,11,10,7,1,29,Pass
Raj Khan,06-12-2005,322407,Madhya Pradesh,3,4,11,23,41,Pass
Aarav Singh,12-02-2005,829297,Uttar Pradesh,16,3,8,12,39,Pass
Aarav Khan,06-03-2005,521989,Punjab,1,7,11,23,42,Pass
Aarav Verma,24-03-2006,947531,Kerala,11,14,22,10,57,Fail
John Chopra,12-05-2005,311822,Rajasthan,8,14,17,17,56,Pass
Manpreet Chopra,05-08-2005,350628,Uttar Pradesh,0,24,17,4,45,Pass
Aryan Khan,13-04-2005,386714,Uttar Pradesh,13,10,19,5,47,Pass
Krishna Verma,08-11-2005,698994,Maharashtra,20,23,5,3,51,Pass
Ishaan Chopra,10-12-2005,539829,Karnataka,3,17,19,12,51,Pass
Krishna Pillai,12-03-2005,731966,Tamil Nadu,21,14,19,7,61,Pass
Farhan Verma,23-07-2005,781743,Kerala,20,4,9,16,49,Fail
Imran Sharma,27-11-2005,357023,Karnataka,1,20,10,15,46,Pass
Aarav Sharma,17-02-2005,505797,Manipur,13,3,24,10,50,Fail
Balbir Reddy,21-11-2005,868144,Punjab,1,19,9,20,49,Pass
Sukhwinder Mehta,08-02-2005,157562,Uttar Pradesh,23,1,16,21,61,Pass
Rohan Khan,19-02-2006,482447,Punjab,5,11,17,0,33,Pass
John Chopra,30-01-2006,517395,Jharkhand,23,7,5,16,51,Pass
Rohan D'Souza,30-06-2005,776679,Himachal Pradesh,20,18,17,21,76,Fail
Rohan Singh,14-03-2005,823756,Assam,24,4,3,11,42,Pass
Zaid Singh,12-08-2005,305221,Tamil Nadu,23,16,11,21,71,Pass
Rohan Sharma,08-03-2006,743799,Andhra Pradesh,22,0,21,11,54,Pass
Krishna Sharma,08-01-2005,710050,Uttar Pradesh,2,22,18,15,57,Pass
Aryan D'Souza,24-11-2005,763100,Rajasthan,15,0,22,19,56,Pass
Vivaan Mehta,02-05-2006,900721,Uttar Pradesh,6,17,8,21,52,Pass
Kunal Pillai,08-05-2005,417272,Maharashtra,12,12,9,10,43,Pass
Rohan Verma,21-01-2005,588051,Maharashtra,14,15,14,2,45,Pass
Paul Verma,26-06-2005,169405,Jharkhand,14,2,13,12,41,Pass
Ayaan Khan,11-04-2005,982920,Himachal Pradesh,13,5,1,3,22,Pass
Aryan Verma,17-01-2006,124474,Madhya Pradesh,24,4,13,10,51,Pass
Aditya D'Souza,17-11-2005,224146,Karnataka,23,20,0,20,63,Pass
Aarav Khan,24-12-2005,312272,Madhya Pradesh,6,16,23,4,49,Pass
Kunal Pillai,06-03-2006,588288,Tripura,20,21,3,20,64,Pass
Krishna Chopra,27-10-2005,281922,Bihar,14,7,24,0,45,Pass
Manpreet Chopra,13-03-2006,816623,Karnataka,9,23,1,17,50,Pass
Mathew Pillai,23-04-2005,297013,Kerala,15,22,23,5,65,Fail
Yash Chopra,21-11-2004,904618,Karnataka,12,16,2,15,45,Pass
Krishna D'Souza,18-11-2005,959332,Karnataka,11,21,11,2,45,Pass
David Pillai,02-11-2005,618487,Tamil Nadu,14,8,7,2,31,Pass
Balbir Reddy,30-06-2005,120139,Uttar Pradesh,12,20,12,9,53,Pass
Balbir Fernandes,21-11-2005,218199,Madhya Pradesh,1,22,11,20,54,Pass
Peter Chopra,20-12-2005,989418,Haryana,14,11,24,0,49,Pass
Raj Chopra,02-04-2005,489415,Gujarat,17,19,4,16,56,Fail
Rohan Reddy,01-05-2005,406474,Bihar,10,4,10,8,32,Pass
Ishaan D'Souza,29-04-2005,740840,Jammu & Kashmir + Ladakh,17,12,20,17,66,Pass
David Verma,30-06-2005,472360,Andhra Pradesh,8,13,13,1,35,Pass
Peter Verma,26-06-2005,581281,Andhra Pradesh,7,23,18,22,70,Pass
Zaid Mehta,24-06-2005,483297,Rajasthan,18,19,3,10,50,Pass
Ishaan Reddy,05-02-2005,336435,Goa,5,1,3,11,20,Fail
Sukhwinder D'Souza,07-05-2006,597181,Gujarat,23,11,13,20,67,Fail
Ishaan Sharma,14-10-2005,431052,Andhra Pradesh,2,16,15,18,51,Pass
Gurpreet Fernandes,21-06-2005,157254,Uttarakhand,19,19,0,0,38,Pass
Rohan D'Souza,18-01-2005,934338,Madhya Pradesh,16,8,2,4,30,Pass
Yash D'Souza,05-01-2006,820532,Andhra Pradesh,0,14,19,10,43,Pass
Ishaan Singh,21-04-2006,117824,Telangana,7,8,12,20,47,Pass
Raj Khan,21-04-2006,928032,West Bengal,14,3,20,22,59,Pass
Aryan Reddy,16-11-2005,824757,Bihar,23,15,18,4,60,Pass
Aarav Mehta,24-03-2006,262805,Delhi,17,14,10,11,52,Pass
Yash Reddy,31-05-2005,761979,Bihar,2,11,4,23,40,Pass
Yash Mehta,02-07-2005,645921,Andhra Pradesh,2,0,20,2,24,Pass
Aryan Mehta,01-10-2005,715269,Uttar Pradesh,24,15,9,7,55,Pass
Raj Fernandes,11-12-2004,577787,Andhra Pradesh,15,11,23,11,60,Pass
Aryan Pillai,11-04-2006,144378,Meghalaya,18,7,5,21,51,Fail
Kunal Mehta,06-05-2005,129619,Bihar,14,12,6,11,43,Pass
Aditya Sharma,05-06-2005,485816,Rajasthan,10,16,17,9,52,Pass
Kunal Pillai,14-05-2005,237495,Karnataka,3,23,14,9,49,Pass
Raj Pillai,15-02-2006,809921,Himachal Pradesh,9,4,8,24,45,Pass
Balbir Mehta,15-07-2005,467387,Rajasthan,0,12,8,15,35,Pass
Aarav Khan,02-06-2005,433388,Karnataka,20,0,4,7,31,Pass
Raj Fernandes,02-08-2005,243357,Uttar Pradesh,1,21,18,4,44,Pass
Aryan Sharma,07-09-2005,125522,Madhya Pradesh,8,0,17,1,26,Pass
Sukhwinder Sharma,12-08-2005,424771,Odisha,7,5,2,10,24,Pass
Yash Reddy,03-05-2005,355430,Jharkhand,1,16,19,12,48,Pass
Aditya Mehta,05-05-2006,569375,Andaman & Nicobar,8,6,15,4,33,Pass
Zaid Pillai,21-03-2006,219139,Delhi,15,11,6,0,32,Pass
Aarav Fernandes,10-03-2006,335559,Uttar Pradesh,21,11,7,2,41,Pass
Kunal Pillai,15-12-2005,534741,Maharashtra,14,23,7,3,47,Pass
David Chopra,16-07-2005,804441,Maharashtra,8,12,13,12,45,Pass
Aditya Fernandes,14-03-2005,552577,Chhattisgarh,13,1,19,18,51,Fail
Vivaan Khan,06-12-2005,204550,Punjab,22,24,21,17,84,Pass
Balbir D'Souza,21-12-2004,805585,Chhattisgarh,15,2,18,7,42,Fail
Ishaan Reddy,23-01-2006,336937,West Bengal,3,3,19,19,44,Pass
Rohan Pillai,30-04-2005,340119,Uttar Pradesh,0,3,1,19,23,Pass
Balbir Verma,27-01-2005,107375,Assam,20,10,5,7,42,Pass
Ishaan Fernandes,03-11-2005,394659,Odisha,6,20,5,16,47,Pass
Zaid Reddy,04-10-2005,687811,Himachal Pradesh,22,2,10,14,48,Pass
Ishaan Fernandes,20-02-2006,680615,Uttar Pradesh,14,23,9,6,52,Pass
Aryan Verma,14-02-2005,210001,Arunachal Pradesh,18,2,0,11,31,Fail
Rohan D'Souza,22-09-2005,637349,Rajasthan,6,22,8,6,42,Pass
Vivaan Fernandes,04-01-2006,874861,Jharkhand,12,14,3,6,35,Pass
Raj Mehta,13-04-2005,381403,Andhra Pradesh,19,4,21,5,49,Pass
Krishna Fernandes,05-05-2005,567853,Tripura,9,10,12,13,44,Pass
Manpreet Verma,11-05-2005,618303,Bihar,3,23,11,23,60,Pass
Yash Fernandes,02-05-2006,884905,Bihar,5,9,12,8,34,Pass
Rohan Chopra,16-11-2005,799913,Uttarakhand,9,14,21,0,44,Pass
Vivaan Sharma,28-12-2005,411853,Bihar,10,2,24,2,38,Pass
Raj Chopra,16-10-2005,654990,Uttar Pradesh,6,1,0,2,9,Pass
Yash D'Souza,18-01-2006,890717,Meghalaya,24,4,2,3,33,Pass
Raj Chopra,06-12-2005,199685,Bihar,15,18,16,20,69,Pass
Vivaan Sharma,29-07-2005,945672,West Bengal,12,9,21,7,49,Pass
Aryan Fernandes,08-06-2005,809126,Kerala,14,9,9,4,36,Fail
John Fernandes,11-03-2005,867019,Odisha,0,20,20,3,43,Pass
Krishna D'Souza,10-12-2004,229087,Odisha,18,20,16,8,62,Pass
Gurpreet Sharma,03-08-2005,775683,Haryana,22,10,11,24,67,Pass
Balbir D'Souza,17-12-2004,769964,West Bengal,0,3,17,20,40,Pass
Gurpreet Singh,07-03-2005,891943,Rajasthan,17,16,15,19,67,Pass
Manpreet D'Souza,14-02-2005,128240,Gujarat,15,0,23,19,57,Fail
Aditya Reddy,05-02-2006,199688,Assam,5,7,5,10,27,Pass
Aditya Khan,12-11-2005,688549,Tamil Nadu,5,11,17,4,37,Pass
Kunal Khan,01-03-2006,628484,Rajasthan,12,12,24,0,48,Pass
Kunal Verma,24-06-2005,191612,Haryana,13,20,18,14,65,Pass
Manpreet Khan,18-12-2005,212964,Assam,15,6,7,20,48,Pass
Harjeet Mehta,09-09-2005,750718,Punjab,22,20,13,14,69,Pass
Gurpreet Singh,14-01-2005,331386,Uttar Pradesh,18,7,16,10,51,Pass
Rehan Reddy,27-10-2005,843217,Jharkhand,8,15,19,22,64,Pass
Aryan Fernandes,12-11-2005,941936,Rajasthan,18,17,7,9,51,Pass
Raj Chopra,18-09-2005,799275,West Bengal,11,4,7,15,37,Pass
Manpreet D'Souza,11-07-2005,530577,Rajasthan,5,21,7,7,40,Pass
Aarav Singh,20-12-2005,557109,Rajasthan,18,10,20,14,62,Pass
Rohan Fernandes,17-04-2006,200092,Bihar,15,19,20,18,72,Pass
Rohan Sharma,01-02-2005,478564,Bihar,21,3,6,22,52,Pass
Kunal Verma,06-12-2004,858534,Telangana,18,23,7,18,66,Pass
Kunal Pillai,26-02-2005,296138,Tamil Nadu,19,13,13,6,51,Pass
Raj Mehta,03-01-2006,130745,Punjab,19,0,10,24,53,Pass
Ishaan Singh,03-10-2005,745399,Jammu & Kashmir + Ladakh,21,4,10,14,49,Pass
Kunal Singh,07-01-2006,392054,Punjab,3,14,21,3,41,Pass
Rohan Verma,16-03-2005,997574,Madhya Pradesh,3,7,10,5,25,Pass
Sukhwinder Reddy,19-09-2005,270192,Rajasthan,19,12,3,15,49,Pass
Rohan D'Souza,30-03-2006,815626,Bihar,21,19,8,24,72,Pass
Harjeet D'Souza,18-11-2005,266884,Rajasthan,22,18,8,23,71,Pass
Ishaan D'Souza,16-09-2005,161744,Meghalaya,14,9,18,6,47,Fail
Balbir Pillai,28-12-2005,101741,Rajasthan,17,15,0,12,44,Pass
Raj Sharma,24-12-2005,166426,Bihar,5,17,15,2,39,Pass
Rohan Chopra,16-04-2006,965261,Maharashtra,2,23,4,18,47,Pass
Aarav Khan,20-03-2006,100511,Rajasthan,2,20,7,8,37,Pass
Aarav Chopra,02-04-2005,806429,Odisha,24,13,3,21,61,Pass
Rohan Singh,15-01-2005,502645,Punjab,13,15,6,9,43,Pass
Rohan Fernandes,30-04-2005,280596,Rajasthan,17,9,4,13,43,Pass
Krishna D'Souza,06-02-2006,978662,Madhya Pradesh,4,23,14,14,55,Pass
Vivaan Khan,26-04-2005,894247,Maharashtra,10,10,12,2,34,Pass
Aryan D'Souza,17-01-2006,691999,Uttarakhand,10,6,3,17,36,Pass
Yash Reddy,25-12-2005,885441,Uttar Pradesh,6,8,8,24,46,Pass
Yash Pillai,20-02-2006,684238,Bihar,19,3,10,24,56,Pass
Krishna Verma,11-05-2005,922235,Uttar Pradesh,23,7,19,3,52,Pass
Aryan Khan,01-04-2005,897534,Karnataka,13,14,23,1,51,Pass
Aryan Khan,23-10-2005,876993,Uttarakhand,13,13,23,1,50,Pass
Raj Chopra,10-06-2005,281238,Tamil Nadu,20,2,15,16,53,Fail
Aryan Khan,26-12-2004,338350,Bihar,2,3,23,21,49,Pass
Kunal Reddy,25-10-2005,356158,Goa,5,23,0,4,32,Fail
Harjeet Verma,11-07-2005,910816,Maharashtra,17,0,24,3,44,Pass
Aryan Reddy,26-12-2005,899672,Rajasthan,0,10,7,10,27,Pass
Kunal Singh,10-06-2005,954363,Madhya Pradesh,10,4,16,19,49,Pass
Raj Pillai,26-05-2005,568288,Telangana,14,18,20,17,69,Pass
Aditya Fernandes,04-11-2005,931480,Jammu & Kashmir + Ladakh,12,21,13,14,60,Pass
Yash Pillai,21-10-2005,310175,West Bengal,22,3,5,21,51,Pass
Raj Pillai,30-12-2005,377670,Gujarat,1,23,1,6,31,Fail
Ayaan Mehta,25-11-2004,822603,Telangana,10,10,24,3,47,Pass
Ayaan D'Souza,08-08-2005,271612,Bihar,22,18,19,9,68,Pass
Aryan Pillai,14-02-2005,626251,Bihar,17,4,22,19,62,Pass
Paul Fernandes,28-10-2005,299285,Rajasthan,17,1,22,7,47,Pass
Paul Fernandes,19-04-2006,288189,Haryana,10,15,15,12,52,Pass
Balbir Chopra,18-03-2006,988770,Punjab,17,9,3,21,50,Pass
Harjeet Pillai,26-03-2005,645785,Maharashtra,2,14,2,18,36,Pass
Ishaan Mehta,09-04-2006,553594,Telangana,0,18,1,20,39,Pass
Raj Reddy,27-09-2005,770960,Bihar,9,24,7,0,40,Pass
Yash Pillai,23-01-2006,472620,Gujarat,24,11,0,17,52,Fail
Ishaan Mehta,08-02-2005,984620,Telangana,2,20,12,14,48,Pass
Yash Sharma,23-11-2005,423084,Bihar,13,23,21,18,75,Pass
Aditya Chopra,28-02-2006,632741,Maharashtra,14,6,13,3,36,Pass
Rohan Fernandes,21-09-2005,878122,Arunachal Pradesh,9,9,10,13,41,Fail
Rohan Singh,05-05-2006,885085,Andhra Pradesh,8,23,15,11,57,Pass
Yash Verma,31-12-2004,291700,Rajasthan,9,16,9,22,56,Pass
Ishaan Chopra,01-06-2005,599283,Madhya Pradesh,9,20,4,12,45,Pass
Aditya Fernandes,08-05-2006,145336,Bihar,17,12,20,0,49,Pass
Mathew Sharma,07-08-2005,341283,Andhra Pradesh,10,22,6,23,61,Pass
Mathew Pillai,20-04-2005,608442,Tamil Nadu,18,6,16,3,43,Fail
Yash Chopra,27-11-2005,836685,Maharashtra,7,15,22,5,49,Pass
Raj Singh,01-10-2005,720064,Rajasthan,20,21,11,6,58,Pass
Harjeet Chopra,10-01-2006,594522,Madhya Pradesh,24,4,5,24,57,Pass
Harjeet Singh,03-04-2005,752716,Andhra Pradesh,1,5,0,22,28,Pass
Aditya D'Souza,01-01-2006,636288,Chhattisgarh,12,19,3,4,38,Fail
Krishna Sharma,14-08-2005,486682,Madhya Pradesh,20,9,12,9,50,Pass
Ishaan Khan,01-09-2005,175455,Punjab,18,23,1,15,57,Pass
Yash Reddy,12-07-2005,845090,Maharashtra,10,17,24,3,54,Pass
Kunal Sharma,11-01-2006,855855,Delhi,14,15,21,7,57,Pass
Aarav Khan,11-12-2005,223791,Rajasthan,14,23,9,14,60,Pass
Aditya D'Souza,11-10-2005,979081,Uttar Pradesh,23,23,10,2,58,Pass
Aditya Singh,17-01-2006,500499,Bihar,24,11,5,12,52,Pass
Vivaan Khan,24-10-2005,711547,Madhya Pradesh,6,11,17,4,38,Pass
Vivaan Khan,08-01-2005,637451,West Bengal,0,17,11,19,47,Pass
Rohan D'Souza,15-12-2004,308961,Assam,16,16,10,9,51,Pass
Vivaan Mehta,14-11-2005,691879,Andhra Pradesh,13,1,14,14,42,Pass
Kunal Reddy,30-12-2004,713657,Tamil Nadu,18,12,13,8,51,Pass
Krishna Reddy,19-07-2005,247854,Jharkhand,18,5,9,4,36,Pass
Aryan Verma,13-05-2005,526689,Andhra Pradesh,14,10,6,16,46,Pass
Rehan Sharma,08-03-2006,326457,Uttar Pradesh,21,6,6,22,55,Pass
Aryan Reddy,30-03-2006,769274,Himachal Pradesh,13,6,1,23,43,Pass
Aryan Singh,05-01-2006,186275,Bihar,5,5,14,17,41,Pass
Harjeet Fernandes,20-03-2006,564385,Madhya Pradesh,20,4,13,10,47,Pass
Aditya Khan,30-04-2005,721912,Andhra Pradesh,15,17,19,2,53,Pass
Yash Sharma,16-11-2004,370119,Rajasthan,4,10,3,19,36,Pass
Ishaan Chopra,17-01-2005,260848,Tamil Nadu,18,15,20,8,61,Pass
Vivaan D'Souza,23-03-2006,773335,Punjab,6,20,15,11,52,Pass
Rohan Verma,24-06-2005,721747,Bihar,12,23,14,18,67,Pass
Sukhwinder Fernandes,07-06-2005,467319,Haryana,9,19,9,4,41,Pass
Paul Reddy,01-12-2005,973759,Bihar,16,7,15,9,47,Pass
Rohan Verma,15-10-2005,363952,West Bengal,14,11,15,1,41,Fail
Aarav Sharma,25-04-2006,613019,Tamil Nadu,20,12,13,4,49,Fail
Aditya Verma,13-11-2004,142615,Andhra Pradesh,17,23,8,16,64,Pass
Aditya Fernandes,08-08-2005,507553,West Bengal,11,1,3,2,17,Fail
Peter Pillai,08-06-2005,679933,Uttar Pradesh,10,18,19,10,57,Pass
Rohan Singh,20-05-2005,822204,Himachal Pradesh,1,1,9,24,35,Pass
Aarav D'Souza,20-01-2005,743082,Punjab,19,11,13,7,50,Pass
Paul Pillai,01-02-2006,883794,Telangana,4,10,22,11,47,Pass
Yash Fernandes,23-02-2006,889828,Maharashtra,22,18,7,3,50,Pass
Aryan Verma,20-07-2005,620867,Uttar Pradesh,14,23,19,4,60,Pass
Mathew D'Souza,27-01-2006,999691,Chhattisgarh,13,18,24,8,63,Fail
Vivaan D'Souza,18-09-2005,584092,Gujarat,23,6,6,2,37,Fail
John Reddy,24-01-2006,165685,Bihar,22,9,7,6,44,Pass
Vivaan Chopra,15-12-2005,710299,West Bengal,22,11,0,18,51,Fail
Aditya Mehta,13-04-2006,799368,Uttar Pradesh,24,3,14,21,62,Pass
Gurpreet Khan,27-11-2005,925288,Uttar Pradesh,22,11,1,22,56,Pass
Aarav Khan,06-07-2005,614068,Punjab,0,23,22,22,67,Pass
Rohan Sharma,18-03-2005,695089,Chhattisgarh,12,7,12,8,39,Fail
Balbir Chopra,09-06-2005,734339,Rajasthan,4,17,10,24,55,Pass
Aarav Verma,26-03-2005,737978,Uttar Pradesh,22,2,16,0,40,Pass
Aarav Khan,10-11-2005,260950,Punjab,0,20,18,22,60,Pass
Vivaan Sharma,07-01-2006,258086,Chhattisgarh,6,0,17,16,39,Fail
Balbir Chopra,01-12-2004,828922,Assam,4,20,17,7,48,Pass
Aditya Reddy,23-07-2005,498242,Bihar,1,15,7,16,39,Pass
Kunal Singh,09-09-2005,798523,Uttar Pradesh,9,1,24,9,43,Pass
Ishaan Pillai,01-04-2006,214542,Rajasthan,14,10,15,21,60,Pass
Aarav Sharma,04-12-2005,122494,Telangana,14,11,2,19,46,Pass
Aarav Fernandes,20-10-2005,654557,Jammu & Kashmir + Ladakh,16,20,10,3,49,Pass
Vivaan Khan,03-04-2006,186795,Madhya Pradesh,9,20,6,1,36,Pass
Aditya Khan,12-08-2005,381490,Uttarakhand,24,11,0,4,39,Pass
Zaid Mehta,20-12-2004,926484,Chhattisgarh,12,16,20,24,72,Fail
Kunal Khan,28-04-2006,160593,Bihar,5,17,9,6,37,Pass
Aditya Sharma,19-08-2005,256630,Uttar Pradesh,8,2,20,22,52,Pass
Krishna D'Souza,08-04-2006,412008,Gujarat,0,3,4,22,29,Fail
Yash Sharma,29-04-2006,728729,Manipur,12,7,4,22,45,Fail
Aarav Khan,20-04-2005,136805,Uttar Pradesh,12,9,3,20,44,Pass
Yash Singh,07-03-2005,226495,Jharkhand,19,13,1,11,44,Pass
Krishna Sharma,08-03-2006,303338,Uttar Pradesh,13,9,14,10,46,Pass
Krishna Sharma,26-02-2006,201566,Tamil Nadu,6,0,15,3,24,Pass
Peter Khan,30-01-2006,851815,Uttar Pradesh,2,0,14,23,39,Pass
Ishaan Reddy,25-01-2005,615025,Bihar,7,21,0,24,52,Pass
Aryan Reddy,31-10-2005,278071,Bihar,11,9,24,14,58,Pass
Aarav Khan,10-08-2005,538137,West Bengal,10,13,1,17,41,Fail
Rehan Khan,22-12-2005,340437,Chhattisgarh,21,22,13,22,78,Fail
Paul Khan,12-02-2006,127459,Uttar Pradesh,8,2,14,8,32,Pass
Raj Chopra,12-04-2006,731897,Uttarakhand,8,11,2,7,28,Pass
Aditya Khan,24-08-2005,390610,Uttarakhand,24,14,3,9,50,Pass
Aryan D'Souza,30-01-2005,166482,West Bengal,23,23,8,8,62,Fail
Aryan Sharma,02-12-2005,322885,Delhi,19,24,19,11,73,Pass
Ishaan Fernandes,15-01-2005,638364,Assam,13,16,10,17,56,Pass
Vivaan Sharma,21-05-2005,918676,Tamil Nadu,3,1,20,11,35,Pass
Kunal Pillai,15-03-2005,245698,Tamil Nadu,18,21,24,4,67,Fail
Aarav D'Souza,25-04-2006,538404,Bihar,15,1,12,4,32,Pass
Vivaan Pillai,17-01-2006,493807,Rajasthan,9,0,23,6,38,Pass
Gurpreet Pillai,08-01-2005,144060,Tripura,6,0,8,12,26,Pass
Manpreet Khan,25-02-2005,786038,Rajasthan,17,14,1,7,39,Pass
Aryan Singh,12-09-2005,730801,Jharkhand,11,8,2,15,36,Pass
Ishaan Reddy,03-11-2005,721773,Maharashtra,2,4,22,13,41,Pass
Aditya Chopra,19-03-2005,565557,Rajasthan,16,14,21,5,56,Pass
Sukhwinder Fernandes,22-03-2005,738711,Rajasthan,5,14,10,4,33,Pass
Rohan Chopra,14-02-2005,176710,Maharashtra,22,6,1,4,33,Pass
Raj Reddy,10-06-2005,856471,Andhra Pradesh,15,22,13,23,73,Pass
Ishaan Chopra,07-12-2005,648363,Gujarat,18,5,14,6,43,Fail
Kunal Chopra,24-04-2006,320365,Maharashtra,8,3,7,16,34,Pass
Manpreet Khan,12-04-2006,534844,Himachal Pradesh,1,5,1,19,26,Pass
Farhan Sharma,27-01-2006,289825,Maharashtra,7,2,21,1,31,Pass
David Verma,30-03-2005,422163,West Bengal,13,6,7,13,39,Fail
Yash Reddy,23-12-2005,934883,Bihar,12,4,9,12,37,Pass
Ishaan Sharma,30-09-2005,696018,Haryana,0,17,4,1,22,Pass
Krishna Singh,27-01-2006,887439,Odisha,22,16,14,10,62,Pass
Paul Sharma,07-04-2006,525826,West Bengal,7,21,15,10,53,Fail
Raj Pillai,29-04-2005,833158,Bihar,12,9,22,18,61,Pass
Aditya Chopra,31-01-2005,538797,Bihar,11,17,9,4,41,Pass
Ishaan Sharma,28-04-2006,833019,Punjab,11,21,5,2,39,Pass
Aryan Reddy,23-04-2006,895284,Punjab,7,1,5,5,18,Pass
Ishaan Singh,27-02-2006,652506,Gujarat,1,9,16,8,34,Fail
Vivaan Fernandes,04-05-2006,623090,Rajasthan,12,12,5,5,34,Pass
John Verma,08-07-2005,714961,Maharashtra,20,24,22,3,69,Pass
Balbir Mehta,07-12-2005,212165,Bihar,22,10,4,18,54,Pass
Farhan D'Souza,25-02-2006,449090,Madhya Pradesh,16,12,10,13,51,Pass
Yash Chopra,18-03-2006,272039,Uttarakhand,21,11,0,6,38,Pass
Aarav Mehta,06-12-2005,909492,Karnataka,7,17,22,18,64,Pass
Ishaan Fernandes,20-05-2005,598490,Punjab,9,9,5,12,35,Pass
Aditya Verma,23-10-2005,181640,Uttar Pradesh,14,8,23,17,62,Pass
David Sharma,18-08-2005,740873,Tamil Nadu,1,0,24,21,46,Fail
Aryan Mehta,30-10-2005,395396,Tamil Nadu,10,18,13,0,41,Pass
Aarav Pillai,24-03-2006,243511,Maharashtra,1,6,15,12,34,Pass
Kunal Reddy,05-02-2006,107769,Gujarat,20,13,7,7,47,Fail
Rohan D'Souza,14-02-2006,503792,Andhra Pradesh,12,5,5,21,43,Pass
Kunal Verma,30-11-2004,502259,Madhya Pradesh,15,4,17,10,46,Pass
Sukhwinder Singh,04-08-2005,460877,West Bengal,3,0,23,3,29,Fail
Rohan Chopra,11-12-2005,336577,Odisha,22,0,11,19,52,Pass
Yash Fernandes,08-09-2005,265175,Rajasthan,21,5,21,23,70,Pass
Aryan Khan,29-06-2005,444479,Andhra Pradesh,2,17,7,8,34,Pass
Ishaan Khan,14-03-2005,129109,Uttarakhand,18,19,4,1,42,Pass
Aditya Chopra,22-07-2005,835280,Punjab,20,15,18,17,70,Pass
Rohan Khan,27-07-2005,173860,Madhya Pradesh,5,14,7,21,47,Pass
Aditya Pillai,19-07-2005,479523,West Bengal,2,9,8,12,31,Fail
Rohan D'Souza,31-05-2005,750286,Gujarat,5,17,0,13,35,Fail
Aryan Khan,17-02-2006,641218,Andhra Pradesh,20,1,10,22,53,Pass
Rohan Fernandes,11-02-2006,155969,Bihar,8,23,0,9,40,Pass
Vivaan Khan,15-01-2005,995945,Haryana,2,0,0,3,5,Pass
Raj Reddy,11-02-2005,662347,Punjab,15,0,16,23,54,Pass
Raj Pillai,08-02-2006,848446,Uttarakhand,23,5,2,18,48,Pass
Ishaan Singh,12-12-2004,474380,Punjab,0,9,17,0,26,Pass
Ishaan Chopra,03-05-2005,603819,Tamil Nadu,24,12,9,14,59,Pass
Gurpreet Chopra,14-05-2005,721489,Punjab,18,21,21,13,73,Pass
David Verma,27-04-2006,429198,Karnataka,24,6,23,1,54,Pass
Imran Fernandes,28-01-2006,317935,Bihar,7,10,3,7,27,Pass
Aarav Mehta,29-04-2005,395918,Meghalaya,13,11,2,15,41,Pass
Rohan Verma,19-12-2004,571937,Odisha,13,19,2,2,36,Pass
Raj Singh,22-06-2005,732757,Punjab,9,16,8,15,48,Pass
Kunal Mehta,18-12-2004,992606,Maharashtra,16,5,1,24,46,Pass
Zaid Fernandes,07-04-2005,876024,Delhi,11,11,23,17,62,Pass
Kunal Verma,06-01-2005,370532,Jharkhand,20,1,14,7,42,Pass
Vivaan Pillai,31-01-2006,924755,Himachal Pradesh,22,9,11,12,54,Pass
Yash Reddy,29-04-2005,781114,Bihar,13,19,9,19,60,Pass
Rohan Chopra,29-05-2005,474338,Bihar,8,9,17,2,36,Pass
Aarav Mehta,10-02-2006,165784,Bihar,9,14,23,7,53,Pass
Yash Chopra,09-09-2005,177137,Madhya Pradesh,2,4,17,24,47,Pass
Manpreet Singh,15-03-2006,199133,Assam,15,22,2,15,54,Pass
Rohan Chopra,24-05-2005,465705,Kerala,0,9,8,22,39,Fail
Mathew Khan,06-05-2006,399249,Chhattisgarh,7,2,11,8,28,Fail
Vivaan Pillai,31-10-2005,494057,Punjab,7,15,8,19,49,Pass
Kunal Verma,08-06-2005,535445,Punjab,19,7,15,5,46,Pass
Vivaan Mehta,29-01-2005,161259,Bihar,11,3,21,3,38,Pass
Aryan Reddy,26-11-2005,428804,Odisha,18,7,8,2,35,Pass
Ishaan Singh,01-04-2006,695454,Tamil Nadu,23,10,4,24,61,Pass
Ishaan Khan,09-02-2005,937935,Jharkhand,12,14,12,19,57,Pass
Kunal Verma,22-10-2005,545450,West Bengal,12,24,4,24,64,Fail
Ayaan Reddy,30-01-2005,200107,Maharashtra,18,22,13,3,56,Pass
Aditya Chopra,15-10-2005,876860,Uttarakhand,19,9,3,13,44,Pass
Aarav Mehta,20-03-2005,752161,Uttar Pradesh,2,21,20,9,52,Pass
Gurpreet Mehta,04-03-2006,792589,Bihar,24,16,12,4,56,Pass
Ishaan Sharma,16-05-2005,366868,Telangana,4,2,1,20,27,Pass
Aditya Fernandes,18-02-2006,317539,Uttar Pradesh,7,19,8,9,43,Pass
Aryan Singh,26-10-2005,689528,Rajasthan,13,12,23,10,58,Pass
David Fernandes,10-04-2006,790548,Haryana,10,10,24,5,49,Pass
Yash Pillai,28-06-2005,192905,Himachal Pradesh,23,23,5,1,52,Pass
Aryan Verma,05-05-2006,967911,Uttar Pradesh,18,5,23,19,65,Pass
David Fernandes,31-12-2004,662193,Uttar Pradesh,11,3,19,18,51,Pass
Krishna Verma,28-05-2005,729944,Chhattisgarh,6,15,4,24,49,Fail
Vivaan D'Souza,29-08-2005,726813,Bihar,1,9,16,22,48,Pass
Aditya Singh,22-12-2005,810707,Bihar,22,16,11,0,49,Pass
Yash Mehta,29-03-2005,602936,Rajasthan,24,5,13,21,63,Pass
Vivaan Singh,15-02-2005,996582,Andhra Pradesh,18,5,14,5,42,Pass
Ishaan Pillai,23-09-2005,765486,Chhattisgarh,19,0,4,0,23,Fail
Vivaan Reddy,06-02-2006,178256,Jharkhand,4,16,22,20,62,Fail
Yash Chopra,17-09-2005,289764,Bihar,10,9,7,24,50,Pass
Kunal Mehta,23-11-2004,983637,Madhya Pradesh,0,16,5,7,28,Pass
Aarav Verma,29-04-2006,807928,Maharashtra,16,15,1,4,36,Pass
David Mehta,15-10-2005,349515,Telangana,1,7,21,19,48,Pass
Yash Reddy,11-01-2006,874782,Rajasthan,20,23,3,9,55,Pass
Aditya Chopra,19-08-2005,991987,Rajasthan,5,13,13,13,44,Pass
Aarav Verma,21-03-2006,282235,Tamil Nadu,5,16,3,14,38,Pass
Rohan Reddy,19-01-2005,621612,Uttar Pradesh,7,8,16,15,46,Pass
Harjeet Fernandes,23-09-2005,227374,Telangana,21,0,5,11,37,Pass
Aryan Singh,06-01-2006,835459,West Bengal,14,10,14,14,52,Fail
Vivaan Mehta,11-08-2005,848453,Uttar Pradesh,5,5,15,10,35,Pass
Sukhwinder Chopra,06-07-2005,811141,Tamil Nadu,12,9,11,5,37,Pass
Vivaan Chopra,11-08-2005,537909,Maharashtra,2,14,23,3,42,Pass
Peter Singh,24-12-2005,739903,Punjab,14,23,7,20,64,Pass
Yash Sharma,13-06-2005,766830,Andhra Pradesh,17,17,6,10,50,Pass
Aarav Fernandes,06-05-2006,338631,Maharashtra,23,2,22,3,50,Pass
Aryan Mehta,13-02-2006,361872,Tamil Nadu,15,3,14,12,44,Pass
Aditya Mehta,01-01-2006,193659,Bihar,21,19,5,11,56,Pass
Ayaan Reddy,22-11-2004,265516,Karnataka,1,1,21,7,30,Pass
Rohan Singh,02-02-2005,173821,Rajasthan,13,13,0,17,43,Pass
Kunal D'Souza,24-03-2005,918059,Jharkhand,6,19,0,12,37,Pass
Imran Singh,08-12-2005,960927,Maharashtra,8,20,8,8,44,Pass
Rohan Singh,04-07-2005,897940,Rajasthan,16,9,1,16,42,Pass
Aditya Fernandes,17-01-2006,182666,Rajasthan,10,10,8,3,31,Pass
Zaid Fernandes,19-12-2005,560620,Odisha,18,22,23,9,72,Pass
Ayaan Mehta,31-12-2005,208556,Rajasthan,7,4,13,13,37,Pass
Aryan Chopra,19-11-2005,329492,Madhya Pradesh,9,4,2,11,26,Pass
Rohan Singh,03-12-2005,739640,Punjab,21,19,7,21,68,Pass
David D'Souza,20-12-2004,835099,Odisha,8,18,19,8,53,Pass
Ishaan Chopra,05-09-2005,735432,Daman & Diu / D&N Haveli,17,5,20,5,47,Fail
Ishaan Fernandes,02-04-2005,758866,Kerala,10,4,23,10,47,Fail
Aryan D'Souza,05-04-2005,331624,Kerala,16,18,0,16,50,Fail
Yash Sharma,21-03-2005,314362,Bihar,8,3,16,0,27,Pass
Harjeet Khan,03-06-2005,341449,Maharashtra,6,23,13,1,43,Pass
Sukhwinder Mehta,07-05-2006,198561,Bihar,3,2,16,6,27,Pass
Aarav D'Souza,11-07-2005,344070,Madhya Pradesh,6,1,9,8,24,Pass
Harjeet Pillai,09-04-2005,381027,Maharashtra,13,5,17,2,37,Pass
Aditya Mehta,14-11-2004,176817,Tamil Nadu,16,7,8,12,43,Fail
Raj Khan,14-11-2004,576255,Andhra Pradesh,23,8,1,18,50,Pass
Raj Mehta,12-07-2005,293154,Uttar Pradesh,21,0,4,17,42,Pass
Ishaan Reddy,29-12-2005,390119,Telangana,4,19,2,5,30,Pass
Aryan Fernandes,06-04-2005,928285,Odisha,7,20,11,23,61,Pass
Ishaan Chopra,23-12-2005,491345,Bihar,4,4,17,7,32,Pass
Vivaan Chopra,04-10-2005,347249,Meghalaya,2,13,16,15,46,Fail
Aryan Fernandes,22-05-2005,316790,Chhattisgarh,11,2,7,12,32,Fail
Farhan Sharma,17-02-2005,958010,Madhya Pradesh,8,18,3,2,31,Pass
Manpreet Reddy,16-02-2006,477506,Rajasthan,22,8,4,15,49,Pass
Krishna Chopra,08-10-2005,848993,Punjab,4,5,24,4,37,Pass
Aditya Singh,14-02-2005,459951,Chhattisgarh,24,7,1,13,45,Fail
Kunal Mehta,31-07-2005,818560,Gujarat,0,9,20,11,40,Fail
Yash Pillai,25-10-2005,294400,Bihar,23,3,22,8,56,Pass
Yash Chopra,20-12-2004,339772,Maharashtra,13,9,17,3,42,Pass
Aarav Mehta,23-01-2005,401545,Maharashtra,1,5,2,10,18,Pass
Raj Pillai,02-12-2005,915614,Jammu & Kashmir + Ladakh,20,5,12,7,44,Pass
Yash Khan,16-04-2006,726641,Haryana,17,16,0,4,37,Pass
Vivaan Reddy,06-05-2006,487837,Delhi,6,3,21,1,31,Pass
Raj D'Souza,04-03-2005,897451,Uttar Pradesh,24,0,6,3,33,Pass
Kunal Mehta,16-01-2006,909949,Rajasthan,24,1,18,17,60,Pass
Krishna Chopra,19-02-2005,641363,Andhra Pradesh,3,12,23,0,38,Pass
Kunal Sharma,27-12-2005,343688,Bihar,11,19,10,19,59,Pass
Krishna Reddy,21-04-2006,936869,Tamil Nadu,14,0,17,3,34,Pass
Yash Pillai,13-05-2005,912279,Andhra Pradesh,15,18,3,12,48,Pass
Raj Chopra,29-10-2005,546418,Uttar Pradesh,18,8,22,5,53,Pass
Yash Sharma,04-06-2005,124911,West Bengal,24,7,14,13,58,Fail
Gurpreet Mehta,12-04-2005,676189,Punjab,14,21,8,23,66,Pass
Gurpreet Fernandes,04-08-2005,522433,Gujarat,6,17,3,5,31,Fail
Aryan Sharma,14-04-2005,910543,Tamil Nadu,10,12,2,23,47,Pass
Rohan Khan,24-04-2005,909377,Punjab,23,4,10,16,53,Pass
Sukhwinder Mehta,08-12-2005,242202,Maharashtra,24,8,24,3,59,Pass
Vivaan Pillai,06-07-2005,545762,Jharkhand,22,8,3,5,38,Pass
Aditya Mehta,24-07-2005,325545,Madhya Pradesh,7,4,24,2,37,Pass
Kunal Singh,05-08-2005,610502,Madhya Pradesh,8,4,13,4,29,Pass
Krishna Reddy,07-11-2005,556643,Maharashtra,18,24,13,3,58,Pass
Aryan Singh,23-08-2005,462036,West Bengal,9,5,19,1,34,Fail
John Sharma,31-01-2006,632659,Madhya Pradesh,12,19,2,9,42,Pass
Ishaan D'Souza,30-01-2005,909708,Gujarat,19,16,11,8,54,Fail
Ishaan Sharma,25-03-2006,826605,Telangana,14,14,24,12,64,Fail
Aryan D'Souza,05-05-2006,711390,Bihar,8,17,6,15,46,Pass
Peter Pillai,18-05-2005,390041,Andhra Pradesh,3,12,8,20,43,Pass
Peter Reddy,07-11-2005,875780,Tamil Nadu,15,2,13,23,53,Fail
Ishaan Fernandes,01-05-2006,767100,Punjab,18,4,11,19,52,Pass
Ishaan Khan,06-03-2006,921577,Tamil Nadu,19,10,0,21,50,Fail
Aryan Verma,14-04-2005,488534,Rajasthan,8,0,1,16,25,Pass
Aryan Chopra,22-06-2005,375721,Chhattisgarh,20,20,2,23,65,Fail
Sukhwinder Reddy,23-03-2005,752515,Jammu & Kashmir + Ladakh,1,10,1,0,12,Pass
Rohan Verma,14-04-2005,678460,Manipur,17,11,10,0,38,Fail
Krishna Chopra,12-05-2005,618072,West Bengal,23,21,15,12,71,Fail
Peter Mehta,25-02-2006,287308,Uttar Pradesh,1,5,8,23,37,Pass
Gurpreet Reddy,21-01-2005,320856,Punjab,6,18,18,19,61,Pass
Ishaan Chopra,29-03-2005,957709,Tamil Nadu,12,3,8,2,25,Pass
Manpreet Verma,25-12-2005,200948,Bihar,3,24,12,9,48,Pass
Sukhwinder D'Souza,20-12-2005,427571,Rajasthan,18,9,5,20,52,Pass
Vivaan Singh,14-08-2005,744845,Haryana,18,23,23,15,79,Pass
Gurpreet Chopra,26-11-2005,639430,Jammu & Kashmir + Ladakh,15,12,15,6,48,Pass
Ishaan D'Souza,18-12-2004,670102,Arunachal Pradesh,3,4,24,19,50,Fail
Sukhwinder Sharma,31-12-2005,898717,Chhattisgarh,18,0,0,6,24,Fail
Aryan Reddy,06-12-2004,820404,Karnataka,12,20,0,0,32,Pass
Balbir Verma,17-11-2005,234966,West Bengal,15,14,7,21,57,Fail
Raj Chopra,27-09-2005,554058,Rajasthan,18,20,17,15,70,Pass
Ishaan Verma,04-02-2006,203001,Gujarat,1,4,21,19,45,Fail
John Chopra,23-03-2006,723920,Uttar Pradesh,9,23,14,1,47,Pass
Peter Khan,22-12-2004,503291,Tamil Nadu,11,16,7,2,36,Pass
Raj Fernandes,24-05-2005,795629,Maharashtra,1,19,15,3,38,Pass
Raj Fernandes,29-05-2005,876091,Punjab,7,8,3,23,41,Pass
Balbir Sharma,03-07-2005,761375,Haryana,15,23,5,0,43,Pass
Rohan Reddy,14-01-2006,423871,Uttar Pradesh,10,3,2,18,33,Pass
Gurpreet Sharma,30-05-2005,115278,Bihar,10,15,1,19,45,Pass
Yash Sharma,25-07-2005,514771,West Bengal,2,12,18,18,50,Fail
John D'Souza,11-05-2005,462882,Haryana,9,20,23,24,76,Pass
Gurpreet Pillai,11-05-2005,821646,Tamil Nadu,7,2,4,2,15,Pass
Vivaan Verma,30-08-2005,243934,Bihar,6,15,2,5,28,Pass
Kunal Singh,12-03-2006,545526,Punjab,7,19,1,19,46,Pass
Krishna Pillai,24-02-2005,241939,Bihar,17,21,23,17,78,Pass
Mathew Khan,16-08-2005,971869,Uttar Pradesh,6,1,17,11,35,Pass
Ishaan Chopra,17-10-2005,308799,Uttar Pradesh,4,15,5,2,26,Pass
Ishaan Mehta,24-03-2006,548404,Uttar Pradesh,5,16,16,17,54,Pass
Aarav Reddy,17-07-2005,980999,West Bengal,10,22,5,7,44,Fail
Aditya Khan,20-12-2005,992993,Jharkhand,11,6,24,1,42,Pass
Krishna Fernandes,12-02-2005,965441,Rajasthan,24,20,13,24,81,Pass
Aditya D'Souza,13-07-2005,150085,Madhya Pradesh,24,4,7,19,54,Pass
Aryan D'Souza,14-05-2005,801181,Andhra Pradesh,12,22,3,16,53,Pass
Manpreet Reddy,06-06-2005,766448,Uttar Pradesh,3,16,7,2,28,Pass
Paul Mehta,18-08-2005,998631,Uttar Pradesh,4,17,18,3,42,Pass
Krishna Verma,19-11-2004,428401,Andhra Pradesh,15,13,3,14,45,Pass
Rehan Reddy,05-04-2005,911530,Maharashtra,4,2,11,8,25,Pass
John Chopra,25-12-2004,911802,Bihar,23,9,6,10,48,Pass
Raj Chopra,29-04-2005,774991,Uttar Pradesh,19,14,19,11,63,Pass
Aditya D'Souza,23-05-2005,114177,West Bengal,8,24,3,13,48,Fail
John Fernandes,03-01-2006,789040,Karnataka,8,10,13,21,52,Pass
Vivaan Singh,01-04-2006,369214,Bihar,6,9,11,21,47,Pass
Peter Fernandes,25-03-2005,256701,Rajasthan,24,9,7,6,46,Pass
Balbir Mehta,01-10-2005,216098,Odisha,2,8,16,10,36,Pass
Kunal Verma,12-12-2005,176739,Bihar,5,6,0,2,13,Pass
Gurpreet Khan,07-04-2006,190017,Uttar Pradesh,12,16,17,22,67,Pass
Krishna Fernandes,24-10-2005,597223,Gujarat,12,22,18,2,54,Fail
Rohan Khan,25-04-2005,516893,Jharkhand,16,3,23,17,59,Pass
Aarav Chopra,04-04-2005,509395,Maharashtra,4,0,9,23,36,Pass
Aarav Pillai,08-08-2005,814063,Maharashtra,1,11,17,17,46,Pass
Balbir Singh,03-06-2005,828747,Haryana,24,17,14,3,58,Pass
Vivaan Singh,18-11-2004,811229,Gujarat,6,19,3,8,36,Fail
Rohan Fernandes,24-07-2005,247263,Madhya Pradesh,10,19,16,1,46,Pass
Aditya Pillai,08-09-2005,648256,Gujarat,0,3,10,3,16,Fail
Krishna Sharma,22-09-2005,639706,Maharashtra,12,16,13,3,44,Pass
Krishna Singh,16-01-2006,519567,Rajasthan,17,22,22,0,61,Pass
Farhan Chopra,13-04-2006,291134,Rajasthan,24,18,16,23,81,Pass
Vivaan Singh,10-07-2005,603727,Rajasthan,23,5,23,3,54,Pass
Manpreet D'Souza,26-12-2005,269036,Telangana,3,5,5,23,36,Pass
Kunal Reddy,08-12-2005,911558,Uttar Pradesh,10,3,11,0,24,Pass
Sukhwinder Verma,03-04-2006,307711,Rajasthan,15,7,15,19,56,Pass
Aarav Sharma,02-03-2005,434773,Uttar Pradesh,11,1,6,11,29,Pass
Kunal Khan,03-01-2005,662648,Telangana,2,13,23,7,45,Pass
David Mehta,10-04-2006,953070,Bihar,24,5,9,3,41,Pass
Ishaan Sharma,20-04-2006,404542,Delhi,21,23,19,14,77,Pass
Aarav Fernandes,05-05-2006,774676,Andhra Pradesh,10,22,14,21,67,Pass
Kunal Sharma,08-11-2004,811075,Karnataka,6,11,9,18,44,Pass
John Mehta,15-11-2004,384871,Madhya Pradesh,11,22,5,16,54,Pass
Vivaan D'Souza,25-10-2005,222011,Uttar Pradesh,21,13,8,23,65,Pass
Rohan Chopra,31-12-2004,403255,Assam,9,17,12,1,39,Pass
Balbir Fernandes,10-10-2005,885831,Telangana,16,12,22,8,58,Fail
Aryan Singh,10-07-2005,890036,Telangana,19,19,23,9,70,Fail
Rohan Sharma,24-12-2004,225876,Tripura,13,10,12,14,49,Pass
Sukhwinder Singh,12-03-2006,976701,Maharashtra,22,12,2,3,39,Pass
Balbir Pillai,06-10-2005,121545,Gujarat,7,2,6,8,23,Fail
Harjeet Chopra,11-11-2005,826530,Uttar Pradesh,8,23,1,1,33,Pass
Imran Khan,06-10-2005,140425,Telangana,12,14,7,3,36,Pass
Sukhwinder Khan,24-12-2004,672996,West Bengal,22,8,21,17,68,Fail
Krishna D'Souza,19-11-2004,305026,Rajasthan,13,12,16,16,57,Pass
Krishna Singh,05-01-2005,484089,Jharkhand,12,13,12,10,47,Pass
Aarav Reddy,19-10-2005,994947,Madhya Pradesh,13,8,10,17,48,Pass
Gurpreet Mehta,16-05-2005,183477,Odisha,22,4,8,22,56,Pass
David Khan,08-11-2005,248653,Madhya Pradesh,11,13,12,11,47,Pass
Farhan Chopra,06-03-2006,388258,Telangana,13,19,14,7,53,Fail
John D'Souza,07-01-2005,865828,Gujarat,6,11,11,15,43,Fail
Vivaan Fernandes,04-02-2005,643864,Haryana,11,11,12,11,45,Pass
Aditya Khan,23-12-2004,539559,Uttar Pradesh,7,9,21,21,58,Pass
Ayaan Mehta,25-01-2005,271895,Madhya Pradesh,5,20,12,15,52,Pass
Sukhwinder Verma,11-08-2005,418666,Uttar Pradesh,15,2,18,24,59,Pass
Balbir Singh,06-08-2005,849559,Uttar Pradesh,5,22,6,17,50,Pass
Aditya Reddy,27-11-2004,358805,Bihar,16,16,20,8,60,Pass
Raj Sharma,06-08-2005,739258,Tamil Nadu,5,23,20,16,64,Fail
Yash Verma,10-04-2006,536171,Haryana,24,5,18,2,49,Pass
Aryan Reddy,10-11-2005,427146,Tamil Nadu,13,15,18,23,69,Pass
Sukhwinder Fernandes,02-07-2005,300024,Uttar Pradesh,8,24,6,2,40,Pass
Rehan Sharma,02-09-2005,604161,Tripura,24,8,24,10,66,Pass
Vivaan Singh,08-03-2006,708496,Uttar Pradesh,1,16,1,11,29,Pass
Aditya Pillai,03-05-2005,725961,Delhi,11,3,17,8,39,Pass
Yash Sharma,23-03-2006,149437,Uttar Pradesh,21,15,23,12,71,Pass
Vivaan Mehta,13-06-2005,495518,Bihar,11,15,15,10,51,Pass
Krishna Khan,24-12-2005,805947,Bihar,11,7,22,13,53,Pass
Vivaan Sharma,28-07-2005,726176,Gujarat,9,5,22,16,52,Fail
Aditya Singh,08-01-2005,953124,Karnataka,3,21,18,19,61,Pass
Harjeet Chopra,06-04-2006,123361,Himachal Pradesh,6,21,11,6,44,Pass
Peter Pillai,25-09-2005,417574,Uttar Pradesh,1,8,2,14,25,Pass
Aryan Pillai,07-07-2005,582730,Jammu & Kashmir + Ladakh,7,11,10,15,43,Pass
Aryan D'Souza,25-08-2005,484929,Haryana,10,1,5,9,25,Pass
Gurpreet Chopra,09-03-2005,730871,Gujarat,20,4,9,15,48,Fail
John Khan,11-01-2005,821292,Punjab,17,20,8,9,54,Pass
Aditya Singh,30-12-2005,628165,Madhya Pradesh,0,20,13,14,47,Pass
Yash D'Souza,10-11-2004,420309,Maharashtra,4,10,14,4,32,Pass
Manpreet Chopra,15-03-2006,261685,Uttar Pradesh,3,19,1,4,27,Pass
Aditya D'Souza,02-09-2005,393368,Himachal Pradesh,20,0,6,20,46,Pass
Ishaan Khan,05-07-2005,855947,West Bengal,0,12,3,4,19,Fail
Ishaan Pillai,01-08-2005,404692,Odisha,16,19,22,23,80,Pass
Krishna Mehta,05-09-2005,160287,Bihar,15,3,18,2,38,Pass
Kunal Khan,14-03-2005,902528,Punjab,10,19,2,19,50,Pass
Sukhwinder Mehta,03-08-2005,297005,Maharashtra,14,11,19,3,47,Pass
Aryan Chopra,26-12-2004,812393,Maharashtra,19,18,20,3,60,Pass
Krishna Sharma,13-04-2006,267814,Odisha,20,11,13,21,65,Pass
Aarav Chopra,04-01-2005,328298,Andhra Pradesh,14,0,1,4,19,Pass
Gurpreet Fernandes,09-12-2004,412288,Odisha,24,0,11,5,40,Pass
Yash Verma,12-11-2004,469136,Telangana,18,1,10,21,50,Fail
Sukhwinder D'Souza,28-03-2006,301537,Haryana,16,9,18,24,67,Pass
Kunal Mehta,14-04-2006,470877,Karnataka,16,19,16,19,70,Fail
Sukhwinder Singh,04-01-2005,647805,Uttar Pradesh,20,17,23,8,68,Pass
Aarav D'Souza,19-11-2004,383630,Jharkhand,0,16,6,1,23,Pass
Kunal Pillai,05-04-2006,244664,Telangana,7,6,10,7,30,Pass
Aditya Khan,05-04-2005,832146,Gujarat,20,14,18,1,53,Fail
Yash Khan,13-11-2004,243399,Andhra Pradesh,14,1,15,3,33,Pass
Aarav Fernandes,14-03-2006,134116,Rajasthan,6,10,6,8,30,Pass
Aarav D'Souza,04-08-2005,433115,Punjab,7,18,12,5,42,Pass
Harjeet Mehta,06-07-2005,975864,Gujarat,3,12,6,18,39,Fail
Aditya Fernandes,29-01-2005,542421,Karnataka,19,11,17,17,64,Pass
Raj Chopra,05-12-2005,192721,Andhra Pradesh,21,21,15,20,77,Pass
Aditya Fernandes,13-05-2005,741061,Odisha,14,7,8,13,42,Pass
Vivaan D'Souza,12-08-2005,413118,Haryana,2,23,17,12,54,Pass
Sukhwinder Fernandes,05-01-2005,206316,Tripura,16,2,20,6,44,Pass
John D'Souza,04-05-2006,742300,Bihar,1,2,22,24,49,Pass
Aditya Reddy,04-12-2005,955385,Haryana,14,13,18,1,46,Pass
Aditya Pillai,11-08-2005,902559,Andhra Pradesh,6,14,17,10,47,Pass
Raj Singh,08-01-2006,948019,Uttar Pradesh,0,17,18,7,42,Pass
Yash Singh,29-04-2005,387035,Maharashtra,15,7,13,3,38,Pass
Sukhwinder D'Souza,16-02-2006,630118,Maharashtra,17,23,15,3,58,Pass
Aditya Chopra,14-09-2005,340587,Punjab,16,5,22,12,55,Pass
Kunal Reddy,10-11-2004,141782,Maharashtra,3,16,20,3,42,Pass
Aryan Pillai,17-07-2005,665235,Jharkhand,8,15,8,13,44,Pass
Yash Chopra,28-04-2006,724549,Madhya Pradesh,0,14,22,9,45,Pass
Rohan Mehta,31-12-2004,298919,Bihar,18,17,2,21,58,Pass
Aarav Singh,20-10-2005,425125,West Bengal,7,17,23,4,51,Fail
Mathew Singh,29-12-2004,509567,Gujarat,22,15,8,6,51,Fail
Aarav Reddy,14-01-2005,642574,Jammu & Kashmir + Ladakh,7,12,3,6,28,Pass
Manpreet Singh,26-04-2005,430282,Delhi,5,21,16,22,64,Pass
Aryan Fernandes,23-10-2005,750799,Odisha,2,22,0,18,42,Pass
Aarav Mehta,29-03-2006,178005,Telangana,11,2,5,17,35,Pass
Balbir Mehta,22-07-2005,723623,Bihar,7,7,11,11,36,Pass
Aarav Singh,29-07-2005,808628,Jammu & Kashmir + Ladakh,4,23,2,23,52,Pass
Ishaan Pillai,09-09-2005,847356,Punjab,3,2,17,13,35,Pass
Ishaan Mehta,10-11-2005,878463,Madhya Pradesh,14,0,18,23,55,Pass
Gurpreet Pillai,16-07-2005,929537,Bihar,14,10,7,13,44,Pass
Aryan Reddy,02-04-2005,108621,Bihar,11,7,14,12,44,Pass
Krishna Pillai,04-05-2005,594727,Rajasthan,14,12,8,13,47,Pass
Sukhwinder Singh,01-06-2005,756705,Uttar Pradesh,5,2,12,2,21,Pass
Aarav Verma,26-06-2005,214558,Rajasthan,13,1,1,8,23,Pass
Ishaan Verma,25-08-2005,360422,Bihar,24,6,2,24,56,Pass
Raj Fernandes,29-09-2005,489580,Madhya Pradesh,11,4,15,18,48,Pass
Krishna D'Souza,08-03-2005,349460,Maharashtra,12,18,4,11,45,Pass
Aarav Singh,07-12-2005,745464,Odisha,20,3,1,7,31,Pass
Vivaan Mehta,18-11-2005,394538,Telangana,7,11,23,17,58,Fail
Vivaan Singh,22-12-2004,517077,Jharkhand,9,20,1,20,50,Pass
Aarav Khan,03-11-2005,937845,Punjab,8,22,22,24,76,Pass
Aditya Chopra,14-04-2005,947483,Andhra Pradesh,0,22,16,14,52,Pass
Aarav Pillai,04-05-2006,466676,Karnataka,11,22,6,0,39,Pass
Mathew D'Souza,15-03-2006,449953,Rajasthan,12,22,3,18,55,Pass
Harjeet Fernandes,20-12-2005,976286,Bihar,22,10,15,3,50,Pass
Raj Chopra,21-05-2005,813997,West Bengal,14,3,7,13,37,Fail
Rohan Khan,03-07-2005,225462,Uttar Pradesh,5,7,1,22,35,Pass
Gurpreet Chopra,18-08-2005,309014,Bihar,2,18,23,11,54,Pass
John Reddy,12-10-2005,396328,Nagaland,4,20,20,20,64,Fail
Vivaan Mehta,12-03-2006,520484,Punjab,22,13,5,24,64,Pass
Aryan Reddy,08-01-2006,559068,West Bengal,8,3,24,4,39,Fail
Ishaan Mehta,18-02-2006,805936,Tamil Nadu,2,4,13,22,41,Pass
Aryan Reddy,05-04-2005,156485,Maharashtra,11,4,21,3,39,Pass
Manpreet Reddy,03-12-2005,486176,Telangana,21,11,16,13,61,Pass
Kunal Sharma,22-01-2005,685453,Gujarat,15,10,23,17,65,Fail
Krishna Reddy,13-11-2005,148602,Bihar,6,12,1,22,41,Pass
Sukhwinder Chopra,19-09-2005,574845,Punjab,20,17,16,0,53,Pass
Gurpreet Mehta,05-03-2005,290018,Tamil Nadu,23,21,5,0,49,Fail
Raj Fernandes,28-04-2005,720893,Kerala,1,17,9,1,28,Fail
Yash Fernandes,11-01-2006,277932,Uttar Pradesh,18,11,16,13,58,Pass
Rohan Reddy,10-03-2006,616861,Haryana,6,20,12,8,46,Pass
Aryan Sharma,25-10-2005,416261,Andhra Pradesh,21,18,14,7,60,Pass
Aryan Verma,05-03-2006,913097,Gujarat,22,3,8,15,48,Fail
Peter Pillai,09-02-2006,164725,Maharashtra,11,18,2,9,40,Pass
Vivaan Pillai,26-10-2005,156779,Gujarat,19,21,19,23,82,Fail
Aditya Fernandes,18-08-2005,700991,Haryana,10,1,14,0,25,Pass
David D'Souza,27-03-2005,425346,Odisha,11,15,13,16,55,Pass
Peter Reddy,04-02-2005,258590,Jharkhand,24,8,0,24,56,Pass
Imran Pillai,25-08-2005,737175,Uttar Pradesh,12,6,3,2,23,Pass
Aarav Pillai,01-04-2005,896865,Jharkhand,15,14,7,1,37,Pass
Balbir Khan,08-03-2005,183146,Rajasthan,17,10,18,0,45,Pass
Krishna Khan,14-10-2005,889692,Uttar Pradesh,11,24,12,15,62,Pass
Rohan Chopra,17-04-2005,913345,Haryana,17,12,7,10,46,Pass
Aditya Singh,07-03-2005,173799,Jharkhand,0,6,14,7,27,Pass
Rohan Pillai,04-12-2005,992197,Karnataka,10,18,14,6,48,Pass
Yash D'Souza,04-08-2005,624890,West Bengal,11,17,10,4,42,Fail
Sukhwinder Pillai,05-06-2005,359445,Maharashtra,11,21,0,2,34,Pass
Vivaan Verma,03-03-2006,131443,Rajasthan,2,7,4,1,14,Pass
David Verma,10-11-2004,362501,Uttar Pradesh,7,20,4,0,31,Pass
Harjeet Chopra,01-07-2005,329299,Bihar,20,18,23,0,61,Pass
Vivaan Khan,24-06-2005,902345,Bihar,10,1,16,8,35,Pass
Rohan Verma,10-05-2005,659867,Andhra Pradesh,1,5,1,15,22,Pass
Rohan Mehta,27-07-2005,811699,Bihar,6,5,13,12,36,Pass
Vivaan D'Souza,13-01-2006,957583,Uttar Pradesh,5,15,9,8,37,Pass
Aryan Khan,22-02-2005,241794,Rajasthan,21,10,20,6,57,Pass
Paul Mehta,16-11-2005,155583,Rajasthan,23,22,1,19,65,Pass
Kunal Singh,19-08-2005,504253,Daman & Diu / D&N Haveli,23,22,6,4,55,Fail
Aryan Khan,11-11-2005,332238,Punjab,13,8,7,21,49,Pass
Yash Reddy,09-03-2006,887890,Uttar Pradesh,7,17,14,16,54,Pass
Vivaan Sharma,01-03-2006,654312,Kerala,1,8,7,10,26,Fail
Aryan Mehta,14-06-2005,754716,Himachal Pradesh,5,3,7,5,20,Pass
Rohan Singh,26-09-2005,804788,Bihar,13,3,12,20,48,Pass
Ishaan Mehta,09-11-2004,183760,Rajasthan,3,16,19,24,62,Pass
Aryan Reddy,15-09-2005,392804,Rajasthan,10,14,4,14,42,Pass
Balbir Mehta,24-06-2005,715555,Uttarakhand,1,4,8,12,25,Pass
Kunal Verma,27-01-2006,735972,Rajasthan,9,15,12,22,58,Pass
Gurpreet Fernandes,19-09-2005,844908,Bihar,11,15,16,11,53,Pass
Raj Reddy,12-07-2005,561292,Haryana,10,21,17,23,71,Pass
Vivaan Singh,11-03-2005,573851,Odisha,24,15,2,16,57,Pass
Vivaan Khan,02-01-2006,419217,Kerala,5,23,18,7,53,Fail
Mathew Mehta,04-12-2004,297389,Maharashtra,0,15,6,16,37,Pass
Kunal Chopra,18-05-2005,443680,Rajasthan,5,16,15,4,40,Pass
Yash Singh,22-04-2005,534391,Rajasthan,5,6,4,12,27,Pass
Ishaan Khan,08-11-2005,745855,Telangana,10,7,16,15,48,Pass
Gurpreet Khan,02-05-2005,148536,Punjab,23,2,22,3,50,Pass
Krishna Mehta,29-01-2005,554361,Nagaland,17,20,20,13,70,Fail
Aarav Reddy,22-06-2005,215169,Bihar,0,24,24,14,62,Pass
Ayaan Khan,01-02-2005,959190,Andhra Pradesh,4,1,13,10,28,Pass
Kunal Reddy,24-02-2006,405261,Kerala,10,16,4,5,35,Fail
Aryan Mehta,09-12-2005,932734,West Bengal,0,10,8,5,23,Fail
John Khan,12-03-2005,927524,Odisha,21,12,23,20,76,Pass
Manpreet Verma,31-08-2005,846825,Andhra Pradesh,21,1,14,23,59,Pass
Aarav Singh,25-11-2004,610633,Madhya Pradesh,20,0,2,19,41,Pass
Vivaan D'Souza,12-11-2004,266062,West Bengal,18,12,10,8,48,Fail
Aditya Reddy,29-06-2005,160611,Maharashtra,10,15,14,3,42,Pass
Ishaan Sharma,25-02-2006,403421,Maharashtra,12,13,2,5,32,Pass
Ishaan Reddy,08-01-2005,277073,Punjab,0,8,19,1,28,Pass
Vivaan Khan,14-12-2005,350944,Haryana,16,10,6,12,44,Pass
Aryan Sharma,12-10-2005,561934,Delhi,16,18,3,10,47,Pass
Kunal Reddy,13-03-2005,488760,Assam,20,5,8,21,54,Pass
Aryan Chopra,04-05-2005,414581,Maharashtra,21,13,16,3,53,Pass
Aryan D'Souza,07-04-2006,757630,Kerala,16,8,1,3,28,Fail
Rohan Khan,06-07-2005,819250,Bihar,13,7,21,14,55,Pass
Gurpreet Khan,30-12-2005,163708,Telangana,13,6,19,17,55,Fail
Vivaan Fernandes,26-11-2004,917847,Uttar Pradesh,8,24,12,12,56,Pass
Rehan Reddy,18-03-2006,417477,Rajasthan,0,0,9,12,21,Pass
Raj Singh,09-06-2005,585110,Chhattisgarh,0,17,2,4,23,Fail
David Khan,05-08-2005,586829,Gujarat,4,11,2,22,39,Fail
Rohan Pillai,29-12-2005,162440,Tamil Nadu,21,17,6,14,58,Fail
Aarav Reddy,19-11-2005,703774,Uttar Pradesh,11,16,12,5,44,Pass
Vivaan D'Souza,11-10-2005,344212,Tamil Nadu,19,14,2,7,42,Pass
Vivaan Fernandes,20-09-2005,320918,Punjab,11,0,15,20,46,Pass
Yash Mehta,24-03-2006,518198,Odisha,7,18,21,22,68,Pass
Rohan D'Souza,10-02-2005,993416,Jharkhand,4,10,23,19,56,Fail
Vivaan Fernandes,31-12-2004,494623,Gujarat,8,23,11,19,61,Fail
Kunal Pillai,30-03-2005,847672,Tamil Nadu,9,17,17,5,48,Fail
Balbir Sharma,18-08-2005,606115,Tamil Nadu,23,14,24,9,70,Fail
Kunal Verma,28-09-2005,663787,Gujarat,20,11,4,7,42,Fail
Aditya Reddy,04-08-2005,673001,Telangana,2,5,14,5,26,Pass
Rohan Fernandes,05-07-2005,151615,Maharashtra,3,5,24,3,35,Pass
Aditya Pillai,19-03-2006,171446,Rajasthan,21,22,18,8,69,Pass
Aarav Chopra,15-03-2006,395749,Rajasthan,11,23,14,0,48,Pass
Gurpreet Singh,27-11-2004,871871,Andhra Pradesh,15,20,8,24,67,Pass
Rohan Khan,11-10-2005,181914,Haryana,18,21,0,20,59,Pass
Aryan Fernandes,15-12-2005,600962,Uttarakhand,24,17,3,19,63,Pass
Kunal Mehta,05-01-2006,836084,Chhattisgarh,3,1,23,16,43,Fail
Yash Sharma,28-11-2004,358544,Bihar,0,9,16,17,42,Pass
Raj D'Souza,04-01-2005,619287,Jammu & Kashmir + Ladakh,14,0,15,21,50,Pass
Sukhwinder Sharma,10-02-2006,112286,Assam,17,20,1,18,56,Pass
Raj Mehta,09-08-2005,878274,Delhi,13,1,5,18,37,Pass
Kunal Sharma,22-12-2004,382345,Rajasthan,20,1,2,23,46,Pass
Ishaan Verma,12-10-2005,627972,Uttar Pradesh,5,15,16,19,55,Pass
Rehan Khan,18-06-2005,300383,Madhya Pradesh,18,3,10,24,55,Pass
Aarav D'Souza,14-07-2005,203649,Uttar Pradesh,6,13,22,18,59,Pass
John Fernandes,12-02-2005,591583,Haryana,12,24,16,13,65,Pass
Gurpreet Reddy,17-08-2005,651601,Uttar Pradesh,4,5,10,8,27,Pass
Aryan Singh,21-04-2006,174366,Haryana,6,19,9,13,47,Pass
Raj Fernandes,10-11-2005,578074,Madhya Pradesh,13,20,3,16,52,Pass
Kunal Mehta,27-05-2005,116526,Maharashtra,0,6,11,18,35,Pass
Aryan Pillai,15-01-2005,218021,West Bengal,1,1,0,4,6,Fail
Vivaan Reddy,08-11-2004,182473,Bihar,9,3,23,19,54,Pass
Rohan Sharma,23-12-2004,152912,Uttar Pradesh,21,14,23,10,68,Pass
Imran Fernandes,31-12-2004,527511,Puducherry,4,23,2,6,35,Pass
Imran Reddy,16-09-2005,325466,Tamil Nadu,16,5,11,2,34,Pass
Rohan Mehta,19-11-2005,463918,West Bengal,19,20,0,3,42,Fail
Ishaan Reddy,17-04-2006,646182,Uttarakhand,19,20,3,13,55,Pass
John Mehta,16-04-2005,483908,Maharashtra,3,10,7,22,42,Pass
Aarav Verma,27-04-2006,649381,Bihar,21,5,13,16,55,Pass
Manpreet Khan,23-11-2005,601139,Andhra Pradesh,3,5,24,13,45,Pass
Rohan Mehta,14-11-2004,564174,Rajasthan,1,20,8,0,29,Pass
Yash Singh,03-07-2005,552948,Haryana,22,17,2,24,65,Pass
Raj Chopra,12-02-2005,986791,Uttarakhand,16,24,3,21,64,Pass
Krishna Reddy,10-12-2005,147576,Kerala,2,16,2,8,28,Fail
Aarav Verma,03-12-2005,624792,Maharashtra,6,24,23,3,56,Pass
Vivaan Chopra,14-08-2005,112888,Uttar Pradesh,1,18,14,16,49,Pass
Yash Mehta,20-06-2005,635302,Andhra Pradesh,20,9,19,12,60,Pass
Raj Mehta,13-03-2006,480855,Telangana,1,3,2,7,13,Pass
Krishna Sharma,15-11-2005,225257,Rajasthan,3,18,14,20,55,Pass
Raj Pillai,18-02-2006,692097,Gujarat,17,12,5,15,49,Fail
Rohan Sharma,27-06-2005,768368,Himachal Pradesh,9,19,23,13,64,Pass
Mathew D'Souza,18-03-2005,343856,Uttar Pradesh,6,6,10,15,37,Pass
Rehan Pillai,29-12-2005,511591,Delhi,13,17,24,24,78,Pass
Kunal Pillai,01-10-2005,583476,Jharkhand,21,24,13,5,63,Pass
Yash D'Souza,12-11-2004,137090,Delhi,11,24,15,0,50,Pass
Balbir Fernandes,30-03-2005,613217,Maharashtra,6,13,21,5,45,Pass
Mathew Verma,15-07-2005,682918,Uttarakhand,16,24,3,13,56,Pass
Aditya Mehta,29-03-2006,214075,Uttar Pradesh,15,7,3,4,29,Pass
Peter Sharma,13-03-2006,309067,Uttar Pradesh,10,18,17,1,46,Pass
Balbir Sharma,13-01-2005,277708,Tamil Nadu,15,22,16,22,75,Pass
Ayaan Sharma,24-02-2005,247893,Haryana,20,0,17,23,60,Pass
Aryan Reddy,04-03-2005,449179,Jammu & Kashmir + Ladakh,8,19,0,19,46,Pass
Yash Reddy,28-04-2005,626649,Kerala,24,20,3,10,57,Fail
Vivaan Reddy,27-01-2005,346394,Puducherry,2,5,2,1,10,Pass
Sukhwinder Verma,09-01-2006,653099,Tamil Nadu,8,8,19,19,54,Fail
Rohan Singh,28-07-2005,551424,Karnataka,3,9,6,6,24,Pass
Yash Verma,16-04-2005,548216,Tamil Nadu,15,3,4,6,28,Pass
Aryan Sharma,11-01-2006,548813,Jharkhand,22,6,7,5,40,Pass
Aryan Fernandes,24-12-2004,505272,Jharkhand,15,16,14,14,59,Pass
Raj Sharma,16-12-2004,896236,West Bengal,19,8,6,7,40,Fail
Farhan Singh,27-12-2004,638284,Bihar,1,5,9,12,27,Pass
Rohan Verma,10-03-2005,772455,Jammu & Kashmir + Ladakh,14,21,15,14,64,Pass
Krishna Chopra,31-01-2006,876826,Bihar,13,11,22,23,69,Pass
Harjeet Chopra,04-03-2006,805350,Andhra Pradesh,2,5,24,23,54,Pass
Krishna Verma,08-10-2005,346019,Gujarat,10,7,16,5,38,Fail
Sukhwinder Mehta,12-12-2005,905774,Punjab,5,24,10,24,63,Pass
Aarav D'Souza,05-05-2006,510901,Uttar Pradesh,18,19,6,8,51,Pass
Zaid Fernandes,27-02-2006,389900,Uttar Pradesh,14,8,2,24,48,Pass
Aryan Chopra,07-03-2005,262045,Andaman & Nicobar,16,4,20,10,50,Pass
Yash Khan,14-09-2005,590795,Rajasthan,4,21,11,21,57,Pass
Kunal D'Souza,12-05-2005,632260,Chhattisgarh,10,8,21,22,61,Fail
Aryan Khan,27-03-2006,477223,Bihar,0,4,9,1,14,Pass
Vivaan Sharma,22-03-2005,674855,West Bengal,11,15,2,19,47,Fail
Krishna D'Souza,02-01-2005,581509,Maharashtra,17,0,13,10,40,Pass
Aryan Sharma,20-11-2004,672318,Tamil Nadu,17,23,15,19,74,Pass
Yash Sharma,07-03-2006,225758,Telangana,7,17,12,20,56,Pass
Rohan D'Souza,18-04-2006,740623,Gujarat,0,3,23,0,26,Fail
Kunal Khan,29-01-2006,872041,Tamil Nadu,1,17,23,0,41,Pass
Sukhwinder D'Souza,13-11-2004,203271,Maharashtra,19,17,9,3,48,Pass
Krishna Verma,26-04-2005,347603,Uttar Pradesh,10,6,12,20,48,Pass
Rohan Mehta,10-12-2005,338286,Rajasthan,6,7,2,6,21,Pass
Gurpreet Khan,22-07-2005,257547,West Bengal,3,17,15,14,49,Fail
Kunal Reddy,13-06-2005,882554,Maharashtra,22,13,22,3,60,Pass
Rohan Fernandes,25-01-2006,935387,Karnataka,16,7,6,5,34,Pass
Paul Verma,15-03-2005,979556,Uttarakhand,19,18,3,0,40,Pass
Balbir Pillai,06-12-2004,862068,Andhra Pradesh,0,14,8,22,44,Pass
Raj Singh,17-04-2005,151354,Telangana,24,20,19,0,63,Fail
Peter Pillai,22-04-2006,455008,Punjab,19,3,1,10,33,Pass
Gurpreet Fernandes,11-03-2005,294004,Rajasthan,24,22,17,0,63,Pass
Rohan D'Souza,02-12-2004,574354,Uttar Pradesh,6,2,23,3,34,Pass
Ayaan Pillai,01-11-2005,242554,Odisha,11,1,13,15,40,Pass
Aditya Verma,23-10-2005,292361,Tamil Nadu,12,14,5,1,32,Pass
Harjeet Verma,16-02-2006,790139,Gujarat,24,4,5,2,35,Fail
Aditya Sharma,19-09-2005,987983,Maharashtra,3,22,11,9,45,Pass
Krishna D'Souza,17-03-2005,799032,Haryana,7,7,21,8,43,Pass
Raj Reddy,06-10-2005,696330,Kerala,14,10,23,3,50,Fail
Kunal Pillai,25-10-2005,969461,Karnataka,20,3,21,18,62,Pass
Aditya Verma,21-09-2005,873639,Uttar Pradesh,15,10,24,1,50,Pass
Kunal Sharma,22-03-2006,396828,Puducherry,17,16,15,7,55,Fail
Balbir Sharma,27-06-2005,148724,Uttar Pradesh,0,23,20,14,57,Pass
Ishaan Pillai,23-02-2005,498429,Madhya Pradesh,3,15,9,7,34,Pass
Yash Khan,15-04-2006,634543,Karnataka,16,17,4,0,37,Pass
Yash Chopra,12-02-2005,193392,Himachal Pradesh,1,12,22,3,38,Pass
Rohan Reddy,24-12-2005,836504,Madhya Pradesh,17,4,2,9,32,Pass
Ishaan Chopra,28-07-2005,650308,Bihar,23,9,17,13,62,Pass
Rohan Reddy,19-09-2005,868012,Uttarakhand,17,19,3,13,52,Pass
Peter Sharma,12-07-2005,953122,Uttar Pradesh,8,15,19,17,59,Pass
Raj Fernandes,28-06-2005,847138,Kerala,14,2,21,2,39,Fail
Gurpreet Singh,13-01-2006,646533,Maharashtra,19,20,9,3,51,Pass
Sukhwinder Chopra,13-03-2005,302197,Punjab,8,17,8,1,34,Pass
Imran Fernandes,16-12-2004,415514,Kerala,12,9,10,8,39,Fail
Vivaan D'Souza,15-11-2004,771008,Madhya Pradesh,7,24,14,9,54,Pass
Kunal D'Souza,15-04-2006,972247,West Bengal,24,8,5,23,60,Fail
Gurpreet Chopra,15-05-2005,714901,Tamil Nadu,11,10,0,9,30,Pass
Harjeet Pillai,19-04-2005,575276,Maharashtra,21,10,17,3,51,Pass
Manpreet Pillai,12-07-2005,755880,Maharashtra,14,4,13,3,34,Pass
Balbir Reddy,08-08-2005,206198,Madhya Pradesh,1,4,22,5,32,Pass
Raj Reddy,03-03-2005,734300,Andhra Pradesh,19,12,4,12,47,Pass
Krishna Pillai,31-01-2006,481725,Rajasthan,14,14,1,19,48,Pass
Aditya Fernandes,12-02-2006,548305,Delhi,0,8,8,17,33,Pass
Aditya Pillai,28-06-2005,463002,Tamil Nadu,22,5,24,24,75,Pass
Raj D'Souza,05-12-2004,682572,Uttarakhand,18,24,3,17,62,Pass
Rohan Chopra,14-08-2005,179570,Telangana,16,1,2,21,40,Pass
John D'Souza,25-06-2005,858946,Assam,5,3,5,8,21,Pass
Aditya Chopra,27-01-2006,876486,Bihar,6,11,3,23,43,Pass
Vivaan Pillai,25-06-2005,325643,Uttar Pradesh,3,3,16,2,24,Pass
Aryan Khan,30-12-2004,238119,Rajasthan,6,22,23,2,53,Pass
Aditya Reddy,29-01-2005,965025,Rajasthan,11,11,4,0,26,Pass
Mathew Fernandes,08-04-2005,117379,Uttar Pradesh,4,8,2,5,19,Pass
Yash D'Souza,31-05-2005,240330,Maharashtra,13,6,19,9,47,Pass
Kunal Pillai,25-03-2005,811614,Karnataka,9,20,9,22,60,Pass
David Chopra,08-10-2005,391719,Odisha,23,16,19,9,67,Pass
Yash Verma,11-07-2005,755544,Assam,5,7,11,17,40,Pass
Kunal Fernandes,24-12-2004,733226,Uttar Pradesh,17,22,1,11,51,Pass
Aarav D'Souza,29-04-2005,716942,Andhra Pradesh,2,11,0,19,32,Pass
Peter Verma,21-10-2005,886916,Andhra Pradesh,22,4,10,15,51,Pass
Vivaan Pillai,06-04-2006,287047,Chhattisgarh,24,19,7,8,58,Fail
Vivaan D'Souza,15-04-2005,168654,Tamil Nadu,19,17,4,19,59,Pass
Raj Verma,31-12-2005,171263,Himachal Pradesh,2,22,8,4,36,Pass
Aarav D'Souza,25-02-2005,178585,Gujarat,1,0,8,17,26,Fail
Rohan Khan,15-05-2005,105074,Maharashtra,0,16,20,6,42,Pass
Raj D'Souza,03-10-2005,393652,Uttar Pradesh,11,8,9,10,38,Pass
David Sharma,01-08-2005,177501,Karnataka,4,8,18,7,37,Pass
Ishaan Fernandes,01-09-2005,162188,Uttarakhand,1,19,3,12,35,Pass
Aryan Singh,23-11-2005,893517,Uttarakhand,4,4,3,3,14,Pass
Rohan Verma,04-05-2005,839376,Madhya Pradesh,4,20,1,24,49,Pass
Harjeet Mehta,17-01-2005,207675,Madhya Pradesh,23,4,16,20,63,Pass
Rohan Reddy,10-05-2005,399295,Manipur,7,4,0,7,18,Fail
Aditya Mehta,12-08-2005,340542,Karnataka,9,8,22,14,53,Pass
Vivaan Pillai,25-10-2005,664284,Jammu & Kashmir + Ladakh,13,16,6,9,44,Pass
Krishna Mehta,06-03-2006,701582,Maharashtra,7,17,24,3,51,Pass
Balbir Verma,20-07-2005,286125,Maharashtra,22,8,23,3,56,Pass
Gurpreet Pillai,08-07-2005,768936,West Bengal,6,4,22,21,53,Fail
Aryan D'Souza,28-05-2005,388683,Haryana,10,22,7,18,57,Pass
Aryan Verma,20-04-2006,997011,Bihar,21,4,22,1,48,Pass
Farhan Verma,19-12-2004,487934,Jammu & Kashmir + Ladakh,14,9,22,16,61,Pass
Aarav Fernandes,08-03-2005,836973,Uttar Pradesh,20,23,8,7,58,Pass
Aditya Mehta,06-05-2006,344654,Rajasthan,3,2,18,12,35,Pass
Ishaan D'Souza,18-04-2006,285936,Haryana,6,15,10,9,40,Pass
Kunal Mehta,09-02-2005,697012,Bihar,9,21,15,12,57,Pass
Imran Fernandes,12-03-2006,232324,Andhra Pradesh,0,24,6,6,36,Pass
Sukhwinder Reddy,25-03-2006,779280,Karnataka,9,6,17,20,52,Pass
Ayaan Khan,30-09-2005,950924,Punjab,18,24,13,7,62,Pass
Rohan Chopra,26-11-2005,151290,Himachal Pradesh,18,13,6,23,60,Pass
Raj Reddy,25-06-2005,920743,Madhya Pradesh,18,4,21,9,52,Pass
John Pillai,20-11-2004,814498,Jharkhand,11,21,14,9,55,Pass
Yash Verma,17-03-2005,690959,Chhattisgarh,15,1,24,23,63,Fail
Vivaan Pillai,19-01-2006,168867,Haryana,6,0,1,18,25,Pass
Krishna Verma,26-10-2005,986724,Chhattisgarh,15,19,16,10,60,Fail
Raj Singh,25-10-2005,740287,Madhya Pradesh,21,0,13,6,40,Pass
Krishna Verma,24-01-2006,282802,West Bengal,9,22,8,1,40,Fail
Krishna Fernandes,07-06-2005,372421,Jharkhand,6,8,23,13,50,Pass
Rohan Singh,20-04-2006,154550,Chhattisgarh,14,21,24,18,77,Fail
Krishna Pillai,28-09-2005,509499,Maharashtra,23,8,8,1,40,Pass
Zaid Khan,09-02-2006,599168,Maharashtra,23,15,14,3,55,Pass
David Singh,12-01-2005,769552,Jharkhand,23,0,18,9,50,Pass
Aditya Mehta,18-08-2005,868920,Rajasthan,8,1,17,1,27,Pass
Aryan Fernandes,04-08-2005,261525,Tamil Nadu,3,1,15,2,21,Pass
Krishna Verma,15-09-2005,692845,Rajasthan,8,17,10,10,45,Pass
Yash Singh,01-05-2005,381394,Rajasthan,24,11,11,17,63,Pass
Kunal Singh,16-11-2004,484218,Haryana,11,7,4,14,36,Pass
Ishaan Mehta,07-10-2005,636835,Assam,4,17,21,19,61,Pass
Krishna Pillai,14-03-2005,909990,Jammu & Kashmir + Ladakh,5,19,24,19,67,Pass
Aarav Pillai,31-07-2005,260121,Odisha,4,1,6,13,24,Pass
Ishaan Mehta,16-07-2005,572617,Rajasthan,1,3,17,18,39,Pass
Gurpreet D'Souza,16-12-2005,302198,Uttar Pradesh,4,21,20,14,59,Pass
Harjeet Pillai,28-09-2005,721466,Tamil Nadu,1,6,14,7,28,Pass
Kunal Fernandes,01-04-2005,235056,Telangana,18,22,3,19,62,Pass
Raj Reddy,13-04-2006,391284,Punjab,17,9,17,5,48,Pass
Krishna Mehta,03-09-2005,550163,Uttarakhand,10,1,5,21,37,Pass
Ishaan Chopra,22-04-2006,141840,Uttar Pradesh,6,0,8,5,19,Pass
Vivaan Khan,16-03-2006,198923,Haryana,9,2,10,15,36,Pass
Kunal Reddy,08-11-2004,552412,Telangana,5,8,8,19,40,Pass
Aarav Pillai,26-04-2006,190296,Himachal Pradesh,13,8,20,23,64,Pass
Harjeet Mehta,19-02-2005,804994,Haryana,17,4,19,16,56,Pass
Aditya Pillai,08-01-2006,164602,Uttar Pradesh,15,3,24,24,66,Pass
Aditya Sharma,26-03-2005,641178,Assam,2,3,4,6,15,Pass
Ishaan Mehta,04-06-2005,729851,Maharashtra,19,4,20,2,45,Pass
Aditya Pillai,02-05-2005,774986,Haryana,6,13,23,9,51,Pass
Aryan Reddy,15-09-2005,336254,Madhya Pradesh,24,4,23,9,60,Pass
Vivaan Chopra,14-04-2005,138619,Bihar,21,15,17,4,57,Pass
Zaid Reddy,28-08-2005,213727,Assam,4,16,5,14,39,Pass
Raj Singh,03-03-2005,397063,Jammu & Kashmir + Ladakh,2,16,15,11,44,Pass
Ishaan D'Souza,15-02-2006,650548,Chhattisgarh,16,0,22,10,48,Fail
Kunal Reddy,22-07-2005,584693,Madhya Pradesh,8,7,12,4,31,Pass
Aarav Khan,20-01-2006,899329,Haryana,0,16,11,3,30,Pass
David Pillai,31-08-2005,163143,Andhra Pradesh,16,15,14,0,45,Pass
Ishaan Chopra,06-05-2006,882939,Telangana,17,10,6,20,53,Fail
Aryan Chopra,19-01-2005,628008,Jharkhand,22,24,2,11,59,Pass
Aditya Khan,24-11-2005,176781,Telangana,8,22,12,0,42,Pass
Rohan Mehta,13-11-2004,883465,Madhya Pradesh,23,4,22,17,66,Pass
Manpreet Chopra,13-02-2006,692460,Daman & Diu / D&N Haveli,8,16,5,15,44,Fail
Imran Reddy,07-02-2006,286749,Bihar,22,18,7,22,69,Pass
Vivaan D'Souza,29-07-2005,348146,Bihar,2,2,10,21,35,Pass
Rohan Singh,14-07-2005,750980,Uttarakhand,3,14,19,9,45,Pass
Kunal Singh,22-03-2006,733108,Chhattisgarh,6,2,9,22,39,Fail
Imran Singh,06-05-2006,905557,Gujarat,6,10,3,24,43,Fail
Aryan Mehta,08-11-2004,988503,Uttar Pradesh,1,6,8,9,24,Pass
Yash Verma,08-11-2004,531347,Haryana,22,2,21,20,65,Pass
Raj Chopra,07-10-2005,278233,Haryana,12,18,13,2,45,Pass
Mathew Pillai,31-08-2005,987678,Uttar Pradesh,19,10,13,19,61,Pass
Aryan Singh,01-04-2006,118587,Tamil Nadu,17,16,0,7,40,Pass
Vivaan Mehta,29-11-2004,355504,Uttar Pradesh,2,21,23,7,53,Pass
Sukhwinder Fernandes,03-02-2005,138459,Uttarakhand,13,2,3,17,35,Pass
Krishna Fernandes,03-02-2005,321847,Rajasthan,2,21,11,22,56,Pass
Paul Mehta,29-04-2005,655547,Delhi,23,7,2,9,41,Pass
Aarav D'Souza,13-08-2005,184148,Uttar Pradesh,12,0,8,0,20,Pass
Ishaan Pillai,19-03-2005,452903,Rajasthan,18,23,8,15,64,Pass
Aditya D'Souza,27-02-2006,244436,Haryana,14,5,6,5,30,Pass
Kunal Fernandes,17-01-2006,194665,Uttar Pradesh,9,12,21,1,43,Pass
Harjeet Pillai,20-04-2006,913123,Maharashtra,14,7,7,21,49,Pass
Aryan Verma,14-07-2005,231127,Assam,15,17,23,16,71,Pass
Aarav Reddy,18-11-2005,716058,Himachal Pradesh,17,2,20,7,46,Pass
Vivaan Reddy,09-05-2005,424227,Bihar,0,15,5,17,37,Pass
Ishaan Pillai,17-05-2005,485670,Rajasthan,1,14,13,14,42,Pass
Rohan Pillai,16-11-2004,102985,Bihar,8,16,23,2,49,Pass
Rohan Singh,27-12-2005,390231,Tamil Nadu,24,9,15,21,69,Pass
Aryan Sharma,02-07-2005,473982,Uttar Pradesh,12,8,20,2,42,Pass
Yash Singh,28-08-2005,655465,Bihar,10,17,13,16,56,Pass
Imran Chopra,29-07-2005,403001,Maharashtra,22,17,15,3,57,Pass
Vivaan Pillai,16-12-2004,121321,Gujarat,20,20,18,13,71,Fail
Sukhwinder Singh,10-12-2004,601761,Madhya Pradesh,10,6,4,2,22,Pass
Peter Reddy,25-03-2006,432787,Chhattisgarh,9,8,15,12,44,Fail
Vivaan D'Souza,02-07-2005,329312,Rajasthan,6,9,11,13,39,Pass
Aryan Mehta,04-04-2005,443718,Rajasthan,20,14,11,10,55,Pass
David Reddy,05-01-2005,615691,Karnataka,1,2,3,24,30,Pass
Mathew D'Souza,27-07-2005,933241,Jharkhand,2,3,17,22,44,Pass
Vivaan Verma,10-04-2005,478620,Karnataka,21,20,17,10,68,Fail
Aryan Fernandes,06-07-2005,834341,Telangana,2,13,9,21,45,Pass
Rohan Verma,08-11-2004,123863,Maharashtra,12,3,3,21,39,Pass
Harjeet Reddy,28-08-2005,386542,Odisha,2,17,9,9,37,Pass
Gurpreet Mehta,19-07-2005,852656,Bihar,18,5,9,13,45,Pass
Yash Verma,27-07-2005,528765,Rajasthan,8,9,1,23,41,Pass
Sukhwinder Mehta,20-11-2004,171510,Rajasthan,16,14,6,7,43,Pass
Kunal Mehta,04-06-2005,991143,Bihar,9,20,2,8,39,Pass
Ishaan Chopra,23-07-2005,228183,Uttar Pradesh,15,3,18,22,58,Pass
Balbir Singh,22-10-2005,705160,Madhya Pradesh,3,19,8,1,31,Pass
Raj Verma,04-02-2006,322244,Gujarat,22,22,3,23,70,Fail
Yash Reddy,09-05-2006,784927,Chhattisgarh,19,9,21,18,67,Fail
Ishaan Mehta,19-10-2005,765658,Karnataka,21,2,8,4,35,Pass
Aarav Reddy,28-12-2005,916753,Rajasthan,0,20,18,16,54,Pass
Aditya Mehta,21-04-2005,339332,Assam,21,10,23,15,69,Pass
Raj D'Souza,01-06-2005,329433,Rajasthan,12,18,13,16,59,Pass
Rohan D'Souza,26-12-2004,915262,Madhya Pradesh,19,15,15,6,55,Pass
Mathew D'Souza,19-07-2005,960234,Haryana,9,6,21,11,47,Pass
Aryan Mehta,21-03-2006,345859,Punjab,3,6,13,12,34,Pass
Vivaan Mehta,24-09-2005,259504,Maharashtra,5,20,2,21,48,Pass
Aditya Reddy,28-04-2006,917136,Haryana,20,15,7,17,59,Pass
Ishaan Verma,27-10-2005,370479,Gujarat,17,5,23,7,52,Fail
Sukhwinder D'Souza,05-05-2006,650973,Uttar Pradesh,10,22,22,15,69,Pass
Ishaan D'Souza,07-03-2006,612753,Bihar,0,17,9,13,39,Pass
Sukhwinder D'Souza,11-11-2004,534043,Rajasthan,6,23,5,12,46,Pass
Vivaan Singh,19-01-2006,857798,Haryana,1,4,21,21,47,Pass
Krishna Reddy,04-06-2005,238677,Himachal Pradesh,22,10,0,15,47,Pass
Aarav Sharma,31-10-2005,681572,Telangana,24,17,5,6,52,Fail
Sukhwinder Singh,03-12-2005,654220,Kerala,8,22,5,19,54,Fail
Rohan Verma,14-12-2004,352070,Haryana,6,11,15,3,35,Pass
Krishna Pillai,19-11-2005,821189,Uttar Pradesh,14,4,0,4,22,Pass
Aarav Singh,20-11-2005,529799,Maharashtra,5,10,7,23,45,Pass
Vivaan Pillai,05-12-2005,253790,Gujarat,12,14,14,2,42,Fail
Kunal Singh,31-07-2005,590099,Uttar Pradesh,4,0,10,21,35,Pass
Harjeet Pillai,22-01-2006,185657,Karnataka,12,19,21,12,64,Pass
Kunal Chopra,23-04-2006,663930,Uttar Pradesh,1,2,22,4,29,Pass
Rohan Fernandes,02-06-2005,944522,Rajasthan,10,7,4,4,25,Pass
Kunal Singh,06-06-2005,133921,Haryana,17,16,8,7,48,Pass
Yash Sharma,16-04-2005,373912,Uttarakhand,16,9,16,8,49,Pass
Aarav Chopra,25-09-2005,310744,Bihar,4,13,12,13,42,Pass
Vivaan Fernandes,25-01-2006,374942,Tamil Nadu,1,1,13,24,39,Pass
Ishaan Singh,04-05-2005,400003,Tamil Nadu,17,14,21,6,58,Fail
Aarav Reddy,19-04-2006,510755,Gujarat,9,10,9,20,48,Fail
Rohan Chopra,15-12-2005,447703,Gujarat,19,21,12,11,63,Fail
Yash D'Souza,01-03-2005,950913,Kerala,9,17,13,11,50,Fail
Krishna Khan,18-09-2005,574807,Karnataka,17,24,2,6,49,Pass
Vivaan Chopra,08-11-2005,793264,West Bengal,6,20,14,11,51,Fail
Raj Sharma,29-03-2005,313652,Uttar Pradesh,4,15,22,5,46,Pass
Yash Sharma,21-04-2006,866524,Chhattisgarh,16,19,19,19,73,Fail
Raj Fernandes,10-05-2005,614123,Assam,9,6,12,10,37,Pass
David Sharma,30-01-2005,530428,Bihar,14,13,9,24,60,Pass
Manpreet Reddy,14-04-2006,472510,Maharashtra,5,24,9,3,41,Pass
Aditya D'Souza,24-05-2005,484857,Nagaland,4,8,9,2,23,Pass
Raj D'Souza,29-07-2005,159222,Bihar,14,18,21,24,77,Pass
Raj Pillai,24-06-2005,207835,Punjab,9,10,11,12,42,Pass
Vivaan Chopra,16-04-2005,596758,Kerala,8,8,24,8,48,Fail
Vivaan Sharma,29-04-2006,149830,Haryana,2,6,8,6,22,Pass
Aditya Mehta,20-09-2005,114525,Madhya Pradesh,21,4,15,17,57,Pass
Aditya Reddy,27-10-2005,518385,Punjab,5,3,8,19,35,Pass
Aarav Verma,28-06-2005,912403,Bihar,13,19,3,16,51,Pass
Rohan Pillai,02-03-2006,692269,Uttarakhand,21,0,0,7,28,Pass
Zaid Mehta,20-01-2005,664161,Madhya Pradesh,9,15,15,7,46,Pass
Imran Verma,14-03-2006,144183,Jharkhand,19,21,10,7,57,Pass
Gurpreet Sharma,30-04-2006,499024,West Bengal,14,24,22,20,80,Fail
Sukhwinder Khan,27-11-2004,752456,Bihar,7,8,2,23,40,Pass
Krishna Chopra,19-01-2005,873720,Rajasthan,20,5,4,1,30,Pass
Ishaan Singh,08-01-2005,179708,Uttar Pradesh,13,3,16,24,56,Pass
Vivaan Fernandes,02-01-2006,569059,Tamil Nadu,24,21,3,23,71,Pass
Vivaan Chopra,27-02-2006,213366,Delhi,1,20,13,23,57,Pass
Aryan Sharma,27-10-2005,404109,Rajasthan,7,3,20,3,33,Pass
Aryan Chopra,04-05-2006,849165,Uttar Pradesh,16,18,12,16,62,Pass
Kunal Verma,01-05-2006,111682,Bihar,0,2,15,0,17,Pass
Rehan Khan,16-03-2005,124544,Gujarat,15,20,18,8,61,Fail
Aditya Sharma,12-11-2004,120193,Telangana,6,2,12,17,37,Pass
Aarav Reddy,03-04-2005,815130,Haryana,19,17,0,17,53,Pass
Kunal Khan,26-11-2005,604953,Maharashtra,24,6,10,0,40,Pass
Rohan Chopra,29-07-2005,151617,Karnataka,6,23,14,6,49,Pass
Aarav Mehta,13-10-2005,347421,Uttar Pradesh,16,17,1,16,50,Pass
Krishna Chopra,29-12-2004,596529,Delhi,16,8,18,1,43,Pass
Rohan Chopra,13-07-2005,429081,Delhi,10,11,5,21,47,Pass
Peter Fernandes,29-07-2005,812793,West Bengal,7,2,8,12,29,Fail
Harjeet Khan,25-07-2005,396250,Uttar Pradesh,21,3,21,5,50,Pass
Balbir Sharma,14-11-2005,797914,Odisha,10,9,8,1,28,Pass
Imran Pillai,18-05-2005,434766,Andhra Pradesh,10,7,13,7,37,Pass
Ishaan Verma,24-12-2005,454046,Uttar Pradesh,23,10,20,5,58,Pass
Raj Mehta,09-01-2005,956221,Bihar,6,21,20,7,54,Pass
Balbir Singh,01-09-2005,612197,Haryana,12,8,8,19,47,Pass
Ishaan Verma,02-08-2005,900704,Assam,1,1,18,12,32,Pass
Harjeet Verma,18-03-2005,467616,Haryana,11,6,5,17,39,Pass
Aarav Fernandes,11-04-2005,410099,Tamil Nadu,2,8,13,16,39,Pass
Kunal Fernandes,29-10-2005,181582,Uttar Pradesh,13,9,10,19,51,Pass
Aditya Fernandes,24-06-2005,127275,Bihar,13,22,12,10,57,Pass
Harjeet Fernandes,21-04-2005,196390,Punjab,7,15,9,16,47,Pass
Aryan Mehta,12-11-2005,704538,Karnataka,22,10,3,5,40,Pass
Yash Pillai,23-10-2005,710026,Tamil Nadu,10,5,17,16,48,Fail
Krishna Fernandes,12-04-2005,763282,Maharashtra,13,23,0,13,49,Pass
Peter Verma,22-12-2005,861151,Punjab,2,22,7,21,52,Pass
David Sharma,14-07-2005,782852,Rajasthan,20,21,22,16,79,Pass
Kunal Chopra,31-03-2005,278040,Rajasthan,4,0,19,14,37,Pass
Rehan Singh,24-09-2005,358126,Telangana,2,8,4,19,33,Pass
Ishaan D'Souza,03-12-2004,169350,Karnataka,1,8,12,17,38,Pass
Aditya Singh,26-12-2005,129463,Uttar Pradesh,13,0,18,15,46,Pass
Vivaan D'Souza,17-11-2005,147558,Jharkhand,24,1,10,3,38,Pass
Yash Singh,25-04-2005,395983,Bihar,18,13,14,11,56,Pass
Ishaan Khan,14-04-2005,772068,Uttar Pradesh,2,0,7,22,31,Pass
Aarav Verma,18-02-2005,159772,Jharkhand,2,11,5,8,26,Pass
Raj Sharma,11-09-2005,556930,Odisha,9,10,24,1,44,Pass
Rohan Pillai,21-09-2005,953418,Uttar Pradesh,6,22,1,8,37,Pass
Aryan Pillai,06-02-2005,306661,Uttar Pradesh,5,3,13,2,23,Pass
Raj Mehta,04-07-2005,225251,Bihar,18,8,1,24,51,Pass
Ishaan Fernandes,23-07-2005,759334,West Bengal,4,18,20,6,48,Fail
Aditya Reddy,22-04-2005,281168,Assam,21,15,0,24,60,Pass
Aditya Verma,30-07-2005,317158,Gujarat,19,0,12,4,35,Fail
Mathew Mehta,28-04-2006,713920,Rajasthan,7,10,11,8,36,Pass
Vivaan Reddy,18-04-2006,792263,Maharashtra,2,11,3,23,39,Pass
Aryan Fernandes,21-08-2005,394166,Odisha,14,14,8,12,48,Pass
Aarav Sharma,11-12-2004,104584,Madhya Pradesh,23,18,7,4,52,Pass
Aryan Khan,31-07-2005,301338,Bihar,14,0,11,14,39,Pass
Ishaan Reddy,30-10-2005,506203,Andhra Pradesh,9,15,4,3,31,Pass
Farhan Mehta,08-09-2005,890963,Tamil Nadu,22,22,14,16,74,Pass
John Mehta,04-03-2005,488452,Uttar Pradesh,15,5,21,1,42,Pass
Kunal Singh,29-11-2004,304019,Uttar Pradesh,5,1,17,15,38,Pass
Ishaan Verma,27-01-2006,943444,Gujarat,23,15,18,1,57,Fail
Ishaan D'Souza,10-03-2006,810195,Haryana,8,13,7,3,31,Pass
Aryan Verma,21-01-2006,548234,Gujarat,2,22,4,23,51,Fail
Aditya Singh,04-03-2006,345451,Jammu & Kashmir + Ladakh,23,10,8,20,61,Pass
Ishaan Sharma,26-04-2006,974286,Maharashtra,12,18,6,3,39,Pass
Peter Singh,23-12-2005,236517,West Bengal,16,14,21,11,62,Fail
Krishna Mehta,21-11-2004,668085,Tamil Nadu,6,4,18,18,46,Fail
Manpreet Khan,20-04-2006,821726,Maharashtra,10,7,8,22,47,Pass
Sukhwinder Mehta,15-04-2006,317345,Arunachal Pradesh,19,6,6,14,45,Fail
Krishna Sharma,30-08-2005,657298,Uttar Pradesh,9,7,13,23,52,Pass
Balbir D'Souza,20-07-2005,362806,Tripura,11,18,10,3,42,Pass
Ishaan Pillai,04-03-2005,708599,Punjab,21,10,0,19,50,Pass
Yash Verma,13-11-2004,386755,Madhya Pradesh,11,6,9,21,47,Pass
Kunal Pillai,04-04-2005,617011,Uttar Pradesh,21,6,18,0,45,Pass
Yash Verma,23-11-2005,576718,Uttar Pradesh,3,20,21,1,45,Pass
Krishna Fernandes,20-11-2005,453876,Uttarakhand,22,24,3,13,62,Pass
Balbir Verma,03-05-2005,769460,Punjab,0,22,16,10,48,Pass
Ayaan Sharma,01-01-2006,384297,Madhya Pradesh,4,4,21,24,53,Pass
Raj Sharma,31-12-2005,738114,Uttar Pradesh,14,0,10,18,42,Pass
Krishna Mehta,16-02-2006,373021,Himachal Pradesh,12,22,20,9,63,Pass
Rohan Pillai,25-04-2006,492549,Rajasthan,18,12,21,23,74,Pass
Kunal Singh,27-12-2005,483082,Maharashtra,7,14,9,13,43,Pass
Rohan Pillai,25-11-2004,303158,Nagaland,12,4,9,4,29,Pass
Harjeet Fernandes,14-11-2005,964580,Madhya Pradesh,14,4,16,14,48,Pass
Rohan D'Souza,11-10-2005,242251,Uttar Pradesh,24,14,22,7,67,Pass
Aarav Pillai,18-11-2004,918567,Kerala,4,15,4,10,33,Fail
Yash Mehta,15-12-2005,723564,West Bengal,14,8,20,3,45,Fail
Ishaan Pillai,05-07-2005,470287,Punjab,24,14,10,1,49,Pass
Yash Singh,15-07-2005,207228,Uttar Pradesh,24,6,18,2,50,Pass
Manpreet Reddy,04-09-2005,202161,Chhattisgarh,18,1,16,10,45,Fail
Harjeet Chopra,06-12-2004,437505,Maharashtra,10,0,16,16,42,Pass
Vivaan Sharma,08-02-2005,675205,Tamil Nadu,7,11,18,4,40,Pass
Krishna Sharma,22-05-2005,171370,Tripura,10,17,0,13,40,Pass
Ishaan Fernandes,29-09-2005,848677,Rajasthan,11,10,15,10,46,Pass
Aarav Singh,13-04-2005,996056,Uttar Pradesh,4,3,0,13,20,Pass
Yash Verma,28-11-2005,884462,Kerala,22,17,3,10,52,Fail
Yash Singh,04-02-2005,222411,Haryana,7,4,19,13,43,Pass
Krishna Chopra,10-11-2005,658654,Uttar Pradesh,23,19,0,0,42,Pass
Aarav Sharma,15-04-2006,297591,Maharashtra,15,21,6,3,45,Pass
Paul D'Souza,04-04-2005,211624,West Bengal,24,3,18,24,69,Fail
Mathew Reddy,26-08-2005,628826,Rajasthan,3,20,24,15,62,Pass
Krishna Fernandes,03-07-2005,469506,Madhya Pradesh,15,4,21,16,56,Pass
Vivaan Pillai,21-03-2005,403096,West Bengal,17,24,1,8,50,Fail
Rohan Singh,26-04-2005,402550,Kerala,10,4,1,4,19,Fail
Aryan Fernandes,16-04-2006,644786,Maharashtra,24,10,13,3,50,Pass
Krishna D'Souza,06-10-2005,511579,Rajasthan,20,1,16,23,60,Pass
Rohan Fernandes,03-02-2006,391568,Himachal Pradesh,3,18,13,9,43,Pass
Kunal Reddy,11-04-2006,764195,Uttarakhand,0,21,15,9,45,Pass
Vivaan D'Souza,19-10-2005,180862,Maharashtra,20,20,9,3,52,Pass
Ishaan Chopra,12-01-2006,959236,Odisha,0,12,14,9,35,Pass
Ishaan Fernandes,19-08-2005,854989,Bihar,19,8,13,14,54,Pass
Zaid Pillai,02-05-2005,388152,Punjab,10,5,17,20,52,Pass
Rohan Chopra,16-04-2005,217598,Rajasthan,0,10,5,1,16,Pass
Farhan Sharma,17-03-2006,803730,Karnataka,12,19,7,14,52,Pass
Rohan Singh,05-05-2006,802336,Kerala,19,21,14,12,66,Fail
John Mehta,16-03-2005,340204,West Bengal,18,3,17,4,42,Fail
Ishaan Sharma,18-02-2006,141527,Gujarat,14,19,23,19,75,Fail
Ishaan Mehta,12-04-2005,509083,Chhattisgarh,11,8,23,12,54,Fail
Aarav Pillai,26-09-2005,633540,Maharashtra,10,12,2,13,37,Pass
Raj Singh,18-11-2004,952544,Maharashtra,5,21,16,4,46,Fail
Peter Reddy,13-11-2005,589925,Karnataka,2,13,11,13,39,Pass
Aditya Sharma,17-08-2005,614659,Telangana,11,9,4,22,46,Pass
Ishaan D'Souza,18-02-2005,148525,Uttar Pradesh,6,7,3,9,25,Pass
Aarav Singh,19-04-2006,765026,Haryana,8,9,8,11,36,Pass
Gurpreet Khan,01-03-2006,770523,Rajasthan,6,6,18,0,30,Pass
Ishaan Fernandes,19-04-2006,618234,Bihar,16,1,18,2,37,Pass
Sukhwinder Pillai,13-08-2005,594665,Haryana,15,12,0,18,45,Pass
Kunal Chopra,23-03-2006,737286,Andhra Pradesh,6,0,18,12,36,Pass
Krishna Singh,23-01-2006,366088,West Bengal,15,2,6,8,31,Fail
Krishna Chopra,30-04-2006,337655,Andhra Pradesh,3,11,8,16,38,Pass
Rohan D'Souza,10-09-2005,538790,Uttar Pradesh,11,17,17,17,62,Pass
Vivaan Mehta,01-04-2006,868815,Uttar Pradesh,11,10,17,6,44,Pass
Mathew Fernandes,11-03-2006,743531,Maharashtra,16,17,13,17,63,Fail
Krishna Khan,11-02-2005,490934,Telangana,0,22,13,23,58,Fail
Kunal Mehta,03-01-2005,755343,Tamil Nadu,23,6,12,18,59,Pass
Yash Pillai,07-04-2005,937033,Assam,2,5,24,6,37,Pass
Gurpreet Pillai,30-06-2005,697978,West Bengal,8,23,16,22,69,Fail
Rohan D'Souza,09-12-2005,259365,Rajasthan,16,24,5,24,69,Pass
Yash Reddy,20-09-2005,846601,Puducherry,24,10,8,16,58,Fail
Raj Verma,21-10-2005,713280,Punjab,10,18,13,2,43,Pass
Rehan Singh,31-07-2005,364888,Tamil Nadu,13,5,1,10,29,Pass
Rohan Pillai,25-08-2005,714884,Bihar,7,2,1,16,26,Pass
Peter Khan,05-01-2006,860674,Maharashtra,8,20,21,12,61,Fail
Krishna Pillai,21-11-2005,756986,Madhya Pradesh,18,4,24,11,57,Pass
Manpreet Mehta,11-10-2005,124295,Rajasthan,12,14,20,0,46,Pass
David Sharma,02-03-2005,409109,Tamil Nadu,19,18,10,6,53,Fail
Mathew Singh,12-08-2005,806028,Andhra Pradesh,13,20,6,24,63,Pass
Raj Mehta,08-12-2005,785747,Madhya Pradesh,10,2,14,20,46,Pass
Ishaan Mehta,25-01-2006,464336,Andhra Pradesh,6,19,4,4,33,Pass
Paul Sharma,11-03-2006,363458,Punjab,10,5,3,18,36,Pass
Aarav Sharma,28-07-2005,358143,Kerala,21,4,12,16,53,Fail
Aarav Verma,27-04-2005,126996,Uttar Pradesh,24,8,11,14,57,Pass
Vivaan Sharma,10-11-2004,131217,Maharashtra,13,13,11,18,55,Fail
Yash Khan,30-03-2006,654953,Rajasthan,10,14,15,20,59,Pass
David Reddy,20-04-2006,487436,Maharashtra,20,7,1,16,44,Fail
Aarav Mehta,07-08-2005,414642,Maharashtra,5,3,5,23,36,Fail
Ishaan Reddy,17-01-2006,295535,Kerala,7,24,5,23,59,Pass
Vivaan Fernandes,07-06-2005,132707,West Bengal,14,2,5,18,39,Fail
Rohan Fernandes,26-11-2005,563102,Mizoram,22,19,21,9,71,Fail
Vivaan Mehta,03-09-2005,216318,Madhya Pradesh,3,11,18,12,44,Pass
Peter Chopra,07-07-2005,569358,Maharashtra,21,20,22,8,71,Fail
Raj Fernandes,23-08-2005,942015,Uttar Pradesh,3,21,5,6,35,Pass
Mathew Singh,10-09-2005,296420,West Bengal,6,5,12,15,38,Fail
Harjeet Singh,14-09-2005,405179,Uttar Pradesh,0,6,11,0,17,Pass
Aditya Sharma,12-05-2005,782822,Rajasthan,21,19,21,18,79,Pass
Raj Khan,16-03-2005,678675,Punjab,7,12,12,21,52,Pass
Vivaan Khan,22-01-2005,667537,West Bengal,5,24,3,20,52,Fail
Aditya Chopra,21-09-2005,480342,Chhattisgarh,9,1,17,24,51,Fail
Sukhwinder Reddy,07-03-2006,996103,Maharashtra,18,16,17,6,57,Fail
Aditya Sharma,26-02-2005,656302,Uttar Pradesh,9,22,11,16,58,Pass
Paul Singh,15-02-2006,766243,Tamil Nadu,3,0,6,8,17,Pass
Ishaan Fernandes,21-01-2005,567096,Punjab,19,24,16,22,81,Pass
Krishna Sharma,10-02-2006,930236,Madhya Pradesh,0,1,22,17,40,Pass
Vivaan Pillai,12-06-2005,621655,Delhi,3,18,22,13,56,Pass
Aryan Chopra,03-08-2005,338356,Jharkhand,22,13,17,7,59,Pass
Peter Chopra,13-08-2005,684555,Punjab,11,6,13,19,49,Pass
Balbir Pillai,05-03-2005,270074,Jharkhand,3,0,5,10,18,Pass
Aarav Chopra,31-12-2004,272457,Bihar,11,7,0,15,33,Pass
Aryan Mehta,11-11-2004,622406,Bihar,20,1,12,10,43,Pass
Yash Khan,23-02-2006,833694,Bihar,19,17,13,0,49,Pass
Rohan Verma,27-11-2005,369604,Tamil Nadu,9,2,7,22,40,Pass
Yash Verma,15-08-2005,409078,Kerala,20,24,8,18,70,Fail
Krishna Chopra,06-07-2005,601527,Chhattisgarh,12,0,6,11,29,Fail
Peter Verma,04-05-2005,935982,Telangana,1,4,1,19,25,Pass
Aryan Verma,29-08-2005,981722,Kerala,15,11,21,14,61,Pass
David D'Souza,24-04-2005,653790,Andhra Pradesh,8,24,24,12,68,Pass
Sukhwinder Reddy,12-11-2004,463079,Maharashtra,14,5,12,10,41,Fail
Sukhwinder Fernandes,14-03-2006,839092,Kerala,4,12,18,8,42,Pass
Sukhwinder Khan,19-12-2004,511999,Uttar Pradesh,9,13,14,8,44,Pass
Aditya Singh,31-08-2005,740454,Madhya Pradesh,14,18,9,1,42,Pass
Raj Chopra,26-09-2005,515558,Maharashtra,22,4,23,4,53,Fail
Krishna Chopra,25-11-2004,793000,Jammu & Kashmir + Ladakh,22,2,22,13,59,Pass
Krishna Pillai,30-07-2005,468062,Kerala,18,17,13,15,63,Pass
Kunal Pillai,23-08-2005,810833,Andhra Pradesh,1,17,19,1,38,Pass
Aarav Mehta,25-03-2006,667272,Uttar Pradesh,16,8,13,22,59,Pass
Aditya Verma,08-03-2006,319498,Rajasthan,13,2,10,0,25,Pass
Krishna Fernandes,30-11-2004,886568,Uttar Pradesh,8,24,4,22,58,Pass
Aditya Singh,08-06-2005,379757,Uttarakhand,16,18,3,24,61,Pass
Raj Reddy,15-03-2005,490131,Karnataka,15,3,2,17,37,Pass
Kunal Pillai,27-11-2005,793963,Andhra Pradesh,12,0,21,20,53,Pass
Aditya Pillai,18-08-2005,205570,Uttar Pradesh,5,22,20,5,52,Pass
Krishna Mehta,28-10-2005,648117,Uttar Pradesh,6,9,12,14,41,Pass
Vivaan Mehta,27-07-2005,764294,Telangana,22,7,9,8,46,Pass
Kunal Verma,17-11-2004,701807,Telangana,23,3,5,1,32,Pass
Raj Chopra,13-09-2005,243068,Haryana,22,10,8,17,57,Pass
Aditya Verma,12-06-2005,991853,Bihar,15,24,4,5,48,Pass
Aarav Sharma,11-10-2005,138392,Madhya Pradesh,9,4,10,17,40,Pass
Aarav Pillai,20-10-2005,137624,Madhya Pradesh,12,6,5,2,25,Pass
Peter Reddy,09-05-2005,492693,Chhattisgarh,3,18,23,21,65,Fail
Ishaan Chopra,24-07-2005,987079,Jammu & Kashmir + Ladakh,19,7,15,5,46,Pass
Zaid Singh,04-08-2005,526135,Tamil Nadu,6,1,17,19,43,Fail
Aditya Mehta,07-03-2005,729909,Chhattisgarh,19,7,20,16,62,Fail
Balbir Mehta,13-08-2005,453138,Punjab,2,6,24,20,52,Pass
Raj Chopra,19-10-2005,872442,Tamil Nadu,8,15,4,23,50,Fail
Harjeet Fernandes,21-02-2006,879821,Maharashtra,9,23,1,24,57,Fail
Ishaan Fernandes,12-10-2005,408176,Madhya Pradesh,10,4,23,23,60,Pass
Sukhwinder Mehta,19-04-2005,606834,Tamil Nadu,16,8,10,9,43,Fail
Manpreet D'Souza,26-04-2005,723932,Punjab,5,0,1,2,8,Fail
Kunal Fernandes,23-05-2005,881724,Maharashtra,13,13,1,20,47,Fail
Kunal Chopra,07-11-2005,635699,Rajasthan,12,23,22,20,77,Fail
Gurpreet Reddy,09-02-2006,712049,Punjab,7,10,4,13,34,Fail
Balbir Chopra,14-01-2006,232937,Punjab,21,19,21,23,84,Fail
Vivaan Mehta,30-03-2006,347053,Uttar Pradesh,10,8,17,13,48,Pass
Raj Pillai,21-03-2005,143350,Tamil Nadu,19,10,14,10,53,Fail
Aryan D'Souza,11-01-2005,394597,Rajasthan,9,18,24,5,56,Fail
Krishna Sharma,27-01-2005,711108,Uttar Pradesh,2,19,11,23,55,Pass
Vivaan Mehta,01-06-2005,183115,Tamil Nadu,15,15,17,8,55,Fail
Vivaan Mehta,30-01-2006,163548,Haryana,0,13,20,14,47,Pass
Harjeet Mehta,27-08-2005,813333,Rajasthan,20,13,9,10,52,Fail
Aarav Khan,04-05-2005,944523,Punjab,17,7,15,6,45,Pass
Aarav D'Souza,02-12-2005,372324,Rajasthan,0,10,4,8,22,Fail
Kunal Mehta,10-12-2004,340579,Karnataka,7,5,19,23,54,Fail
Mathew Mehta,01-07-2005,285419,Odisha,18,1,21,13,53,Pass
Aryan Verma,19-12-2004,663671,Rajasthan,11,22,18,11,62,Pass
Manpreet D'Souza,24-03-2005,551101,Haryana,21,17,22,3,63,Pass
Aarav Mehta,04-02-2005,629867,Sikkim,11,5,7,8,31,Pass
Paul Khan,07-08-2005,281557,Chhattisgarh,17,8,23,13,61,Fail
Peter Sharma,28-10-2005,591148,Madhya Pradesh,12,14,18,12,56,Pass
David Khan,10-09-2005,540546,Jharkhand,5,0,21,8,34,Fail
Aryan Verma,13-02-2006,593282,Sikkim,5,6,5,16,32,Pass
Vivaan Fernandes,31-12-2005,400128,Rajasthan,9,8,0,18,35,Fail
Gurpreet Pillai,19-08-2005,630128,Assam,6,21,1,3,31,Pass
Gurpreet Reddy,24-03-2006,358734,Chhattisgarh,19,24,15,16,74,Fail
Krishna Khan,17-08-2005,549830,Uttarakhand,21,23,3,7,54,Pass
John Reddy,26-10-2005,337632,Uttar Pradesh,5,13,1,15,34,Pass
Ishaan Singh,12-05-2005,219974,Maharashtra,17,9,21,9,56,Fail
Kunal Sharma,30-12-2004,326550,Rajasthan,5,11,13,4,33,Fail
Paul Chopra,31-01-2005,360682,Punjab,18,4,10,16,48,Pass
Mathew Sharma,02-06-2005,711573,Punjab,13,24,22,2,61,Pass
Aryan Mehta,06-12-2005,134417,Tamil Nadu,24,8,14,16,62,Fail
Kunal Reddy,15-02-2006,727306,Telangana,22,11,22,5,60,Pass
Kunal Verma,26-12-2004,512489,Goa,8,21,19,19,67,Fail
Vivaan Verma,29-06-2005,772559,Maharashtra,14,19,9,10,52,Fail
Aditya D'Souza,09-01-2005,985682,Rajasthan,5,5,20,1,31,Fail
Manpreet Pillai,08-08-2005,460141,Uttar Pradesh,20,6,0,6,32,Pass
Yash Reddy,21-09-2005,967796,Madhya Pradesh,17,4,18,22,61,Pass
Sukhwinder D'Souza,27-02-2005,417098,Maharashtra,2,22,13,22,59,Fail
John Pillai,28-02-2006,378020,Telangana,17,24,10,14,65,Pass
Aryan Reddy,20-12-2005,212151,Uttar Pradesh,0,5,3,21,29,Pass
Peter Pillai,24-04-2006,137894,Kerala,9,3,22,4,38,Pass
Aditya Pillai,15-01-2006,246985,Tamil Nadu,3,8,20,13,44,Fail
Raj Mehta,05-12-2005,461665,Andhra Pradesh,20,1,0,0,21,Pass
Aryan Khan,19-12-2004,973444,Maharashtra,12,16,10,2,40,Fail
Aditya D'Souza,10-07-2005,774328,Maharashtra,20,12,8,9,49,Fail
Aditya Fernandes,10-07-2005,153099,Rajasthan,22,9,9,14,54,Fail
Aarav Verma,04-07-2005,219829,Bihar,9,20,1,17,47,Pass
Aarav Singh,02-12-2004,953754,Madhya Pradesh,10,13,7,14,44,Pass
Aarav Fernandes,13-11-2004,755225,Andhra Pradesh,8,9,15,12,44,Pass
Aryan Fernandes,16-10-2005,866257,Madhya Pradesh,18,4,15,15,52,Pass
John Mehta,12-02-2006,320322,Andhra Pradesh,13,9,14,5,41,Pass
Aditya Verma,07-05-2005,760943,Gujarat,3,9,9,10,31,Fail
Krishna Pillai,10-07-2005,637966,Uttar Pradesh,9,8,3,19,39,Pass
Aditya Chopra,21-07-2005,299925,West Bengal,22,0,6,11,39,Fail
Kunal Fernandes,30-11-2005,889339,Tamil Nadu,19,14,20,19,72,Fail
Kunal Verma,01-03-2006,171454,Uttar Pradesh,8,24,4,14,50,Pass
Raj Pillai,01-05-2005,887020,Uttar Pradesh,9,16,13,15,53,Pass
Aryan Khan,26-12-2005,709863,Tripura,8,5,19,24,56,Pass
Aarav Sharma,12-03-2006,301247,West Bengal,12,21,1,21,55,Fail
Vivaan Fernandes,01-05-2005,491594,Bihar,24,22,6,20,72,Pass
Manpreet Sharma,24-04-2006,727009,Haryana,11,6,18,11,46,Pass
Aditya Singh,07-01-2006,483807,Uttar Pradesh,15,11,16,14,56,Pass
Krishna Fernandes,08-04-2006,723529,Madhya Pradesh,15,21,7,6,49,Pass
Yash Chopra,14-01-2006,552956,Karnataka,2,5,5,4,16,Fail
John Pillai,20-06-2005,221583,Chhattisgarh,1,20,17,20,58,Fail
Aditya Reddy,21-08-2005,283515,Bihar,10,6,8,4,28,Fail
Krishna Mehta,01-05-2005,480951,Gujarat,13,10,14,12,49,Fail
Farhan Chopra,21-04-2006,471940,Gujarat,8,24,22,4,58,Fail
Aditya Singh,29-05-2005,596157,Madhya Pradesh,12,4,24,4,44,Pass
Sukhwinder Mehta,08-01-2005,758744,Rajasthan,7,13,9,10,39,Fail
Krishna Mehta,18-03-2005,568712,Jammu & Kashmir + Ladakh,20,20,11,10,61,Fail
Kunal Sharma,31-10-2005,466716,Uttar Pradesh,19,16,1,19,55,Pass
Ishaan Khan,27-08-2005,711558,Uttar Pradesh,17,8,14,17,56,Pass
Kunal D'Souza,27-04-2006,966285,Bihar,12,23,4,12,51,Pass
Ayaan D'Souza,02-12-2004,604134,Kerala,3,11,14,4,32,Pass
Krishna Verma,17-10-2005,254570,Rajasthan,22,15,19,13,69,Pass
Kunal Fernandes,09-12-2004,866576,Telangana,6,1,12,0,19,Pass
Sukhwinder Chopra,06-03-2005,501914,Gujarat,18,13,16,6,53,Fail
Krishna Chopra,14-11-2005,832712,Punjab,4,11,6,17,38,Fail
Krishna D'Souza,11-02-2006,982560,Madhya Pradesh,10,20,6,10,46,Pass
Vivaan Verma,12-07-2005,739066,Rajasthan,7,0,22,0,29,Fail
Manpreet Chopra,01-10-2005,652760,Maharashtra,24,3,6,7,40,Fail
Aarav Chopra,20-06-2005,929886,Uttar Pradesh,10,9,20,23,62,Pass
Rohan D'Souza,26-12-2004,171494,Uttar Pradesh,16,13,2,0,31,Pass
Aryan Khan,22-04-2006,265185,Haryana,5,8,15,6,34,Pass
Manpreet Sharma,20-01-2005,845014,Haryana,17,22,19,21,79,Pass
Raj Singh,15-02-2006,825735,Rajasthan,21,21,21,17,80,Fail
Vivaan Verma,22-03-2005,203612,Maharashtra,22,1,0,24,47,Fail
Yash Chopra,27-10-2005,239406,Maharashtra,5,19,21,4,49,Fail
John Singh,30-10-2005,901062,Rajasthan,10,10,4,16,40,Fail
Krishna Pillai,28-09-2005,361785,Bihar,10,8,13,1,32,Fail
Gurpreet Mehta,15-11-2004,494867,Maharashtra,9,23,4,0,36,Fail
Vivaan Singh,28-10-2005,927168,Manipur,1,11,11,11,34,Fail
Rohan Reddy,14-04-2005,785350,Telangana,22,23,23,10,78,Pass
Mathew Khan,24-04-2005,569898,Karnataka,15,21,11,11,58,Fail
Rohan Verma,14-06-2005,937655,Uttar Pradesh,0,14,3,15,32,Pass
Imran Pillai,09-02-2006,407586,Chhattisgarh,11,3,7,7,28,Fail
Aditya Verma,13-02-2005,548752,Uttar Pradesh,5,23,15,6,49,Pass
Aarav Mehta,25-04-2006,751385,Assam,8,23,6,10,47,Pass
Ishaan Chopra,30-11-2005,601637,Punjab,20,8,17,6,51,Pass
Farhan Verma,29-05-2005,404795,Bihar,18,1,9,18,46,Pass
Kunal Chopra,31-01-2006,803426,Jharkhand,0,2,5,13,20,Fail
Aarav Sharma,23-05-2005,502847,Punjab,23,10,6,11,50,Pass
Imran Fernandes,27-03-2006,989552,Goa,7,22,11,0,40,Fail
Rohan D'Souza,11-12-2004,212261,Uttar Pradesh,24,0,1,5,30,Pass
Aarav Chopra,03-04-2006,417204,Madhya Pradesh,0,21,5,20,46,Pass
Raj Sharma,17-12-2004,426072,Uttar Pradesh,23,3,11,20,57,Pass
Aryan Singh,26-12-2004,822666,Tamil Nadu,8,11,13,6,38,Fail
Aarav Singh,22-01-2006,794778,Telangana,0,3,5,12,20,Pass
Ishaan Pillai,01-02-2005,874947,Rajasthan,3,21,7,9,40,Fail
Ishaan Verma,01-03-2005,623360,Bihar,16,13,6,15,50,Pass
Kunal Sharma,01-06-2005,691348,West Bengal,8,22,19,5,54,Fail
Imran Pillai,09-10-2005,996960,Madhya Pradesh,21,4,7,18,50,Pass
Aryan Reddy,18-05-2005,835710,Rajasthan,21,20,3,21,65,Pass
Peter Mehta,05-05-2006,836451,Uttar Pradesh,10,9,17,0,36,Pass
Harjeet Sharma,31-12-2004,721009,Kerala,2,0,21,3,26,Pass
Raj D'Souza,14-08-2005,849549,Gujarat,9,0,23,16,48,Fail
Aarav Pillai,09-05-2005,741775,Rajasthan,18,2,15,9,44,Fail
Kunal Pillai,10-05-2005,585751,Madhya Pradesh,2,5,4,13,24,Pass
Aditya Pillai,27-06-2005,701336,Chhattisgarh,4,12,1,19,36,Fail
Kunal Khan,31-12-2005,640406,Punjab,8,23,13,4,48,Pass
Yash Chopra,13-08-2005,247199,Uttar Pradesh,1,19,8,15,43,Pass
Mathew Mehta,10-03-2005,267621,Mizoram,22,21,23,1,67,Fail
Raj Pillai,07-01-2006,607542,Rajasthan,0,4,9,5,18,Fail
Manpreet Sharma,06-11-2005,305197,West Bengal,17,24,4,9,54,Fail
Aditya Khan,21-09-2005,802823,Rajasthan,0,24,2,14,40,Fail
Vivaan Pillai,26-05-2005,763745,Maharashtra,9,19,24,16,68,Fail
Raj D'Souza,12-11-2004,935666,Madhya Pradesh,23,4,24,22,73,Pass
Aarav Singh,10-02-2005,939813,Bihar,13,14,7,2,36,Fail
Yash Singh,21-04-2006,583450,Maharashtra,20,17,3,13,53,Fail
Ishaan Pillai,10-07-2005,821761,Himachal Pradesh,15,18,3,6,42,Fail
Kunal Verma,18-11-2005,790529,Bihar,9,10,10,7,36,Fail
Krishna Reddy,04-04-2005,232582,Odisha,5,11,7,6,29,Fail
Harjeet Mehta,22-11-2005,644745,Bihar,23,1,10,16,50,Pass
Manpreet Reddy,28-06-2005,535683,Uttar Pradesh,23,12,13,17,65,Pass
Ishaan Chopra,06-04-2005,516872,Odisha,19,23,7,23,72,Pass
Harjeet Mehta,25-03-2005,478933,Maharashtra,19,22,5,5,51,Fail
Rehan Verma,30-11-2004,398284,Telangana,15,10,19,19,63,Fail
Rohan Mehta,15-12-2004,885259,Telangana,1,22,14,19,56,Pass
Aditya Mehta,29-09-2005,931054,Andhra Pradesh,0,7,18,1,26,Pass
Aditya Khan,04-09-2005,155287,Assam,1,11,9,2,23,Pass
Kunal Reddy,16-09-2005,837620,Karnataka,5,4,8,20,37,Fail
Gurpreet Khan,29-12-2004,250668,Karnataka,19,4,18,11,52,Fail
Krishna Reddy,24-05-2005,170891,Bihar,18,20,9,3,50,Pass
Ishaan Chopra,26-04-2006,494232,Rajasthan,8,10,5,24,47,Fail
Aditya Verma,08-12-2005,608645,Rajasthan,1,17,16,16,50,Fail
Rohan Sharma,10-04-2006,201639,West Bengal,22,9,17,9,57,Fail
Manpreet Chopra,24-02-2006,562736,Kerala,15,14,14,3,46,Pass
Aditya Khan,14-06-2005,937076,Punjab,19,5,11,0,35,Fail
Rohan Pillai,30-03-2006,130321,Rajasthan,23,20,21,6,70,Pass
Paul Khan,06-05-2005,590928,Maharashtra,13,22,19,3,57,Fail
Kunal Singh,01-05-2005,819624,Rajasthan,19,24,18,12,73,Pass
Raj Pillai,18-02-2005,404209,Bihar,22,20,9,21,72,Pass
Raj Pillai,04-10-2005,796368,West Bengal,18,21,21,14,74,Fail
Aarav Verma,01-05-2006,953164,Kerala,1,20,22,7,50,Pass
Rohan Mehta,05-12-2004,103110,Uttar Pradesh,1,22,24,11,58,Pass
Harjeet Fernandes,29-03-2005,700680,Haryana,0,8,10,10,28,Pass
Ayaan D'Souza,25-01-2005,638325,Telangana,17,21,2,12,52,Fail
Ishaan D'Souza,21-05-2005,767484,Bihar,12,15,19,12,58,Pass
Aarav Reddy,26-08-2005,106073,Himachal Pradesh,20,21,4,4,49,Fail
Aditya Singh,28-10-2005,671692,Uttar Pradesh,16,2,1,7,26,Pass
Ayaan Verma,12-11-2004,463840,West Bengal,20,5,3,23,51,Fail
Aryan Singh,22-12-2004,163588,Telangana,15,8,14,16,53,Fail
Aarav Singh,22-01-2006,949382,Andaman & Nicobar,4,19,4,9,36,Pass
Yash Verma,17-04-2005,983052,Haryana,7,18,3,8,36,Pass
Ishaan D'Souza,21-10-2005,992180,Bihar,19,15,15,20,69,Pass
Yash Chopra,08-04-2006,582618,Tamil Nadu,12,1,0,18,31,Fail
Raj Fernandes,03-09-2005,445739,Bihar,0,0,2,1,3,Fail
Aditya Fernandes,17-03-2005,203956,Punjab,8,7,0,18,33,Fail
Kunal Khan,26-11-2005,479492,Uttar Pradesh,15,1,15,14,45,Pass
Kunal Khan,07-01-2005,123233,Maharashtra,18,15,17,8,58,Fail
Mathew Singh,19-05-2005,983942,Tamil Nadu,21,21,12,10,64,Fail
Imran Verma,22-04-2006,116304,Rajasthan,24,12,18,6,60,Pass
Vivaan Mehta,23-04-2006,821317,Tamil Nadu,23,18,16,6,63,Fail
Kunal Chopra,19-11-2004,316109,Madhya Pradesh,21,4,15,19,59,Pass
Aryan Singh,09-03-2006,896226,Maharashtra,22,16,3,20,61,Fail
Aditya Pillai,05-09-2005,368466,Rajasthan,17,14,24,12,67,Pass
Krishna Fernandes,25-04-2005,708262,Rajasthan,5,12,19,0,36,Fail
Kunal Pillai,16-01-2006,190303,Uttar Pradesh,18,19,16,3,56,Pass
Sukhwinder Sharma,29-11-2005,919492,Bihar,17,17,4,1,39,Fail
Rohan Singh,04-04-2006,869487,Andhra Pradesh,21,20,18,1,60,Pass
Krishna Chopra,25-11-2004,322065,Rajasthan,5,19,23,0,47,Fail
Aryan Verma,20-09-2005,895317,Jharkhand,24,11,21,19,75,Fail
Vivaan Singh,19-04-2006,878918,Mizoram,19,7,18,6,50,Fail
Krishna Verma,13-01-2005,545483,Delhi,15,3,11,11,40,Pass
Raj Reddy,27-02-2006,365631,Maharashtra,21,7,14,24,66,Fail
Aryan Fernandes,23-08-2005,953470,Punjab,15,2,23,18,58,Pass
Rohan Pillai,30-06-2005,565077,Bihar,1,19,3,9,32,Fail
Yash Mehta,30-12-2005,117510,Uttar Pradesh,1,6,19,2,28,Pass
Vivaan Reddy,25-10-2005,419829,Bihar,6,4,15,7,32,Fail
Kunal Mehta,20-04-2005,460456,Tamil Nadu,8,16,6,4,34,Fail
Yash Chopra,12-01-2006,945286,Tamil Nadu,4,17,14,6,41,Fail
Balbir Mehta,11-03-2006,197891,Andhra Pradesh,17,10,8,14,49,Pass
Vivaan Fernandes,28-10-2005,847850,Assam,24,7,21,23,75,Pass
Yash Khan,02-04-2005,349350,West Bengal,15,12,12,22,61,Fail
Balbir Fernandes,20-02-2005,278539,Bihar,7,10,17,18,52,Pass
Yash Verma,18-12-2004,222960,Rajasthan,21,23,7,17,68,Pass
Aarav D'Souza,18-11-2005,657275,Odisha,3,9,6,15,33,Fail
Manpreet Mehta,16-05-2005,685072,Bihar,12,4,9,6,31,Fail
Yash Chopra,05-10-2005,322458,Bihar,16,11,19,10,56,Pass
Aarav D'Souza,02-02-2006,666551,Telangana,4,8,23,17,52,Fail
Krishna Khan,16-12-2005,721851,Delhi,10,6,14,14,44,Pass
Rohan Verma,07-08-2005,378035,Kerala,10,14,4,14,42,Pass
Zaid Fernandes,07-04-2006,275606,Uttar Pradesh,15,4,2,24,45,Pass
Aarav Singh,26-01-2006,969081,Bihar,22,10,7,24,63,Pass
Kunal Reddy,26-01-2005,320792,Madhya Pradesh,7,23,14,0,44,Pass
Gurpreet Reddy,13-09-2005,742024,Uttar Pradesh,9,13,18,3,43,Pass
Ishaan Pillai,13-08-2005,837197,Kerala,16,8,11,23,58,Pass
Harjeet Chopra,13-03-2006,629287,Andhra Pradesh,19,12,15,18,64,Pass
Yash Khan,30-03-2006,574070,Bihar,22,17,2,13,54,Pass
Aditya Fernandes,07-04-2006,797469,West Bengal,22,17,16,10,65,Fail
Aryan Reddy,13-04-2005,196686,Uttar Pradesh,1,8,11,21,41,Pass
John Sharma,27-04-2005,525165,Telangana,17,23,10,2,52,Fail
Vivaan Mehta,17-04-2005,419019,Telangana,5,10,18,18,51,Pass
Aryan Verma,17-05-2005,748204,Madhya Pradesh,15,10,1,23,49,Pass
Aarav Fernandes,24-10-2005,319429,Nagaland,21,23,10,17,71,Fail
Balbir Reddy,15-10-2005,722091,Rajasthan,14,11,23,1,49,Fail
Kunal Pillai,04-04-2005,412204,Bihar,17,7,9,0,33,Fail
Ishaan Pillai,17-12-2005,194209,Uttar Pradesh,16,18,17,1,52,Pass
Aarav Chopra,05-10-2005,971264,Maharashtra,22,7,3,12,44,Fail
Gurpreet Reddy,24-01-2005,159626,Tamil Nadu,21,15,24,15,75,Fail
Ishaan Sharma,02-05-2006,645369,Assam,17,22,20,5,64,Pass
Kunal D'Souza,03-06-2005,676159,Uttar Pradesh,20,15,10,22,67,Pass
Aryan Singh,10-10-2005,624211,Bihar,3,12,0,8,23,Fail
Ishaan Verma,19-01-2005,608704,Telangana,8,16,13,7,44,Pass
Ishaan D'Souza,11-01-2005,841571,Bihar,22,24,2,1,49,Pass
Aarav Pillai,06-04-2005,245862,Assam,23,3,5,22,53,Pass
Ishaan Singh,04-05-2006,793008,Gujarat,7,24,15,10,56,Fail
Aarav Singh,28-04-2005,703250,Bihar,22,22,22,10,76,Pass
Vivaan Khan,09-03-2005,530996,Punjab,16,11,19,5,51,Pass
Ishaan Sharma,07-03-2006,421721,Punjab,13,13,12,3,41,Fail
John Pillai,20-08-2005,247844,Mizoram,3,7,21,8,39,Fail
Kunal Sharma,28-03-2006,979071,Rajasthan,2,19,5,15,41,Fail
Aditya Verma,16-01-2005,577948,Uttar Pradesh,9,4,9,23,45,Pass
Rohan Singh,05-11-2005,360396,Telangana,14,12,10,6,42,Pass
Vivaan Singh,29-01-2006,165692,Jharkhand,7,23,15,21,66,Fail
Aditya Pillai,08-10-2005,429043,Rajasthan,14,5,17,3,39,Fail
Aarav Singh,10-03-2005,314532,Rajasthan,14,0,2,19,35,Fail
Ishaan Fernandes,09-10-2005,254252,Haryana,2,7,0,17,26,Pass
Kunal Fernandes,17-04-2005,238125,Rajasthan,0,16,18,15,49,Fail
Ishaan Fernandes,29-09-2005,564456,Himachal Pradesh,4,10,6,15,35,Fail
John D'Souza,01-12-2004,716885,Maharashtra,1,12,2,0,15,Fail
Yash Fernandes,16-03-2005,742282,Telangana,2,3,18,5,28,Pass
Vivaan Reddy,23-08-2005,135044,Bihar,16,13,4,9,42,Fail
Imran Fernandes,18-10-2005,123876,Tamil Nadu,9,10,3,5,27,Fail
Kunal Mehta,15-02-2005,369853,Maharashtra,14,1,17,1,33,Fail
Aditya D'Souza,31-03-2005,843408,Uttar Pradesh,22,15,9,4,50,Pass
Harjeet Chopra,18-01-2006,783738,Andhra Pradesh,0,13,1,4,18,Pass
Rohan Mehta,26-08-2005,652465,Punjab,10,1,13,13,37,Fail
Aditya Khan,11-12-2004,353745,Haryana,11,2,22,14,49,Pass
Harjeet Pillai,22-09-2005,214798,Punjab,2,4,9,10,25,Fail
Raj Verma,12-06-2005,360165,Odisha,3,8,24,5,40,Fail
Rohan Singh,06-03-2005,258808,Haryana,8,1,4,3,16,Pass
Aryan Chopra,22-07-2005,241398,Haryana,12,17,23,14,66,Pass
Yash Sharma,01-01-2006,641210,Bihar,10,12,13,0,35,Fail
Rohan Chopra,19-03-2006,909786,West Bengal,8,24,15,16,63,Fail
Rohan Verma,12-03-2006,457212,Uttar Pradesh,5,18,24,5,52,Pass
Krishna Mehta,24-08-2005,747992,Gujarat,1,21,1,14,37,Fail
Yash D'Souza,10-11-2005,864449,Chhattisgarh,18,2,15,24,59,Fail
Kunal Verma,20-02-2006,768792,Madhya Pradesh,22,15,15,2,54,Pass
Yash Verma,17-01-2006,463153,Maharashtra,8,0,1,8,17,Fail
Manpreet Mehta,02-04-2005,315302,Maharashtra,24,24,3,19,70,Fail
Aarav Reddy,16-08-2005,914215,Maharashtra,16,13,10,1,40,Fail
Yash Mehta,21-12-2005,515904,West Bengal,8,22,6,9,45,Fail
Aryan Verma,09-01-2006,169062,Bihar,12,23,21,14,70,Pass
Aarav D'Souza,09-08-2005,401771,Bihar,18,1,4,18,41,Fail
Yash Verma,18-01-2006,432595,Maharashtra,14,2,7,3,26,Fail
Ishaan Chopra,25-10-2005,129477,Andhra Pradesh,2,4,20,24,50,Pass
Aryan Pillai,12-01-2005,343056,Maharashtra,4,14,9,4,31,Fail
Kunal Reddy,04-02-2006,730633,Maharashtra,20,9,3,7,39,Fail
Vivaan Fernandes,27-01-2005,365481,Tripura,15,15,11,9,50,Pass
Raj Verma,08-02-2006,117201,Odisha,2,4,13,5,24,Fail
Rohan Fernandes,04-03-2005,203831,Bihar,3,23,6,18,50,Pass
Harjeet Khan,26-03-2005,296360,Uttar Pradesh,10,6,19,9,44,Pass
Gurpreet D'Souza,07-05-2006,623445,Jammu & Kashmir + Ladakh,21,9,21,3,54,Fail
Sukhwinder Singh,17-02-2005,900832,Punjab,23,10,6,17,56,Pass
Rehan Pillai,08-10-2005,595238,Jharkhand,16,19,2,9,46,Fail
Yash Fernandes,23-12-2004,143365,Haryana,13,13,18,7,51,Pass
Krishna D'Souza,07-12-2004,277267,Tamil Nadu,0,19,19,8,46,Fail
Raj Reddy,31-10-2005,483847,Nagaland,22,16,14,6,58,Fail
Aryan Singh,20-08-2005,607479,Uttar Pradesh,20,10,16,12,58,Pass
Ishaan Sharma,02-09-2005,196052,West Bengal,24,6,8,5,43,Fail
Gurpreet Pillai,08-03-2005,732267,Andhra Pradesh,14,23,19,18,74,Pass
Aditya D'Souza,23-04-2005,945524,West Bengal,17,0,14,15,46,Fail
Aditya Pillai,04-01-2006,946247,Andhra Pradesh,0,14,6,11,31,Pass
Ishaan Pillai,26-04-2006,699116,Odisha,14,15,0,6,35,Fail
Aryan Sharma,26-01-2005,306235,Odisha,24,24,12,14,74,Fail
Ishaan Mehta,15-01-2005,564340,Delhi,6,15,8,6,35,Pass
Vivaan Chopra,24-06-2005,951202,Telangana,6,4,10,7,27,Pass
Aditya Pillai,30-11-2005,674544,Kerala,2,9,19,18,48,Pass
Aditya Chopra,20-07-2005,229891,Tamil Nadu,20,13,0,19,52,Fail
Kunal Sharma,12-12-2004,472406,Punjab,2,21,4,10,37,Fail
Ishaan Pillai,23-05-2005,837520,Andhra Pradesh,14,3,17,1,35,Pass
Peter Singh,14-02-2005,276905,Rajasthan,17,1,19,14,51,Fail
Yash Mehta,07-04-2005,127577,Rajasthan,24,0,15,11,50,Fail
Harjeet Reddy,08-07-2005,597744,Uttar Pradesh,23,5,12,24,64,Pass
Balbir Reddy,15-07-2005,650168,Uttar Pradesh,22,21,12,9,64,Pass
Aditya Singh,19-03-2006,733682,Rajasthan,18,19,23,19,79,Fail
Rohan D'Souza,06-02-2006,472006,West Bengal,5,24,6,8,43,Fail
Yash Pillai,18-03-2006,465690,Chhattisgarh,0,9,3,22,34,Fail
Paul Chopra,12-03-2005,279677,Uttar Pradesh,10,10,15,10,45,Pass
Sukhwinder Verma,11-08-2005,968829,Haryana,21,18,21,20,80,Pass
Sukhwinder Fernandes,13-11-2004,235596,West Bengal,3,24,11,7,45,Fail
Manpreet D'Souza,06-04-2006,316899,Jammu & Kashmir + Ladakh,2,21,8,7,38,Fail
Krishna Mehta,23-04-2006,652982,Punjab,12,17,15,4,48,Pass
Manpreet Singh,19-11-2005,913603,Himachal Pradesh,18,16,16,0,50,Fail
Ishaan Reddy,04-10-2005,635729,Himachal Pradesh,19,9,17,13,58,Fail
Balbir Singh,14-07-2005,479933,Andhra Pradesh,22,13,24,3,62,Pass
Harjeet Mehta,21-09-2005,451487,Uttarakhand,4,19,13,13,49,Pass
Harjeet Sharma,18-01-2005,925564,Bihar,3,23,12,0,38,Fail
Kunal Verma,27-01-2005,893034,Haryana,20,15,17,17,69,Pass
Yash Fernandes,18-09-2005,289987,Maharashtra,7,11,10,2,30,Fail
Vivaan Khan,15-03-2006,567065,Telangana,20,16,0,3,39,Pass
Gurpreet Mehta,16-01-2005,606094,Jharkhand,12,9,8,9,38,Fail
Krishna Reddy,05-03-2005,715242,Manipur,18,3,22,4,47,Fail
Ishaan Verma,11-09-2005,424344,Delhi,11,12,14,18,55,Pass
Harjeet Fernandes,05-03-2006,788161,Uttar Pradesh,12,17,11,11,51,Pass
Krishna Sharma,29-08-2005,759333,Assam,7,1,18,20,46,Pass
Aditya Pillai,21-05-2005,202031,Uttar Pradesh,5,19,21,17,62,Pass
Manpreet Reddy,15-10-2005,933152,Madhya Pradesh,13,4,24,23,64,Pass
Ishaan Pillai,22-02-2005,668889,Kerala,2,14,16,5,37,Pass
Aryan Verma,25-04-2006,783167,Punjab,8,1,0,17,26,Fail
Sukhwinder Singh,12-02-2005,473373,Uttarakhand,3,22,3,15,43,Pass
Vivaan Reddy,23-05-2005,337557,Madhya Pradesh,13,23,3,17,56,Pass
Aryan Singh,24-12-2005,326646,Tamil Nadu,8,9,5,15,37,Fail
Krishna Mehta,03-04-2005,878636,Punjab,11,17,0,0,28,Fail
Yash Sharma,26-02-2005,918176,Telangana,23,3,10,23,59,Pass
Kunal Khan,03-10-2005,925542,West Bengal,8,16,8,7,39,Fail
Aarav Singh,12-01-2005,362442,Odisha,12,24,10,5,51,Pass
Kunal Pillai,28-03-2006,628299,Himachal Pradesh,4,20,15,18,57,Fail
Gurpreet Khan,08-02-2006,381776,Haryana,14,11,1,23,49,Pass
Yash Verma,20-03-2006,750596,Himachal Pradesh,3,17,16,4,40,Fail
Aarav Khan,14-01-2006,867508,Telangana,9,22,19,3,53,Fail
Raj Khan,15-04-2006,310888,Maharashtra,7,4,20,14,45,Fail
Mathew Khan,16-08-2005,128307,West Bengal,24,17,4,23,68,Fail
Mathew Mehta,18-05-2005,123151,Telangana,3,6,3,13,25,Pass
Vivaan Verma,30-05-2005,520130,Jharkhand,14,10,17,9,50,Fail
Balbir Verma,05-09-2005,353346,West Bengal,5,5,19,8,37,Fail
Vivaan Mehta,11-02-2006,506364,Rajasthan,4,8,19,18,49,Fail
Aryan Verma,03-02-2006,323023,Nagaland,7,13,11,22,53,Fail
Raj Pillai,21-10-2005,879483,Uttar Pradesh,6,14,23,18,61,Pass
Rohan Verma,17-01-2006,381028,Uttar Pradesh,7,20,7,8,42,Pass
Aditya Chopra,29-03-2005,686750,Kerala,24,6,12,4,46,Pass
Rohan Reddy,21-07-2005,603694,Uttar Pradesh,21,3,23,24,71,Pass
Manpreet Mehta,06-06-2005,890541,Manipur,7,2,22,9,40,Fail
Aryan Khan,20-06-2005,961288,Delhi,23,12,17,9,61,Pass
John Sharma,20-01-2005,587370,Rajasthan,18,9,6,11,44,Fail
Rohan Khan,22-01-2006,211596,Madhya Pradesh,5,6,2,18,31,Pass
Aarav Khan,05-04-2005,300269,Kerala,10,8,21,2,41,Pass
David Khan,10-02-2005,197509,Haryana,22,19,3,6,50,Pass
Aryan Sharma,24-04-2005,767707,Kerala,5,15,19,12,51,Pass
Ayaan Chopra,27-08-2005,963686,Rajasthan,19,17,3,6,45,Fail
Manpreet Verma,15-10-2005,257555,Tamil Nadu,18,14,15,0,47,Fail
Rohan D'Souza,05-08-2005,609953,Assam,17,5,12,16,50,Pass
Rohan Singh,23-02-2005,149767,West Bengal,8,12,16,14,50,Fail
Aditya Chopra,06-04-2005,467357,Maharashtra,17,16,6,5,44,Fail
Raj D'Souza,28-12-2005,887335,Bihar,11,11,15,20,57,Pass
Ishaan Sharma,09-11-2004,287511,Andhra Pradesh,3,8,23,7,41,Pass
Paul Sharma,31-07-2005,938516,Telangana,3,22,9,23,57,Pass
Aditya Singh,13-06-2005,815719,Uttar Pradesh,23,11,12,4,50,Pass
Yash Sharma,03-04-2006,587944,Bihar,0,24,24,9,57,Pass
Sukhwinder Mehta,27-01-2005,644351,Tripura,3,23,4,0,30,Pass
Krishna Mehta,13-04-2006,489126,Uttar Pradesh,10,7,21,5,43,Pass
David D'Souza,13-11-2004,756322,Gujarat,23,2,9,24,58,Fail
Yash Fernandes,10-02-2006,131787,Gujarat,3,1,12,14,30,Fail
Raj D'Souza,04-05-2006,572428,Jharkhand,11,8,5,22,46,Fail
Vivaan Pillai,24-07-2005,617249,Uttar Pradesh,17,19,3,16,55,Pass
Vivaan Singh,06-12-2005,380578,Rajasthan,11,15,5,4,35,Fail
Peter Singh,10-02-2005,163121,Bihar,7,3,1,15,26,Fail
Aryan Mehta,09-01-2006,324832,Telangana,12,19,7,9,47,Pass
Aarav Singh,22-11-2004,783436,Uttar Pradesh,20,6,10,6,42,Pass
Vivaan Chopra,27-03-2005,289472,Uttar Pradesh,0,22,10,18,50,Pass
Vivaan Pillai,31-03-2005,953673,Gujarat,4,4,19,6,33,Fail
Rohan Pillai,02-04-2006,934691,Jharkhand,5,19,4,12,40,Fail
Ishaan Pillai,05-04-2006,660651,Delhi,11,11,11,17,50,Pass
Gurpreet Singh,21-03-2006,352063,Rajasthan,6,14,2,13,35,Fail
Krishna Chopra,04-01-2006,187592,Uttar Pradesh,18,12,4,17,51,Pass
Rohan Khan,08-06-2005,775992,Madhya Pradesh,16,4,13,23,56,Pass
Aditya Verma,13-05-2005,693021,Uttarakhand,12,21,3,6,42,Pass
Aryan Reddy,21-12-2004,349939,Haryana,21,6,7,17,51,Pass
Harjeet Sharma,12-12-2004,491838,Bihar,11,11,22,14,58,Pass
Aryan D'Souza,14-09-2005,317928,Punjab,23,15,11,6,55,Pass
Aryan D'Souza,21-04-2006,660881,Uttar Pradesh,17,17,6,11,51,Pass
Raj Singh,07-07-2005,753124,Jharkhand,20,23,23,3,69,Fail
Yash Mehta,26-04-2006,732390,Andhra Pradesh,17,0,11,14,42,Pass
Ishaan Mehta,22-09-2005,249077,West Bengal,2,16,21,21,60,Fail
Peter Singh,09-03-2006,557397,Maharashtra,3,20,8,12,43,Fail
Rohan Khan,16-04-2006,418121,Uttar Pradesh,13,11,15,17,56,Pass
Aarav D'Souza,01-05-2005,221501,Punjab,7,18,10,24,59,Pass
Aryan Pillai,14-03-2005,972250,Maharashtra,13,13,10,9,45,Fail
David Mehta,09-02-2006,133946,Bihar,2,19,12,8,41,Fail
Aditya Verma,07-04-2006,201461,West Bengal,8,2,3,8,21,Fail
Balbir Khan,15-05-2005,831272,Bihar,10,0,5,13,28,Fail
Manpreet Verma,03-12-2005,358066,Odisha,20,10,17,0,47,Pass
Yash Fernandes,19-11-2004,373665,Andhra Pradesh,23,14,17,0,54,Pass
Aryan Khan,02-12-2004,988564,Uttar Pradesh,8,22,9,13,52,Pass
Rohan D'Souza,12-04-2005,503279,Uttar Pradesh,20,13,21,17,71,Pass
Aryan Fernandes,01-11-2005,589482,Delhi,22,12,17,1,52,Pass
Yash Reddy,08-04-2005,422852,Jammu & Kashmir + Ladakh,2,8,10,19,39,Fail
Peter Mehta,24-12-2005,912266,Delhi,10,18,3,11,42,Pass
Ishaan Mehta,19-10-2005,209236,Odisha,20,2,6,15,43,Fail
Paul Verma,10-06-2005,124417,Assam,13,12,20,23,68,Pass
Krishna Mehta,25-04-2006,658964,Punjab,0,7,11,3,21,Fail
Imran D'Souza,11-03-2006,739997,Rajasthan,2,15,19,14,50,Fail
Balbir Fernandes,04-01-2006,502340,Bihar,7,6,15,12,40,Fail
Sukhwinder Pillai,23-09-2005,460049,Rajasthan,15,23,11,4,53,Fail
Zaid Pillai,04-07-2005,459160,West Bengal,9,12,2,1,24,Fail
Yash Verma,28-02-2005,195943,Uttar Pradesh,2,2,21,13,38,Pass
Balbir Reddy,16-07-2005,199060,Tamil Nadu,24,12,14,14,64,Fail
Vivaan Reddy,14-10-2005,187357,Uttar Pradesh,3,13,7,9,32,Pass
Peter Singh,24-02-2005,852531,Maharashtra,15,8,24,10,57,Fail
Rohan D'Souza,08-04-2005,229445,West Bengal,10,10,1,24,45,Fail
Aryan Reddy,05-03-2006,408866,Tamil Nadu,14,8,9,15,46,Fail
Aditya Reddy,09-03-2006,522224,Gujarat,12,14,0,19,45,Fail
Aryan Reddy,19-05-2005,343196,Madhya Pradesh,4,9,3,1,17,Pass
David Singh,21-09-2005,415032,Punjab,21,21,15,19,76,Fail
Manpreet Reddy,28-05-2005,872718,Uttar Pradesh,1,6,9,19,35,Pass
Manpreet D'Souza,17-02-2005,675528,Odisha,21,4,6,6,37,Fail
Kunal Fernandes,28-04-2005,433194,Uttar Pradesh,19,24,19,6,68,Pass
Manpreet Sharma,27-03-2005,901565,Rajasthan,9,18,20,23,70,Pass
Kunal Sharma,13-03-2005,862766,Andhra Pradesh,1,10,4,16,31,Pass
Raj Chopra,23-10-2005,647611,Assam,18,20,7,1,46,Pass
Kunal Chopra,27-04-2005,621747,Gujarat,2,16,16,8,42,Fail
Sukhwinder Chopra,30-12-2004,399749,Maharashtra,14,16,11,8,49,Fail
Krishna Sharma,12-11-2005,597230,Karnataka,7,13,12,3,35,Fail
Kunal Verma,21-08-2005,663274,Rajasthan,15,12,8,7,42,Fail
Manpreet Verma,26-04-2005,682121,Maharashtra,20,1,15,7,43,Fail
Kunal Reddy,01-01-2005,693515,Bihar,14,5,13,1,33,Fail
David Sharma,12-03-2006,600510,Maharashtra,24,2,10,0,36,Fail
Krishna Verma,19-11-2005,337308,Assam,20,16,22,18,76,Pass
Zaid Pillai,08-07-2005,423025,Jharkhand,12,20,11,23,66,Fail
Manpreet D'Souza,26-10-2005,197851,Himachal Pradesh,12,15,8,13,48,Fail
Aarav Khan,06-09-2005,957563,Odisha,22,3,9,24,58,Pass
Aarav Verma,02-12-2005,425398,Bihar,16,12,15,16,59,Pass
Krishna Chopra,28-04-2005,479364,Jammu & Kashmir + Ladakh,21,0,15,7,43,Fail
Rohan Khan,02-05-2006,304294,Uttarakhand,20,15,3,2,40,Pass
Krishna Sharma,18-08-2005,577013,Uttarakhand,17,17,3,6,43,Pass
Aditya Sharma,22-10-2005,327412,Uttar Pradesh,17,3,22,18,60,Pass
Ayaan Chopra,03-04-2006,773897,Arunachal Pradesh,0,9,14,24,47,Fail
Mathew Pillai,28-05-2005,269990,Odisha,22,14,11,13,60,Pass
Kunal Singh,26-12-2004,918903,Rajasthan,10,21,22,10,63,Pass
John Sharma,06-10-2005,877252,Rajasthan,16,17,6,12,51,Fail
Aditya Khan,28-09-2005,499497,Tamil Nadu,18,11,4,13,46,Fail
Paul Mehta,03-06-2005,631523,Rajasthan,13,21,19,14,67,Pass
Kunal Khan,08-11-2004,974725,Kerala,17,24,22,19,82,Fail
Manpreet Verma,25-12-2004,633123,Karnataka,12,6,17,20,55,Fail
Rohan Reddy,31-01-2005,723269,Bihar,13,9,8,12,42,Fail
Rohan Pillai,23-11-2005,365241,Telangana,6,12,3,6,27,Pass
Krishna Verma,13-12-2005,729176,Rajasthan,4,1,14,24,43,Fail
Krishna Chopra,06-02-2005,364252,Jharkhand,21,21,2,15,59,Fail
Aryan Singh,24-10-2005,803208,Uttar Pradesh,4,5,16,23,48,Pass
David Sharma,15-11-2005,793779,Rajasthan,8,19,8,5,40,Fail
Manpreet Pillai,29-12-2004,248426,Telangana,5,15,23,23,66,Pass
Manpreet D'Souza,13-05-2005,777668,Assam,18,18,21,17,74,Pass
Ayaan Reddy,14-10-2005,350790,Rajasthan,20,16,13,14,63,Pass
Balbir Verma,08-08-2005,973387,Telangana,0,4,10,10,24,Pass
Ishaan Fernandes,07-12-2005,260574,Kerala,18,22,5,20,65,Pass
John Mehta,01-04-2005,337836,Tamil Nadu,23,13,22,10,68,Fail
Gurpreet Fernandes,19-06-2005,200870,Punjab,18,13,19,22,72,Pass
Gurpreet Sharma,17-02-2006,454347,Haryana,24,7,23,21,75,Pass
John Chopra,20-06-2005,913379,Bihar,20,23,0,1,44,Fail
Raj Chopra,03-05-2005,792727,Madhya Pradesh,5,13,19,19,56,Pass
Aryan Chopra,11-03-2006,382646,Kerala,12,9,22,24,67,Pass
Rohan Chopra,17-05-2005,534522,Chhattisgarh,10,16,16,13,55,Fail
Kunal D'Souza,28-11-2005,653302,West Bengal,0,7,17,21,45,Fail
Kunal D'Souza,15-08-2005,777662,Uttar Pradesh,8,10,9,19,46,Pass
Rohan Singh,18-03-2006,301419,Madhya Pradesh,10,3,6,15,34,Pass
Rehan D'Souza,01-12-2005,932708,Tamil Nadu,11,20,6,3,40,Fail
Yash Chopra,24-11-2004,594778,Telangana,15,3,16,22,56,Pass
Kunal Sharma,07-03-2006,814210,Uttar Pradesh,10,5,0,10,25,Pass
Rohan Reddy,27-02-2005,861548,Odisha,6,16,24,24,70,Pass
Rohan Khan,18-02-2006,491096,Bihar,12,14,23,19,68,Pass
Raj Khan,01-12-2004,767411,Haryana,23,16,6,6,51,Pass
Vivaan Reddy,02-09-2005,295130,Jammu & Kashmir + Ladakh,12,0,11,10,33,Fail
Harjeet Chopra,17-01-2006,430178,Gujarat,12,14,12,12,50,Fail
Peter Chopra,31-01-2005,336847,West Bengal,18,15,3,21,57,Fail
Raj Reddy,05-12-2004,645125,Rajasthan,4,21,2,6,33,Fail
Farhan D'Souza,16-07-2005,895347,Uttar Pradesh,7,21,2,17,47,Pass
Kunal Mehta,01-01-2006,861405,Uttar Pradesh,24,23,3,22,72,Pass
Krishna Reddy,20-06-2005,419318,Madhya Pradesh,18,4,19,16,57,Pass
Vivaan Pillai,16-12-2005,921156,Rajasthan,9,16,8,20,53,Fail
Kunal Fernandes,02-01-2006,303516,Uttar Pradesh,5,14,3,10,32,Pass
Aditya Sharma,26-01-2005,827561,Rajasthan,19,22,16,24,81,Fail
Raj Pillai,10-07-2005,882171,Haryana,14,5,9,16,44,Pass
Vivaan Fernandes,11-08-2005,982092,Gujarat,7,24,21,2,54,Fail
Raj Reddy,12-10-2005,879115,Maharashtra,14,4,20,20,58,Fail
Yash Verma,08-10-2005,243502,Odisha,11,18,11,1,41,Fail
Aarav Sharma,09-02-2006,104562,Odisha,16,6,23,16,61,Pass
Paul Chopra,12-03-2006,135353,Assam,13,3,14,17,47,Pass
Raj Fernandes,02-06-2005,575357,Gujarat,21,12,13,20,66,Fail
Vivaan Singh,27-04-2006,726092,Odisha,11,9,8,14,42,Fail
Aditya Reddy,08-02-2006,405241,Andhra Pradesh,1,5,6,24,36,Pass
Peter Chopra,07-04-2006,253111,Maharashtra,16,13,14,16,59,Fail
Aryan Singh,09-03-2005,656916,Uttar Pradesh,8,23,23,9,63,Pass
Krishna Verma,06-03-2005,179190,Tamil Nadu,23,11,15,0,49,Fail
Raj Singh,15-01-2006,235437,Tamil Nadu,16,10,14,10,50,Fail
Vivaan Singh,15-01-2006,275356,Bihar,21,5,5,23,54,Pass
Vivaan Verma,10-05-2005,233571,Himachal Pradesh,7,23,16,4,50,Fail
Mathew D'Souza,07-05-2005,771079,Bihar,6,7,24,21,58,Pass
Yash Mehta,24-04-2006,325801,Punjab,7,11,1,12,31,Fail
Aditya Mehta,08-12-2005,770380,Rajasthan,17,3,16,14,50,Fail
Yash Khan,30-07-2005,154012,Bihar,22,7,21,16,66,Pass
Raj Pillai,20-09-2005,964162,Rajasthan,2,0,14,19,35,Fail
Sukhwinder Chopra,18-03-2005,189410,Bihar,23,11,16,16,66,Pass
Vivaan Khan,20-11-2005,118288,Bihar,11,24,6,22,63,Pass
Ishaan Fernandes,27-12-2005,137474,Bihar,13,18,21,9,61,Pass
Balbir Chopra,07-01-2005,506160,Uttar Pradesh,9,13,19,23,64,Pass
Krishna Fernandes,13-04-2005,291530,Bihar,23,19,21,0,63,Pass
Balbir Khan,03-10-2005,542107,Assam,6,7,21,15,49,Pass
Aryan Fernandes,29-07-2005,534334,Uttar Pradesh,17,1,22,6,46,Pass
Krishna Sharma,23-11-2005,462078,Uttar Pradesh,18,17,8,1,44,Pass
Vivaan D'Souza,23-12-2004,917927,Maharashtra,19,18,9,1,47,Fail
Aarav Verma,06-09-2005,278130,Jharkhand,3,18,5,4,30,Fail
Yash D'Souza,09-03-2005,462598,Maharashtra,10,11,14,12,47,Fail
Ishaan Fernandes,26-02-2006,102733,Gujarat,23,5,1,7,36,Fail
Rohan Fernandes,25-04-2006,159050,Rajasthan,8,2,11,20,41,Fail
Krishna D'Souza,24-10-2005,226447,Telangana,23,22,0,24,69,Pass
Krishna D'Souza,24-07-2005,743752,Haryana,9,8,2,21,40,Pass
Raj Verma,13-03-2006,835285,Rajasthan,2,23,3,9,37,Fail
Yash Mehta,19-02-2005,688166,Bihar,5,18,9,4,36,Fail
Aditya Mehta,30-09-2005,436018,Odisha,20,6,12,16,54,Pass
Sukhwinder Pillai,18-04-2005,605305,Madhya Pradesh,17,4,21,15,57,Pass
Krishna Mehta,11-01-2005,621291,Chhattisgarh,4,8,12,8,32,Fail
Aarav Singh,26-02-2006,882444,Haryana,4,7,17,15,43,Pass
Kunal Singh,07-02-2006,111477,Jharkhand,23,1,14,20,58,Fail
Mathew Reddy,07-06-2005,702679,Uttar Pradesh,6,1,9,1,17,Pass
Gurpreet Reddy,06-12-2005,231406,Haryana,13,21,9,1,44,Pass
Sukhwinder Reddy,05-12-2005,295627,Uttar Pradesh,21,10,4,4,39,Pass
Rohan D'Souza,21-04-2005,262625,Maharashtra,15,11,23,21,70,Fail
Manpreet Pillai,28-08-2005,762884,Andhra Pradesh,3,14,20,12,49,Pass
David Pillai,10-08-2005,362766,Andaman & Nicobar,20,10,24,19,73,Pass
Kunal Khan,10-12-2005,704001,West Bengal,18,16,9,19,62,Fail
Ishaan Sharma,01-06-2005,872776,West Bengal,21,18,6,23,68,Fail
Sukhwinder Mehta,21-01-2006,150656,Uttar Pradesh,9,6,16,11,42,Pass
Raj Pillai,06-04-2006,160268,Punjab,22,5,12,17,56,Pass
Aarav D'Souza,30-12-2004,923476,Andhra Pradesh,21,17,11,1,50,Pass
Yash D'Souza,17-08-2005,238913,Tamil Nadu,11,9,21,19,60,Fail
Aarav Reddy,19-12-2004,221385,West Bengal,6,4,22,15,47,Fail
Raj Reddy,11-12-2004,749940,Himachal Pradesh,14,19,9,6,48,Fail
Vivaan Khan,25-04-2006,720912,Uttar Pradesh,2,24,11,2,39,Pass
Aditya Fernandes,30-04-2006,146861,West Bengal,23,17,3,19,62,Fail
Krishna D'Souza,07-12-2005,789825,Rajasthan,15,11,5,0,31,Fail
Ishaan Fernandes,10-04-2006,460254,West Bengal,22,12,13,14,61,Fail
Krishna Khan,20-10-2005,216114,Gujarat,1,19,24,17,61,Fail
Yash Khan,05-12-2004,966580,Tamil Nadu,19,17,8,7,51,Fail
David D'Souza,19-12-2004,130811,West Bengal,16,6,2,2,26,Fail
Rohan Verma,02-05-2006,323433,West Bengal,21,6,14,22,63,Fail
Vivaan Pillai,31-12-2004,278996,Telangana,13,21,12,5,51,Pass
Kunal Reddy,04-05-2006,868571,Karnataka,8,17,2,15,42,Fail
Krishna Sharma,31-12-2005,619828,Maharashtra,9,13,16,11,49,Fail
David Sharma,09-03-2005,360282,Tamil Nadu,21,1,4,5,31,Fail
Vivaan Pillai,08-12-2005,997315,Bihar,22,5,4,7,38,Fail
Sukhwinder Khan,16-01-2006,681037,Meghalaya,19,20,7,13,59,Fail
Rohan D'Souza,21-02-2005,949611,Madhya Pradesh,18,2,14,20,54,Pass
Raj Khan,08-11-2004,337516,Telangana,12,7,0,24,43,Pass
Ishaan Chopra,21-04-2006,265930,Uttar Pradesh,14,3,19,20,56,Pass
Aryan Pillai,30-06-2005,386448,Bihar,21,7,2,15,45,Fail
Aditya Reddy,09-05-2005,802439,Tamil Nadu,8,22,0,17,47,Fail
Rohan D'Souza,14-11-2005,220145,Andhra Pradesh,13,19,22,17,71,Pass
Kunal Reddy,02-04-2005,811456,Maharashtra,20,14,6,0,40,Fail
Imran D'Souza,04-08-2005,815026,Maharashtra,7,15,21,3,46,Fail
Ishaan Singh,12-03-2006,818475,Madhya Pradesh,19,23,3,9,54,Pass
Rohan Fernandes,10-11-2004,151822,Maharashtra,8,17,24,0,49,Fail
Mathew Singh,13-07-2005,794905,Tamil Nadu,23,0,1,7,31,Fail
Krishna Chopra,01-01-2005,715992,Assam,5,11,9,8,33,Pass
Sukhwinder Singh,30-04-2006,685019,Gujarat,23,5,5,2,35,Fail
Aryan Singh,24-01-2005,844599,Madhya Pradesh,0,10,23,22,55,Pass
Raj Pillai,25-11-2004,320846,Andaman & Nicobar,13,16,20,7,56,Pass
Aarav Singh,07-07-2005,735171,Jharkhand,4,6,20,19,49,Fail
Yash Chopra,28-06-2005,431225,Uttar Pradesh,11,12,22,11,56,Pass
Ishaan Khan,27-03-2006,516859,Chhattisgarh,0,7,10,18,35,Fail
Krishna Singh,06-01-2006,309307,Rajasthan,20,11,1,1,33,Fail
Raj Khan,18-11-2004,291929,Tamil Nadu,20,9,6,21,56,Fail
Aarav Khan,02-04-2006,721108,Assam,23,5,4,17,49,Pass
Harjeet Reddy,03-01-2005,601420,Rajasthan,1,18,2,13,34,Fail
Kunal Sharma,10-12-2004,871102,Tripura,22,11,3,13,49,Pass
Raj D'Souza,07-12-2004,746649,Telangana,4,5,15,12,36,Pass
Sukhwinder Singh,01-09-2005,515627,Andhra Pradesh,1,14,23,7,45,Pass
Paul Sharma,23-12-2004,820925,West Bengal,9,0,6,16,31,Fail
Aarav Verma,20-02-2005,106115,Delhi,11,1,14,5,31,Pass
Gurpreet Mehta,29-09-2005,779714,Uttar Pradesh,24,14,23,6,67,Pass
Aarav Reddy,21-05-2005,361903,Telangana,6,1,19,9,35,Pass
Rohan Reddy,04-04-2006,238761,Madhya Pradesh,3,21,11,5,40,Pass
David Verma,20-09-2005,896396,West Bengal,2,9,3,3,17,Fail
David D'Souza,12-03-2005,703944,Rajasthan,5,1,19,19,44,Fail
Rehan Pillai,13-12-2005,734373,Uttar Pradesh,22,10,9,20,61,Pass
Yash Fernandes,01-05-2005,142094,Puducherry,17,21,6,11,55,Fail
Zaid Fernandes,14-01-2006,707880,Haryana,3,16,1,15,35,Pass
Kunal Chopra,28-09-2005,549797,West Bengal,0,24,6,16,46,Fail
Rohan Singh,22-04-2005,275982,Madhya Pradesh,21,4,17,20,62,Pass
Ishaan Mehta,08-04-2005,212727,Gujarat,10,3,24,12,49,Fail
Aditya Chopra,11-11-2004,783521,Chhattisgarh,22,1,5,16,44,Fail
Vivaan Reddy,16-12-2005,577461,Jharkhand,21,2,20,9,52,Fail
Aarav Chopra,01-05-2005,213146,Chhattisgarh,2,15,18,10,45,Fail
Aryan Chopra,14-02-2006,130311,Karnataka,11,12,24,9,56,Fail
Aryan Fernandes,25-11-2004,397301,Bihar,19,11,20,12,62,Pass
Kunal Singh,13-06-2005,519384,Madhya Pradesh,11,22,0,15,48,Pass
Aditya D'Souza,22-09-2005,373620,Bihar,24,24,9,22,79,Pass
Krishna Fernandes,21-07-2005,654751,Punjab,6,1,5,14,26,Fail
Rohan Singh,28-05-2005,881079,Uttar Pradesh,8,15,12,0,35,Pass
Yash Fernandes,19-12-2005,965389,Delhi,17,18,8,22,65,Pass
Rohan Verma,06-05-2005,185147,Karnataka,15,1,17,12,45,Fail
Peter Singh,22-07-2005,922667,Punjab,17,13,1,7,38,Fail
Gurpreet Chopra,03-02-2006,706039,Rajasthan,22,3,7,12,44,Fail
Krishna Singh,15-01-2006,548904,Bihar,14,19,21,4,58,Pass
Rohan Sharma,24-12-2004,566312,Jammu & Kashmir + Ladakh,23,22,21,3,69,Fail
Kunal Khan,30-01-2006,604851,Andhra Pradesh,12,15,16,1,44,Pass
Aditya Singh,04-05-2006,864643,Maharashtra,13,3,14,1,31,Fail
Rohan Verma,23-04-2005,223391,Bihar,4,1,3,23,31,Fail
Ishaan Khan,12-01-2005,839538,Rajasthan,9,20,0,2,31,Fail
Yash Pillai,03-01-2005,813208,Uttar Pradesh,7,8,6,7,28,Pass
Harjeet Chopra,20-01-2005,990248,Andhra Pradesh,2,6,6,17,31,Pass
Vivaan Fernandes,20-10-2005,822341,Gujarat,19,3,13,19,54,Fail
Aryan Pillai,27-03-2005,976007,Madhya Pradesh,13,1,5,15,34,Pass
Raj Mehta,16-09-2005,632894,Maharashtra,2,2,8,21,33,Fail
Vivaan Chopra,04-12-2005,877714,Odisha,13,22,18,18,71,Pass
Aditya Khan,20-02-2005,285886,Uttarakhand,12,8,5,21,46,Pass
Gurpreet Pillai,18-08-2005,258623,Odisha,19,8,14,11,52,Pass
Kunal Verma,17-12-2005,656013,Telangana,3,12,5,1,21,Pass
Yash Fernandes,20-01-2005,643388,Tamil Nadu,16,13,13,18,60,Fail
Krishna Verma,22-04-2006,174029,Chhattisgarh,14,14,14,8,50,Fail
Raj Reddy,17-03-2005,759336,Bihar,3,23,11,22,59,Pass
Mathew Mehta,10-02-2006,958366,Bihar,8,17,22,7,54,Pass
Vivaan Mehta,10-02-2006,741868,Rajasthan,1,7,21,15,44,Fail
Harjeet D'Souza,12-02-2006,585917,Chhattisgarh,1,16,21,13,51,Fail
Gurpreet Chopra,28-04-2006,638719,Bihar,6,21,5,21,53,Pass
Rehan Mehta,11-09-2005,274571,Andhra Pradesh,13,19,24,23,79,Pass
Aryan Pillai,09-08-2005,930238,Uttar Pradesh,3,17,15,5,40,Pass
Aditya Mehta,17-09-2005,658849,Madhya Pradesh,18,4,16,19,57,Pass
Vivaan Pillai,19-09-2005,494007,West Bengal,19,21,12,8,60,Fail
Raj D'Souza,10-04-2006,982108,Karnataka,6,23,15,19,63,Fail
Raj Khan,16-02-2006,323960,Bihar,1,22,8,6,37,Fail
Zaid Singh,17-11-2004,972938,Bihar,11,22,20,1,54,Pass
Gurpreet Verma,02-03-2005,122148,Punjab,1,8,4,12,25,Fail
Rehan Sharma,21-08-2005,674739,Bihar,1,1,1,21,24,Fail
Kunal Mehta,29-03-2006,508519,Bihar,20,16,1,16,53,Pass
Kunal Khan,23-09-2005,422706,Madhya Pradesh,4,1,9,16,30,Pass
Aditya Verma,18-11-2005,129769,Jharkhand,11,2,6,6,25,Fail
Kunal Sharma,02-03-2006,894732,Madhya Pradesh,5,3,23,6,37,Pass
Krishna Chopra,12-02-2006,568916,Telangana,10,20,10,9,49,Pass
Paul Reddy,15-04-2006,266375,Bihar,21,1,1,18,41,Fail
Rohan Mehta,08-02-2006,128516,Punjab,15,6,23,11,55,Pass
Sukhwinder Reddy,22-12-2004,345720,Maharashtra,7,19,22,16,64,Fail
Aryan Singh,07-12-2004,886069,Delhi,13,1,21,20,55,Pass
Aryan Khan,02-03-2005,598205,Punjab,22,12,16,8,58,Pass
Vivaan Pillai,03-01-2006,502372,Gujarat,8,0,10,16,34,Fail
Krishna Pillai,26-01-2005,407800,Assam,17,14,13,23,67,Pass
Harjeet Reddy,20-01-2006,125095,West Bengal,4,17,14,20,55,Fail
Paul Reddy,16-02-2005,882310,Gujarat,24,7,14,7,52,Fail
Aarav Verma,17-06-2005,138084,Rajasthan,7,7,24,23,61,Pass
Aditya Reddy,12-11-2005,903614,Uttar Pradesh,13,9,5,15,42,Pass
Krishna Verma,16-07-2005,530202,Himachal Pradesh,15,14,3,10,42,Fail
Yash Chopra,02-10-2005,848891,Himachal Pradesh,22,5,12,7,46,Fail
Peter Fernandes,10-02-2006,490994,Madhya Pradesh,24,18,8,2,52,Pass
Aditya Fernandes,29-11-2004,301418,Rajasthan,3,20,8,11,42,Fail
David Sharma,20-04-2006,399865,Maharashtra,4,15,3,17,39,Fail
Aditya Mehta,24-03-2006,548323,Punjab,10,8,14,6,38,Fail
Ishaan Singh,10-05-2005,924287,Rajasthan,22,16,8,18,64,Pass
Ishaan Mehta,07-02-2005,191327,Jharkhand,8,14,18,5,45,Fail
Ishaan D'Souza,06-09-2005,787944,Rajasthan,6,15,20,21,62,Pass
Farhan Pillai,15-05-2005,386654,Uttar Pradesh,19,1,4,17,41,Pass
Sukhwinder Verma,27-08-2005,843084,Bihar,7,19,19,10,55,Pass
Aarav Pillai,28-07-2005,328597,Madhya Pradesh,0,19,20,4,43,Pass
Imran Singh,20-06-2005,498675,West Bengal,14,13,22,4,53,Fail
John D'Souza,24-02-2005,385863,Jammu & Kashmir + Ladakh,16,2,2,15,35,Fail
Raj D'Souza,22-02-2005,527663,Himachal Pradesh,5,5,10,21,41,Fail
Paul Chopra,25-04-2006,502902,West Bengal,16,8,19,10,53,Fail
Yash Mehta,05-02-2005,770199,Karnataka,1,24,10,14,49,Fail
Aryan Sharma,09-02-2005,998886,Karnataka,7,14,18,17,56,Fail
Peter Reddy,27-12-2005,715511,Bihar,6,15,8,9,38,Fail
Aryan Reddy,11-04-2005,291324,Bihar,6,21,1,2,30,Fail
Raj Sharma,29-06-2005,894353,Rajasthan,19,21,13,16,69,Pass
Rohan Khan,04-01-2006,100934,Rajasthan,13,0,13,11,37,Fail
Raj Mehta,09-03-2006,428605,Uttar Pradesh,7,6,5,4,22,Pass
Krishna D'Souza,11-06-2005,993999,Daman & Diu / D&N Haveli,24,6,22,0,52,Fail
Yash Reddy,05-01-2006,840295,Kerala,19,1,20,8,48,Pass
Sukhwinder D'Souza,13-03-2005,321130,Uttar Pradesh,21,1,18,11,51,Pass
Ishaan Mehta,22-03-2006,422581,Maharashtra,15,22,11,2,50,Fail
Mathew Verma,19-06-2005,257883,Jharkhand,23,13,24,11,71,Fail
Sukhwinder Khan,13-07-2005,532282,Andhra Pradesh,6,9,24,3,42,Pass
David Singh,25-06-2005,131496,Tripura,6,15,18,18,57,Pass
Aryan Reddy,18-07-2005,694232,Rajasthan,20,8,21,24,73,Pass
Aryan D'Souza,09-10-2005,132041,Uttarakhand,16,11,9,10,46,Pass
Vivaan Pillai,19-11-2004,394820,Bihar,18,5,16,17,56,Pass
Sukhwinder Khan,15-11-2005,564389,Bihar,20,5,17,11,53,Pass
Vivaan Khan,24-01-2005,612307,Uttar Pradesh,7,14,14,14,49,Pass
Aryan Fernandes,06-12-2004,711706,Uttar Pradesh,4,2,11,3,20,Pass
Aarav Khan,04-09-2005,676423,Andaman & Nicobar,19,20,4,0,43,Pass
Aryan Chopra,11-06-2005,475273,Uttar Pradesh,18,22,19,3,62,Pass
Aryan Mehta,01-02-2006,554715,Bihar,20,19,0,15,54,Pass
Kunal Mehta,27-11-2005,909828,Tamil Nadu,10,17,13,4,44,Fail
Rehan Chopra,02-01-2005,145970,Maharashtra,2,13,15,15,45,Fail
Ishaan Verma,04-07-2005,150775,Maharashtra,13,12,11,2,38,Fail
Ishaan Fernandes,09-01-2006,327262,Tripura,5,0,0,18,23,Pass
Manpreet Pillai,11-01-2005,499613,Madhya Pradesh,15,4,22,13,54,Pass
Aryan Chopra,18-03-2006,997959,Uttarakhand,14,6,4,15,39,Pass
Ishaan Mehta,02-04-2006,177497,Uttarakhand,19,23,3,1,46,Pass
Kunal Khan,25-12-2004,437007,Bihar,24,15,23,24,86,Fail
Krishna Khan,24-12-2005,669905,Rajasthan,9,14,5,12,40,Fail
Vivaan Reddy,01-07-2005,869629,West Bengal,22,21,18,24,85,Fail
Rohan Singh,20-03-2005,122582,Jharkhand,21,11,6,3,41,Fail
Kunal Sharma,27-01-2006,835522,Uttar Pradesh,2,9,6,20,37,Pass
Aditya Verma,14-04-2005,897568,West Bengal,13,22,22,0,57,Fail
Yash Singh,06-12-2004,347038,Chhattisgarh,14,7,12,22,55,Fail
Mathew Sharma,08-11-2005,583687,West Bengal,9,17,23,1,50,Fail
Krishna Sharma,10-04-2005,346902,Rajasthan,19,6,0,23,48,Fail
Harjeet Fernandes,24-05-2005,978631,Uttar Pradesh,6,1,24,24,55,Pass
Sukhwinder Reddy,24-04-2005,892901,Bihar,24,13,9,3,49,Pass
Vivaan Chopra,10-10-2005,128332,Madhya Pradesh,10,10,13,1,34,Pass
Aryan Khan,07-12-2004,232208,Rajasthan,10,1,20,21,52,Fail
Aditya Singh,24-07-2005,311509,Rajasthan,2,0,2,19,23,Fail
Aarav Mehta,23-01-2006,758896,Assam,18,10,5,23,56,Pass
Kunal Khan,28-11-2005,683360,Andhra Pradesh,4,2,6,8,20,Pass
Aryan Mehta,23-12-2004,750371,Punjab,15,21,23,18,77,Fail
Mathew Chopra,03-02-2006,349059,Assam,21,20,17,13,71,Pass
Krishna Pillai,30-11-2004,192083,Maharashtra,7,22,1,9,39,Fail
Balbir Verma,14-11-2005,644075,Jharkhand,10,20,15,21,66,Fail
Kunal D'Souza,24-10-2005,116728,Uttar Pradesh,15,23,4,12,54,Pass
Vivaan Singh,14-04-2006,423251,Himachal Pradesh,2,2,14,11,29,Fail
Sukhwinder Sharma,17-11-2005,862150,Bihar,12,23,9,19,63,Pass
Raj Sharma,26-01-2005,910265,Rajasthan,11,9,5,7,32,Fail
John Khan,30-09-2005,789973,Bihar,5,22,9,11,47,Pass
Aryan Reddy,06-12-2005,116409,Telangana,9,13,7,24,53,Fail
Aditya Verma,23-01-2006,423066,Odisha,6,7,10,5,28,Fail
Rohan Verma,18-03-2005,785139,Jharkhand,1,11,22,1,35,Fail
Kunal Singh,16-04-2006,316027,Maharashtra,0,7,7,17,31,Fail
Aarav Singh,22-03-2005,230110,Bihar,14,4,11,2,31,Fail
Aarav Sharma,06-09-2005,350124,Gujarat,5,14,14,6,39,Fail
Aarav Fernandes,22-05-2005,565709,Telangana,2,12,3,8,25,Pass
Peter Verma,09-11-2004,736617,Gujarat,22,19,12,16,69,Fail
Rohan Mehta,09-09-2005,659004,Karnataka,22,4,20,14,60,Fail
Aarav Verma,14-01-2005,647050,Delhi,16,8,20,18,62,Pass
Aditya Reddy,25-10-2005,545828,Karnataka,20,5,10,15,50,Fail
Aarav Verma,22-03-2005,523958,Madhya Pradesh,4,1,19,19,43,Pass
Krishna Singh,09-04-2006,629895,Uttar Pradesh,8,20,16,19,63,Pass
Krishna Khan,27-08-2005,773271,Tamil Nadu,18,4,0,9,31,Fail
John Khan,03-12-2005,136741,Assam,8,2,6,5,21,Pass
Raj Sharma,19-04-2006,927245,Madhya Pradesh,24,4,17,0,45,Pass
Aditya Reddy,17-11-2005,568857,Madhya Pradesh,1,15,2,8,26,Pass
Aryan D'Souza,24-02-2006,813484,Bihar,19,13,3,15,50,Pass
Harjeet Reddy,06-11-2005,648823,Madhya Pradesh,2,8,12,8,30,Pass
Rohan Pillai,22-08-2005,114434,Bihar,17,21,10,20,68,Pass
Sukhwinder Mehta,27-07-2005,317139,Assam,18,6,23,1,48,Pass
Vivaan D'Souza,28-06-2005,376040,Tamil Nadu,2,24,24,22,72,Fail
Raj Chopra,24-12-2005,155510,Maharashtra,22,1,21,23,67,Fail
Yash Fernandes,18-01-2006,498904,Andhra Pradesh,6,7,17,1,31,Pass
Gurpreet Mehta,19-12-2005,776028,Uttar Pradesh,22,3,18,22,65,Pass
Aryan Chopra,09-01-2005,465584,Gujarat,0,14,17,4,35,Fail
Aryan Fernandes,23-01-2005,921823,Punjab,24,7,17,23,71,Pass
Ishaan Chopra,11-08-2005,541690,Tripura,7,8,15,10,40,Pass
Ishaan Reddy,23-04-2006,334767,Rajasthan,19,7,13,10,49,Fail
Kunal Fernandes,03-12-2004,614355,Haryana,22,12,10,18,62,Pass
John Verma,02-04-2006,869609,Rajasthan,21,13,13,10,57,Fail
Manpreet Mehta,27-02-2005,581472,Assam,12,1,19,20,52,Pass
John Verma,16-06-2005,216733,Bihar,24,11,16,22,73,Pass
Ishaan Chopra,14-04-2006,477435,West Bengal,24,4,3,13,44,Fail
Ishaan Mehta,20-10-2005,432411,Telangana,16,21,3,17,57,Pass
Aditya Pillai,20-06-2005,178439,Odisha,13,23,16,11,63,Pass
Aarav Pillai,23-12-2004,478518,Jammu & Kashmir + Ladakh,7,0,18,22,47,Fail
Kunal Mehta,18-11-2004,942632,Bihar,18,11,1,18,48,Pass
Peter Fernandes,01-11-2005,730381,Rajasthan,22,10,2,18,52,Fail
Aditya Singh,08-02-2005,685751,Rajasthan,1,22,4,20,47,Fail
Vivaan Sharma,22-10-2005,490262,Odisha,2,17,4,7,30,Fail
Mathew Verma,09-01-2005,232088,Chhattisgarh,18,23,12,0,53,Fail
Aryan Reddy,02-09-2005,955174,Punjab,7,2,19,13,41,Fail
Balbir Pillai,16-06-2005,839548,Haryana,0,4,18,18,40,Pass
Yash Pillai,01-04-2005,122568,Punjab,16,0,4,21,41,Fail
Ishaan Mehta,07-08-2005,464837,Madhya Pradesh,9,4,24,9,46,Pass
Aryan D'Souza,26-07-2005,556401,Bihar,8,3,19,6,36,Fail
Manpreet Singh,13-05-2005,969818,Andhra Pradesh,5,19,24,15,63,Pass
Aarav Chopra,27-05-2005,220164,Bihar,17,20,10,7,54,Pass
Ayaan Reddy,30-11-2005,765934,Gujarat,6,18,10,15,49,Fail
Vivaan Fernandes,10-06-2005,667133,Tripura,20,4,12,12,48,Pass
Rohan Verma,15-02-2005,390803,Gujarat,11,17,24,13,65,Fail
Harjeet D'Souza,12-04-2005,478984,West Bengal,9,14,13,20,56,Fail
Aditya Verma,05-08-2005,807656,Maharashtra,19,4,12,0,35,Fail
Aarav Khan,17-03-2006,394699,Tamil Nadu,5,6,11,4,26,Fail
Aarav Mehta,14-02-2006,913385,Karnataka,2,9,4,10,25,Fail
Kunal D'Souza,02-12-2004,276888,Karnataka,6,18,21,6,51,Fail
Rohan Sharma,28-05-2005,892742,Manipur,18,3,19,11,51,Fail
Aarav Pillai,19-11-2005,414277,Uttar Pradesh,24,4,17,21,66,Pass
Harjeet Chopra,30-01-2006,197320,Telangana,22,9,13,20,64,Fail
Ishaan Reddy,13-02-2005,175961,Rajasthan,8,14,23,15,60,Pass
Vivaan Chopra,31-12-2005,495260,Andhra Pradesh,4,1,9,13,27,Pass
John Pillai,21-04-2006,561056,Uttar Pradesh,21,16,13,11,61,Pass
Raj Sharma,14-03-2005,431987,Odisha,15,19,5,2,41,Fail
Kunal Sharma,22-08-2005,768227,Maharashtra,7,0,2,18,27,Fail
Krishna Singh,03-09-2005,976387,Bihar,23,22,11,22,78,Pass
Yash Sharma,17-05-2005,958337,Karnataka,15,22,2,6,45,Fail
Sukhwinder Fernandes,27-03-2006,573653,Haryana,2,7,10,18,37,Pass
Ishaan Pillai,13-10-2005,637358,West Bengal,5,19,8,13,45,Fail
Raj Reddy,30-12-2005,277047,Uttar Pradesh,16,19,2,8,45,Pass
Rohan Sharma,02-02-2005,148292,Madhya Pradesh,14,5,2,5,26,Pass
Krishna Fernandes,12-12-2004,299680,Bihar,23,17,11,22,73,Pass
Mathew Reddy,09-09-2005,821480,Jharkhand,6,21,0,1,28,Fail
Ishaan Singh,10-11-2005,886805,Karnataka,20,7,14,8,49,Fail
Ishaan Khan,04-06-2005,390396,Punjab,6,17,16,20,59,Pass
Harjeet D'Souza,12-09-2005,191858,West Bengal,12,2,19,3,36,Fail
Krishna Sharma,07-04-2005,503075,Goa,1,8,0,9,18,Fail
Yash Sharma,14-01-2005,554854,Bihar,11,20,14,23,68,Pass
Harjeet Fernandes,18-10-2005,831358,Madhya Pradesh,5,17,4,7,33,Pass
Aditya Chopra,24-12-2004,654067,Uttar Pradesh,6,14,10,6,36,Pass
Ayaan Pillai,09-04-2005,680997,Uttar Pradesh,14,21,2,5,42,Pass
Kunal Khan,13-11-2005,809029,Karnataka,9,19,23,3,54,Fail
Manpreet Khan,02-05-2005,151523,Jammu & Kashmir + Ladakh,24,13,4,19,60,Fail
Vivaan Sharma,29-07-2005,168634,Delhi,11,23,14,4,52,Pass
Gurpreet Chopra,12-01-2005,581783,Assam,7,20,1,21,49,Pass
Krishna Singh,24-10-2005,256230,Bihar,19,13,18,19,69,Pass
Sukhwinder Reddy,21-02-2005,980074,Bihar,15,18,20,7,60,Pass
Ishaan Pillai,24-03-2006,195991,Odisha,19,16,11,7,53,Pass
Aryan D'Souza,12-04-2006,619186,Tamil Nadu,16,4,0,6,26,Fail
Yash Chopra,08-04-2006,602234,Uttar Pradesh,20,22,8,7,57,Pass
Ishaan Singh,18-03-2006,737021,Uttar Pradesh,11,5,18,10,44,Pass
Zaid Chopra,05-08-2005,276583,Bihar,12,11,16,10,49,Pass
Sukhwinder D'Souza,20-01-2005,349617,Haryana,16,13,4,13,46,Pass
Rohan Pillai,16-07-2005,799826,Uttarakhand,16,3,9,0,28,Pass
Harjeet Chopra,09-09-2005,596854,Jharkhand,14,18,3,24,59,Fail
Yash Verma,15-05-2005,652661,Sikkim,14,23,0,3,40,Pass
Yash Verma,15-05-2005,764380,Rajasthan,11,15,16,14,56,Fail
Ishaan Pillai,07-01-2005,291918,Uttar Pradesh,13,1,14,24,52,Pass
Aditya Khan,12-02-2005,999665,Andhra Pradesh,19,13,18,15,65,Pass
Mathew Khan,30-10-2005,262787,Jharkhand,8,1,19,5,33,Fail
Vivaan Singh,02-09-2005,225263,Haryana,13,1,6,24,44,Pass
Aditya D'Souza,28-08-2005,219605,West Bengal,18,6,12,7,43,Fail
Kunal Khan,18-07-2005,222680,Punjab,15,18,10,21,64,Pass
John Sharma,06-08-2005,875925,Maharashtra,23,10,3,11,47,Fail
Kunal Reddy,06-02-2006,747506,Punjab,7,5,12,6,30,Fail
Gurpreet Pillai,11-11-2004,882672,Karnataka,24,3,2,5,34,Fail
Balbir Fernandes,04-01-2006,576430,Madhya Pradesh,13,6,6,8,33,Pass
Kunal Reddy,27-01-2005,744079,Uttar Pradesh,0,22,14,1,37,Pass
Aditya Khan,23-01-2005,134129,Nagaland,0,14,23,19,56,Fail
Ayaan Reddy,19-09-2005,604662,West Bengal,6,6,2,7,21,Fail
Raj D'Souza,18-06-2005,247807,Chhattisgarh,23,10,7,12,52,Fail
Aryan Sharma,12-08-2005,994976,Telangana,22,0,6,14,42,Pass
Vivaan Khan,27-01-2006,947795,Uttar Pradesh,13,5,11,22,51,Pass
Aditya Khan,26-04-2005,424775,Telangana,6,7,3,17,33,Pass
Ishaan Chopra,10-12-2005,572179,Punjab,10,16,4,0,30,Fail
Mathew Reddy,05-12-2004,677658,Uttarakhand,19,13,3,21,56,Pass
Ishaan D'Souza,19-03-2006,996636,Gujarat,11,9,2,5,27,Fail
Kunal Singh,25-11-2004,431150,Bihar,21,5,13,17,56,Pass
Raj Reddy,06-07-2005,227576,Bihar,23,18,15,6,62,Pass
Aryan Fernandes,11-12-2004,133870,Kerala,3,8,6,0,17,Pass
Raj D'Souza,15-05-2005,234761,Uttar Pradesh,17,8,16,22,63,Pass
Balbir Chopra,15-12-2005,584306,Rajasthan,12,2,0,18,32,Fail
Aarav Sharma,04-08-2005,273724,Odisha,19,21,7,7,54,Pass
Ishaan Reddy,06-04-2006,337434,West Bengal,4,17,3,21,45,Fail
Vivaan Reddy,25-08-2005,720231,Rajasthan,8,17,17,5,47,Fail
Rohan Chopra,14-07-2005,167639,Jharkhand,24,19,17,23,83,Fail
Raj Verma,04-03-2006,436215,Jharkhand,14,0,4,6,24,Fail
Raj Pillai,19-07-2005,451586,Odisha,12,20,12,6,50,Pass
Paul Verma,05-09-2005,166701,Gujarat,20,20,13,12,65,Fail
Raj Pillai,09-09-2005,110025,Karnataka,4,20,1,2,27,Fail
Rehan Sharma,10-01-2006,267264,Maharashtra,21,14,0,18,53,Fail
Balbir Mehta,24-12-2004,872358,Tamil Nadu,5,5,20,8,38,Fail
Ishaan Pillai,26-07-2005,859177,Uttar Pradesh,7,2,24,13,46,Pass
Aarav Fernandes,19-09-2005,493233,Rajasthan,6,1,22,17,46,Fail
Yash Khan,27-05-2005,599187,Kerala,8,13,9,0,30,Pass
Aarav Singh,14-12-2004,752212,Andhra Pradesh,23,0,10,24,57,Pass
Ishaan Pillai,22-12-2005,606740,Tamil Nadu,17,2,16,11,46,Fail
Yash Khan,05-12-2005,597324,Rajasthan,1,5,24,16,46,Fail
Kunal Mehta,10-01-2005,795461,Karnataka,10,19,4,19,52,Fail
Manpreet Sharma,09-10-2005,663017,Rajasthan,3,11,0,0,14,Fail
Harjeet Chopra,24-09-2005,285815,Jharkhand,5,0,19,0,24,Fail
Ishaan Chopra,19-02-2006,514513,Haryana,19,5,19,12,55,Pass
Vivaan Sharma,04-06-2005,890943,Tamil Nadu,5,9,13,22,49,Fail
Raj Verma,19-06-2005,432344,Rajasthan,2,18,20,16,56,Fail
Harjeet Khan,21-11-2004,209660,Bihar,21,23,5,17,66,Pass
Aarav Pillai,03-06-2005,245794,Punjab,15,4,0,8,27,Fail
Kunal Sharma,03-02-2006,769399,Madhya Pradesh,20,7,16,5,48,Pass
Rehan Chopra,12-07-2005,523324,Jammu & Kashmir + Ladakh,9,16,3,12,40,Fail
Rohan Pillai,06-03-2005,285481,Gujarat,1,15,19,0,35,Fail
Ayaan Pillai,06-08-2005,330051,Uttar Pradesh,13,17,8,14,52,Pass
Yash Chopra,03-06-2005,637351,Bihar,0,2,17,19,38,Fail
Ishaan Pillai,14-10-2005,617914,Rajasthan,0,10,17,7,34,Fail
Paul Pillai,07-11-2005,821580,Madhya Pradesh,15,4,23,18,60,Pass
Rohan Mehta,20-12-2004,398240,Haryana,20,3,24,23,70,Pass
Gurpreet Reddy,11-04-2006,585543,Gujarat,15,23,9,10,57,Fail
Sukhwinder Sharma,29-03-2005,636057,Sikkim,5,7,6,15,33,Pass
Aryan Chopra,07-01-2005,896074,Uttar Pradesh,17,2,8,1,28,Pass
Manpreet Sharma,28-10-2005,386116,Maharashtra,23,19,2,7,51,Fail
Aarav Mehta,25-01-2005,246274,Bihar,16,6,8,11,41,Fail
Mathew Sharma,19-11-2005,238289,Uttar Pradesh,6,13,10,23,52,Pass
Vivaan Singh,23-01-2006,823826,Rajasthan,7,7,3,4,21,Fail
Ishaan Sharma,11-01-2006,519100,Gujarat,12,21,11,20,64,Fail
Rohan Reddy,27-12-2005,753884,Telangana,4,7,3,12,26,Pass
Aarav Sharma,29-04-2005,517253,Delhi,20,19,13,12,64,Pass
Rohan Reddy,19-01-2005,218236,Bihar,24,20,5,10,59,Pass
Paul Sharma,19-04-2005,293790,Uttar Pradesh,20,5,8,16,49,Pass
Krishna D'Souza,08-12-2005,396379,Uttar Pradesh,17,1,2,10,30,Pass
Kunal Khan,04-12-2005,218152,Maharashtra,4,15,16,4,39,Fail
Yash Verma,12-07-2005,827858,Punjab,20,14,7,6,47,Pass
Kunal Singh,22-10-2005,702102,Rajasthan,19,7,15,16,57,Fail
Balbir Reddy,20-05-2005,458944,Odisha,19,2,1,19,41,Fail
David Sharma,02-03-2005,467597,Jharkhand,11,10,1,19,41,Fail
Kunal D'Souza,18-02-2006,292699,Himachal Pradesh,6,12,15,8,41,Fail
Ishaan Verma,20-12-2005,736945,Uttarakhand,4,5,19,7,35,Pass
Yash Sharma,31-10-2005,489099,Uttar Pradesh,19,18,17,7,61,Pass
Rohan Fernandes,24-12-2004,509129,Odisha,3,12,15,9,39,Fail
Mathew Singh,25-02-2005,864404,Uttar Pradesh,9,21,9,12,51,Pass
Mathew Mehta,23-11-2005,703481,Bihar,2,9,24,21,56,Pass
Raj D'Souza,27-11-2005,935834,West Bengal,7,10,24,2,43,Fail
Rohan Verma,29-05-2005,445957,Jharkhand,6,13,20,15,54,Fail
Raj Verma,08-03-2005,928408,Tamil Nadu,20,15,19,0,54,Fail
Aarav Pillai,25-03-2005,854604,Karnataka,0,17,23,1,41,Fail
Raj Mehta,08-03-2005,254702,Rajasthan,19,13,8,19,59,Fail
Aarav D'Souza,20-05-2005,364419,Andhra Pradesh,2,3,5,20,30,Pass
David Chopra,28-07-2005,490742,West Bengal,12,12,11,17,52,Fail
Krishna Mehta,28-09-2005,360666,Jharkhand,11,6,13,1,31,Fail
David Fernandes,06-08-2005,195156,Madhya Pradesh,23,24,5,0,52,Pass
Yash Sharma,01-05-2006,743035,Meghalaya,20,15,15,23,73,Fail
John D'Souza,06-08-2005,535591,Punjab,16,18,11,18,63,Pass
Paul Singh,26-05-2005,569970,Tamil Nadu,18,3,10,21,52,Fail
Yash Verma,21-11-2004,306332,Maharashtra,12,5,9,8,34,Fail
Mathew Pillai,11-04-2006,640675,Telangana,23,14,3,1,41,Pass
Krishna Khan,21-09-2005,679378,Punjab,22,6,9,3,40,Fail
Krishna Khan,01-04-2005,228899,Maharashtra,13,6,13,20,52,Fail
Raj D'Souza,23-06-2005,907622,Punjab,8,6,17,20,51,Pass
Rohan D'Souza,19-11-2004,718760,West Bengal,19,20,14,12,65,Fail
Paul Pillai,03-09-2005,960824,Haryana,7,6,22,13,48,Pass
Sukhwinder Chopra,23-10-2005,109895,Andhra Pradesh,6,0,2,20,28,Pass
Ishaan Singh,11-02-2006,732459,Gujarat,13,21,0,20,54,Fail
Peter Mehta,24-09-2005,513980,West Bengal,3,2,8,19,32,Fail
Ishaan Sharma,20-09-2005,612019,Tamil Nadu,19,14,22,3,58,Fail
Kunal Khan,14-12-2004,701854,Madhya Pradesh,11,16,8,9,44,Pass
Aarav Singh,16-02-2005,923094,Bihar,23,10,17,5,55,Pass
Yash Mehta,16-10-2005,166551,Kerala,11,21,6,0,38,Pass
Aryan Mehta,08-02-2005,224044,Jharkhand,0,23,18,8,49,Fail
Yash D'Souza,16-08-2005,351738,Haryana,14,14,5,22,55,Pass
Ishaan Verma,05-11-2005,127196,Karnataka,22,10,24,13,69,Fail
Imran Pillai,28-01-2006,839018,Karnataka,8,16,23,12,59,Fail
Yash Pillai,14-09-2005,618425,Uttar Pradesh,22,16,3,12,53,Pass
Raj Fernandes,31-10-2005,514794,West Bengal,1,0,9,22,32,Fail
Aarav Singh,29-09-2005,666009,Bihar,19,5,2,12,38,Fail
Ishaan Verma,03-02-2005,540019,Tamil Nadu,23,15,10,5,53,Fail
Raj Mehta,31-05-2005,677075,Chhattisgarh,3,9,21,16,49,Fail
Gurpreet Mehta,24-03-2006,768816,Bihar,0,18,0,8,26,Fail
Vivaan Verma,02-05-2006,339538,Odisha,19,3,22,24,68,Pass
Vivaan D'Souza,25-05-2005,298737,Tripura,4,22,17,9,52,Fail
Kunal Sharma,15-11-2005,162640,Telangana,16,6,10,15,47,Pass
Gurpreet D'Souza,23-05-2005,787414,Maharashtra,6,20,4,17,47,Fail
Raj D'Souza,23-09-2005,626944,Bihar,4,6,11,24,45,Fail
Aarav Fernandes,31-01-2006,332960,Rajasthan,20,15,2,23,60,Pass
Raj Verma,24-04-2006,252827,Madhya Pradesh,23,0,12,1,36,Pass
Yash Fernandes,26-05-2005,657455,Bihar,17,17,11,24,69,Pass
Aryan Sharma,01-05-2005,542863,Uttar Pradesh,13,16,13,12,54,Pass
Ishaan Khan,31-10-2005,345203,Maharashtra,20,7,15,2,44,Fail
Yash Fernandes,30-08-2005,738807,Maharashtra,4,20,24,1,49,Fail
Vivaan Pillai,08-12-2005,339370,Tamil Nadu,13,5,14,16,48,Fail
Raj Singh,14-07-2005,473023,Uttar Pradesh,18,9,9,8,44,Pass
Yash Khan,20-11-2005,793484,Madhya Pradesh,11,2,21,17,51,Pass
Balbir Fernandes,14-04-2005,828763,Rajasthan,2,9,13,12,36,Fail
Aryan Verma,08-02-2005,256344,Kerala,9,11,16,14,50,Pass
Vivaan Verma,17-01-2006,334651,Haryana,2,13,20,0,35,Pass
Rohan Mehta,23-03-2005,757510,Karnataka,21,16,17,13,67,Fail
Rohan Mehta,12-09-2005,359394,West Bengal,11,17,22,10,60,Fail
Aryan Sharma,05-05-2005,266536,West Bengal,7,24,23,24,78,Fail
Manpreet Fernandes,02-03-2005,483831,Telangana,19,18,14,2,53,Fail
Raj Chopra,19-06-2005,570009,Uttar Pradesh,10,6,9,19,44,Pass
Aditya Singh,07-12-2005,845701,Jharkhand,13,13,1,12,39,Fail
Krishna Khan,04-04-2006,551058,Karnataka,5,12,11,6,34,Fail
Aryan Pillai,09-03-2006,199245,Chhattisgarh,20,8,23,16,67,Fail
Harjeet Fernandes,10-12-2004,438417,Assam,15,2,9,7,33,Pass
Aryan Fernandes,25-10-2005,185796,Uttarakhand,4,11,6,4,25,Pass
Raj Khan,08-04-2006,335415,Bihar,21,4,19,22,66,Pass
Yash Singh,09-04-2006,909833,Tamil Nadu,23,21,14,22,80,Fail
Raj Mehta,05-01-2006,957590,Bihar,13,22,21,17,73,Pass
Vivaan Sharma,05-01-2005,343470,Himachal Pradesh,17,24,16,18,75,Fail
Kunal Pillai,11-07-2005,916653,Maharashtra,16,4,8,6,34,Fail
Aryan Verma,29-01-2006,144946,Gujarat,1,5,22,6,34,Fail
Aditya Sharma,18-08-2005,392930,Uttar Pradesh,14,20,12,23,69,Pass
Kunal Khan,06-04-2005,489672,Tamil Nadu,4,15,21,19,59,Fail
Kunal Sharma,07-01-2005,553117,Himachal Pradesh,0,8,22,13,43,Fail
Rohan Pillai,29-07-2005,738442,Maharashtra,8,23,13,23,67,Fail
Aryan Mehta,17-01-2005,510087,Andhra Pradesh,16,5,24,5,50,Pass
Vivaan Singh,09-04-2005,927868,Haryana,18,13,8,24,63,Pass
David D'Souza,13-01-2005,183413,West Bengal,22,17,13,11,63,Fail
Ishaan Pillai,13-03-2005,413566,Gujarat,13,9,1,14,37,Fail
Vivaan Fernandes,09-02-2006,144236,Rajasthan,2,19,24,20,65,Pass
Raj Verma,31-10-2005,771002,Uttar Pradesh,24,23,7,11,65,Pass
Vivaan D'Souza,31-05-2005,582008,Uttarakhand,21,1,11,14,47,Pass
Balbir Reddy,26-07-2005,172269,Bihar,10,3,19,11,43,Fail
Yash Khan,06-12-2004,730287,Madhya Pradesh,24,4,23,24,75,Pass
Aarav Khan,21-12-2004,627810,Rajasthan,19,23,0,7,49,Fail
Ishaan Sharma,19-02-2006,467794,Tripura,1,6,1,24,32,Fail
Ishaan Verma,16-07-2005,904423,Bihar,10,6,10,23,49,Pass
Raj Verma,30-01-2005,457602,Maharashtra,5,6,4,2,17,Fail
Krishna Khan,20-04-2005,405572,Uttar Pradesh,14,1,4,13,32,Pass
Yash Fernandes,06-06-2005,308814,West Bengal,20,7,23,16,66,Fail
John Singh,09-02-2005,596229,Bihar,19,13,18,19,69,Pass
Aditya Reddy,11-01-2006,613561,West Bengal,1,1,8,8,18,Fail
Manpreet Sharma,07-01-2006,794581,Puducherry,11,5,21,22,59,Fail
Manpreet Pillai,16-05-2005,707103,Bihar,2,6,4,2,14,Fail
Krishna Chopra,06-03-2006,890734,Telangana,1,1,6,1,9,Pass
Vivaan Mehta,21-01-2006,736143,West Bengal,14,3,17,7,41,Fail
Rohan Singh,26-05-2005,563570,Gujarat,22,15,23,19,79,Fail
Manpreet Verma,26-01-2005,525952,Rajasthan,9,19,24,14,66,Pass
Mathew Fernandes,09-09-2005,455825,Bihar,14,19,19,12,64,Pass
Imran Fernandes,11-02-2005,731838,Madhya Pradesh,14,4,24,20,62,Pass
Peter Sharma,26-03-2006,279594,Uttar Pradesh,15,3,9,4,31,Pass
Rohan Chopra,22-11-2005,756712,Rajasthan,11,14,6,11,42,Fail
Ishaan Pillai,10-11-2005,621531,Rajasthan,20,21,6,24,71,Pass
Raj Mehta,26-08-2005,991457,Tamil Nadu,12,13,8,21,54,Fail
Krishna Mehta,05-05-2005,598837,Assam,16,4,0,9,29,Pass
Vivaan Chopra,23-02-2005,946969,Bihar,17,2,14,6,39,Fail
Harjeet Singh,12-12-2004,896673,Delhi,21,19,10,2,52,Pass
David Khan,04-03-2005,988784,Uttar Pradesh,16,3,2,12,33,Pass
Peter Mehta,17-03-2005,614753,Tamil Nadu,10,1,1,15,27,Fail
Rohan Reddy,02-05-2005,788173,Maharashtra,17,2,18,1,38,Fail
Balbir Chopra,14-05-2005,427151,Haryana,23,1,7,17,48,Pass
Krishna Chopra,07-06-2005,647755,Himachal Pradesh,4,3,19,21,47,Fail
Aryan Reddy,13-07-2005,237702,Andhra Pradesh,6,0,21,13,40,Pass
Manpreet Reddy,15-01-2005,767591,Bihar,12,1,18,5,36,Fail
Aryan Verma,23-12-2004,930866,Madhya Pradesh,2,8,20,24,54,Pass
Manpreet Pillai,28-07-2005,591788,Telangana,0,11,0,12,23,Pass
Vivaan Reddy,17-12-2005,476327,Andhra Pradesh,11,13,7,8,39,Pass
John Mehta,11-01-2006,886139,Bihar,18,20,16,17,71,Pass
Aditya Verma,28-06-2005,317360,Odisha,18,13,22,14,67,Pass
David Singh,27-06-2005,472115,Telangana,2,16,14,12,44,Pass
Ishaan Fernandes,23-01-2005,295670,Daman & Diu / D&N Haveli,15,13,20,23,71,Fail
Kunal Sharma,21-10-2005,479651,Maharashtra,15,10,5,10,40,Fail
Balbir Fernandes,18-04-2006,627615,Bihar,15,21,2,4,42,Fail
Raj Chopra,03-02-2006,488649,Maharashtra,4,1,24,11,40,Fail
Harjeet Fernandes,13-08-2005,297359,West Bengal,12,8,5,4,29,Fail
Rohan Verma,04-02-2006,140854,Meghalaya,13,11,24,20,68,Fail
Paul Chopra,09-06-2005,163660,Rajasthan,7,6,8,3,24,Fail
Aryan Singh,11-07-2005,102768,Madhya Pradesh,9,18,3,0,30,Pass
Yash Reddy,01-05-2006,262630,Maharashtra,11,15,2,0,28,Fail
Raj Khan,20-04-2005,922434,Odisha,10,16,6,7,39,Fail
Mathew D'Souza,12-01-2006,987364,Rajasthan,16,6,24,3,49,Fail
Aditya Reddy,03-11-2005,223642,Punjab,11,17,6,16,50,Pass
Harjeet Singh,05-01-2006,337977,Madhya Pradesh,12,20,5,0,37,Pass
Yash Sharma,06-06-2005,679379,Bihar,14,9,8,21,52,Pass
David Sharma,01-01-2005,906148,Himachal Pradesh,9,17,1,16,43,Fail
Paul D'Souza,16-02-2005,718868,Gujarat,18,21,18,5,62,Fail
Aarav Khan,28-10-2005,484683,Maharashtra,2,8,20,5,35,Fail
Krishna D'Souza,18-12-2005,806737,Andhra Pradesh,21,1,17,12,51,Pass
Yash Chopra,08-01-2006,397325,Karnataka,9,23,2,0,34,Fail
Ishaan Chopra,30-01-2006,703875,Bihar,23,8,14,6,51,Pass
Harjeet Singh,04-11-2005,228813,Rajasthan,22,24,21,9,76,Fail
Rohan Sharma,03-05-2005,120499,Rajasthan,22,23,0,6,51,Fail
Yash D'Souza,16-12-2005,727955,Maharashtra,3,0,20,6,29,Fail
Vivaan Chopra,10-12-2005,498732,Bihar,16,2,10,22,50,Pass
Aditya Chopra,17-03-2006,235190,Jharkhand,6,18,5,19,48,Fail
Rohan Verma,08-02-2006,129690,Uttar Pradesh,9,24,11,7,51,Pass
Harjeet Fernandes,12-09-2005,569462,Bihar,9,15,9,5,38,Fail
Krishna Verma,04-02-2006,920103,Gujarat,2,3,21,18,44,Fail
Aditya D'Souza,03-06-2005,271367,Haryana,13,4,15,22,54,Pass
Aditya Reddy,08-12-2005,792816,Sikkim,14,11,13,21,59,Fail
Vivaan Mehta,20-03-2005,447553,Bihar,15,10,2,20,47,Pass
Mathew Pillai,09-04-2005,432351,Uttar Pradesh,4,17,10,0,31,Pass
Raj D'Souza,21-02-2005,743022,Bihar,2,9,12,20,43,Fail
Yash Singh,20-01-2005,339004,Andhra Pradesh,9,16,5,11,41,Pass
Yash Pillai,15-04-2005,400316,Jharkhand,20,22,2,10,54,Fail
Aditya D'Souza,22-03-2006,381646,Gujarat,21,6,10,11,48,Fail
Rehan Sharma,02-05-2005,213133,Haryana,3,1,1,14,19,Pass
Rohan Fernandes,20-11-2005,190804,Jharkhand,24,11,1,5,41,Fail
Krishna Pillai,18-02-2006,226400,Himachal Pradesh,14,2,21,12,49,Fail
Aditya D'Souza,30-05-2005,315245,Maharashtra,17,13,19,9,58,Fail
Yash Chopra,25-12-2004,871562,Maharashtra,10,20,14,4,48,Fail
Raj Khan,16-06-2005,975768,Madhya Pradesh,5,10,3,24,42,Pass
Krishna Fernandes,16-09-2005,596464,Gujarat,9,18,14,1,42,Fail
John Mehta,29-11-2005,284047,Chhattisgarh,7,12,24,15,58,Fail
Peter D'Souza,09-06-2005,882215,Uttar Pradesh,3,8,6,4,21,Pass
Zaid Fernandes,22-01-2005,168676,West Bengal,4,16,6,2,28,Fail
Aarav Fernandes,10-04-2006,762036,Bihar,22,7,17,0,46,Pass
Aarav Chopra,19-02-2005,757605,West Bengal,0,15,8,2,25,Fail
Gurpreet Verma,08-04-2005,601968,Maharashtra,22,1,6,8,37,Fail
Rohan Khan,15-03-2005,391510,Bihar,20,20,12,24,76,Pass
Mathew Pillai,03-08-2005,329530,Punjab,7,24,4,10,45,Pass
Ishaan Verma,25-09-2005,423477,Telangana,1,12,9,7,29,Pass
Kunal Chopra,31-01-2006,420215,West Bengal,3,8,14,1,26,Fail
Aditya Singh,12-12-2005,974804,Gujarat,14,11,17,4,46,Fail
Rohan Reddy,13-04-2006,926606,Uttar Pradesh,0,3,17,5,25,Pass
Vivaan Verma,16-12-2005,277558,Gujarat,13,23,7,16,59,Fail
Krishna Sharma,15-04-2006,654362,Assam,6,19,15,12,52,Pass
Manpreet Pillai,14-03-2005,321139,Madhya Pradesh,7,21,3,11,42,Pass
David Chopra,11-11-2004,572420,Jharkhand,23,17,5,21,66,Fail
Aditya Mehta,12-04-2006,324912,Madhya Pradesh,13,4,6,24,47,Pass
Kunal Sharma,15-01-2005,953086,Telangana,4,23,13,0,40,Pass
Ishaan D'Souza,12-02-2005,883646,Andhra Pradesh,2,20,12,24,58,Pass
Aarav D'Souza,20-01-2005,767087,Madhya Pradesh,24,0,10,18,52,Pass
Kunal Mehta,20-03-2006,310879,Uttar Pradesh,6,18,0,12,36,Pass
Peter D'Souza,24-12-2004,178134,Rajasthan,0,15,13,13,41,Fail
Aditya Sharma,06-10-2005,478940,Gujarat,7,21,24,3,55,Fail
Vivaan Chopra,01-03-2006,464090,Tamil Nadu,8,5,14,18,45,Fail
Krishna Verma,09-11-2005,731650,Madhya Pradesh,13,4,15,18,50,Pass
Rohan Khan,24-12-2005,627296,Punjab,21,24,8,19,72,Pass
Aryan Sharma,20-11-2005,861048,Rajasthan,2,13,21,20,56,Fail
Raj Mehta,23-03-2005,202352,Uttar Pradesh,24,11,4,19,58,Pass
Rohan Reddy,20-04-2006,762491,Bihar,23,0,6,4,33,Fail
Paul Reddy,19-06-2005,121802,Uttar Pradesh,6,24,7,9,46,Pass
Kunal Singh,15-08-2005,413666,Himachal Pradesh,13,13,16,12,54,Fail
Aditya Khan,01-04-2005,398592,Uttarakhand,24,20,3,0,47,Pass
Vivaan Singh,15-03-2006,401134,Rajasthan,10,11,6,10,37,Fail
Vivaan Pillai,03-06-2005,304848,Meghalaya,7,3,18,4,32,Fail
Aryan Khan,14-11-2004,936696,Andhra Pradesh,0,19,18,19,56,Pass
Kunal Chopra,23-03-2005,973231,Bihar,5,5,9,17,36,Fail
Rohan Mehta,04-06-2005,599435,Rajasthan,7,7,0,4,18,Fail
Gurpreet Sharma,08-12-2005,675787,Gujarat,19,11,8,23,61,Fail
Balbir Reddy,04-06-2005,560459,Haryana,15,4,4,21,44,Pass
Krishna D'Souza,02-08-2005,766297,West Bengal,13,21,6,20,60,Fail
Sukhwinder Singh,11-02-2006,452869,Tamil Nadu,7,2,12,13,34,Fail
Aryan Reddy,26-06-2005,513396,Uttar Pradesh,7,11,9,24,51,Pass
Aditya Pillai,18-06-2005,176159,Punjab,22,11,10,14,57,Pass
Aryan Reddy,19-12-2004,180654,Telangana,17,2,0,20,39,Pass
Manpreet Fernandes,24-03-2005,845582,Rajasthan,17,12,24,21,74,Fail
Vivaan Chopra,07-01-2006,750208,Tamil Nadu,3,14,20,7,44,Fail
Sukhwinder Chopra,21-02-2005,273939,Kerala,6,24,19,20,69,Fail
Rohan Sharma,30-11-2005,327569,Uttar Pradesh,11,8,22,20,61,Pass
Manpreet Mehta,14-03-2006,888593,Tamil Nadu,15,13,0,1,29,Fail
Imran Khan,19-10-2005,579599,Maharashtra,3,17,3,8,31,Fail
Aditya Sharma,16-12-2005,730800,Puducherry,20,5,0,22,47,Fail
Ishaan Reddy,01-06-2005,863198,Bihar,20,5,5,11,41,Fail
Krishna Chopra,17-04-2005,231021,Madhya Pradesh,3,0,16,12,31,Pass
Raj Reddy,04-12-2004,582050,Maharashtra,9,12,20,5,46,Fail
Kunal Fernandes,06-05-2006,614104,Uttar Pradesh,8,7,15,7,37,Pass
Aryan Fernandes,27-03-2005,794270,Rajasthan,17,24,2,24,67,Pass
Kunal D'Souza,09-08-2005,605849,Rajasthan,3,21,13,8,45,Fail
David Verma,04-07-2005,506261,Chhattisgarh,4,0,13,6,23,Fail
Kunal Mehta,19-04-2005,547046,Odisha,19,20,16,11,66,Pass
Krishna Reddy,12-03-2005,440444,Maharashtra,19,7,22,10,58,Fail
Aditya Reddy,16-02-2005,544860,Andhra Pradesh,15,13,8,9,45,Pass
Harjeet Fernandes,25-02-2005,557589,Delhi,2,22,13,1,38,Pass
Ishaan Pillai,26-10-2005,766992,Rajasthan,14,8,15,6,43,Fail
Ishaan Reddy,04-07-2005,825554,Uttar Pradesh,13,23,7,19,62,Pass
Aarav Reddy,10-03-2006,423759,Bihar,21,23,7,7,58,Pass
Aarav Chopra,26-12-2005,282166,Maharashtra,13,10,18,19,60,Fail
Ishaan D'Souza,07-04-2005,688144,Meghalaya,11,19,22,12,64,Fail
Aarav Singh,29-12-2005,206661,Rajasthan,16,4,21,19,60,Pass
Mathew Reddy,28-01-2005,185187,Maharashtra,5,12,21,2,40,Fail
Kunal Sharma,04-03-2006,472923,Andhra Pradesh,19,9,18,18,64,Pass
Rohan Khan,05-12-2005,559090,Uttar Pradesh,16,0,18,18,52,Pass
Kunal Chopra,09-07-2005,763072,Uttar Pradesh,6,12,24,21,63,Pass
Balbir D'Souza,26-11-2004,546280,West Bengal,6,10,24,9,49,Fail
Raj Reddy,24-12-2004,612151,Haryana,9,18,9,24,60,Pass
Ishaan Verma,08-06-2005,559691,Rajasthan,1,18,6,18,43,Fail
Yash Khan,17-04-2005,939628,Bihar,15,7,15,24,61,Pass
Vivaan D'Souza,15-11-2005,117718,West Bengal,7,3,21,0,31,Fail
Vivaan Verma,10-01-2006,514398,Tamil Nadu,10,1,8,16,35,Fail
Peter Khan,31-03-2005,678998,Uttarakhand,16,16,11,21,64,Fail
Raj Fernandes,19-04-2006,841830,Rajasthan,14,4,8,14,40,Fail
Aryan D'Souza,15-05-2005,176830,Haryana,14,12,5,16,47,Pass
Manpreet Chopra,11-04-2005,964640,Rajasthan,14,4,17,11,46,Fail
Krishna Pillai,20-11-2004,954042,Odisha,17,15,13,7,52,Pass
Manpreet D'Souza,10-12-2005,559326,Rajasthan,0,1,13,11,25,Fail
Balbir D'Souza,18-08-2005,175516,Andhra Pradesh,23,0,14,6,43,Pass
Krishna Reddy,21-01-2006,598096,Bihar,5,11,10,14,40,Fail
Kunal Sharma,22-02-2006,584608,Jammu & Kashmir + Ladakh,10,7,7,12,36,Fail
Balbir Khan,22-08-2005,291487,Rajasthan,10,24,19,16,69,Pass
Kunal Khan,08-11-2004,519607,Assam,17,22,7,10,56,Pass
Vivaan Sharma,13-04-2005,900741,Kerala,14,17,5,21,57,Pass
Peter Reddy,23-01-2005,600920,Bihar,16,15,0,11,42,Fail
Aditya Reddy,23-01-2005,516422,Manipur,5,2,20,14,41,Fail
Aryan Singh,08-01-2005,976262,West Bengal,9,1,1,17,28,Fail
Ishaan Pillai,08-05-2005,724231,Haryana,0,18,4,20,42,Pass
Balbir Sharma,20-01-2006,210962,West Bengal,9,11,13,9,42,Fail
Yash Fernandes,15-07-2005,441121,Gujarat,19,9,18,11,57,Fail
Kunal D'Souza,10-07-2005,253853,Andhra Pradesh,20,16,15,1,52,Pass
Kunal Khan,08-02-2006,351130,Telangana,9,21,10,24,64,Fail
Krishna Mehta,08-08-2005,598769,Bihar,21,11,17,13,62,Pass
Raj Khan,11-06-2005,103485,Karnataka,18,22,19,21,80,Fail
Sukhwinder Fernandes,25-03-2005,331620,Uttar Pradesh,12,17,16,3,48,Pass
Manpreet Chopra,27-03-2006,523054,Andhra Pradesh,7,19,1,13,40,Pass
Aditya Chopra,31-07-2005,714818,Bihar,19,1,22,23,65,Pass
David Chopra,16-04-2005,351117,Uttarakhand,0,15,19,3,37,Fail
Kunal Verma,07-03-2005,539961,Madhya Pradesh,0,17,2,6,25,Pass
Sukhwinder Reddy,16-05-2005,634632,Uttar Pradesh,22,5,8,6,41,Pass
John Mehta,06-01-2005,566132,Uttar Pradesh,17,15,10,14,56,Pass
Raj Pillai,19-07-2005,993081,Maharashtra,9,6,18,5,38,Fail
Raj Sharma,17-03-2006,541219,Tamil Nadu,23,1,3,0,27,Fail
Kunal Verma,19-03-2006,468647,Punjab,20,13,23,3,59,Pass
Manpreet Verma,01-05-2005,261248,Andhra Pradesh,18,11,20,21,70,Pass
Yash Fernandes,17-07-2005,111387,Uttar Pradesh,9,21,11,12,53,Pass
Paul Reddy,17-01-2005,385733,Andhra Pradesh,17,15,13,8,53,Pass
Yash Chopra,31-03-2006,307341,Gujarat,16,16,0,22,54,Fail
Raj Reddy,29-08-2005,708437,Uttar Pradesh,23,3,14,23,63,Pass
Aryan Mehta,20-11-2005,142193,Andhra Pradesh,17,11,16,10,54,Pass
Aarav Fernandes,27-01-2006,542845,Andhra Pradesh,21,5,12,1,39,Pass
Raj Fernandes,17-04-2006,933722,West Bengal,4,10,8,17,39,Fail
Yash Fernandes,29-01-2006,931098,Bihar,20,0,8,21,49,Pass
Raj Pillai,22-12-2005,915283,Rajasthan,24,20,20,23,87,Fail
David Fernandes,27-08-2005,538677,Himachal Pradesh,7,13,1,19,40,Fail
Aryan Reddy,02-02-2005,927651,Chhattisgarh,16,10,0,3,29,Fail
Ishaan D'Souza,20-05-2005,246221,Chhattisgarh,21,24,14,14,73,Fail
Aryan Khan,20-02-2005,136211,Puducherry,20,19,5,20,64,Fail
Aarav Reddy,06-11-2005,408325,Gujarat,3,20,15,5,43,Fail
Aarav Khan,23-01-2006,706634,Andhra Pradesh,10,9,11,9,39,Pass
Harjeet D'Souza,05-05-2006,100707,Telangana,9,21,17,8,55,Fail
Aarav D'Souza,31-01-2006,996218,West Bengal,12,13,5,16,46,Fail
Mathew D'Souza,04-11-2005,514766,Bihar,19,21,17,18,75,Pass
David Pillai,18-11-2005,515932,Maharashtra,1,23,2,14,40,Fail
Harjeet Pillai,20-04-2006,308617,Maharashtra,3,9,10,16,38,Fail
Peter D'Souza,04-02-2006,835114,Odisha,3,17,8,17,45,Pass
Harjeet Fernandes,26-01-2005,444869,Odisha,4,15,22,20,61,Pass
Manpreet Chopra,29-01-2005,569533,Delhi,7,4,6,6,23,Pass
Krishna Pillai,18-02-2005,386417,Rajasthan,2,0,8,23,33,Fail
Gurpreet Mehta,25-10-2005,911956,Haryana,6,20,13,3,42,Pass
Aditya Reddy,18-07-2005,946505,Madhya Pradesh,21,4,19,21,65,Pass
Yash Verma,02-01-2005,750059,West Bengal,18,13,20,7,58,Fail
Rohan Pillai,14-11-2005,231105,Madhya Pradesh,21,4,12,18,55,Pass
Rohan Reddy,12-09-2005,887512,Maharashtra,8,17,4,6,35,Fail
Aryan Sharma,22-01-2006,959338,Karnataka,1,19,0,12,32,Fail
Ishaan Singh,12-06-2005,648622,Karnataka,16,21,10,18,65,Fail
Balbir Mehta,09-05-2006,893793,Delhi,7,17,6,17,47,Pass
Krishna Singh,17-02-2005,668785,Assam,6,6,17,20,49,Pass
Aryan Sharma,04-08-2005,904400,Punjab,6,5,17,15,43,Fail
Harjeet Khan,31-01-2005,350716,Kerala,19,2,1,3,25,Pass
Rohan Verma,25-07-2005,620769,Bihar,17,8,18,13,56,Pass
Mathew Chopra,23-12-2005,981888,Bihar,24,10,7,6,47,Pass
Manpreet Sharma,08-12-2004,472040,Rajasthan,8,11,19,11,49,Fail
Rohan Reddy,14-08-2005,768782,West Bengal,6,11,1,19,37,Fail
Imran Khan,06-05-2006,259542,Jammu & Kashmir + Ladakh,20,0,8,0,28,Fail
Imran Singh,19-07-2005,906606,Jammu & Kashmir + Ladakh,24,12,1,11,48,Fail
Krishna Verma,16-03-2005,303525,Telangana,24,5,9,11,49,Pass
Aarav Khan,20-06-2005,595280,Jammu & Kashmir + Ladakh,14,3,19,16,52,Fail
Vivaan Khan,14-10-2005,110352,Tripura,14,7,12,12,45,Fail
Kunal Fernandes,27-03-2005,964401,Rajasthan,9,3,9,10,31,Fail
Rohan D'Souza,21-12-2004,987232,Andhra Pradesh,16,0,15,10,41,Pass
Raj Khan,03-04-2005,630060,Bihar,6,24,7,7,44,Fail
Krishna Pillai,05-06-2005,778181,Uttar Pradesh,23,3,13,24,63,Pass
Aarav Verma,24-04-2005,939443,Jammu & Kashmir + Ladakh,0,2,3,24,29,Fail
Raj Pillai,30-11-2004,605222,Telangana,10,18,4,13,45,Pass
Krishna Sharma,13-09-2005,114250,Andhra Pradesh,5,7,18,9,39,Pass
Raj Khan,15-02-2006,813648,Bihar,17,19,1,8,45,Fail
Paul Sharma,08-04-2006,573265,Punjab,20,14,6,5,45,Pass
Zaid Fernandes,14-05-2005,243007,Rajasthan,4,17,12,13,46,Fail
Yash Khan,10-03-2006,865954,Bihar,11,24,18,22,75,Pass
Harjeet Singh,06-10-2005,919539,Tamil Nadu,17,18,20,24,79,Fail
Balbir Singh,16-11-2005,437146,Rajasthan,19,4,7,3,33,Fail
David Verma,27-11-2005,365591,West Bengal,2,7,11,16,36,Fail
Aarav Fernandes,16-12-2005,219006,Bihar,10,5,21,20,56,Pass
Peter Khan,01-05-2006,274629,Maharashtra,9,0,13,23,45,Fail
Kunal Singh,10-01-2005,307295,Uttar Pradesh,16,10,0,13,39,Pass
Aditya Verma,11-10-2005,813091,Nagaland,20,18,18,24,80,Fail
Peter Reddy,14-03-2005,484054,Uttar Pradesh,21,3,17,19,60,Pass
Manpreet D'Souza,06-05-2005,252003,Maharashtra,22,11,11,1,45,Fail
Yash Singh,07-09-2005,629367,Bihar,13,24,24,15,76,Pass
Ishaan Chopra,16-09-2005,871940,Delhi,16,4,11,20,51,Pass
Vivaan Singh,19-04-2005,584260,Uttar Pradesh,24,7,11,18,60,Pass
Ishaan Singh,22-12-2005,629316,Madhya Pradesh,6,7,4,24,41,Pass
Vivaan Mehta,01-06-2005,530062,Telangana,7,17,16,5,45,Pass
Aarav Sharma,06-03-2006,114278,Gujarat,8,4,2,24,38,Fail
John Pillai,20-05-2005,431060,Bihar,23,11,15,18,67,Pass
Vivaan Chopra,09-01-2006,493044,Madhya Pradesh,14,5,21,11,51,Pass
Aarav Singh,20-11-2005,859128,Haryana,9,21,15,10,55,Pass
Rohan Pillai,07-05-2005,612113,Madhya Pradesh,16,4,21,4,45,Pass
Yash Chopra,06-08-2005,351697,Madhya Pradesh,16,1,10,14,41,Pass
Vivaan Fernandes,21-11-2004,813615,Assam,10,7,14,8,39,Pass
Vivaan D'Souza,20-01-2005,845281,Andhra Pradesh,24,4,19,22,69,Pass
Aarav D'Souza,11-01-2006,834494,Maharashtra,11,3,15,2,31,Fail
Ishaan Pillai,27-12-2005,765902,Kerala,24,3,20,5,52,Pass
Ayaan Reddy,25-02-2006,266472,Bihar,18,14,2,10,44,Fail
Aryan Pillai,21-01-2005,541689,Madhya Pradesh,14,4,19,8,45,Pass
Ishaan Khan,27-02-2006,992492,Tamil Nadu,13,3,4,4,24,Fail
Vivaan Mehta,29-08-2005,479390,Uttar Pradesh,13,11,12,14,50,Pass
Raj Verma,21-07-2005,276575,Jammu & Kashmir + Ladakh,11,0,12,10,33,Fail
Aditya Khan,04-06-2005,676169,Kerala,10,21,10,14,55,Pass
Ishaan Khan,17-07-2005,716273,Uttar Pradesh,23,2,22,11,58,Pass
Vivaan Singh,27-12-2005,344268,Andhra Pradesh,13,11,3,21,48,Pass
Rohan Khan,12-01-2005,561199,Kerala,18,3,20,3,44,Pass
Ishaan Pillai,06-05-2005,648871,Uttar Pradesh,15,10,5,22,52,Pass
Yash Singh,23-12-2004,997945,Kerala,4,2,13,5,24,Pass
Yash Khan,29-10-2005,481534,Maharashtra,3,9,0,10,22,Fail
Mathew Reddy,04-03-2006,582154,Kerala,22,6,14,18,60,Pass
Aryan Khan,05-04-2006,825546,Rajasthan,2,20,23,3,48,Fail
Aryan Khan,22-01-2006,338123,Daman & Diu / D&N Haveli,14,19,1,14,48,Fail
Krishna Reddy,10-03-2006,667344,West Bengal,14,17,8,2,41,Fail
Peter Singh,02-12-2004,661783,Bihar,17,8,24,12,61,Pass
Mathew Chopra,12-02-2005,477182,Gujarat,21,9,19,10,59,Fail
Aditya D'Souza,19-02-2005,458292,Maharashtra,21,1,19,17,58,Fail
Sukhwinder Fernandes,03-08-2005,365483,Tamil Nadu,16,5,21,12,54,Fail
Aditya D'Souza,21-12-2004,842989,Haryana,0,24,22,17,63,Pass
Kunal Verma,16-10-2005,415687,Rajasthan,7,1,23,22,53,Fail
Raj D'Souza,15-06-2005,981470,Madhya Pradesh,17,9,9,9,44,Pass
Krishna Khan,26-05-2005,517855,Gujarat,14,5,21,22,62,Fail
Aryan Pillai,20-06-2005,883704,Telangana,24,6,10,9,49,Pass
Balbir Pillai,09-01-2006,949912,Bihar,3,3,7,23,36,Fail
Kunal Verma,12-02-2006,759535,Uttarakhand,11,1,22,6,40,Fail
Krishna D'Souza,24-06-2005,527761,Himachal Pradesh,19,11,14,5,49,Fail
Yash D'Souza,02-04-2006,945898,Bihar,23,24,15,2,64,Pass
Peter Mehta,19-03-2006,741986,Maharashtra,24,19,22,12,77,Fail
Aditya Sharma,06-01-2006,550001,Telangana,9,8,23,21,61,Pass
Gurpreet Fernandes,20-01-2005,498762,Uttar Pradesh,24,10,14,20,68,Pass
Vivaan D'Souza,08-10-2005,167471,Telangana,18,19,10,11,58,Fail
Aryan D'Souza,18-12-2004,386962,Madhya Pradesh,17,7,4,16,44,Pass
Aarav Singh,22-08-2005,588660,Assam,18,13,9,0,40,Pass
Aarav Khan,19-04-2005,262826,Uttar Pradesh,5,14,20,10,49,Pass
Kunal Khan,05-12-2005,371589,West Bengal,23,14,15,12,64,Fail
Imran Verma,02-06-2005,477709,Assam,3,0,7,23,33,Pass
Aarav Verma,05-02-2006,383845,Bihar,8,1,18,16,43,Fail
Aarav Chopra,12-08-2005,259015,Haryana,23,6,15,23,67,Pass
Balbir D'Souza,08-11-2005,733363,Tamil Nadu,19,6,24,10,59,Fail
Raj Sharma,22-11-2005,876133,Maharashtra,18,6,18,4,46,Fail
Aryan Reddy,28-01-2005,914475,West Bengal,7,21,9,13,50,Fail
Rohan Singh,26-05-2005,638495,Assam,7,11,15,5,38,Pass
Aryan D'Souza,14-08-2005,274316,Gujarat,3,16,2,24,45,Fail
Aarav Verma,01-04-2005,325677,Jharkhand,8,16,2,15,41,Fail
Peter Verma,07-04-2006,909389,Haryana,19,17,10,3,49,Pass
Raj Verma,22-03-2005,616471,Punjab,9,16,22,17,64,Pass
Aryan Sharma,31-01-2006,954677,Telangana,12,19,23,13,67,Fail
Gurpreet Reddy,20-02-2005,448344,Rajasthan,12,5,22,0,39,Fail
Ishaan Chopra,08-01-2006,616786,Rajasthan,22,1,20,19,62,Pass
Krishna Singh,23-06-2005,212222,Uttar Pradesh,21,9,13,18,61,Pass
Krishna Mehta,14-10-2005,302416,Bihar,8,3,21,16,48,Pass
Peter Reddy,27-11-2004,790007,West Bengal,8,14,13,2,37,Fail
Aditya Reddy,26-12-2005,484965,Goa,5,9,17,6,37,Fail
Raj Verma,28-06-2005,849560,West Bengal,22,7,7,2,38,Fail
Kunal Sharma,08-06-2005,109729,Delhi,19,24,10,10,63,Pass
Yash Chopra,23-11-2005,799077,Rajasthan,20,23,8,16,67,Pass
Ayaan Mehta,18-03-2005,786494,Jharkhand,0,19,18,12,49,Fail
Krishna Mehta,12-12-2005,408633,Telangana,21,23,22,3,69,Pass
Aditya Mehta,20-03-2006,668808,West Bengal,11,4,18,20,53,Fail
Vivaan Singh,16-01-2005,269838,Jharkhand,24,9,21,16,70,Fail
Aarav Verma,11-12-2005,818434,Bihar,20,3,8,9,40,Fail
Ishaan Pillai,04-05-2005,754708,Uttar Pradesh,5,10,5,10,30,Pass
Vivaan Reddy,21-01-2005,913938,Madhya Pradesh,8,2,3,5,18,Pass
Rohan D'Souza,18-02-2005,952311,Rajasthan,4,9,1,11,25,Fail
Ishaan Mehta,12-04-2006,823016,Rajasthan,8,19,9,14,50,Fail
Raj Chopra,14-12-2004,725729,Andhra Pradesh,13,20,16,17,66,Pass
Krishna Sharma,08-02-2005,472430,Punjab,21,21,18,14,74,Fail
Zaid Fernandes,08-10-2005,246855,Delhi,21,22,2,14,59,Pass
Krishna Fernandes,22-01-2006,553400,Odisha,0,22,2,1,25,Fail
Raj D'Souza,17-01-2005,558557,Punjab,12,9,14,12,47,Pass
Krishna Singh,19-11-2005,123197,Andhra Pradesh,1,1,19,1,22,Pass
Yash Sharma,24-04-2005,308835,Punjab,23,10,16,16,65,Pass
Raj Fernandes,08-12-2005,655110,West Bengal,3,16,1,9,29,Fail
Ishaan Khan,26-01-2005,454828,Punjab,2,3,7,1,13,Fail
Peter Chopra,28-03-2005,999325,Uttar Pradesh,10,8,3,16,37,Pass
Raj Singh,18-03-2006,681257,Madhya Pradesh,24,4,18,12,58,Pass
Peter Chopra,10-12-2004,114111,Bihar,0,13,18,7,38,Fail
Vivaan D'Souza,02-02-2006,717874,Chhattisgarh,4,8,14,19,45,Fail
Vivaan Singh,20-04-2005,894068,Rajasthan,10,7,18,23,58,Fail
Rohan Verma,09-01-2006,320268,Rajasthan,6,18,7,19,50,Fail
Ishaan Sharma,16-11-2005,886219,Bihar,10,24,21,9,64,Pass
Raj Fernandes,25-12-2004,913124,Uttar Pradesh,10,3,11,13,37,Pass
Ishaan Sharma,27-11-2004,958022,Odisha,21,12,23,6,62,Pass
Rohan Singh,03-11-2005,872455,Tamil Nadu,18,22,17,3,60,Fail
Krishna Reddy,30-09-2005,639129,Delhi,3,12,5,10,30,Pass
Rohan Pillai,18-11-2005,155620,Sikkim,12,1,7,23,43,Fail
Aarav Mehta,24-02-2005,535710,Rajasthan,1,21,4,16,42,Fail
Vivaan Pillai,16-12-2005,663144,Tamil Nadu,6,18,22,19,65,Fail
Aarav Chopra,22-11-2004,113309,Himachal Pradesh,1,23,24,3,51,Fail
Manpreet D'Souza,06-04-2006,296239,Rajasthan,13,3,10,12,38,Fail
Kunal D'Souza,02-10-2005,982165,Punjab,5,10,22,21,58,Pass
Yash Reddy,02-12-2004,806638,Maharashtra,7,9,4,11,31,Fail
Yash Verma,14-12-2004,865967,Karnataka,8,11,3,10,32,Fail
Yash Khan,10-12-2004,445476,Telangana,3,0,17,3,23,Pass
Manpreet Verma,27-03-2006,228489,Bihar,13,0,2,9,24,Fail
Aarav Pillai,28-06-2005,779646,Meghalaya,22,6,10,16,54,Fail
Harjeet Mehta,14-03-2006,360448,Karnataka,5,21,15,24,65,Fail
Aditya Pillai,18-11-2004,487861,Odisha,17,24,0,1,42,Fail
Kunal Chopra,21-02-2005,855819,Jammu & Kashmir + Ladakh,23,3,13,22,61,Fail
Krishna Verma,06-08-2005,940434,Maharashtra,12,11,5,21,49,Fail
Rohan Fernandes,25-04-2005,453972,Tamil Nadu,14,0,23,14,51,Fail
David Singh,29-01-2005,107617,Madhya Pradesh,5,15,11,3,34,Pass
Aarav Fernandes,29-06-2005,245199,Uttarakhand,21,7,19,12,59,Fail
Yash Chopra,13-04-2005,591223,Uttar Pradesh,2,16,20,23,61,Pass
Yash Mehta,17-04-2005,304038,Uttar Pradesh,5,16,13,17,51,Pass
Gurpreet Chopra,08-05-2006,372473,Bihar,2,2,3,2,9,Fail
Aryan Mehta,10-03-2005,521172,Uttar Pradesh,16,14,18,24,72,Pass
Krishna Singh,20-01-2006,239468,Maharashtra,12,2,15,3,32,Fail
John Singh,27-03-2006,873336,Telangana,19,12,22,12,65,Pass
Vivaan Mehta,09-12-2005,765858,Madhya Pradesh,17,15,12,8,52,Pass
Manpreet Singh,04-10-2005,938543,Haryana,0,0,18,6,24,Pass
Yash Sharma,16-05-2005,240892,Uttar Pradesh,13,18,23,13,67,Pass
Krishna Sharma,17-02-2006,684060,Rajasthan,23,21,6,20,70,Pass
John Mehta,19-06-2005,538634,Maharashtra,8,20,15,14,57,Fail
Raj Mehta,18-08-2005,601484,Jharkhand,23,10,14,8,55,Fail
Aditya Reddy,16-09-2005,257399,Uttar Pradesh,23,0,3,2,28,Pass
Aryan Khan,25-03-2006,459608,Himachal Pradesh,4,8,19,7,38,Fail
Rohan Pillai,09-01-2006,754086,Uttar Pradesh,23,0,7,18,48,Pass
David Sharma,29-07-2005,932798,Nagaland,1,2,23,11,37,Fail
Raj Khan,12-08-2005,189289,Uttar Pradesh,6,5,24,10,45,Pass
Vivaan Singh,11-12-2005,338852,Punjab,2,19,9,16,46,Pass
Rehan Chopra,17-06-2005,108187,Andhra Pradesh,7,17,15,11,50,Pass
Yash Khan,22-01-2006,476629,Gujarat,24,15,13,14,66,Fail
Zaid Chopra,26-04-2006,888314,Uttar Pradesh,11,10,17,19,57,Pass
Ishaan Sharma,31-05-2005,968063,Uttar Pradesh,5,4,0,13,22,Pass
Kunal Sharma,07-10-2005,620097,Delhi,6,24,18,15,63,Pass
Krishna Pillai,20-11-2005,331781,Punjab,2,20,21,7,50,Pass
Balbir Fernandes,07-12-2004,383744,Rajasthan,0,2,6,12,20,Fail
Ishaan Khan,21-08-2005,337915,Bihar,13,24,24,9,70,Pass
Rohan Khan,06-02-2005,843894,Uttar Pradesh,20,9,10,14,53,Pass
Yash Verma,01-05-2005,655956,Maharashtra,21,8,0,21,50,Fail
Sukhwinder Sharma,08-06-2005,202058,Bihar,6,16,10,9,41,Fail
Aarav Reddy,17-03-2006,934214,Maharashtra,16,4,1,0,21,Fail
Rohan Sharma,03-07-2005,832157,Uttar Pradesh,7,7,14,20,48,Pass
Balbir Mehta,24-05-2005,560542,Punjab,14,5,23,15,57,Pass
Aryan Reddy,18-02-2006,650170,Kerala,16,17,22,2,57,Pass
Rohan Reddy,30-04-2006,725051,Rajasthan,16,4,24,22,66,Pass
Manpreet Khan,03-04-2006,648705,Andaman & Nicobar,7,16,1,0,24,Pass
Peter Khan,16-02-2006,151046,Maharashtra,1,10,19,24,54,Fail
Krishna Pillai,03-01-2006,542404,Uttar Pradesh,7,1,0,4,12,Pass
Krishna Singh,20-02-2006,433563,Telangana,6,22,14,14,56,Pass
Balbir Sharma,30-04-2005,521392,Telangana,18,15,3,17,53,Pass
Balbir Reddy,21-12-2004,369466,Rajasthan,2,20,12,9,43,Fail
Krishna Chopra,21-10-2005,230002,Gujarat,5,3,20,7,35,Fail
Aryan Singh,25-11-2005,137148,Bihar,22,1,19,5,47,Pass
Paul Khan,06-07-2005,920211,Rajasthan,12,24,11,24,71,Pass
Vivaan Pillai,21-03-2006,325731,Haryana,14,20,4,21,59,Pass
Yash Singh,02-02-2006,835963,Madhya Pradesh,8,2,0,7,17,Pass
Aryan Reddy,15-12-2005,402677,Rajasthan,0,14,1,16,31,Fail
Ayaan Chopra,08-12-2004,867585,Chhattisgarh,15,12,13,23,63,Fail
Aarav Sharma,05-04-2006,183815,Uttar Pradesh,23,3,11,10,47,Pass
Raj Mehta,16-03-2005,247622,Gujarat,8,0,6,18,32,Fail
Aryan Pillai,21-12-2005,527315,Rajasthan,2,14,9,10,35,Fail
Rehan Sharma,10-11-2005,529836,Rajasthan,23,17,13,12,65,Pass
Kunal Chopra,29-08-2005,292662,Chhattisgarh,22,12,15,17,66,Fail
Farhan Sharma,07-10-2005,752226,West Bengal,19,17,12,5,53,Fail
Gurpreet Reddy,08-04-2005,689813,Gujarat,19,15,0,11,45,Fail
Aryan Mehta,23-04-2005,913002,Haryana,6,14,3,12,35,Pass
Vivaan Verma,06-10-2005,931805,Bihar,4,18,4,9,35,Fail
Krishna Singh,25-12-2004,607507,Uttarakhand,3,8,0,3,14,Fail
Krishna Singh,16-01-2006,175298,Rajasthan,13,19,19,8,59,Fail
Kunal Mehta,02-04-2006,372514,Karnataka,23,10,6,2,41,Fail
Aarav Singh,13-09-2005,376775,Karnataka,6,10,19,6,41,Fail
Balbir Pillai,18-11-2004,392256,Madhya Pradesh,21,4,23,17,65,Pass
Yash Verma,20-04-2006,428805,Tamil Nadu,2,11,19,9,41,Fail
Paul Mehta,30-05-2005,103821,Uttar Pradesh,18,6,23,24,71,Pass
Krishna Fernandes,06-02-2005,151535,Kerala,18,3,14,10,45,Pass
Yash Verma,19-01-2005,795328,Jharkhand,10,10,17,4,41,Fail
Vivaan Mehta,08-01-2005,604697,Uttar Pradesh,7,2,24,6,39,Pass
Rohan Chopra,05-02-2006,879714,Andhra Pradesh,20,12,3,13,48,Pass
John Reddy,25-04-2005,809394,Bihar,1,18,13,10,42,Fail
Kunal Fernandes,15-06-2005,284922,Telangana,2,12,3,10,27,Pass
Peter Reddy,09-03-2006,429606,Bihar,21,10,21,7,59,Pass
Kunal Verma,21-12-2005,279123,Andhra Pradesh,16,11,8,2,37,Pass
Kunal Chopra,16-10-2005,183884,Tamil Nadu,4,13,21,8,46,Fail
Rohan Mehta,08-07-2005,667117,Himachal Pradesh,20,11,6,16,53,Fail
Aditya Singh,13-08-2005,905766,Rajasthan,23,12,7,3,45,Fail
Aryan Khan,17-05-2005,917393,West Bengal,2,4,20,9,35,Fail
Vivaan Singh,02-06-2005,952949,Uttar Pradesh,10,0,21,10,41,Pass
Sukhwinder Sharma,02-05-2005,258352,Odisha,16,22,22,16,76,Fail
Manpreet Reddy,22-02-2006,164342,Karnataka,15,2,9,9,35,Fail
Balbir Khan,14-01-2005,535176,Meghalaya,0,6,1,11,18,Fail
Rohan Reddy,09-12-2004,511711,Uttar Pradesh,5,1,8,11,25,Pass
Aryan Fernandes,07-03-2006,198639,Rajasthan,15,3,11,2,31,Fail
Yash Pillai,03-04-2006,399075,Tamil Nadu,23,16,22,7,68,Fail
Vivaan Chopra,10-12-2005,154733,Himachal Pradesh,11,19,22,3,55,Fail
Rohan Pillai,23-03-2006,535464,Gujarat,0,13,22,9,44,Fail
Aryan Reddy,02-03-2006,455669,Gujarat,14,10,19,8,51,Fail
Ishaan Fernandes,02-01-2006,974870,Uttar Pradesh,21,19,5,6,51,Pass
Zaid Reddy,25-02-2005,443260,Uttar Pradesh,9,7,15,13,44,Pass
Balbir D'Souza,03-08-2005,453210,Telangana,11,8,0,1,20,Pass
Aarav Reddy,19-01-2006,274911,Bihar,8,11,22,8,49,Pass
Krishna Verma,30-11-2005,355859,Karnataka,2,7,16,2,27,Fail
Aryan Singh,18-04-2006,379069,Chhattisgarh,20,21,17,6,64,Fail
Ishaan Fernandes,10-11-2005,789265,Uttar Pradesh,16,19,20,14,69,Pass
Aditya Khan,30-12-2005,768337,Rajasthan,2,8,22,3,35,Fail
Vivaan Chopra,11-03-2006,404029,Punjab,12,24,22,21,79,Fail
Kunal Mehta,04-08-2005,167490,Bihar,6,12,15,20,53,Pass
Aditya Reddy,24-08-2005,399335,Punjab,2,9,7,13,31,Fail
Raj Pillai,28-01-2005,291288,Maharashtra,0,8,12,18,38,Fail
Rohan Reddy,15-04-2005,152538,Madhya Pradesh,15,13,0,4,32,Pass
Ishaan D'Souza,19-12-2005,356545,Rajasthan,4,10,8,4,26,Fail
Peter Verma,02-01-2006,903336,Uttar Pradesh,8,0,4,14,26,Pass
Aditya Pillai,27-11-2004,436299,Andhra Pradesh,2,13,7,17,39,Pass
Ishaan Pillai,19-11-2004,604337,Haryana,12,0,5,3,20,Pass
Yash Chopra,25-02-2005,743086,Uttar Pradesh,10,19,13,15,57,Pass
Kunal Fernandes,17-11-2004,481835,Andhra Pradesh,24,22,3,1,50,Pass
Aarav D'Souza,16-11-2005,230138,Maharashtra,9,1,17,7,34,Fail
Yash Reddy,26-01-2005,155308,Arunachal Pradesh,6,20,12,10,48,Fail
Harjeet Fernandes,14-01-2006,374445,Gujarat,17,14,21,18,70,Fail
Rohan Mehta,16-04-2006,485468,Rajasthan,8,20,3,24,55,Fail
Peter Verma,07-09-2005,714764,West Bengal,23,16,22,22,83,Fail
Ishaan Mehta,14-06-2005,366034,Haryana,23,23,17,11,74,Pass
Gurpreet Chopra,06-03-2005,915221,Bihar,15,21,22,13,71,Pass
Aarav D'Souza,28-12-2005,966660,Gujarat,6,5,6,9,26,Fail
Yash Khan,02-03-2005,655558,Andhra Pradesh,17,13,13,21,64,Pass
Kunal Khan,25-01-2005,646123,Maharashtra,3,23,4,23,53,Fail
Raj Mehta,24-12-2004,643643,Maharashtra,2,0,21,20,43,Fail
Paul Singh,05-10-2005,194600,Karnataka,24,11,17,10,62,Fail
Gurpreet Singh,28-04-2005,523047,Andhra Pradesh,11,10,12,15,48,Pass
Aditya Khan,05-03-2005,766644,Jammu & Kashmir + Ladakh,14,2,13,21,50,Fail
Farhan Verma,29-07-2005,715421,West Bengal,13,21,7,21,62,Fail
Rohan Verma,17-01-2006,548963,Punjab,19,13,17,18,67,Pass
Mathew D'Souza,22-10-2005,132255,Andhra Pradesh,6,5,4,20,35,Pass
Ayaan Mehta,30-04-2006,938374,Gujarat,14,24,9,14,61,Fail
Kunal Singh,05-10-2005,221263,Tamil Nadu,16,24,1,12,53,Fail
Ishaan Fernandes,19-05-2005,318580,Bihar,23,24,2,16,65,Pass
Ishaan Fernandes,09-05-2005,423331,Punjab,9,11,9,14,43,Fail
Rehan Sharma,20-02-2006,250828,Assam,12,17,1,17,47,Pass
Sukhwinder Khan,24-01-2006,400720,Madhya Pradesh,3,14,20,13,50,Pass
Vivaan Reddy,27-01-2006,179723,Punjab,7,10,11,4,32,Fail
Yash Sharma,03-04-2006,682486,Tamil Nadu,21,20,23,0,64,Fail
David Reddy,05-12-2005,512223,Himachal Pradesh,7,15,24,13,59,Fail
Gurpreet Singh,09-09-2005,887692,Madhya Pradesh,7,3,4,5,19,Pass
Aarav Pillai,11-06-2005,967612,Chhattisgarh,7,6,10,1,24,Fail
Aarav Fernandes,08-06-2005,966156,Uttarakhand,15,5,10,9,39,Fail
Raj Pillai,02-10-2005,823433,Maharashtra,14,3,20,7,44,Fail
Farhan Pillai,02-02-2005,381238,Delhi,4,18,3,11,36,Pass
Rohan Khan,12-03-2006,397360,Delhi,19,23,14,1,57,Fail
Balbir Mehta,17-06-2005,744886,Telangana,6,5,4,16,31,Pass
Peter Chopra,08-12-2005,257488,Jammu & Kashmir + Ladakh,8,0,10,2,20,Fail
Ishaan Singh,04-04-2006,283441,Uttar Pradesh,3,0,8,18,29,Pass
Raj Reddy,11-01-2005,677360,Himachal Pradesh,16,23,0,1,40,Fail
Aarav Chopra,21-12-2005,190578,Madhya Pradesh,9,4,16,12,41,Pass
Yash Sharma,28-11-2004,924356,Assam,13,12,12,19,56,Pass
Vivaan Chopra,07-01-2005,644296,Uttar Pradesh,22,13,1,7,43,Pass
Vivaan Chopra,11-02-2006,751026,Karnataka,16,14,12,9,51,Fail
Sukhwinder Reddy,08-10-2005,205495,Himachal Pradesh,11,22,8,17,58,Fail
Balbir Pillai,15-04-2005,306260,Madhya Pradesh,17,23,13,3,56,Pass
Vivaan Chopra,14-01-2005,831793,Uttar Pradesh,15,7,0,24,46,Pass
Raj Reddy,30-11-2004,255251,Telangana,10,6,17,20,53,Fail
Aryan Verma,31-05-2005,437734,Karnataka,22,3,15,12,52,Fail
Krishna Reddy,12-08-2005,795789,Uttar Pradesh,5,10,14,8,37,Pass
Aryan Fernandes,31-10-2005,215973,West Bengal,16,20,6,17,59,Fail
Aryan Verma,26-08-2005,921768,Jharkhand,6,20,0,3,29,Fail
Rehan Pillai,18-08-2005,824581,Rajasthan,13,7,3,21,44,Fail
Raj Sharma,06-08-2005,289910,Bihar,8,19,1,7,35,Fail
Yash Verma,21-01-2006,206558,Uttar Pradesh,7,6,8,17,38,Pass
Kunal Chopra,14-03-2006,391107,Karnataka,18,1,1,21,41,Fail
Yash Reddy,29-07-2005,564444,Maharashtra,23,6,15,8,52,Fail
Manpreet Verma,03-03-2005,536422,Punjab,5,8,17,11,41,Fail
Mathew Verma,16-01-2006,261320,Punjab,8,6,2,15,31,Fail
Kunal Reddy,28-05-2005,710047,Maharashtra,8,24,19,4,55,Fail
Aryan Verma,20-03-2006,852260,Tamil Nadu,5,2,8,17,32,Fail
Ayaan Khan,11-04-2006,224569,Bihar,21,14,3,0,38,Fail
Vivaan Sharma,27-11-2005,279782,Uttar Pradesh,15,16,5,15,51,Pass
Manpreet Verma,07-01-2005,200247,Punjab,9,23,17,21,70,Pass
Ishaan Sharma,11-01-2006,602476,Himachal Pradesh,17,9,4,24,54,Fail
Rohan Pillai,15-09-2005,671174,Uttar Pradesh,9,3,23,5,40,Pass
Harjeet Pillai,13-10-2005,178094,Manipur,13,5,5,18,41,Fail
Raj Pillai,15-10-2005,582257,Madhya Pradesh,13,6,20,8,47,Pass
Krishna Reddy,03-07-2005,739325,Gujarat,14,7,21,2,44,Fail
Harjeet Verma,28-12-2005,239763,Maharashtra,17,8,14,17,56,Fail
Aryan Fernandes,29-03-2005,788645,Haryana,11,6,19,17,53,Pass
Krishna Chopra,12-08-2005,257627,Uttar Pradesh,12,18,24,3,57,Pass
Peter Chopra,26-11-2004,217571,Kerala,0,7,0,10,17,Pass
Aryan Khan,17-03-2005,642018,Maharashtra,4,5,20,13,42,Fail
Aryan Mehta,06-04-2006,189269,Bihar,5,12,8,16,41,Fail
Raj Reddy,08-07-2005,432789,Andhra Pradesh,23,3,15,20,61,Pass
Yash Verma,01-02-2005,682218,Uttar Pradesh,24,4,21,3,52,Pass
Aryan Fernandes,07-01-2005,996052,Uttarakhand,2,21,20,0,43,Fail
Peter Mehta,12-02-2005,345827,Bihar,11,6,1,14,32,Fail
Krishna Verma,30-05-2005,995069,Uttar Pradesh,6,15,3,7,31,Pass
Aryan Sharma,23-05-2005,734244,Andhra Pradesh,2,8,20,14,44,Pass
Aditya Mehta,18-06-2005,133886,Jharkhand,13,3,14,1,31,Fail
Krishna Verma,09-09-2005,185905,West Bengal,22,11,21,16,70,Fail
Ishaan Khan,25-06-2005,322501,Kerala,12,7,6,13,38,Pass
Aditya Mehta,19-05-2005,708668,West Bengal,9,9,13,4,35,Fail
Vivaan Mehta,15-05-2005,523925,Madhya Pradesh,9,4,21,23,57,Pass
Aryan Chopra,25-02-2005,560208,Jharkhand,5,16,4,17,42,Fail
Ishaan Chopra,29-05-2005,606183,Rajasthan,10,5,24,10,49,Fail
Ishaan Singh,23-06-2005,487103,Rajasthan,24,7,24,22,77,Fail
Raj Chopra,31-05-2005,738053,Rajasthan,13,8,5,9,35,Fail
Aditya D'Souza,02-03-2006,415730,Rajasthan,22,24,23,17,86,Fail
Aditya Khan,29-12-2004,170844,Karnataka,20,8,8,24,60,Fail
Aditya Fernandes,09-03-2005,415318,Rajasthan,3,0,20,6,29,Fail
Kunal Reddy,22-02-2005,157670,Odisha,21,12,12,9,54,Pass
Ishaan Pillai,20-10-2005,957165,Haryana,19,14,24,22,79,Pass
Aryan Reddy,04-11-2005,150828,Jharkhand,8,11,7,15,41,Fail
Vivaan Chopra,15-02-2005,102412,Haryana,6,18,12,16,52,Pass
Vivaan Mehta,29-11-2004,558959,Maharashtra,20,5,23,12,60,Fail
Imran Fernandes,10-04-2006,190293,Himachal Pradesh,21,8,10,0,39,Fail
Rohan D'Souza,01-02-2005,161176,Rajasthan,0,23,2,6,31,Fail
Imran Singh,22-04-2006,490972,Tamil Nadu,2,23,19,1,45,Fail
John Reddy,17-04-2005,483928,Uttar Pradesh,12,16,11,8,47,Pass
Sukhwinder Pillai,13-12-2005,776180,Tamil Nadu,18,17,5,9,49,Fail
Krishna Fernandes,12-01-2006,867263,Kerala,3,18,17,11,49,Pass
Krishna D'Souza,02-03-2006,266110,Tamil Nadu,15,2,5,0,22,Fail
Rohan Mehta,13-03-2005,298506,Maharashtra,11,5,20,21,57,Fail
Ishaan Verma,05-03-2006,412679,Haryana,21,2,13,14,50,Pass
Vivaan Sharma,20-12-2004,626097,Gujarat,7,24,6,17,54,Fail
Aryan Mehta,05-07-2005,616171,Madhya Pradesh,8,19,5,6,38,Pass
Vivaan Mehta,22-01-2005,601579,Karnataka,10,11,17,22,60,Fail
Harjeet Sharma,09-11-2004,609026,Bihar,0,3,15,24,42,Fail
Vivaan D'Souza,25-09-2005,744743,West Bengal,9,15,0,7,31,Fail
Rohan Mehta,24-03-2006,339098,Uttar Pradesh,19,7,2,20,48,Pass
Ayaan Pillai,03-04-2006,544998,Telangana,14,1,18,0,33,Pass
Raj Khan,08-02-2006,174937,Telangana,4,3,3,7,17,Pass
Ishaan Chopra,18-02-2006,882260,Assam,13,8,16,4,41,Pass
Yash Fernandes,04-05-2005,720182,Tamil Nadu,18,6,14,9,47,Fail
Ishaan Fernandes,02-05-2005,788424,Uttar Pradesh,4,8,4,1,17,Pass
Aditya Verma,26-09-2005,663050,Rajasthan,20,7,7,3,37,Fail
Krishna Singh,24-04-2006,127736,Bihar,11,14,13,17,55,Pass
Harjeet Chopra,10-12-2004,692640,Assam,14,4,18,4,40,Pass
Aditya Chopra,08-04-2005,452498,Rajasthan,17,15,7,24,63,Pass
Raj Reddy,31-01-2006,308423,Rajasthan,1,18,4,1,24,Fail
Vivaan D'Souza,14-03-2005,949364,Uttar Pradesh,23,9,7,6,45,Pass
Rohan Chopra,13-08-2005,229853,Madhya Pradesh,0,8,23,6,37,Pass
Kunal Fernandes,04-07-2005,603428,Telangana,16,11,5,14,46,Pass
Yash Mehta,02-05-2006,555769,Uttar Pradesh,3,0,20,17,40,Pass
Peter Mehta,12-11-2004,653919,Jharkhand,15,11,13,4,43,Fail
Rohan D'Souza,09-02-2006,215754,Chhattisgarh,21,0,5,19,45,Fail
Aryan Reddy,10-03-2006,913271,Bihar,21,13,14,7,55,Pass
Raj Chopra,08-01-2005,985532,Telangana,6,5,15,7,33,Pass
Yash Fernandes,12-03-2005,857052,Maharashtra,3,21,9,8,41,Fail
Rohan Singh,02-08-2005,743623,Bihar,24,23,12,16,75,Pass
Harjeet Chopra,21-08-2005,212109,Jharkhand,24,13,18,19,74,Fail
Aarav Khan,10-04-2006,123153,Sikkim,2,11,6,16,35,Fail
Yash Fernandes,04-02-2006,404718,West Bengal,12,9,11,6,38,Fail
Vivaan D'Souza,31-03-2006,302310,Punjab,7,19,13,21,60,Pass
Raj Sharma,27-04-2005,260457,West Bengal,0,5,0,20,25,Fail
Ishaan Fernandes,31-12-2004,527993,Maharashtra,4,0,3,10,17,Fail
Mathew Mehta,08-11-2005,123380,Uttarakhand,16,4,21,23,64,Fail
Ishaan Pillai,30-11-2005,978491,Odisha,10,23,2,0,35,Fail
Kunal Sharma,23-03-2006,230736,Bihar,4,19,4,21,48,Pass
Kunal Singh,12-06-2005,570304,West Bengal,14,24,0,20,58,Fail
Krishna Singh,21-09-2005,718457,Uttarakhand,4,7,9,0,20,Fail
Gurpreet D'Souza,27-12-2004,282043,Maharashtra,13,3,4,1,21,Fail
Rehan D'Souza,26-02-2006,423897,Karnataka,0,9,11,6,26,Fail
Rohan Chopra,28-01-2005,180265,Maharashtra,6,22,8,9,45,Fail
Aryan Verma,14-02-2006,901328,Bihar,8,23,22,21,74,Pass
Aditya Mehta,09-10-2005,259407,Madhya Pradesh,18,5,11,16,50,Pass
Aryan Singh,26-04-2005,697096,Bihar,24,16,15,8,63,Pass
Yash Fernandes,22-11-2005,366128,Tamil Nadu,4,14,6,21,45,Fail
Ishaan Mehta,25-01-2005,284192,Uttarakhand,21,7,17,14,59,Fail
Peter D'Souza,21-02-2005,752777,Rajasthan,20,4,7,7,38,Fail
Aarav Singh,01-07-2005,672024,Kerala,0,22,21,3,46,Pass
Zaid Chopra,25-10-2005,888998,Tamil Nadu,15,3,5,16,39,Fail
Kunal D'Souza,16-01-2006,428635,Kerala,16,4,6,17,43,Pass
Paul Verma,10-10-2005,114432,Madhya Pradesh,20,4,14,16,54,Pass
Sukhwinder Pillai,21-10-2005,556319,Bihar,6,8,2,6,22,Fail
Aditya Chopra,27-02-2005,582183,Uttar Pradesh,19,9,13,18,59,Pass
Balbir Sharma,26-01-2006,922554,Gujarat,24,15,8,20,67,Fail
Paul Chopra,03-09-2005,274196,Andhra Pradesh,21,11,10,12,54,Pass
Ishaan Khan,03-12-2004,680862,Manipur,18,3,21,1,43,Fail
Vivaan Khan,01-05-2006,751335,Rajasthan,10,7,15,11,43,Fail
Kunal Reddy,09-11-2004,524770,Madhya Pradesh,3,4,24,12,43,Pass
Vivaan D'Souza,20-07-2005,659289,Bihar,17,5,12,23,57,Pass
Aryan Verma,06-08-2005,223566,Gujarat,21,1,4,4,30,Fail
Sukhwinder Sharma,11-11-2004,116217,Telangana,9,13,10,20,52,Fail
Raj Mehta,23-11-2004,537264,Maharashtra,10,17,2,5,34,Fail
Raj Sharma,08-11-2005,956290,Rajasthan,10,0,13,16,39,Fail
Vivaan Fernandes,17-02-2005,787359,West Bengal,9,23,11,1,44,Fail
Kunal Chopra,07-01-2005,515634,Gujarat,3,11,12,12,38,Fail
Balbir Singh,29-04-2006,711994,Chhattisgarh,4,9,11,12,36,Fail
Raj Sharma,03-09-2005,350090,Uttar Pradesh,19,1,2,23,45,Pass
Raj Chopra,20-08-2005,919421,Jammu & Kashmir + Ladakh,3,5,23,12,43,Fail
Mathew Sharma,24-12-2005,971329,Bihar,1,13,17,11,42,Fail
Ishaan Khan,21-07-2005,890936,Punjab,10,14,15,2,41,Fail
Harjeet Verma,17-06-2005,195515,Jharkhand,12,0,1,12,25,Fail
Krishna Chopra,30-12-2005,792502,Jharkhand,15,0,9,7,31,Fail
Paul Verma,10-04-2006,326736,Jharkhand,16,20,5,4,45,Fail
Krishna D'Souza,12-11-2004,919893,Jharkhand,4,14,3,18,39,Fail
Sukhwinder Khan,30-08-2005,450587,Madhya Pradesh,12,24,4,13,53,Pass
Balbir Singh,12-01-2006,825781,Tamil Nadu,20,5,1,6,32,Fail
Aarav Mehta,16-12-2004,914130,Tamil Nadu,22,15,1,19,57,Fail
Ishaan Sharma,09-11-2004,556680,Jharkhand,18,3,10,23,54,Fail
Raj Sharma,02-01-2006,993062,Gujarat,4,22,0,24,50,Fail
Krishna Verma,06-04-2005,833653,Bihar,7,22,16,7,52,Pass
Kunal Singh,27-04-2006,599906,West Bengal,13,22,3,23,61,Fail
Kunal Fernandes,25-03-2005,896153,Maharashtra,8,13,8,12,41,Fail
Vivaan D'Souza,29-04-2005,645065,Uttar Pradesh,22,13,0,8,43,Pass
Aditya Sharma,02-05-2006,978562,Gujarat,5,0,10,20,35,Fail
Vivaan Verma,15-08-2005,958405,Tamil Nadu,20,1,20,5,46,Fail
Aarav Singh,10-01-2005,198072,Rajasthan,8,5,11,17,41,Fail
John Pillai,22-01-2006,903841,Jharkhand,9,7,19,9,44,Fail
Harjeet Fernandes,17-12-2005,442711,Maharashtra,0,7,11,13,31,Fail
Ishaan Verma,06-11-2005,454213,Bihar,8,21,4,19,52,Pass
Vivaan Mehta,06-03-2006,403289,Assam,19,11,9,10,49,Pass
Rohan Chopra,23-08-2005,383100,Maharashtra,7,7,20,19,53,Fail
Balbir D'Souza,31-05-2005,808045,Himachal Pradesh,19,14,7,9,49,Fail
Vivaan D'Souza,01-04-2005,288729,Karnataka,9,13,13,18,53,Fail
Krishna Fernandes,11-07-2005,813943,Madhya Pradesh,7,14,3,13,37,Pass
Aarav Verma,17-06-2005,497570,Tamil Nadu,10,24,19,21,74,Fail
Raj Khan,03-02-2006,411899,Haryana,7,16,5,23,51,Pass
Rohan Fernandes,09-12-2005,612835,Bihar,1,21,21,2,45,Fail
Aryan Fernandes,21-12-2005,719119,Telangana,8,2,8,8,26,Pass
Vivaan Khan,03-08-2005,824234,Andhra Pradesh,21,10,3,5,39,Pass
Ishaan Reddy,18-01-2006,915173,Tamil Nadu,5,5,22,5,37,Fail
Aryan Pillai,03-12-2005,918969,Madhya Pradesh,12,8,12,13,45,Pass
Krishna Singh,30-07-2005,487825,Odisha,3,5,14,5,27,Fail
Ishaan Verma,15-10-2005,489060,Uttarakhand,8,3,2,6,19,Fail
Raj Mehta,13-06-2005,511352,Bihar,0,0,23,23,46,Pass
Sukhwinder Chopra,25-01-2005,588428,Uttar Pradesh,20,16,21,2,59,Pass
Ishaan Sharma,20-01-2005,245799,Madhya Pradesh,2,19,19,14,54,Pass
Harjeet Fernandes,31-12-2005,857991,Bihar,23,18,5,1,47,Pass
Peter Khan,16-11-2005,858806,Haryana,13,6,2,22,43,Pass
Ishaan D'Souza,29-04-2006,343641,Uttar Pradesh,8,17,5,4,34,Pass
Sukhwinder Khan,02-02-2006,319796,Gujarat,20,9,19,8,56,Fail
Aryan Sharma,02-01-2005,440129,Andhra Pradesh,17,2,11,16,46,Pass
Gurpreet Singh,06-03-2005,219425,Telangana,12,17,24,10,63,Fail
Peter Khan,18-02-2006,747542,Gujarat,6,2,7,8,23,Fail
Aditya Reddy,24-04-2005,955607,Rajasthan,18,23,8,1,50,Fail
Raj Fernandes,13-12-2004,767421,Bihar,6,22,3,22,53,Pass
Aditya Chopra,19-04-2006,583216,Assam,19,3,23,12,57,Pass
Krishna Khan,24-06-2005,661210,Andhra Pradesh,0,0,23,19,42,Pass
Sukhwinder Sharma,14-07-2005,175884,Jammu & Kashmir + Ladakh,1,0,7,5,13,Fail
Balbir Fernandes,30-10-2005,609925,Rajasthan,16,16,4,15,51,Fail
Krishna Fernandes,21-06-2005,276636,Delhi,5,0,22,16,43,Fail
Raj Verma,28-09-2005,891729,Uttar Pradesh,5,17,5,11,38,Pass
Ishaan Pillai,10-04-2006,397289,Uttar Pradesh,16,1,15,9,41,Pass
Yash Sharma,29-11-2005,362699,Maharashtra,5,1,15,1,22,Fail
Aditya Verma,28-03-2006,580595,Gujarat,18,5,18,17,58,Fail
Rehan Pillai,18-10-2005,378370,Uttar Pradesh,8,2,7,16,33,Pass
Aditya Singh,27-08-2005,541379,Tamil Nadu,14,2,4,9,29,Fail
Kunal Singh,30-07-2005,284007,Daman & Diu / D&N Haveli,1,17,21,18,57,Fail
Peter Sharma,11-08-2005,748731,West Bengal,10,12,5,23,50,Fail
Raj Reddy,15-03-2005,828373,Maharashtra,0,5,17,20,42,Fail
Yash Khan,04-11-2005,934243,Bihar,6,2,5,12,25,Fail
Kunal Pillai,13-10-2005,377051,West Bengal,4,3,13,24,44,Fail
Vivaan Chopra,27-08-2005,391012,Bihar,18,24,20,11,73,Pass
Aditya Sharma,14-07-2005,775991,Maharashtra,2,4,21,17,44,Fail
Rohan Singh,14-01-2006,965315,Bihar,4,15,7,22,48,Pass
Aditya D'Souza,12-01-2006,640347,Karnataka,4,19,2,12,37,Fail
Zaid Mehta,21-01-2005,642097,Madhya Pradesh,9,4,23,21,57,Pass
Rohan Pillai,03-01-2006,628768,Tamil Nadu,4,3,21,13,41,Fail
Aditya Fernandes,26-01-2005,932378,Uttar Pradesh,12,20,7,14,53,Pass
Kunal D'Souza,22-09-2005,441937,Punjab,9,4,16,6,35,Fail
Farhan Singh,24-01-2005,252988,Madhya Pradesh,18,17,11,0,46,Pass
Sukhwinder Mehta,19-09-2005,549753,Andaman & Nicobar,17,4,5,22,48,Pass
Aryan Khan,02-03-2005,853440,Rajasthan,22,16,12,2,52,Fail
Ishaan Khan,12-06-2005,835972,Uttar Pradesh,15,5,0,2,22,Pass
Aditya Pillai,13-01-2005,747438,Uttarakhand,4,20,2,20,46,Fail
Aditya Khan,06-04-2005,683386,Tamil Nadu,17,8,22,16,63,Fail
Balbir Khan,02-03-2006,448775,Jharkhand,9,0,24,8,41,Fail
Sukhwinder Verma,06-02-2005,162894,Jammu & Kashmir + Ladakh,9,18,18,16,61,Fail
Raj Singh,15-11-2005,478257,Bihar,4,20,1,10,35,Fail
Raj Singh,11-08-2005,232726,Himachal Pradesh,8,3,12,17,40,Fail
Yash Sharma,12-06-2005,804014,Uttar Pradesh,18,15,3,19,55,Pass
Aditya D'Souza,13-07-2005,753369,Rajasthan,5,16,19,18,58,Fail
Krishna Mehta,10-09-2005,280648,Bihar,8,3,4,10,25,Fail
Krishna Chopra,05-11-2005,624480,Jharkhand,16,11,7,22,56,Fail
Aryan Khan,29-01-2005,431844,Haryana,20,18,2,19,59,Pass
Ishaan Verma,29-01-2005,409071,Uttar Pradesh,24,7,23,12,66,Pass
Manpreet Verma,08-09-2005,963307,Meghalaya,8,4,0,17,29,Fail
Sukhwinder Singh,10-04-2006,290428,Maharashtra,10,13,18,2,43,Fail
Yash Sharma,16-05-2005,266938,Bihar,7,12,13,15,47,Pass
Vivaan Singh,22-01-2006,142790,Rajasthan,12,23,20,20,75,Pass
Aarav Mehta,12-01-2006,877099,Rajasthan,18,10,21,4,53,Fail
Aarav Mehta,23-07-2005,843261,Haryana,16,10,1,14,41,Pass
Kunal Singh,24-11-2004,412784,Tamil Nadu,22,12,9,6,49,Fail
Rohan Chopra,01-03-2006,303410,Haryana,8,1,22,11,42,Pass
Ishaan Verma,19-04-2006,216984,Tamil Nadu,9,1,14,4,28,Fail
Harjeet Singh,16-07-2005,473767,Uttar Pradesh,24,2,12,14,52,Pass
Farhan Fernandes,12-11-2004,970814,Andhra Pradesh,9,4,24,6,43,Pass
Kunal Verma,24-12-2004,932588,West Bengal,19,14,0,17,50,Fail
Aryan Reddy,14-04-2006,530709,Uttarakhand,14,2,6,12,34,Fail
John Reddy,02-05-2005,647797,Bihar,11,19,17,19,66,Pass
Rohan Singh,26-11-2005,688972,Assam,7,7,5,20,39,Pass
Ishaan Singh,14-12-2005,281321,Tamil Nadu,9,12,13,11,45,Fail
Vivaan Chopra,04-05-2005,315370,Bihar,7,0,0,7,14,Fail
Kunal Verma,25-12-2004,988852,Jammu & Kashmir + Ladakh,12,7,9,22,50,Fail
Krishna Reddy,24-01-2005,316381,Maharashtra,20,22,1,18,61,Fail
Sukhwinder Chopra,22-12-2004,451869,Mizoram,1,0,9,23,33,Fail
Raj Sharma,03-06-2005,890564,Meghalaya,13,22,22,23,80,Fail
Mathew D'Souza,28-11-2005,714757,Chhattisgarh,7,11,10,19,47,Fail
Balbir Sharma,03-03-2005,920395,Bihar,24,20,2,1,47,Pass
Aryan Sharma,10-05-2005,266559,Haryana,3,0,3,22,28,Pass
Mathew Verma,09-12-2004,601898,Madhya Pradesh,24,4,6,13,47,Pass
Yash Verma,21-12-2004,820842,Tamil Nadu,7,14,12,20,53,Fail
Yash D'Souza,04-12-2004,167357,West Bengal,19,12,8,18,57,Fail
Vivaan Sharma,22-01-2006,411778,Kerala,5,9,10,4,28,Pass
Krishna Verma,10-02-2006,500563,West Bengal,6,11,1,7,25,Fail
Raj Reddy,07-02-2005,622598,Gujarat,7,10,6,18,41,Fail
Harjeet D'Souza,06-10-2005,752412,Kerala,9,23,4,10,46,Pass
Raj Chopra,23-03-2005,928264,Andhra Pradesh,9,6,17,0,32,Pass
Raj Chopra,18-03-2006,865344,Punjab,9,15,3,21,48,Pass
Vivaan Chopra,02-02-2006,811500,Uttar Pradesh,14,1,8,16,39,Pass
Yash Mehta,10-11-2005,523405,Uttar Pradesh,2,8,21,23,54,Pass
Aditya Singh,15-10-2005,982909,Kerala,0,4,0,9,13,Pass
Rohan Singh,03-07-2005,777868,Goa,4,12,23,21,60,Fail
Aarav Pillai,22-02-2005,268252,Uttar Pradesh,22,3,19,23,67,Pass
Ishaan Sharma,06-03-2006,724233,Uttar Pradesh,18,23,21,3,65,Pass
Raj Reddy,21-07-2005,817111,Gujarat,3,22,22,21,68,Fail
Manpreet Pillai,11-01-2005,515316,Madhya Pradesh,7,4,22,2,35,Pass
Ishaan Verma,16-02-2005,197693,West Bengal,23,1,1,0,25,Fail
Paul Fernandes,29-08-2005,284810,Kerala,20,8,3,23,54,Pass
Sukhwinder Sharma,13-09-2005,753028,Rajasthan,3,24,6,14,47,Fail
Farhan Verma,23-09-2005,367514,Manipur,24,20,0,0,44,Fail
Vivaan Fernandes,10-03-2006,697597,Rajasthan,8,7,6,24,45,Fail
Manpreet Pillai,08-06-2005,272396,Uttar Pradesh,22,13,15,20,70,Pass
Kunal Pillai,26-05-2005,723256,Goa,6,2,22,13,43,Fail
Raj Reddy,28-11-2005,229867,Telangana,7,14,23,5,49,Pass
Sukhwinder Verma,30-10-2005,865045,Rajasthan,13,19,11,22,65,Pass
Krishna Reddy,25-07-2005,953482,West Bengal,23,22,13,9,67,Fail
Kunal Chopra,10-01-2005,670916,Rajasthan,0,14,5,5,24,Fail
Vivaan Reddy,10-02-2005,314830,Maharashtra,24,13,10,20,67,Fail
Yash Verma,31-08-2005,967065,Madhya Pradesh,8,18,4,5,35,Pass
Raj Mehta,21-06-2005,442319,Karnataka,7,12,9,3,31,Fail
Krishna Singh,01-10-2005,954172,Andhra Pradesh,24,23,1,1,49,Pass
Farhan Singh,30-11-2005,760709,Chhattisgarh,20,3,18,16,57,Fail
Aarav Khan,17-04-2005,870102,Telangana,20,24,1,2,47,Pass
Aarav D'Souza,24-10-2005,582152,Sikkim,2,17,18,0,37,Fail
Krishna Verma,13-03-2006,153040,Uttar Pradesh,13,3,18,18,52,Pass
Ishaan Singh,12-03-2005,630586,Telangana,1,12,18,4,35,Pass
Krishna Chopra,24-03-2005,572626,Rajasthan,9,15,14,12,50,Fail
Rohan Sharma,11-12-2004,208347,Uttar Pradesh,22,22,5,23,72,Pass
Vivaan Mehta,16-12-2004,982490,Assam,6,18,10,20,54,Pass
Aryan D'Souza,16-04-2006,522478,Rajasthan,4,8,2,8,22,Fail
Rohan D'Souza,07-01-2005,617681,West Bengal,19,11,4,21,55,Fail
David Verma,04-03-2005,154638,Rajasthan,6,23,15,10,54,Fail
Krishna D'Souza,21-02-2005,460020,Madhya Pradesh,18,16,14,8,56,Pass
Farhan Chopra,01-12-2004,733722,Maharashtra,8,13,13,15,49,Fail
Raj Reddy,25-01-2006,698649,Bihar,23,21,4,19,67,Pass
Harjeet Pillai,26-08-2005,268601,Punjab,15,3,5,24,47,Pass
David D'Souza,26-07-2005,570814,Uttar Pradesh,17,24,0,19,60,Pass
Ishaan Chopra,27-11-2004,825191,Punjab,11,10,23,12,56,Pass
Raj Verma,14-09-2005,435532,West Bengal,6,3,15,8,32,Fail
Ishaan Fernandes,16-03-2005,995064,Gujarat,4,0,15,12,31,Fail
Aditya Khan,26-03-2005,610178,Maharashtra,23,9,14,6,52,Fail
Paul Reddy,22-12-2005,813726,Arunachal Pradesh,5,7,9,11,32,Fail
Aryan Mehta,05-05-2006,968408,Uttar Pradesh,20,13,19,3,55,Pass
Raj Sharma,24-12-2004,323364,Punjab,3,1,19,6,29,Fail
Sukhwinder Verma,12-07-2005,925916,Andhra Pradesh,13,8,23,3,47,Pass
Krishna Verma,15-06-2005,484905,Himachal Pradesh,16,24,0,10,50,Fail
Ishaan Reddy,16-02-2005,547712,Punjab,7,8,20,13,48,Pass
Aarav D'Souza,13-01-2005,440493,Tamil Nadu,24,0,14,19,57,Fail
Gurpreet Khan,12-05-2005,452488,Delhi,21,18,7,19,65,Fail
Paul Mehta,04-10-2005,437372,Goa,9,19,15,2,45,Fail
Aryan Chopra,07-03-2006,532637,Bihar,6,1,20,2,29,Fail
Yash Chopra,13-01-2005,386095,West Bengal,14,13,12,22,61,Fail
Raj Chopra,27-02-2005,407886,Madhya Pradesh,23,2,21,7,53,Pass
Krishna Verma,04-12-2005,550751,Kerala,18,1,2,19,40,Pass
Vivaan Reddy,19-03-2005,457795,Rajasthan,6,1,17,14,38,Fail
John Khan,09-02-2006,485883,Gujarat,24,13,16,20,73,Fail
Aarav Khan,22-10-2005,134067,Uttar Pradesh,21,17,17,3,58,Pass
Paul Pillai,01-02-2005,814666,Uttar Pradesh,4,23,3,16,46,Pass
Yash Fernandes,29-05-2005,418487,Bihar,10,13,8,10,41,Fail
Raj Khan,03-12-2005,833008,Uttarakhand,13,16,4,0,33,Fail
Ishaan Reddy,01-07-2005,217178,Jammu & Kashmir + Ladakh,21,3,21,1,46,Fail
Aarav Sharma,28-03-2005,559790,Karnataka,23,3,4,6,36,Fail
John Chopra,17-08-2005,271012,Gujarat,6,6,14,0,26,Fail
Raj Khan,27-01-2005,963180,Bihar,2,19,13,8,42,Fail
Kunal D'Souza,26-04-2006,278120,Jharkhand,0,0,8,12,20,Fail
Aarav Khan,26-04-2006,473489,Kerala,0,11,19,20,50,Pass
John D'Souza,17-10-2005,364988,Maharashtra,15,3,19,19,56,Fail
Yash Verma,13-12-2004,911009,Andhra Pradesh,15,1,0,11,27,Pass
Rohan Reddy,17-02-2005,843057,Karnataka,20,16,21,23,80,Fail
Zaid Verma,28-12-2004,646676,Rajasthan,10,0,21,7,38,Fail
Rohan D'Souza,08-02-2006,897203,Uttar Pradesh,19,21,19,10,69,Pass
Gurpreet Verma,02-10-2005,405320,Maharashtra,14,5,14,11,44,Fail
Gurpreet D'Souza,09-03-2006,255868,Bihar,5,8,21,0,34,Fail
Gurpreet Sharma,28-07-2005,310827,Bihar,9,13,5,23,50,Pass
Ishaan Mehta,19-09-2005,406914,Madhya Pradesh,15,4,24,22,65,Pass
Aditya Fernandes,05-03-2006,827469,Bihar,23,14,16,5,58,Pass
Farhan Verma,22-01-2005,237523,Madhya Pradesh,11,6,15,9,41,Pass
Raj Khan,21-03-2006,906232,Maharashtra,5,20,3,7,35,Fail
Kunal Chopra,27-03-2005,623004,Rajasthan,9,10,8,13,40,Fail
Aarav Chopra,21-08-2005,821011,Uttar Pradesh,20,3,23,9,55,Pass
Ishaan Fernandes,24-12-2005,343989,Uttar Pradesh,18,23,16,0,57,Pass
Aarav D'Souza,05-10-2005,243422,Bihar,21,11,3,3,38,Fail
Peter Verma,19-11-2004,733773,Uttar Pradesh,13,12,10,21,56,Pass
Kunal D'Souza,16-01-2006,887907,Karnataka,22,2,17,18,59,Fail
Aditya Fernandes,12-06-2005,551612,Bihar,14,5,5,17,41,Fail
Aditya Singh,22-08-2005,562890,Maharashtra,5,20,20,16,61,Fail
Vivaan Reddy,15-03-2006,484159,Uttar Pradesh,23,3,23,13,62,Pass
Aditya Verma,17-03-2005,677803,Rajasthan,11,15,18,6,50,Fail
Farhan Mehta,23-12-2005,915268,West Bengal,6,10,9,4,29,Fail
Kunal Verma,25-02-2005,156551,Bihar,20,8,9,1,38,Fail
Balbir D'Souza,06-11-2005,242815,Gujarat,4,11,19,5,39,Fail
Harjeet Khan,03-12-2004,286100,Uttar Pradesh,0,1,20,8,29,Pass
Aarav Mehta,23-11-2004,942143,Maharashtra,1,10,14,18,43,Fail
Raj Verma,16-11-2004,667715,Rajasthan,15,16,9,19,59,Fail
Imran Verma,11-05-2005,483128,Chhattisgarh,7,0,6,0,13,Fail
David Verma,09-08-2005,223908,Madhya Pradesh,4,8,8,11,31,Pass
Rohan Reddy,09-08-2005,497313,Maharashtra,21,21,6,20,68,Fail
Krishna Singh,07-12-2005,289796,Jammu & Kashmir + Ladakh,23,14,21,4,62,Fail
Yash Singh,26-05-2005,322867,Andaman & Nicobar,6,2,0,0,8,Pass
Raj Sharma,02-08-2005,720485,Madhya Pradesh,12,17,15,8,52,Pass
Sukhwinder Singh,25-03-2005,642691,Uttar Pradesh,0,24,9,6,39,Pass
Aarav Khan,07-12-2005,577920,Madhya Pradesh,1,14,10,8,33,Pass
Krishna Reddy,29-01-2006,947549,Telangana,8,11,4,17,40,Pass
Manpreet Fernandes,22-01-2005,516041,Uttar Pradesh,5,20,11,10,46,Pass
Yash D'Souza,20-04-2006,366089,Delhi,9,9,6,0,24,Fail
Rohan Verma,23-08-2005,798291,Madhya Pradesh,22,4,24,2,52,Pass
Aryan Reddy,02-09-2005,901465,Gujarat,24,18,17,15,74,Fail
Aarav Chopra,11-01-2006,269712,Madhya Pradesh,19,2,11,10,42,Pass
Raj Reddy,19-03-2005,264055,Rajasthan,14,17,6,2,39,Fail
Harjeet Verma,22-02-2006,661125,Manipur,15,3,21,11,50,Fail
Krishna D'Souza,07-03-2005,945903,Bihar,16,13,16,17,62,Pass
Raj Verma,13-04-2005,106770,Assam,19,0,3,3,25,Pass
Rohan Reddy,03-04-2006,595062,Rajasthan,16,6,0,7,29,Fail
Balbir Khan,14-10-2005,983395,Uttarakhand,19,3,19,18,59,Fail
Kunal D'Souza,19-12-2005,969879,Uttarakhand,20,15,2,3,40,Fail
Krishna Khan,12-01-2005,209024,Nagaland,16,24,19,21,80,Fail
Paul D'Souza,30-11-2005,385888,Uttar Pradesh,10,4,7,19,40,Pass
Vivaan Reddy,17-11-2005,520051,Rajasthan,15,22,18,24,79,Fail
Vivaan Fernandes,15-09-2005,453289,Madhya Pradesh,19,2,21,11,53,Pass
Paul Sharma,18-06-2005,631641,Haryana,16,10,20,9,55,Pass
Rohan Fernandes,11-12-2004,824840,Tamil Nadu,22,17,5,18,62,Fail
Aarav Pillai,17-06-2005,404045,Andhra Pradesh,17,0,17,8,42,Pass
Kunal Reddy,12-06-2005,633954,Rajasthan,8,24,10,6,48,Fail
Rohan Khan,04-10-2005,118045,West Bengal,16,10,12,24,62,Fail
Manpreet Pillai,11-10-2005,144896,Madhya Pradesh,22,4,24,4,54,Pass
Aditya D'Souza,24-11-2005,777187,Andhra Pradesh,9,16,20,22,67,Pass
Aryan Singh,31-03-2006,626863,Maharashtra,10,15,19,15,59,Fail
John Khan,12-02-2005,981119,Uttar Pradesh,15,9,16,16,56,Pass
John Chopra,06-01-2006,450480,Rajasthan,21,18,13,3,55,Fail
Rehan Pillai,07-03-2006,244400,Andhra Pradesh,19,5,15,3,42,Pass
Yash Chopra,04-09-2005,755897,Andhra Pradesh,4,21,11,24,60,Pass
Manpreet Chopra,18-11-2005,634220,Jammu & Kashmir + Ladakh,5,4,0,7,16,Fail
Aarav D'Souza,23-07-2005,890786,Rajasthan,3,20,2,1,26,Fail
Ishaan Reddy,03-04-2006,155202,Rajasthan,10,3,24,23,60,Pass
Sukhwinder Mehta,11-01-2006,690053,Maharashtra,15,17,20,19,71,Fail
Aditya Singh,14-03-2006,885473,Punjab,18,24,3,4,49,Pass
Zaid D'Souza,12-10-2005,473981,Rajasthan,0,4,2,3,9,Fail
Rohan Fernandes,23-12-2004,862276,Assam,4,16,12,3,35,Pass
Ishaan Reddy,31-03-2005,413899,Punjab,19,15,0,23,57,Pass
Kunal Verma,08-11-2005,180166,Gujarat,18,12,5,8,43,Fail
Yash Khan,13-01-2005,882639,Delhi,4,18,5,2,29,Fail
Sukhwinder Fernandes,08-07-2005,325998,Gujarat,8,4,6,24,42,Fail
Vivaan Verma,29-06-2005,751566,Rajasthan,4,18,16,10,48,Fail
Aryan Mehta,30-03-2005,739805,Andhra Pradesh,8,23,11,1,43,Pass
Raj Reddy,09-10-2005,981556,Jharkhand,4,11,0,1,16,Fail
Rohan Sharma,03-06-2005,807987,Uttar Pradesh,5,10,14,15,44,Pass
Vivaan Reddy,25-12-2004,552592,Uttar Pradesh,23,3,20,14,60,Pass
Ishaan Sharma,16-09-2005,682955,Chhattisgarh,3,19,7,19,48,Fail
Paul Reddy,16-09-2005,175854,Jharkhand,19,22,0,4,45,Fail
Raj D'Souza,25-07-2005,974959,Kerala,23,7,14,0,44,Pass
Rohan Singh,14-03-2005,214209,West Bengal,22,12,3,8,45,Fail
Vivaan Mehta,07-04-2005,934306,Maharashtra,20,15,21,1,57,Fail
John Mehta,11-02-2005,375404,Gujarat,1,4,1,11,17,Fail
Aditya Sharma,10-04-2005,957015,Uttar Pradesh,12,16,6,15,49,Pass
Sukhwinder Sharma,18-02-2005,743809,Bihar,17,2,21,5,45,Fail
Raj Mehta,21-08-2005,904265,Bihar,7,5,17,18,47,Pass
Ishaan Mehta,17-02-2005,684075,Maharashtra,18,0,13,24,55,Fail
Vivaan Khan,29-05-2005,815705,Bihar,20,7,16,4,47,Pass
Vivaan D'Souza,12-09-2005,109509,Madhya Pradesh,6,15,4,18,43,Pass
Peter Verma,30-11-2004,616952,Karnataka,24,3,10,8,45,Fail
Yash Chopra,31-08-2005,927547,Maharashtra,17,18,17,9,61,Fail
Paul Mehta,03-03-2005,427807,Tamil Nadu,24,1,18,23,66,Fail
Mathew Verma,02-04-2006,188021,Rajasthan,1,0,24,23,48,Fail
Harjeet Chopra,25-12-2004,931900,Rajasthan,13,23,12,2,50,Fail
Ayaan Chopra,10-11-2005,965970,Uttar Pradesh,23,3,16,24,66,Pass
Raj D'Souza,12-01-2006,785548,Andhra Pradesh,5,18,14,11,48,Pass
Farhan Fernandes,30-11-2004,302755,Telangana,18,6,7,6,37,Pass
Aryan Sharma,20-03-2006,302084,Uttarakhand,19,13,22,10,64,Fail
David Khan,16-07-2005,617575,Maharashtra,21,18,20,24,83,Fail
John Sharma,26-06-2005,750782,Uttar Pradesh,19,6,7,0,32,Pass
Balbir D'Souza,26-03-2006,821139,Uttar Pradesh,4,16,20,14,54,Pass
Farhan Pillai,11-02-2006,397994,Kerala,19,18,15,3,55,Pass
Ishaan Khan,28-03-2005,682434,West Bengal,17,9,15,24,65,Fail
Ishaan Mehta,07-11-2005,777285,Tripura,23,14,2,11,50,Fail
Raj Sharma,01-01-2006,673159,Puducherry,10,19,18,7,54,Fail
Aditya Fernandes,12-01-2006,261602,Uttarakhand,15,19,6,20,60,Fail
Aarav Chopra,23-01-2005,285590,Assam,5,16,13,14,48,Pass
Aditya Verma,09-09-2005,876169,Punjab,9,5,19,2,35,Fail
Ishaan Khan,24-02-2005,212881,Rajasthan,20,6,16,22,64,Pass
Krishna Sharma,07-05-2006,182644,Andhra Pradesh,6,15,21,10,52,Pass
Ishaan Mehta,26-02-2005,635015,Karnataka,6,14,20,20,60,Fail
Yash Khan,03-12-2004,535787,Odisha,8,1,3,2,14,Fail
Raj D'Souza,28-11-2005,232974,Bihar,1,6,22,11,40,Fail
Aarav Singh,12-02-2005,804172,Andhra Pradesh,24,3,19,10,56,Pass
Rohan Pillai,18-04-2005,799016,Telangana,24,2,22,11,59,Pass
Yash Chopra,13-04-2006,340347,Uttarakhand,2,5,3,8,18,Fail
Aryan Khan,21-02-2006,787203,Uttarakhand,22,3,7,6,38,Fail
Aarav Reddy,02-04-2006,185310,Himachal Pradesh,19,20,6,13,58,Fail
Zaid Fernandes,03-09-2005,898503,Uttar Pradesh,4,1,24,11,40,Pass
Aarav Singh,15-08-2005,227437,Rajasthan,24,24,17,20,85,Fail
Aarav Mehta,18-08-2005,142642,Haryana,17,12,6,23,58,Pass
Krishna Verma,06-04-2005,279012,Tamil Nadu,5,10,24,24,63,Fail
Aditya Mehta,03-03-2006,893007,Telangana,12,8,21,3,44,Pass
Kunal Reddy,02-03-2005,759577,Maharashtra,7,10,23,14,54,Fail
Aarav Khan,12-12-2005,632547,Andhra Pradesh,20,18,18,12,68,Pass
Rohan Chopra,25-06-2005,269085,Bihar,13,23,21,6,63,Pass
Krishna Mehta,04-01-2005,794014,Nagaland,5,15,12,1,33,Fail
Kunal Pillai,31-08-2005,887209,Andhra Pradesh,7,10,14,20,51,Pass
Gurpreet Reddy,22-11-2005,621889,Chhattisgarh,12,8,4,6,30,Fail
Balbir Sharma,30-09-2005,587308,Punjab,9,21,23,5,58,Pass
Imran Fernandes,16-06-2005,833111,Bihar,17,16,23,23,79,Pass
Aditya Mehta,24-07-2005,629882,Rajasthan,12,8,8,18,46,Fail
Rohan Verma,07-12-2005,752785,Bihar,5,6,10,1,22,Fail
Paul Singh,10-12-2005,666274,Haryana,11,2,13,16,42,Pass
Harjeet Pillai,22-10-2005,735316,Uttar Pradesh,11,1,22,8,42,Pass
Krishna Khan,19-07-2005,654740,Punjab,5,24,17,11,57,Pass
Imran Fernandes,19-11-2005,716142,Odisha,18,13,1,8,40,Fail
Imran Sharma,16-11-2004,711233,Bihar,8,2,17,16,43,Fail
Ishaan Fernandes,08-11-2004,698011,Nagaland,9,6,6,24,45,Fail
Raj Pillai,17-12-2005,143090,Tamil Nadu,9,24,10,22,65,Fail
Imran D'Souza,12-10-2005,585386,Haryana,0,2,21,5,28,Pass
Kunal Khan,22-07-2005,684281,Assam,16,19,2,16,53,Pass
Aarav Fernandes,05-12-2005,749142,Tamil Nadu,8,20,2,5,35,Fail
Rohan Chopra,21-03-2005,757662,Tamil Nadu,18,8,24,6,56,Fail
Vivaan Fernandes,17-12-2005,838958,Telangana,7,6,14,5,32,Pass
Krishna Reddy,11-12-2004,725792,Punjab,11,24,7,0,42,Fail
Yash Sharma,05-02-2005,889921,Madhya Pradesh,8,3,21,9,41,Pass
John Pillai,03-04-2005,941234,Uttar Pradesh,8,4,21,10,43,Pass
Ishaan Singh,17-12-2005,249845,Madhya Pradesh,3,4,24,24,55,Pass
Aditya Mehta,23-04-2006,236977,Gujarat,20,22,9,7,58,Fail
Mathew Reddy,21-01-2005,625702,West Bengal,18,12,12,21,63,Fail
Vivaan Chopra,01-05-2005,114551,Jammu & Kashmir + Ladakh,6,3,16,8,33,Fail
Vivaan Sharma,29-06-2005,309009,Madhya Pradesh,10,4,17,19,50,Pass
Zaid Reddy,22-07-2005,368409,Madhya Pradesh,23,4,10,24,61,Pass
Vivaan D'Souza,26-02-2005,757468,Madhya Pradesh,9,23,3,10,45,Pass
Rohan Fernandes,30-03-2006,266283,Chhattisgarh,8,3,7,11,29,Fail
Aditya Sharma,28-09-2005,800029,Rajasthan,17,9,4,10,40,Fail
Aryan Sharma,18-04-2006,706907,Himachal Pradesh,1,7,6,21,35,Fail
Ishaan Mehta,09-04-2006,733144,Haryana,14,7,8,2,31,Pass
Aditya Fernandes,06-04-2006,873133,Bihar,13,22,15,24,74,Pass
Aryan Chopra,04-03-2005,943329,Bihar,5,16,24,8,53,Pass
Kunal D'Souza,29-11-2005,934347,Karnataka,2,2,2,11,17,Fail
Aarav Singh,21-11-2004,698699,Karnataka,15,19,17,2,53,Fail
Balbir D'Souza,08-12-2004,546178,Odisha,8,6,5,1,20,Fail
Kunal Verma,18-09-2005,596174,Bihar,1,21,21,17,60,Pass
Yash Sharma,05-08-2005,951429,Gujarat,22,8,2,12,44,Fail
Balbir Khan,27-03-2006,835442,Uttar Pradesh,16,13,8,23,60,Pass
Aarav Reddy,22-11-2005,568992,West Bengal,8,24,15,8,55,Fail
Kunal Fernandes,01-01-2006,873168,Rajasthan,22,22,15,5,64,Pass
Aryan Verma,13-03-2005,106202,Maharashtra,0,23,15,9,47,Fail
Ishaan Verma,18-07-2005,349270,Haryana,1,6,3,8,18,Pass
Aarav Fernandes,03-11-2005,493606,Rajasthan,23,9,20,13,65,Pass
Rehan Khan,26-06-2005,780188,Karnataka,1,21,10,19,51,Fail
Aryan Verma,25-11-2005,144499,Uttar Pradesh,3,16,4,1,24,Pass
Krishna Verma,04-01-2005,406502,Rajasthan,17,0,2,4,23,Fail
Krishna Khan,16-02-2005,565386,Haryana,1,22,20,11,54,Pass
Aryan Pillai,10-04-2005,156498,Tamil Nadu,22,5,2,11,40,Fail
Aarav Verma,04-12-2004,223994,Haryana,10,18,0,16,44,Pass
Yash Fernandes,24-11-2004,280894,Bihar,5,17,13,11,46,Pass
Aarav Mehta,30-12-2004,511958,Uttar Pradesh,0,11,4,10,25,Pass
Balbir Reddy,01-04-2006,515728,Kerala,2,11,21,13,47,Pass
Rohan D'Souza,07-08-2005,677994,Bihar,10,16,21,24,71,Pass
Manpreet Pillai,11-03-2005,259945,West Bengal,17,20,11,12,60,Fail
Krishna Singh,08-09-2005,161645,Gujarat,14,10,2,22,48,Fail
Aryan Khan,09-10-2005,354124,Uttar Pradesh,7,1,3,20,31,Pass
Ishaan Fernandes,12-05-2005,301607,Uttar Pradesh,15,0,8,14,37,Pass
Raj Fernandes,08-02-2005,628994,Punjab,0,22,1,12,35,Fail
Aditya Singh,01-04-2005,284418,Uttar Pradesh,14,14,6,10,44,Pass
Vivaan Khan,19-01-2005,815900,Punjab,17,4,23,21,65,Pass
Krishna Sharma,15-02-2006,663509,Uttar Pradesh,8,1,13,10,32,Pass
John Mehta,04-04-2005,355436,Rajasthan,23,24,5,10,62,Pass
Yash Sharma,18-07-2005,482077,Maharashtra,1,19,15,15,50,Fail
Kunal Reddy,21-05-2005,595261,Jharkhand,22,22,14,0,58,Fail
Sukhwinder D'Souza,28-07-2005,849178,Maharashtra,7,19,13,23,62,Fail
Rohan Verma,16-04-2006,180740,Madhya Pradesh,20,4,21,10,55,Pass
Ishaan Verma,20-10-2005,197847,Delhi,11,22,4,11,48,Fail
Kunal Mehta,26-08-2005,609921,Haryana,3,1,7,16,27,Pass
Aditya Pillai,11-09-2005,323830,Rajasthan,15,4,24,3,46,Fail
Kunal Singh,13-07-2005,778032,Punjab,10,21,8,6,45,Pass
Krishna Chopra,17-08-2005,904736,Telangana,24,20,4,15,63,Fail
Krishna Sharma,21-11-2004,838589,Punjab,9,10,0,7,26,Fail
Vivaan Khan,24-11-2004,768701,Rajasthan,12,22,5,0,39,Fail
Aditya Verma,01-12-2005,574486,Tamil Nadu,12,0,11,16,39,Fail
Yash D'Souza,02-05-2005,887055,Chhattisgarh,14,4,0,10,28,Fail
Rohan Pillai,13-02-2005,221071,Mizoram,15,2,13,2,32,Fail
David D'Souza,03-10-2005,459706,Telangana,22,3,21,6,52,Pass
Aarav Khan,07-02-2006,299211,Bihar,15,19,9,19,62,Pass
Balbir Pillai,05-12-2004,441884,Maharashtra,20,12,9,2,43,Fail
David Reddy,22-04-2006,661816,Andhra Pradesh,23,2,9,18,52,Pass
Yash Sharma,07-12-2004,947852,Madhya Pradesh,22,4,18,18,62,Pass
Gurpreet Verma,19-12-2004,795839,Maharashtra,17,4,11,19,51,Fail
Harjeet Chopra,08-11-2004,104170,Tamil Nadu,12,16,1,5,34,Fail
Mathew Verma,04-05-2006,690523,Bihar,16,5,0,2,23,Fail
Rohan Verma,07-11-2004,311248,Andhra Pradesh,11,1,8,15,35,Pass
David Reddy,09-08-2005,758523,Gujarat,5,2,18,22,47,Fail
John Pillai,27-11-2005,236695,Andhra Pradesh,8,22,22,1,53,Pass
Ishaan Singh,22-11-2005,387999,West Bengal,19,12,24,19,74,Fail
Aryan Mehta,12-03-2005,613162,Jammu & Kashmir + Ladakh,6,8,10,5,29,Fail
Yash Singh,09-09-2005,381881,Gujarat,9,1,15,21,46,Fail
Mathew D'Souza,15-06-2005,289390,Rajasthan,10,13,4,16,43,Fail
Aarav Fernandes,17-11-2005,112836,Andhra Pradesh,13,13,0,8,34,Pass
Aryan Mehta,29-12-2004,399586,Bihar,18,3,3,8,32,Fail
Harjeet Khan,11-04-2006,714527,Bihar,14,18,3,14,49,Pass
John Reddy,17-12-2005,888310,Madhya Pradesh,6,11,7,20,44,Pass
Yash Reddy,04-12-2005,237187,Bihar,3,10,8,4,25,Fail
Mathew Fernandes,12-04-2005,640734,Chhattisgarh,21,3,2,21,47,Fail
Rohan Verma,16-02-2005,302138,Delhi,13,20,19,18,70,Fail
Yash Singh,12-02-2006,262579,Rajasthan,9,0,20,8,37,Fail
Aarav Pillai,14-02-2005,868320,West Bengal,14,23,24,10,71,Fail
Krishna Fernandes,25-02-2006,496645,Karnataka,9,20,1,15,45,Fail
Rehan Chopra,11-10-2005,535740,Haryana,15,21,24,1,61,Pass
Aarav Reddy,05-02-2005,943628,Assam,12,9,8,13,42,Pass
Kunal Sharma,16-12-2004,197207,Telangana,1,17,23,14,55,Fail
Krishna Verma,06-02-2006,585470,Andhra Pradesh,16,23,4,15,58,Pass
Yash Verma,22-02-2006,764437,Gujarat,6,24,19,14,63,Fail
Kunal Reddy,24-07-2005,790855,Andhra Pradesh,17,6,9,2,34,Pass
Yash Mehta,19-04-2005,939371,Jammu & Kashmir + Ladakh,1,16,21,10,48,Fail
Vivaan Khan,16-01-2005,917683,Madhya Pradesh,24,9,13,3,49,Pass
Yash Sharma,24-02-2006,713899,Jammu & Kashmir + Ladakh,5,6,24,4,39,Fail
Mathew D'Souza,08-11-2004,952330,Madhya Pradesh,24,4,23,7,58,Pass
Harjeet Singh,05-04-2005,480181,Bihar,14,13,12,8,47,Pass
Balbir Verma,02-07-2005,614495,Rajasthan,9,4,22,17,52,Fail
Kunal Singh,03-07-2005,971468,Uttar Pradesh,3,0,6,15,24,Pass
Ishaan Fernandes,02-01-2005,347066,Uttar Pradesh,1,16,14,17,48,Pass
Ayaan Fernandes,23-02-2006,283098,Haryana,14,14,14,7,49,Pass
Vivaan Sharma,07-06-2005,639563,Uttar Pradesh,18,3,23,22,66,Pass
Ishaan Verma,11-07-2005,170706,Maharashtra,2,4,11,11,28,Fail
Ishaan Pillai,05-01-2005,624764,Uttar Pradesh,16,13,7,1,37,Pass
Rohan Chopra,21-11-2005,292293,Uttar Pradesh,17,17,14,5,53,Pass
Aryan Fernandes,31-05-2005,340973,Maharashtra,9,9,15,5,38,Fail
Raj Singh,10-06-2005,275483,Jharkhand,21,9,1,3,34,Fail
Raj Sharma,25-12-2005,583508,Haryana,12,16,11,17,56,Pass
Aryan Sharma,08-01-2005,700774,Uttar Pradesh,21,6,15,12,54,Pass
Rohan Pillai,22-04-2006,560893,Rajasthan,21,16,15,3,55,Fail
Krishna Reddy,04-02-2005,532035,Bihar,3,8,5,12,28,Fail
Rohan Sharma,15-01-2006,458683,Rajasthan,2,23,7,22,54,Fail
Manpreet Khan,24-11-2004,363723,Bihar,6,16,13,6,41,Fail
Aryan Singh,17-01-2005,243587,West Bengal,17,19,0,6,42,Fail
Balbir Sharma,14-09-2005,736627,Jammu & Kashmir + Ladakh,1,0,23,18,42,Fail
Krishna Khan,08-04-2005,914221,Rajasthan,18,11,18,13,60,Pass
Aarav Chopra,18-03-2005,527915,Madhya Pradesh,20,0,0,21,41,Pass
John Mehta,01-12-2005,818966,Rajasthan,13,13,18,5,49,Fail
Harjeet Mehta,12-11-2004,991090,Rajasthan,24,4,19,20,67,Pass
Rohan Fernandes,17-07-2005,703444,Jharkhand,5,14,24,12,55,Fail
Paul Verma,16-04-2005,954157,Haryana,13,5,23,9,50,Pass
Manpreet Mehta,18-05-2005,872210,Punjab,17,20,3,13,53,Pass
Raj Sharma,05-09-2005,973383,Himachal Pradesh,13,23,16,15,67,Fail
Aarav Pillai,15-01-2005,226136,Odisha,22,0,18,17,57,Pass
Harjeet D'Souza,23-08-2005,204017,Uttarakhand,21,16,21,9,67,Fail
Rohan Singh,23-11-2004,452452,Bihar,5,5,23,24,57,Pass
Gurpreet Pillai,08-02-2005,825838,Bihar,9,3,8,19,39,Fail
David Khan,20-08-2005,405776,Bihar,13,17,1,10,41,Fail
Krishna Fernandes,04-11-2005,752751,Haryana,3,18,11,14,46,Pass
Balbir Mehta,14-02-2005,672200,West Bengal,24,21,0,6,51,Fail
Ishaan Sharma,19-03-2006,344855,Kerala,15,4,2,15,36,Pass
Vivaan Verma,14-12-2004,389760,Bihar,18,17,7,12,54,Pass
Manpreet Fernandes,17-11-2005,874876,Maharashtra,23,23,5,11,62,Fail
Kunal Sharma,19-10-2005,615144,Bihar,0,17,15,24,56,Pass
Peter Sharma,03-05-2005,898811,Bihar,15,1,4,14,34,Fail
Krishna Reddy,12-10-2005,569141,Rajasthan,5,1,6,20,32,Fail
Balbir D'Souza,19-02-2005,798419,Madhya Pradesh,11,21,6,7,45,Pass
Krishna Khan,16-11-2005,888472,Kerala,3,16,24,14,57,Pass
Aryan D'Souza,02-02-2006,296815,Haryana,6,14,15,8,43,Pass
Yash Verma,27-06-2005,476800,Rajasthan,3,0,20,18,41,Fail
Balbir Fernandes,04-01-2005,603352,Gujarat,23,9,17,18,67,Fail
Ishaan Fernandes,01-06-2005,667487,West Bengal,24,14,18,20,76,Fail
Harjeet Chopra,13-06-2005,589748,Uttar Pradesh,22,3,8,24,57,Pass
Sukhwinder Sharma,31-12-2005,594883,Rajasthan,16,5,17,18,56,Fail
Aarav Mehta,02-01-2005,937351,Madhya Pradesh,6,2,18,4,30,Pass
Rohan Singh,21-02-2005,796028,Rajasthan,16,5,10,12,43,Fail
Aditya Pillai,19-01-2005,838451,West Bengal,21,15,16,21,73,Fail
Yash Singh,13-11-2005,615308,Maharashtra,15,4,16,7,42,Fail
Aarav Sharma,27-03-2005,287322,Uttar Pradesh,16,19,12,4,51,Pass
Krishna Khan,05-08-2005,263567,Bihar,6,2,13,8,29,Fail
Aryan Sharma,07-05-2005,573324,Uttar Pradesh,5,14,10,10,39,Pass
Rohan Mehta,07-12-2004,174809,Gujarat,19,7,24,9,59,Fail
Raj D'Souza,05-02-2005,853288,Uttar Pradesh,6,15,11,1,33,Pass
Aditya Reddy,27-06-2005,950475,Rajasthan,19,13,17,10,59,Fail
Kunal D'Souza,29-01-2006,497472,Gujarat,1,4,0,12,17,Fail
Aditya Singh,06-04-2006,597730,Madhya Pradesh,1,21,12,15,49,Pass
Yash Chopra,26-05-2005,856436,Rajasthan,14,10,17,5,46,Fail
Harjeet D'Souza,25-04-2005,107594,Odisha,18,16,13,11,58,Pass
Yash Fernandes,03-12-2005,352226,West Bengal,2,20,10,13,45,Fail
Rohan Khan,27-12-2004,206081,Rajasthan,15,17,3,17,52,Fail
Manpreet Sharma,22-06-2005,516200,Assam,7,15,23,11,56,Pass
Kunal Sharma,03-05-2005,713147,Maharashtra,15,3,11,10,39,Fail
Rohan Singh,11-08-2005,693233,Madhya Pradesh,23,4,22,8,57,Pass
Rohan D'Souza,29-12-2004,129161,Uttar Pradesh,24,13,4,6,47,Pass
Raj Chopra,10-10-2005,812592,Kerala,0,21,10,14,45,Pass
Vivaan Reddy,20-11-2005,263061,Kerala,5,12,18,15,50,Pass
David D'Souza,13-01-2005,227301,Madhya Pradesh,7,19,10,8,44,Pass
Krishna Singh,30-01-2006,715321,Bihar,9,6,9,5,29,Fail
Aditya Mehta,07-03-2005,954038,Uttar Pradesh,2,24,21,19,66,Pass
Vivaan Verma,25-09-2005,678877,Meghalaya,18,7,2,3,30,Fail
Ishaan Singh,24-02-2005,308075,West Bengal,3,2,8,4,17,Fail
David D'Souza,02-08-2005,765175,Karnataka,15,18,18,21,72,Fail
Aarav D'Souza,06-12-2005,262191,Rajasthan,18,22,18,10,68,Pass
Kunal D'Souza,22-06-2005,426973,Madhya Pradesh,20,2,9,23,54,Pass
Manpreet D'Souza,09-05-2006,503438,Uttar Pradesh,12,17,4,14,47,Pass
Yash Pillai,01-12-2005,555722,Delhi,19,6,23,20,68,Fail
Aditya Sharma,16-08-2005,998919,Rajasthan,4,15,11,19,49,Fail
Aarav Chopra,17-05-2005,389833,Jharkhand,9,24,3,10,46,Fail
Ishaan Fernandes,07-12-2005,690727,Punjab,6,13,12,1,32,Fail
Ishaan D'Souza,28-06-2005,713777,Haryana,21,7,15,6,49,Pass
Gurpreet Mehta,04-08-2005,911221,West Bengal,14,1,12,11,38,Fail
Raj Khan,22-03-2006,799596,Rajasthan,10,3,11,13,37,Fail
Paul Verma,09-12-2005,121271,Bihar,24,9,23,11,67,Pass
Ishaan Sharma,27-12-2004,773958,Bihar,6,10,24,16,56,Pass
Kunal Chopra,11-12-2005,780920,Telangana,16,12,23,17,68,Fail
Raj Chopra,31-01-2006,822949,Bihar,19,22,6,9,56,Pass
Raj Chopra,27-11-2004,564809,Uttar Pradesh,24,11,18,19,72,Pass
Krishna Pillai,14-04-2006,640698,Andhra Pradesh,13,18,14,16,61,Pass
Aarav Fernandes,09-03-2005,460101,Telangana,23,8,19,4,54,Fail
Krishna Chopra,05-01-2005,136499,Bihar,7,15,15,17,54,Pass
Sukhwinder Verma,28-10-2005,815971,Uttar Pradesh,7,16,9,2,34,Pass
Aditya D'Souza,12-02-2005,326032,West Bengal,23,11,3,24,61,Fail
Yash Khan,30-10-2005,131071,Telangana,5,12,3,16,36,Pass
Ishaan Singh,24-10-2005,929694,Tamil Nadu,0,5,23,16,44,Fail
Paul Mehta,14-08-2005,240897,Gujarat,0,21,21,19,61,Fail
Gurpreet Mehta,30-12-2004,206678,Rajasthan,23,2,14,24,63,Pass
Aarav Sharma,20-03-2005,238017,Meghalaya,23,10,9,14,56,Fail
Yash Reddy,27-04-2005,578749,Tamil Nadu,2,24,2,6,34,Fail
Raj Sharma,24-06-2005,239149,Uttarakhand,15,7,17,0,39,Fail
Aarav D'Souza,09-02-2006,482083,Bihar,10,19,12,4,45,Fail
Aarav Fernandes,21-06-2005,354994,Odisha,9,16,7,4,36,Fail
Ishaan Chopra,07-06-2005,155465,Bihar,0,14,10,24,48,Pass
Gurpreet Fernandes,20-02-2005,105570,Kerala,6,9,0,17,32,Pass
Aarav Chopra,22-12-2004,168332,Rajasthan,3,1,7,21,32,Fail
Aryan Sharma,08-04-2006,689367,Himachal Pradesh,24,23,9,23,79,Fail
Harjeet Reddy,15-02-2006,494809,Uttar Pradesh,4,16,13,9,42,Pass
Paul Reddy,10-01-2006,323402,Karnataka,7,2,21,0,30,Fail
Ishaan Reddy,16-11-2004,486927,Rajasthan,4,0,24,24,52,Fail
Vivaan Fernandes,10-01-2006,517136,Himachal Pradesh,22,0,7,8,37,Fail
Aarav Mehta,31-08-2005,919564,Rajasthan,10,23,0,8,41,Fail
Aryan Reddy,20-11-2004,517286,Andhra Pradesh,6,12,1,9,28,Pass
Aryan Verma,21-02-2005,140690,Haryana,18,9,7,24,58,Pass
Aryan Pillai,26-04-2006,821722,Tamil Nadu,15,3,3,9,30,Fail
Vivaan D'Souza,12-04-2005,351063,Uttarakhand,2,19,15,22,58,Fail
Raj Verma,19-12-2005,697370,Tamil Nadu,5,15,17,9,46,Fail
David D'Souza,01-08-2005,967654,West Bengal,24,5,2,1,32,Fail
Aryan Sharma,18-11-2004,467547,Andhra Pradesh,18,7,14,18,57,Pass
Raj Mehta,06-02-2006,366587,Meghalaya,2,9,10,2,23,Fail
Vivaan Khan,02-10-2005,396577,Telangana,12,0,19,9,40,Pass
Gurpreet Pillai,08-02-2005,898678,Gujarat,9,10,0,20,39,Fail
Vivaan Khan,02-07-2005,189765,Madhya Pradesh,5,22,4,16,47,Pass
John Singh,26-07-2005,217303,Assam,8,5,4,8,25,Pass
Vivaan Khan,02-12-2004,306346,Tamil Nadu,2,10,19,20,51,Fail
Balbir Chopra,17-06-2005,137368,Telangana,13,14,20,18,65,Pass
Vivaan Chopra,28-11-2005,890245,Rajasthan,17,5,13,8,43,Fail
Rohan Chopra,28-11-2004,750725,Karnataka,6,2,19,13,40,Fail
Aarav D'Souza,20-03-2005,829015,West Bengal,0,24,13,3,40,Fail
Yash Mehta,20-12-2004,599593,West Bengal,24,16,1,15,56,Fail
Gurpreet Mehta,19-04-2005,624474,Karnataka,5,9,23,8,45,Fail
Kunal Pillai,08-03-2006,289577,Rajasthan,22,22,12,13,69,Fail
Raj Reddy,24-06-2005,133544,West Bengal,6,22,7,4,39,Fail
Kunal Sharma,08-06-2005,630376,Rajasthan,17,14,2,20,53,Fail
Ishaan Fernandes,13-03-2005,854218,Madhya Pradesh,13,21,9,13,56,Pass
Sukhwinder D'Souza,19-05-2005,572531,Andaman & Nicobar,8,0,0,16,24,Pass
Aarav D'Souza,11-04-2005,985547,Jharkhand,1,11,23,15,50,Fail
Aditya Verma,18-04-2006,825474,Maharashtra,7,19,10,14,50,Fail
Aarav Verma,04-04-2005,269887,Madhya Pradesh,19,4,4,19,46,Pass
Krishna Pillai,12-02-2005,763328,Uttar Pradesh,9,3,21,8,41,Pass
Vivaan Verma,14-06-2005,808284,Uttar Pradesh,17,5,16,19,57,Pass
Rehan Pillai,28-10-2005,622379,Uttar Pradesh,10,11,7,19,47,Pass
Imran D'Souza,22-04-2005,520558,Maharashtra,18,13,15,24,70,Fail
Vivaan Khan,02-01-2006,670932,Uttar Pradesh,12,21,7,12,52,Pass
Paul Khan,24-04-2006,711822,Maharashtra,8,3,8,23,42,Fail
Ayaan Fernandes,16-01-2005,839426,Jharkhand,23,19,22,7,71,Fail
Harjeet Mehta,26-04-2006,104425,Uttar Pradesh,19,11,4,16,50,Pass
Yash Fernandes,26-08-2005,746918,Bihar,19,13,20,9,61,Pass
Vivaan Sharma,02-06-2005,240150,Uttar Pradesh,5,23,19,11,58,Pass
Aryan Khan,20-11-2005,101226,Jharkhand,4,18,13,16,51,Fail
Yash Chopra,04-05-2006,719890,Maharashtra,19,14,1,13,47,Fail
Aryan Sharma,09-12-2005,627639,Uttar Pradesh,21,0,11,8,40,Pass
Mathew Pillai,24-02-2006,548948,Punjab,9,15,10,14,48,Pass
Aditya Mehta,09-09-2005,965339,Chhattisgarh,14,14,3,3,34,Fail
Yash Fernandes,13-12-2004,368250,Haryana,13,4,11,19,47,Pass
Raj D'Souza,25-08-2005,784141,Jammu & Kashmir + Ladakh,7,2,12,23,44,Fail
David Pillai,02-05-2006,708559,Rajasthan,21,20,0,7,48,Fail
Rohan Mehta,23-02-2005,247469,Uttar Pradesh,16,10,1,20,47,Pass
Yash Verma,21-10-2005,340339,Rajasthan,20,8,10,0,38,Fail
Sukhwinder Reddy,23-02-2006,853892,Bihar,18,3,0,4,25,Fail
Kunal D'Souza,29-06-2005,450224,Gujarat,5,6,10,4,25,Fail
Ayaan Mehta,13-01-2006,596872,Rajasthan,16,8,20,8,52,Fail
Krishna Pillai,23-09-2005,827807,Madhya Pradesh,23,12,6,8,49,Pass
Aryan Khan,02-04-2005,457184,Maharashtra,20,19,15,14,68,Fail
Aryan Khan,23-10-2005,244742,West Bengal,24,20,9,1,54,Fail
Peter Singh,29-11-2005,341656,Kerala,1,16,0,1,18,Pass
Rohan Mehta,08-02-2005,286222,Uttar Pradesh,18,0,8,1,27,Pass
Ishaan Pillai,21-02-2006,982580,Maharashtra,13,2,20,12,47,Fail
Ishaan D'Souza,23-04-2005,859356,Jharkhand,19,17,0,18,54,Fail
Farhan Chopra,17-03-2006,516783,Jharkhand,6,11,9,22,48,Fail
Aditya Sharma,30-01-2005,202356,Nagaland,9,22,21,16,68,Fail
Manpreet Verma,08-04-2006,275122,Haryana,7,21,19,15,62,Pass
Aarav Mehta,07-12-2004,494559,Chhattisgarh,5,22,13,0,40,Fail
Vivaan Mehta,06-02-2005,698514,Punjab,15,8,5,24,52,Pass
Ayaan D'Souza,29-03-2005,949925,Uttar Pradesh,3,7,0,16,26,Pass
Harjeet Pillai,15-03-2005,399454,Maharashtra,6,13,13,24,56,Fail
Rohan Pillai,19-05-2005,683488,Delhi,12,8,21,13,54,Fail
Raj Sharma,12-06-2005,543262,Bihar,3,7,2,1,13,Fail
Gurpreet D'Souza,10-01-2005,333506,Haryana,22,8,6,0,36,Pass
Rohan Pillai,28-09-2005,309224,Rajasthan,20,24,0,5,49,Fail
Imran D'Souza,27-01-2005,445942,Haryana,4,10,15,22,51,Pass
Aditya D'Souza,16-01-2005,566171,Uttar Pradesh,22,1,19,12,54,Pass
Krishna Mehta,19-02-2005,787515,West Bengal,9,2,0,15,26,Fail
Ishaan Chopra,04-12-2005,918546,Rajasthan,16,18,17,10,61,Fail
Yash Verma,02-08-2005,523956,Gujarat,7,13,13,15,48,Fail
Aryan Singh,29-12-2004,137654,Haryana,18,7,16,0,41,Pass
Aarav Mehta,28-03-2006,985829,Gujarat,2,19,3,2,26,Fail
John D'Souza,01-11-2005,734932,Uttar Pradesh,11,23,1,24,59,Pass
Yash Singh,18-06-2005,141440,Rajasthan,13,24,6,16,59,Fail
Balbir D'Souza,30-08-2005,986742,Tamil Nadu,19,16,14,15,64,Fail
Krishna Pillai,28-01-2005,590821,Assam,24,23,22,2,71,Pass
Krishna Pillai,26-10-2005,914505,Bihar,6,0,13,13,32,Fail
Sukhwinder Reddy,04-02-2006,179084,Uttarakhand,0,19,7,16,42,Fail
Aryan Mehta,15-07-2005,154397,Andhra Pradesh,13,3,10,9,35,Pass
Harjeet Chopra,01-04-2005,809890,Uttar Pradesh,1,23,16,6,46,Pass
Manpreet Fernandes,16-12-2004,468315,Gujarat,12,22,6,4,44,Fail
Aditya Chopra,17-12-2005,586682,Rajasthan,3,21,11,6,41,Fail
Yash Sharma,19-01-2005,848918,Telangana,20,4,0,22,46,Pass
Balbir D'Souza,03-04-2005,511671,Tamil Nadu,2,16,15,10,43,Fail
Vivaan Sharma,22-11-2004,577121,Uttar Pradesh,22,19,22,6,69,Pass
Aditya D'Souza,10-01-2005,883854,West Bengal,23,13,4,20,60,Fail
Kunal Mehta,02-04-2006,267341,Telangana,8,1,23,12,44,Pass
Krishna Chopra,30-08-2005,335714,Uttar Pradesh,21,6,16,4,47,Pass
Rohan D'Souza,15-12-2004,448898,Jharkhand,7,24,14,7,52,Fail
Mathew Pillai,13-03-2006,190090,Assam,8,15,10,24,57,Pass
Kunal Singh,13-03-2005,969702,Madhya Pradesh,13,4,7,23,47,Pass
Kunal Reddy,23-07-2005,322945,Madhya Pradesh,1,6,21,13,41,Pass
Ishaan Chopra,13-01-2005,822434,Assam,24,4,16,5,49,Pass
Aarav Reddy,28-09-2005,849331,Himachal Pradesh,21,10,18,8,57,Fail
Rohan Fernandes,05-03-2006,522344,Telangana,6,3,1,22,32,Pass
Gurpreet Chopra,13-05-2005,775567,Uttar Pradesh,8,9,16,24,57,Pass
David Pillai,08-09-2005,978457,Bihar,0,8,10,21,39,Fail
Balbir Mehta,24-01-2005,319386,West Bengal,12,23,4,4,43,Fail
Sukhwinder Sharma,23-08-2005,975386,Kerala,7,11,19,24,61,Pass
Vivaan D'Souza,09-07-2005,702941,Kerala,1,11,4,2,18,Pass
Imran Pillai,08-12-2005,208969,Uttar Pradesh,13,3,22,23,61,Pass
Ishaan Fernandes,08-12-2005,878869,Manipur,16,3,8,12,39,Fail
Aarav Chopra,10-09-2005,461817,Bihar,5,12,21,10,48,Pass
Sukhwinder Chopra,19-02-2006,638245,Uttar Pradesh,7,21,12,14,54,Pass
Manpreet Khan,29-10-2005,789258,Uttar Pradesh,10,10,7,11,38,Pass
David Sharma,03-03-2006,405868,Madhya Pradesh,7,5,0,20,32,Pass
Rohan Pillai,06-12-2004,578500,Madhya Pradesh,12,4,11,21,48,Pass
Paul Pillai,29-04-2005,446798,Assam,23,0,23,1,47,Pass
John Singh,21-11-2004,316957,Rajasthan,19,21,18,14,72,Fail
Rohan Sharma,08-04-2006,412403,Uttar Pradesh,24,18,4,12,58,Pass
Farhan Verma,01-12-2004,123530,Bihar,7,9,4,19,39,Fail
Aditya Mehta,12-06-2005,410496,Tamil Nadu,1,15,4,1,21,Fail
Zaid Verma,14-11-2005,356737,Sikkim,12,15,9,4,40,Fail
Rohan Khan,09-05-2006,383146,Telangana,18,16,17,5,56,Pass
Ishaan Sharma,16-03-2005,935052,Chhattisgarh,3,1,16,12,32,Fail
Raj Verma,26-05-2005,888626,West Bengal,10,22,24,2,58,Fail
Aditya Sharma,06-05-2005,901040,Punjab,1,5,6,9,21,Fail
Kunal Verma,14-11-2005,403638,Andhra Pradesh,16,0,3,12,31,Pass
Sukhwinder Verma,02-06-2005,602536,Mizoram,11,12,5,19,47,Fail
David D'Souza,10-01-2006,475254,Kerala,9,4,10,17,40,Pass
Aditya D'Souza,28-12-2005,719749,Bihar,10,23,10,9,52,Pass
Kunal Pillai,12-01-2005,334264,Gujarat,24,21,6,11,62,Fail
Raj Reddy,02-06-2005,517344,Maharashtra,7,18,14,1,40,Fail
Ishaan Fernandes,27-11-2005,503466,Jammu & Kashmir + Ladakh,18,16,8,20,62,Fail
Aryan Fernandes,16-01-2006,937564,Gujarat,11,9,11,19,50,Fail
Krishna Khan,11-02-2005,406320,Telangana,12,19,12,10,53,Fail
Aarav Khan,27-07-2005,637272,Haryana,19,12,11,9,51,Pass
Rohan Reddy,09-03-2006,708240,Uttar Pradesh,16,4,18,6,44,Pass
Paul Singh,21-05-2005,987242,Gujarat,14,7,22,13,56,Fail
Aryan Sharma,10-02-2006,893020,Telangana,13,3,17,19,52,Pass
Yash Reddy,20-09-2005,975224,Karnataka,1,9,24,1,35,Fail
Kunal Pillai,04-12-2004,926179,Punjab,15,15,9,24,63,Pass
Kunal Sharma,13-06-2005,552276,West Bengal,9,13,1,14,37,Fail
Aryan Fernandes,15-03-2006,646447,Delhi,17,14,2,21,54,Fail
Balbir Khan,14-04-2005,810697,Maharashtra,4,9,5,7,25,Fail
Paul Verma,10-08-2005,285330,Maharashtra,2,10,11,21,44,Fail
Manpreet D'Souza,21-02-2006,526026,Punjab,14,11,18,6,49,Pass
Vivaan Singh,12-10-2005,193975,Maharashtra,7,18,12,24,61,Fail
Aryan Pillai,16-01-2006,791014,Andhra Pradesh,20,2,22,14,58,Pass
Aarav Sharma,02-11-2005,767968,Madhya Pradesh,12,10,15,5,42,Pass
Mathew Singh,02-01-2006,318768,Tamil Nadu,13,7,16,17,53,Fail
Krishna Pillai,15-02-2006,255197,Maharashtra,23,3,5,24,55,Fail
Raj Chopra,03-08-2005,486516,Uttar Pradesh,3,5,2,13,23,Pass
Krishna Reddy,30-05-2005,101636,Bihar,19,15,4,4,42,Fail
Aryan Mehta,13-11-2004,930882,Uttar Pradesh,16,3,24,20,63,Pass
John Chopra,09-01-2005,401787,West Bengal,14,8,17,10,49,Fail
Yash Sharma,03-05-2005,530335,Rajasthan,24,19,14,6,63,Fail
Aarav Pillai,18-04-2005,188440,Gujarat,7,11,12,19,49,Fail
Rohan Pillai,08-02-2006,785907,Madhya Pradesh,1,5,5,11,22,Pass
Balbir Reddy,01-05-2006,121294,Rajasthan,22,3,11,17,53,Fail
Krishna Khan,19-03-2005,975549,Andhra Pradesh,11,11,2,22,46,Pass
Yash Pillai,30-04-2006,545746,Maharashtra,3,21,17,0,41,Fail
Farhan Pillai,31-01-2006,222934,Haryana,2,4,23,23,52,Pass
Rohan Pillai,02-04-2006,539472,Delhi,17,7,6,17,47,Fail
Yash Verma,23-02-2005,845859,Rajasthan,6,7,9,0,22,Fail
Aditya Verma,04-03-2006,205960,Bihar,22,15,11,9,57,Pass
Gurpreet Verma,20-08-2005,561689,Rajasthan,24,11,15,16,66,Fail
Kunal Chopra,05-08-2005,199212,Bihar,1,22,20,18,61,Pass
Aarav Mehta,05-07-2005,236183,Karnataka,8,18,18,19,63,Fail
Aryan Chopra,24-02-2005,780249,Telangana,6,8,12,13,39,Pass
Paul Mehta,02-08-2005,327975,Madhya Pradesh,7,19,16,8,50,Pass
Aryan D'Souza,09-06-2005,657277,Tamil Nadu,8,15,7,7,37,Fail
Aarav Sharma,05-02-2005,665855,Kerala,20,2,20,7,49,Pass
Yash Chopra,04-09-2005,685264,Andhra Pradesh,22,7,24,1,54,Pass
Manpreet Fernandes,01-12-2005,255089,Assam,7,9,9,8,33,Pass
Ishaan Pillai,01-06-2005,328232,West Bengal,22,14,1,7,44,Fail
Farhan Sharma,20-09-2005,176315,Madhya Pradesh,12,16,19,8,55,Pass
Aarav Khan,19-12-2004,349369,Rajasthan,10,15,23,6,54,Fail
Kunal Sharma,16-09-2005,536905,Madhya Pradesh,1,12,2,23,38,Pass
Manpreet Sharma,26-04-2005,165675,Chhattisgarh,6,4,22,23,55,Fail
Yash Sharma,27-11-2005,193945,Chhattisgarh,18,10,10,14,52,Fail
Aditya Verma,05-02-2005,673961,Uttar Pradesh,19,15,24,3,61,Pass
Raj Mehta,18-11-2004,642094,Maharashtra,7,7,8,3,25,Fail
Manpreet Pillai,12-06-2005,892566,Rajasthan,17,24,4,23,68,Fail
David D'Souza,05-04-2006,999163,West Bengal,0,8,16,23,47,Fail
Aarav Chopra,19-02-2005,674476,Andhra Pradesh,15,4,3,22,44,Pass
Gurpreet Sharma,02-12-2004,316660,West Bengal,18,4,21,5,48,Fail
Yash D'Souza,25-04-2006,470072,Chhattisgarh,17,0,16,15,48,Fail
Aarav Mehta,28-06-2005,905019,Uttar Pradesh,20,2,15,13,50,Pass
Rohan Mehta,20-08-2005,562989,Madhya Pradesh,4,4,7,24,39,Pass
Aarav Singh,12-04-2006,799134,Uttar Pradesh,8,8,17,7,40,Pass
Rohan Reddy,13-10-2005,997058,Haryana,5,20,14,14,53,Fail
Manpreet Fernandes,26-11-2005,816978,Haryana,9,0,3,15,27,Fail
Vivaan Chopra,08-03-2005,422090,West Bengal,20,20,21,22,83,Fail
David Pillai,04-05-2005,628686,Maharashtra,18,15,20,8,61,Fail
Aarav Mehta,07-03-2006,735293,Uttar Pradesh,14,18,15,21,68,Pass
Aarav Khan,01-08-2005,872233,Tamil Nadu,9,14,9,1,33,Fail
Zaid Fernandes,20-12-2005,987297,Kerala,13,20,24,4,61,Pass
Aditya Sharma,05-03-2005,568207,Bihar,2,0,20,1,23,Fail
Paul Singh,01-05-2006,452089,Maharashtra,22,14,8,9,53,Fail
Gurpreet Mehta,28-11-2005,584780,Karnataka,17,16,10,1,44,Fail
Rohan Pillai,01-11-2005,196175,Bihar,2,3,19,12,36,Fail
Krishna Mehta,29-12-2005,384873,Uttar Pradesh,11,2,10,4,27,Pass
John Khan,04-09-2005,767467,Andhra Pradesh,17,20,21,7,65,Pass
Aryan D'Souza,05-11-2005,976109,Uttar Pradesh,11,24,20,9,64,Pass
Vivaan Verma,05-03-2005,548770,Madhya Pradesh,14,3,2,12,31,Pass
David Chopra,31-12-2005,312314,Kerala,16,5,17,4,42,Pass
Harjeet Fernandes,24-10-2005,114541,Bihar,2,24,22,23,71,Pass
Yash Mehta,14-04-2006,886889,Assam,8,20,15,6,49,Pass
Manpreet D'Souza,23-06-2005,742535,Tamil Nadu,14,22,12,15,63,Fail
Raj Verma,10-11-2005,401031,West Bengal,8,21,15,7,51,Fail
Krishna D'Souza,16-07-2005,834443,Jharkhand,16,0,8,10,34,Fail
Aditya Chopra,03-04-2005,743218,Uttar Pradesh,4,17,24,11,56,Pass
Yash D'Souza,14-11-2004,416373,Uttarakhand,10,2,5,19,36,Fail
Vivaan Reddy,12-07-2005,428394,Andhra Pradesh,12,10,22,21,65,Pass
Krishna Reddy,21-04-2005,853509,Jharkhand,1,17,2,10,30,Fail
Yash Mehta,02-04-2005,307794,Maharashtra,13,13,8,9,43,Fail
Raj Singh,30-08-2005,350567,Tamil Nadu,18,12,5,16,51,Fail
Aditya D'Souza,02-12-2005,884378,Kerala,4,15,2,2,23,Pass
Sukhwinder Fernandes,28-03-2005,863664,Haryana,10,7,16,0,33,Fail
Aarav Chopra,28-05-2005,815951,Maharashtra,7,7,13,7,34,Fail
Aryan Khan,07-04-2006,825533,West Bengal,12,18,9,11,50,Fail
Kunal Khan,11-11-2005,750688,Karnataka,22,1,8,16,47,Fail
Kunal Sharma,19-07-2005,794212,Bihar,2,16,13,10,41,Fail
Rohan Fernandes,07-02-2005,919877,Gujarat,16,9,0,17,42,Fail
Zaid Reddy,15-11-2004,450238,Madhya Pradesh,0,4,14,23,41,Pass
Raj Verma,13-06-2005,484959,Uttar Pradesh,21,3,10,17,51,Pass
Gurpreet D'Souza,13-03-2005,855013,Assam,12,17,4,24,57,Pass
Rohan D'Souza,18-06-2005,149604,Uttar Pradesh,6,6,7,16,35,Pass
Rohan Chopra,12-04-2006,647651,Arunachal Pradesh,1,7,14,14,36,Fail
Aarav Fernandes,23-01-2006,462225,West Bengal,16,2,2,3,23,Fail
Balbir Verma,13-10-2005,491922,Rajasthan,13,16,16,8,53,Fail
Ayaan Verma,20-05-2005,809521,Bihar,19,9,23,11,62,Pass
Ayaan Chopra,11-03-2006,587874,Uttar Pradesh,23,11,4,18,56,Pass
Vivaan Chopra,02-02-2006,378069,Odisha,18,22,18,18,76,Fail
Kunal Khan,05-01-2005,874153,Bihar,1,17,12,3,33,Fail
Balbir Verma,12-04-2006,539106,Uttar Pradesh,15,19,11,6,51,Fail
Ayaan Fernandes,10-11-2004,367374,Maharashtra,2,22,21,12,57,Fail
Kunal Khan,09-12-2004,817045,Tamil Nadu,9,18,21,6,54,Fail
Raj Fernandes,17-10-2005,783682,Maharashtra,17,3,1,0,21,Fail
Manpreet Verma,28-11-2005,266690,Uttarakhand,12,5,4,17,38,Fail
Yash D'Souza,07-01-2005,804752,Rajasthan,10,9,19,8,46,Fail
Ishaan Verma,27-07-2005,326430,Haryana,21,19,7,1,48,Fail
Yash Khan,07-12-2004,591269,Uttar Pradesh,10,7,14,17,48,Fail
Manpreet Singh,20-12-2004,907107,Maharashtra,2,24,9,12,47,Fail
Rohan Reddy,05-02-2005,638886,Bihar,11,11,0,12,34,Fail
Raj Verma,29-05-2005,800440,Bihar,5,13,11,16,45,Fail
Rohan Fernandes,02-05-2006,937173,Tamil Nadu,4,13,12,18,47,Fail
Krishna Mehta,08-03-2005,597441,Rajasthan,10,12,0,14,36,Fail
Aditya Fernandes,11-02-2006,315057,Odisha,18,3,8,8,37,Fail
Kunal Pillai,06-07-2005,491125,Assam,14,19,22,23,78,Pass
Aarav D'Souza,04-06-2005,266123,Jammu & Kashmir + Ladakh,7,13,16,20,56,Fail
Yash Reddy,10-08-2005,507343,Gujarat,9,5,17,14,45,Fail
Aryan Chopra,06-07-2005,140531,Bihar,11,19,3,23,56,Pass
Raj Fernandes,18-03-2005,242057,Uttar Pradesh,14,7,9,16,46,Fail
Krishna Pillai,27-02-2006,567900,Uttar Pradesh,18,21,2,3,44,Fail
Zaid Reddy,23-04-2006,102286,Bihar,24,16,16,0,56,Pass
Raj Sharma,11-08-2005,686345,Rajasthan,4,6,24,10,44,Fail
Krishna Fernandes,01-08-2005,451649,Odisha,9,16,23,6,54,Pass
David D'Souza,13-08-2005,423301,Rajasthan,3,3,9,18,33,Fail
Aryan Pillai,12-10-2005,634825,West Bengal,21,12,6,16,55,Fail
Ishaan Khan,11-07-2005,746714,Uttar Pradesh,24,11,4,1,40,Fail
Rohan Reddy,28-02-2006,837465,Uttar Pradesh,9,17,3,22,51,Fail
Farhan Khan,15-03-2006,861844,Chhattisgarh,20,24,15,12,71,Fail
Yash Sharma,08-12-2005,562765,Andhra Pradesh,13,0,4,4,21,Pass
Aditya Khan,08-12-2004,633045,Manipur,1,4,3,5,13,Fail
Krishna Pillai,18-02-2006,137757,Odisha,1,21,12,4,38,Fail
Rohan Fernandes,30-09-2005,570886,Uttar Pradesh,3,3,14,5,25,Fail
Mathew Mehta,02-12-2004,954438,Karnataka,21,0,23,18,62,Fail
Aditya Sharma,16-04-2005,724978,Uttar Pradesh,10,2,9,23,44,Fail
Rohan Khan,04-01-2006,617034,Andhra Pradesh,13,19,20,2,54,Pass
Aarav D'Souza,17-11-2005,702103,Bihar,14,10,5,5,34,Fail
Yash Singh,07-05-2005,244487,Rajasthan,6,19,14,3,42,Fail
Krishna Singh,18-03-2006,900907,Uttarakhand,22,11,10,0,43,Fail
Gurpreet Reddy,04-10-2005,816320,Andhra Pradesh,13,24,18,12,67,Pass
Kunal Verma,01-05-2006,483578,Punjab,13,3,5,15,36,Fail
Balbir Pillai,30-03-2006,123083,Punjab,10,10,3,16,39,Fail
Peter Sharma,19-02-2005,587357,Madhya Pradesh,15,12,18,10,55,Pass
Krishna D'Souza,12-02-2006,503932,Maharashtra,7,12,0,11,30,Fail
Peter Singh,28-10-2005,580649,Uttarakhand,3,12,11,2,28,Fail
Ishaan D'Souza,24-03-2006,131855,West Bengal,10,20,20,4,54,Fail
Ishaan Pillai,11-03-2005,217020,Tamil Nadu,4,23,23,11,61,Fail
Rohan Sharma,18-04-2006,946703,Rajasthan,20,17,17,12,66,Fail
Krishna Reddy,06-12-2005,758074,West Bengal,17,16,2,8,43,Fail
Vivaan Reddy,05-02-2005,503593,Maharashtra,2,3,21,23,49,Fail
Aditya D'Souza,20-05-2005,263852,Rajasthan,1,20,24,11,56,Fail
Aryan Khan,07-03-2006,269143,Rajasthan,12,23,17,16,68,Fail
Rehan Chopra,29-08-2005,869349,Uttar Pradesh,2,8,21,5,36,Fail
Aarav Verma,17-07-2005,827133,Haryana,24,16,20,4,64,Fail
Kunal Verma,27-01-2006,277157,Jharkhand,2,23,0,17,42,Fail
Balbir D'Souza,30-07-2005,838741,Uttarakhand,12,10,19,16,57,Fail
Aryan Mehta,28-10-2005,850838,Madhya Pradesh,21,4,19,19,63,Pass
Sukhwinder Reddy,14-04-2006,932370,Puducherry,9,2,14,24,49,Fail
Rohan Mehta,10-06-2005,797426,Kerala,24,19,7,2,52,Pass
Kunal Singh,20-10-2005,573218,Karnataka,5,3,13,4,25,Fail
Vivaan Sharma,27-03-2005,131804,Odisha,18,18,13,15,64,Pass
Raj D'Souza,18-05-2005,796503,Rajasthan,15,10,22,24,71,Fail
Paul Sharma,15-10-2005,760053,Tamil Nadu,5,6,12,10,33,Fail
Ishaan Singh,21-12-2005,293973,Andhra Pradesh,18,4,15,24,61,Pass
Harjeet Pillai,04-10-2005,506374,Madhya Pradesh,16,4,17,10,47,Pass
Peter Mehta,18-03-2006,172901,Assam,8,13,24,11,56,Pass
Gurpreet Reddy,05-12-2004,778247,Punjab,20,16,24,4,64,Pass
Krishna D'Souza,01-04-2006,127956,Rajasthan,11,11,12,21,55,Fail
Mathew Verma,31-01-2006,748483,Assam,10,23,12,22,67,Pass
Harjeet Singh,10-10-2005,797136,Tamil Nadu,15,22,18,24,79,Fail
David D'Souza,08-02-2006,172192,Telangana,8,1,22,21,52,Fail
Krishna Fernandes,26-03-2006,968033,Uttar Pradesh,0,3,5,4,12,Fail
Vivaan Reddy,29-12-2004,690804,Haryana,13,6,11,2,32,Fail
Yash Verma,26-02-2005,895218,Assam,6,8,19,24,57,Pass
Yash Singh,10-03-2006,161982,Uttar Pradesh,17,12,19,13,61,Fail
Yash Pillai,15-10-2005,559847,Uttar Pradesh,18,1,23,8,50,Fail
Mathew Singh,20-02-2006,585204,Arunachal Pradesh,12,5,22,11,50,Fail
Yash Chopra,04-10-2005,965789,Madhya Pradesh,13,4,20,21,58,Pass
John Fernandes,17-04-2006,682555,Tamil Nadu,10,7,3,16,36,Fail
Peter Mehta,26-03-2006,591377,Madhya Pradesh,15,12,11,6,44,Pass
Ayaan Khan,02-11-2005,308698,Chhattisgarh,21,21,0,8,50,Fail
Aditya Sharma,14-05-2005,650062,Maharashtra,8,20,3,1,32,Fail
Aditya Mehta,06-08-2005,627442,Tamil Nadu,22,10,8,16,56,Fail
Sukhwinder Khan,03-05-2006,383836,West Bengal,16,11,4,8,39,Fail
Sukhwinder Chopra,25-11-2004,162622,Jharkhand,8,3,1,0,12,Fail
Kunal Sharma,24-12-2004,870886,Tamil Nadu,19,6,17,15,57,Fail
Ishaan Khan,03-08-2005,953343,Jharkhand,9,3,16,24,52,Fail
Aarav Mehta,12-12-2005,675143,West Bengal,11,9,17,5,42,Fail
Gurpreet Singh,06-03-2005,637384,Odisha,24,11,6,9,50,Pass
Manpreet Chopra,03-12-2005,164151,Uttar Pradesh,14,16,5,21,56,Fail
Aarav Mehta,03-09-2005,120705,Uttar Pradesh,0,17,24,24,65,Fail
Harjeet Khan,05-05-2005,701600,Madhya Pradesh,24,4,20,7,55,Pass
Kunal Verma,30-06-2005,887951,Madhya Pradesh,18,17,3,4,42,Pass
Aarav Mehta,31-12-2004,257379,Madhya Pradesh,19,9,5,4,37,Pass
Balbir Khan,10-01-2006,415403,Rajasthan,10,5,14,17,46,Fail
John Sharma,20-12-2004,707537,Rajasthan,0,22,21,18,61,Fail
Yash Khan,06-04-2006,381820,Maharashtra,1,0,19,23,43,Fail
Vivaan Pillai,22-12-2004,471319,Uttarakhand,1,12,11,14,38,Fail
Sukhwinder Chopra,21-01-2006,862319,Maharashtra,16,19,12,10,57,Fail
Harjeet Fernandes,26-01-2005,675998,Bihar,13,24,18,23,78,Pass
John Fernandes,02-02-2005,719267,Madhya Pradesh,17,3,3,0,23,Pass
Raj Khan,16-05-2005,235244,Maharashtra,23,24,22,4,73,Fail
Gurpreet Verma,22-06-2005,103094,Andhra Pradesh,0,1,9,10,20,Pass
Aryan Reddy,05-02-2006,761345,Uttarakhand,16,1,19,14,50,Fail
Rehan Mehta,17-04-2005,696190,Andhra Pradesh,5,11,3,6,25,Pass
Yash Chopra,23-03-2006,166748,Jharkhand,3,1,23,13,40,Fail
Rohan Chopra,06-04-2005,262504,Punjab,1,24,4,8,37,Fail
Aryan Fernandes,09-12-2005,643851,West Bengal,23,22,20,3,68,Fail
Ishaan Sharma,14-02-2005,195669,Nagaland,18,12,19,12,61,Fail
Rohan Khan,07-02-2005,577971,Punjab,10,17,5,15,47,Pass
Ishaan Khan,31-01-2005,455081,Maharashtra,8,16,22,11,57,Fail
John Chopra,31-03-2006,634455,Rajasthan,5,18,2,3,28,Fail
Vivaan Singh,11-12-2004,948040,Uttar Pradesh,2,19,12,19,52,Fail
Aarav D'Souza,30-09-2005,411456,Punjab,9,13,16,21,59,Pass
Kunal Singh,19-05-2005,949318,Rajasthan,17,7,7,15,46,Fail
Vivaan Khan,22-08-2005,209904,Telangana,13,11,10,20,54,Fail
Krishna D'Souza,28-01-2005,405521,Uttar Pradesh,7,3,4,2,16,Fail
Yash Singh,03-06-2005,625025,Uttar Pradesh,9,4,3,12,28,Fail
Harjeet Singh,23-03-2005,142795,Uttar Pradesh,2,10,16,0,28,Fail
Vivaan Fernandes,06-05-2005,409548,Andaman & Nicobar,2,13,22,4,41,Pass
Aarav Chopra,03-06-2005,946293,Uttar Pradesh,14,15,14,11,54,Fail
Raj Sharma,19-02-2005,606611,Tamil Nadu,12,15,11,9,47,Fail
Harjeet D'Souza,19-12-2004,916499,Bihar,5,8,9,5,27,Fail
Harjeet Khan,16-03-2006,371127,Madhya Pradesh,10,24,2,4,40,Pass
Vivaan Khan,16-01-2006,210793,Bihar,12,21,7,18,58,Pass
Kunal D'Souza,19-02-2006,120123,Assam,10,6,24,16,56,Pass
Kunal Mehta,30-09-2005,588443,Delhi,22,19,7,3,51,Fail
Ishaan Khan,12-07-2005,365821,West Bengal,13,6,23,10,52,Fail
Aarav Reddy,26-12-2005,908468,Maharashtra,8,8,20,7,43,Fail
Kunal Sharma,22-01-2005,627641,Tamil Nadu,6,11,4,15,36,Fail
Aryan Pillai,10-04-2005,843266,Odisha,12,18,15,18,63,Pass
Imran Singh,16-01-2005,612909,Bihar,8,12,23,16,59,Pass
Krishna Reddy,01-11-2005,504044,Rajasthan,19,17,17,1,54,Fail
Manpreet Mehta,17-03-2006,169586,Rajasthan,13,19,9,6,47,Fail
Rehan Sharma,20-09-2005,113266,Madhya Pradesh,20,0,16,1,37,Pass
John Verma,22-03-2006,742990,West Bengal,5,19,2,21,47,Fail
Peter Fernandes,22-08-2005,564954,Maharashtra,18,23,24,15,80,Fail
Rohan Mehta,20-12-2004,949658,West Bengal,19,4,12,21,56,Fail
Krishna Sharma,21-11-2004,836608,Jammu & Kashmir + Ladakh,2,23,18,17,60,Fail
Sukhwinder Singh,06-08-2005,348685,West Bengal,8,6,1,22,37,Fail
Peter Verma,25-04-2005,989078,Maharashtra,14,4,2,8,28,Fail
Aarav Singh,21-05-2005,915523,Tamil Nadu,20,8,4,7,39,Fail
Raj Reddy,02-05-2006,781431,Odisha,5,9,18,1,33,Fail
Aarav Mehta,27-02-2005,676774,West Bengal,8,17,3,12,40,Fail
Manpreet D'Souza,02-04-2005,889180,West Bengal,21,2,9,4,36,Fail
Mathew Sharma,04-02-2006,421422,Bihar,20,20,2,2,44,Fail
Aarav Pillai,09-12-2005,826161,Bihar,7,9,18,16,50,Pass
Gurpreet Singh,08-06-2005,279261,Gujarat,21,19,1,20,61,Fail
Kunal Singh,18-12-2005,974204,Madhya Pradesh,23,4,2,21,50,Pass
Vivaan Khan,26-02-2006,706900,Madhya Pradesh,1,18,13,10,42,Pass
Ayaan Fernandes,15-05-2005,256898,Chhattisgarh,24,14,22,0,60,Fail
Raj Verma,20-02-2005,485987,Tamil Nadu,5,24,16,2,47,Fail
Sukhwinder Singh,18-08-2005,275699,Maharashtra,11,11,21,22,65,Fail
Aryan Pillai,18-05-2005,768832,Madhya Pradesh,17,5,6,18,46,Pass
Imran Pillai,19-03-2005,412489,Arunachal Pradesh,9,6,8,17,40,Fail
Raj Singh,23-11-2005,965836,Bihar,3,18,13,19,53,Pass
Aarav Verma,08-01-2005,319001,Odisha,19,19,23,4,65,Pass
Harjeet Reddy,02-02-2005,200209,Jharkhand,8,4,2,11,25,Fail
Aarav Khan,23-08-2005,555809,West Bengal,21,2,1,24,48,Fail
Rohan Mehta,27-10-2005,114963,Uttar Pradesh,8,16,16,22,62,Fail
Aditya D'Souza,21-12-2004,542657,Telangana,0,14,7,8,29,Pass
Krishna Verma,12-10-2005,670841,Maharashtra,17,19,21,24,81,Fail
David Mehta,12-06-2005,235806,Assam,20,10,12,18,60,Pass
Vivaan Pillai,24-10-2005,994235,Uttar Pradesh,18,19,12,2,51,Fail
Ayaan Pillai,13-01-2006,397384,Bihar,6,12,20,9,47,Pass
Gurpreet Mehta,25-02-2005,769504,Madhya Pradesh,20,4,8,23,55,Pass
Mathew Khan,20-09-2005,567295,Rajasthan,14,5,13,19,51,Fail
Gurpreet Reddy,23-03-2006,949138,Uttar Pradesh,2,24,20,16,62,Fail
Mathew Chopra,18-08-2005,383460,Jammu & Kashmir + Ladakh,9,7,4,19,39,Fail
Kunal Reddy,09-06-2005,915395,Andhra Pradesh,24,8,23,23,78,Pass
Yash Sharma,23-10-2005,895091,Gujarat,12,24,5,15,56,Fail
Aarav Pillai,20-12-2004,769724,Karnataka,22,22,22,19,85,Fail
Aditya Verma,17-06-2005,882461,Uttar Pradesh,7,17,1,15,40,Fail
Yash Sharma,16-12-2005,110376,Madhya Pradesh,14,23,16,2,55,Pass
Rohan D'Souza,23-08-2005,120281,West Bengal,9,1,6,9,25,Fail
Balbir Chopra,19-02-2006,742770,Rajasthan,1,15,1,12,29,Fail
Aarav Mehta,08-12-2005,269852,Punjab,4,1,21,10,36,Fail
Ishaan D'Souza,21-12-2004,466211,Meghalaya,0,17,23,22,62,Fail
Aditya Singh,05-09-2005,426810,Tamil Nadu,4,20,11,15,50,Fail
Manpreet Reddy,03-02-2006,915566,Madhya Pradesh,1,9,3,7,20,Pass
Aarav Pillai,06-09-2005,194906,Odisha,23,14,3,4,44,Fail
Vivaan Chopra,12-01-2005,731557,Karnataka,24,17,13,24,78,Fail
Krishna Sharma,25-05-2005,730651,Uttar Pradesh,7,23,18,20,68,Fail
Kunal Pillai,21-03-2006,587378,Rajasthan,14,0,11,13,38,Fail
Peter Fernandes,13-02-2006,109699,Jharkhand,9,10,16,18,53,Fail
Ishaan Reddy,22-03-2005,665360,Madhya Pradesh,23,4,15,13,55,Pass
Kunal Chopra,06-07-2005,372335,Haryana,22,22,3,4,51,Fail
Aditya D'Souza,17-11-2004,991126,Rajasthan,2,21,17,21,61,Fail
Raj Mehta,19-04-2005,426585,Bihar,5,11,0,2,18,Fail
Rohan Fernandes,26-07-2005,146596,Punjab,9,16,22,17,64,Pass
Aditya Khan,21-08-2005,931007,Rajasthan,5,0,19,11,35,Fail
Gurpreet Singh,10-12-2005,635539,West Bengal,22,24,1,3,50,Fail
Rehan Chopra,28-01-2006,518623,Uttar Pradesh,7,23,9,18,57,Fail
Yash D'Souza,21-09-2005,484370,Bihar,1,22,4,16,43,Fail
Krishna Reddy,19-04-2006,172423,Madhya Pradesh,1,11,4,3,19,Pass
Mathew Singh,02-01-2006,844683,Uttar Pradesh,15,3,1,18,37,Fail
John D'Souza,17-07-2005,387627,Uttar Pradesh,15,12,4,1,32,Fail
Balbir Chopra,08-08-2005,673433,Tamil Nadu,8,2,8,24,42,Fail
Peter Sharma,30-10-2005,935880,Maharashtra,3,13,2,15,33,Fail
Rohan Pillai,06-05-2006,501089,Jammu & Kashmir + Ladakh,2,21,22,11,56,Fail
Aditya Reddy,12-03-2005,816850,Rajasthan,13,0,23,2,38,Fail
Kunal Pillai,10-04-2006,903372,Andhra Pradesh,3,3,23,23,52,Pass
Krishna Pillai,09-04-2005,831036,Jharkhand,0,8,2,9,19,Fail
Peter Khan,23-01-2005,647141,Himachal Pradesh,13,20,21,5,59,Fail
Manpreet Pillai,29-01-2006,751118,Rajasthan,10,17,6,16,49,Fail
Mathew D'Souza,05-02-2005,315856,Uttarakhand,19,23,10,19,71,Fail
Vivaan Pillai,19-04-2005,634611,Haryana,20,23,21,23,87,Fail
Aditya Singh,29-04-2006,699307,Andhra Pradesh,19,18,11,10,58,Pass
Gurpreet Sharma,10-11-2004,579635,Tamil Nadu,14,0,17,2,33,Fail
Krishna Khan,20-05-2005,673130,Madhya Pradesh,1,7,0,8,16,Pass
Krishna Reddy,10-02-2006,565523,Maharashtra,3,16,11,18,48,Fail
Peter Reddy,27-12-2005,295821,Andhra Pradesh,16,4,16,17,53,Pass
Raj Sharma,22-06-2005,704987,Assam,3,13,12,8,36,Pass
Yash Sharma,04-07-2005,348106,West Bengal,3,0,15,14,32,Fail
Krishna Singh,10-01-2006,971026,Madhya Pradesh,13,17,14,3,47,Pass
Manpreet Fernandes,25-04-2005,187584,Rajasthan,9,24,4,3,40,Fail
Balbir Verma,13-06-2005,547629,Madhya Pradesh,9,13,5,7,34,Pass
Aditya Chopra,11-09-2005,213253,Karnataka,20,0,16,5,41,Fail
Aryan Verma,19-02-2005,239299,Meghalaya,1,1,1,23,26,Fail
Rohan Sharma,25-07-2005,776826,Karnataka,5,14,3,22,44,Fail
Krishna Sharma,04-01-2006,217330,Madhya Pradesh,11,4,17,17,49,Pass
Sukhwinder Mehta,13-10-2005,135054,Karnataka,15,1,0,22,38,Fail
Vivaan Pillai,15-02-2006,443523,Bihar,16,1,14,14,45,Fail
Harjeet Khan,18-08-2005,393878,Gujarat,1,16,7,17,41,Fail
Krishna Fernandes,04-01-2006,288808,Maharashtra,7,0,20,16,43,Fail
Ayaan Mehta,18-07-2005,692403,Odisha,14,14,16,17,61,Pass
Aryan Mehta,19-10-2005,326441,Telangana,4,19,7,0,30,Pass
Rohan Verma,24-01-2005,851303,Uttarakhand,13,5,17,18,53,Fail
Sukhwinder Khan,17-12-2005,482354,Karnataka,10,3,18,10,41,Fail
Yash Verma,08-09-2005,455583,Tamil Nadu,21,19,22,8,70,Fail
Ishaan Mehta,20-11-2005,455052,Odisha,16,19,16,24,75,Pass
Vivaan Fernandes,20-04-2005,929324,Uttarakhand,3,10,0,13,26,Fail
Raj Verma,01-01-2006,798736,Telangana,19,16,22,13,70,Fail
Krishna Sharma,27-09-2005,952690,Telangana,19,4,7,12,42,Pass
Raj Khan,24-04-2005,914955,Punjab,13,23,18,10,64,Pass
Raj Fernandes,11-12-2004,577376,Bihar,13,6,23,21,63,Pass
Rohan D'Souza,04-05-2006,962517,Haryana,20,15,13,2,50,Fail
Rohan Singh,01-11-2005,379908,Andhra Pradesh,16,5,16,10,47,Pass
Kunal Sharma,18-03-2005,381131,Uttar Pradesh,18,22,2,17,59,Fail
Rohan Singh,02-01-2005,226587,Maharashtra,0,11,19,7,37,Fail
Rohan Khan,27-11-2005,806948,Rajasthan,2,19,8,12,41,Fail
Vivaan Verma,17-11-2004,671260,Haryana,7,7,19,6,39,Fail
Sukhwinder Mehta,02-07-2005,445071,West Bengal,13,6,2,10,31,Fail
Aryan Khan,12-10-2005,774732,Tamil Nadu,22,3,24,1,50,Fail
Vivaan Pillai,27-05-2005,468991,Uttar Pradesh,20,3,15,24,62,Fail
Aarav Mehta,04-11-2005,896257,West Bengal,24,8,7,20,59,Fail
Peter D'Souza,08-05-2005,992551,Uttar Pradesh,14,15,12,6,47,Fail
Aarav Pillai,09-04-2006,728119,Karnataka,20,24,19,3,66,Fail
Krishna D'Souza,11-01-2006,807417,West Bengal,1,19,8,21,49,Fail
Raj Verma,09-04-2006,691298,Gujarat,18,24,19,16,77,Fail
Aditya Pillai,06-03-2005,221364,Meghalaya,21,23,23,14,81,Fail
Aarav Sharma,03-08-2005,524364,Haryana,11,6,11,10,38,Fail
Gurpreet Singh,20-03-2005,234493,Rajasthan,3,11,22,7,43,Fail
Aryan Pillai,27-04-2006,929839,Haryana,24,22,9,12,67,Fail
Yash Reddy,10-10-2005,268660,Maharashtra,17,1,15,14,47,Fail
Vivaan D'Souza,14-12-2004,651572,Rajasthan,18,24,10,17,69,Fail
Ishaan Pillai,24-02-2005,416652,Bihar,8,6,17,12,43,Fail
Aarav Pillai,22-06-2005,105528,Uttar Pradesh,13,5,4,18,40,Fail
Vivaan Fernandes,04-04-2005,621222,Maharashtra,0,19,18,11,48,Fail
Ishaan Fernandes,06-11-2005,689712,Punjab,23,0,5,2,30,Fail
Balbir Khan,07-03-2005,207515,Jharkhand,16,11,16,21,64,Fail
Balbir Chopra,28-02-2006,576953,West Bengal,13,23,18,16,70,Fail
Rehan Singh,04-01-2006,743103,Madhya Pradesh,3,23,15,3,44,Pass
Vivaan Reddy,15-12-2005,997070,Uttar Pradesh,18,11,2,1,32,Fail
Kunal Verma,20-03-2005,514564,Telangana,17,1,8,6,32,Pass
Yash Pillai,28-01-2006,282439,Andhra Pradesh,6,2,16,6,30,Pass
Ishaan Fernandes,08-03-2005,282653,Haryana,22,10,3,3,38,Fail
Aditya Pillai,10-11-2004,696125,Uttar Pradesh,16,14,7,7,44,Fail
Vivaan Reddy,21-11-2005,548280,Jammu & Kashmir + Ladakh,23,23,20,3,69,Fail
Yash Mehta,06-05-2005,336342,Uttar Pradesh,9,0,2,4,15,Fail
Raj Mehta,15-01-2005,142552,Andhra Pradesh,12,6,6,10,34,Pass
Ishaan Pillai,27-03-2006,749216,Punjab,10,12,0,20,42,Fail
Ayaan D'Souza,20-08-2005,919141,Madhya Pradesh,15,4,3,22,44,Pass
Aarav Pillai,26-12-2005,576195,Andhra Pradesh,19,23,8,6,56,Pass
Raj Verma,14-05-2005,688802,Bihar,3,8,0,22,33,Fail
Raj Sharma,18-02-2006,554138,Assam,24,2,0,1,27,Pass
John Reddy,15-02-2005,104354,Chhattisgarh,7,13,4,21,45,Fail
Raj Khan,12-09-2005,177403,Telangana,9,15,1,22,47,Pass
Manpreet Singh,16-08-2005,511636,Madhya Pradesh,8,10,22,9,49,Pass
Gurpreet Khan,10-03-2006,600674,Karnataka,8,14,4,15,41,Fail
Balbir Fernandes,13-01-2006,950783,Telangana,16,8,15,9,48,Pass
David Reddy,30-09-2005,311803,Rajasthan,23,18,15,13,69,Fail
Ishaan Chopra,15-03-2005,777590,Odisha,4,14,16,1,35,Fail
Yash Sharma,29-03-2005,574492,Uttar Pradesh,19,18,5,4,46,Fail
Aditya Chopra,20-11-2005,213396,Madhya Pradesh,2,1,23,18,44,Pass
Vivaan Reddy,17-08-2005,648176,Tripura,4,22,24,0,50,Fail
Krishna Reddy,10-02-2006,961643,Tamil Nadu,23,12,13,19,67,Fail
Imran Reddy,03-02-2005,205747,Andhra Pradesh,20,23,0,13,56,Pass
Yash Sharma,23-11-2005,389508,Uttar Pradesh,18,13,7,24,62,Fail
Yash Singh,08-12-2004,339146,Haryana,13,8,3,24,48,Fail
Harjeet Chopra,10-06-2005,792209,Haryana,5,12,7,11,35,Fail
Raj Reddy,22-11-2004,421159,Bihar,21,9,24,8,62,Pass
Raj Khan,14-11-2004,368486,Maharashtra,24,22,12,16,74,Fail
Aryan Chopra,04-01-2005,738049,Rajasthan,16,9,16,1,42,Fail
Sukhwinder Khan,14-01-2006,116591,Gujarat,13,13,24,10,60,Fail
Sukhwinder Khan,09-11-2004,972719,Rajasthan,18,6,4,15,43,Fail
Vivaan Fernandes,15-07-2005,143459,Tripura,10,1,4,1,16,Fail
Ishaan Sharma,05-01-2006,973871,Uttar Pradesh,5,10,4,8,27,Fail
John Sharma,18-10-2005,377254,Uttarakhand,21,23,23,24,91,Fail
Ishaan Pillai,24-03-2005,844011,Bihar,15,19,3,16,53,Pass
Aditya Pillai,09-01-2005,624496,Tamil Nadu,23,12,2,22,59,Fail
Vivaan Khan,28-02-2005,811858,Uttar Pradesh,9,16,0,18,43,Fail
Kunal Verma,26-01-2005,805450,Uttarakhand,16,13,22,7,58,Fail
Krishna Chopra,19-03-2005,925216,Haryana,19,11,5,11,46,Fail
Rehan Sharma,09-01-2006,661599,Madhya Pradesh,2,16,6,11,35,Pass
Aditya Pillai,10-04-2005,570816,Telangana,6,14,3,13,36,Fail
Aditya Sharma,11-08-2005,950977,Tamil Nadu,15,21,9,3,48,Fail
David Chopra,16-04-2006,609864,Bihar,20,4,15,5,44,Fail
Raj Mehta,25-03-2006,355264,Uttar Pradesh,20,17,19,14,70,Fail
Aryan Reddy,16-04-2006,464879,Bihar,20,0,21,0,41,Fail
Vivaan Khan,26-02-2005,861796,Maharashtra,1,23,23,17,64,Fail
Raj Verma,02-07-2005,864709,Jammu & Kashmir + Ladakh,4,6,21,11,42,Fail
Balbir Mehta,11-11-2005,528579,Bihar,14,13,14,2,43,Fail
Kunal Singh,29-01-2005,127558,Rajasthan,15,22,19,21,77,Fail
Aarav Khan,24-03-2005,151532,Gujarat,1,16,3,0,20,Fail
Vivaan Singh,14-02-2006,716266,Andhra Pradesh,7,21,1,12,41,Pass
Rohan Khan,05-05-2006,321019,Assam,22,11,0,22,55,Pass
Rohan Reddy,03-04-2005,581759,Rajasthan,20,22,19,11,72,Fail
Raj Chopra,14-02-2006,894600,Uttar Pradesh,19,7,5,1,32,Fail
Rohan Mehta,18-01-2005,604858,West Bengal,7,10,6,23,46,Fail
Gurpreet Singh,08-02-2006,616212,Uttar Pradesh,23,16,3,24,66,Fail
Kunal Mehta,06-08-2005,207335,Bihar,2,17,1,5,25,Fail
Vivaan Reddy,06-05-2006,315044,Bihar,11,13,23,17,64,Pass
Aditya Verma,03-08-2005,784802,Tamil Nadu,1,6,8,11,26,Fail
Raj Mehta,10-03-2005,453472,Gujarat,18,10,1,10,39,Fail
Aryan Fernandes,18-04-2005,102221,Punjab,17,9,2,6,34,Fail
Harjeet Khan,24-02-2005,739450,Rajasthan,3,10,5,23,41,Fail
Kunal Verma,16-02-2005,643417,Bihar,7,22,1,18,48,Pass
Krishna Chopra,26-11-2005,680553,Uttar Pradesh,17,11,10,18,56,Fail
Aditya Pillai,17-03-2006,683223,West Bengal,10,10,1,1,22,Fail
Rohan Reddy,09-05-2006,278234,Assam,11,8,14,24,57,Pass
Harjeet D'Souza,03-04-2005,536560,Bihar,16,2,3,11,32,Fail
Harjeet Mehta,26-06-2005,892757,Madhya Pradesh,1,10,21,23,55,Pass
Ishaan Chopra,23-01-2006,183964,Maharashtra,2,4,5,19,30,Fail
Aarav Fernandes,06-09-2005,915977,West Bengal,3,17,8,3,31,Fail
Paul Khan,04-07-2005,164307,Haryana,9,5,6,16,36,Fail
Aditya Fernandes,09-03-2005,385747,Assam,16,0,6,3,25,Pass
Balbir Verma,23-12-2005,683460,Telangana,4,6,8,8,26,Fail
Aryan Reddy,17-03-2006,923390,Bihar,12,5,14,18,49,Pass
Ishaan Mehta,10-10-2005,173555,Jharkhand,2,13,13,7,35,Fail
Paul Mehta,14-08-2005,263853,Maharashtra,5,12,18,24,59,Fail
Aditya Sharma,21-01-2006,132856,Madhya Pradesh,7,6,14,1,28,Pass
Raj Pillai,01-11-2005,935739,Tamil Nadu,24,18,12,17,71,Fail
Harjeet Pillai,30-08-2005,245092,Maharashtra,20,11,8,0,39,Fail
Yash Sharma,11-08-2005,735737,Haryana,8,13,18,2,41,Fail
Balbir D'Souza,09-12-2005,512227,Rajasthan,3,4,14,15,36,Fail
Krishna Reddy,31-01-2006,101025,Punjab,20,12,14,4,50,Pass
Raj Khan,17-09-2005,140785,Uttarakhand,10,4,21,23,58,Fail
Raj Pillai,06-05-2006,195366,Andhra Pradesh,2,18,9,2,31,Pass
Krishna Khan,01-11-2005,308197,Haryana,19,16,7,14,56,Fail
Manpreet Chopra,28-12-2004,849715,Assam,14,12,18,24,68,Pass
Ishaan Chopra,23-10-2005,762254,Uttar Pradesh,19,14,5,10,48,Fail
Peter Mehta,15-01-2005,510185,Karnataka,9,0,23,7,39,Fail
Aditya Sharma,14-05-2005,447176,Uttar Pradesh,8,17,2,11,38,Fail
Yash Sharma,01-11-2005,260854,Tamil Nadu,11,19,20,6,56,Fail
Aarav Mehta,26-02-2006,366965,Rajasthan,10,4,17,9,40,Pass
Yash Sharma,20-04-2006,413384,Uttarakhand,4,4,20,15,43,Fail
Kunal Reddy,15-12-2005,549199,Jharkhand,1,20,23,19,63,Pass
Aarav Mehta,23-06-2005,611598,Delhi,4,23,12,24,63,Fail
Aryan Pillai,24-04-2006,203239,Madhya Pradesh,16,4,22,4,46,Pass
Yash Fernandes,30-04-2006,943625,Haryana,7,0,10,2,19,Fail
Aarav Khan,27-01-2006,547226,Tripura,15,13,6,3,37,Fail
Ishaan Pillai,05-01-2005,380980,Gujarat,13,3,4,15,35,Fail
Krishna Reddy,13-05-2005,205059,Tamil Nadu,3,12,18,14,47,Pass
Manpreet Sharma,22-12-2004,869737,Jharkhand,17,12,16,2,47,Pass
Raj Sharma,22-02-2006,986674,Bihar,22,14,22,15,73,Pass
Yash Khan,10-01-2006,650166,Madhya Pradesh,19,13,3,17,52,Pass
Aarav Chopra,24-05-2005,411404,Rajasthan,2,14,10,16,42,Pass
Harjeet Pillai,26-04-2005,766713,Punjab,24,18,5,15,62,Pass
Ishaan Verma,05-09-2005,981906,Bihar,18,3,13,1,35,Pass
Vivaan Fernandes,18-01-2006,625054,Maharashtra,11,16,24,0,51,Fail
John Singh,30-06-2005,299828,Madhya Pradesh,1,4,14,24,43,Pass
Yash Singh,28-09-2005,574384,Madhya Pradesh,14,4,14,24,56,Pass
Sukhwinder Verma,28-07-2005,195052,West Bengal,20,8,12,14,54,Fail
Yash Chopra,02-10-2005,893353,Bihar,22,16,1,24,63,Pass
Aditya D'Souza,12-02-2006,325776,Maharashtra,14,21,16,4,55,Fail
Aditya Khan,26-02-2006,834409,Assam,0,7,2,6,15,Pass
Rohan Singh,15-04-2006,649107,Rajasthan,18,15,21,17,71,Fail
Yash D'Souza,22-09-2005,405455,Maharashtra,13,16,24,5,58,Fail
Aarav Reddy,26-01-2005,421001,Delhi,10,5,3,24,42,Fail
Aditya Reddy,06-03-2005,356359,Bihar,9,8,1,17,35,Pass
Farhan D'Souza,22-02-2005,901116,Chhattisgarh,21,1,17,20,59,Fail
John Chopra,05-02-2005,422045,Bihar,22,8,22,4,56,Pass
Ayaan D'Souza,16-11-2004,173157,Uttar Pradesh,20,2,18,21,61,Fail
Kunal Reddy,25-03-2005,646344,Punjab,14,0,24,10,48,Pass
Aarav Chopra,04-02-2006,831528,Uttar Pradesh,21,10,16,18,65,Fail
Vivaan Singh,24-11-2005,829223,Punjab,15,11,14,7,47,Pass
Ishaan Sharma,26-09-2005,161641,Madhya Pradesh,24,6,4,1,35,Pass
Krishna Chopra,17-10-2005,520127,Uttar Pradesh,5,9,19,22,55,Fail
Krishna Khan,18-02-2006,409561,Kerala,6,11,15,21,53,Pass
Mathew Mehta,30-03-2006,986010,Meghalaya,22,22,11,17,72,Fail
Kunal Chopra,20-06-2005,260715,Rajasthan,19,12,1,1,33,Pass
Aditya Verma,18-12-2005,645379,Madhya Pradesh,22,6,10,2,40,Pass
Yash Pillai,04-10-2005,502166,Rajasthan,0,7,14,17,38,Pass
John Chopra,20-09-2005,889615,West Bengal,6,12,17,7,42,Fail
Gurpreet Chopra,02-03-2005,377879,Rajasthan,3,5,21,6,35,Pass
Vivaan D'Souza,08-03-2006,586610,Uttar Pradesh,20,23,13,7,63,Fail
Krishna Sharma,02-01-2005,912845,Bihar,17,17,7,4,45,Pass
Zaid D'Souza,29-01-2006,531296,Rajasthan,16,14,20,5,55,Pass
Raj Sharma,26-09-2005,867686,Bihar,20,4,7,5,36,Pass
Krishna Pillai,20-03-2006,924204,Bihar,2,9,19,18,48,Pass
Mathew D'Souza,31-08-2005,201312,Andhra Pradesh,2,23,23,0,48,Pass
Manpreet Reddy,29-07-2005,229856,Odisha,18,14,0,14,46,Pass
Aryan Sharma,07-07-2005,581650,Haryana,18,24,14,18,74,Fail
Yash Chopra,03-12-2005,552745,Bihar,19,1,14,5,39,Pass
Krishna Verma,28-09-2005,805793,Uttar Pradesh,9,10,5,16,40,Fail
Aarav Verma,23-12-2005,218047,Punjab,13,1,2,11,27,Pass
Ishaan Fernandes,20-01-2005,228192,Maharashtra,5,17,23,17,62,Fail
Rehan Chopra,23-04-2006,908854,Himachal Pradesh,12,5,8,7,32,Pass
Harjeet Sharma,23-07-2005,953765,Rajasthan,4,1,11,4,20,Pass
Vivaan Sharma,28-12-2005,360242,Uttar Pradesh,20,23,22,23,88,Fail
David Chopra,13-02-2006,688535,Bihar,7,8,2,3,20,Pass
Manpreet Sharma,08-12-2005,469293,Jharkhand,13,10,1,2,26,Pass
Aditya Verma,15-11-2004,258605,Telangana,17,5,20,4,46,Fail
Vivaan Reddy,23-02-2006,366623,Rajasthan,16,2,14,7,39,Pass
John Pillai,01-03-2006,424179,Tamil Nadu,16,17,0,2,35,Pass
Aarav Khan,07-07-2005,347011,Punjab,4,8,0,11,23,Pass
Raj Reddy,05-01-2006,454613,Haryana,18,14,22,4,58,Fail
Rohan Sharma,04-04-2006,546651,Madhya Pradesh,21,3,15,15,54,Pass
Aryan Singh,30-06-2005,753444,Andhra Pradesh,13,20,15,11,59,Pass
Rohan Sharma,31-05-2005,473344,Uttar Pradesh,19,22,10,10,61,Fail
Ishaan Sharma,22-04-2006,121746,Tamil Nadu,1,4,11,20,36,Pass
Yash Reddy,19-01-2006,984345,Jharkhand,16,22,17,5,60,Pass
Ishaan Sharma,19-04-2006,464392,Bihar,10,3,7,12,32,Pass
Aarav Verma,30-11-2005,539452,Bihar,6,20,24,6,56,Pass
Mathew Khan,12-12-2004,835957,Uttarakhand,2,2,11,22,37,Fail
Rohan Mehta,14-11-2004,559740,Rajasthan,17,10,3,8,38,Pass
Peter Khan,02-06-2005,356143,Andhra Pradesh,6,15,1,21,43,Pass
Yash Khan,13-02-2005,155706,Jammu & Kashmir + Ladakh,16,16,23,22,77,Fail
Rohan Chopra,08-03-2006,500346,Daman & Diu / D&N Haveli,23,12,19,20,74,Fail
Ishaan Reddy,08-11-2004,623869,Tamil Nadu,2,17,24,16,59,Pass
Rohan Verma,11-12-2005,308937,Assam,4,20,1,4,29,Pass
Yash Verma,20-05-2005,951392,Rajasthan,19,13,7,7,46,Pass
John Verma,14-05-2005,816191,Telangana,8,24,1,19,52,Fail
Aditya Verma,11-08-2005,450771,Rajasthan,6,19,4,13,42,Pass
Krishna Sharma,21-12-2004,820337,Uttarakhand,7,0,2,21,30,Fail
Harjeet D'Souza,16-12-2005,594929,West Bengal,13,0,4,6,23,Fail
Raj Mehta,21-03-2005,874641,Bihar,20,20,19,1,60,Pass
Yash Mehta,13-03-2006,721314,Karnataka,3,23,6,24,56,Pass
Ishaan Chopra,06-05-2005,625757,Tamil Nadu,20,9,15,5,49,Fail
Ishaan Fernandes,16-01-2006,456137,Gujarat,8,18,22,3,51,Fail
Vivaan Fernandes,07-06-2005,246956,Madhya Pradesh,17,1,22,5,45,Pass
Farhan Pillai,30-06-2005,908463,Bihar,24,14,15,4,57,Pass
Gurpreet Sharma,07-03-2005,186329,Jharkhand,11,17,14,20,62,Pass
Aditya Singh,18-08-2005,667310,Madhya Pradesh,14,10,1,13,38,Pass
Raj Mehta,07-10-2005,684338,Uttar Pradesh,21,23,2,23,69,Fail
Harjeet Verma,12-03-2005,885121,Maharashtra,17,4,1,1,23,Fail
Yash Pillai,14-11-2005,772204,Punjab,2,20,21,0,43,Pass
Aarav D'Souza,13-07-2005,988096,Bihar,15,11,12,24,62,Pass
Rehan D'Souza,19-09-2005,273837,Maharashtra,14,10,1,1,26,Fail
Kunal Singh,02-10-2005,993311,Odisha,10,13,7,19,49,Pass
Rohan Fernandes,22-05-2005,645350,Jharkhand,24,15,21,5,65,Pass
Farhan Mehta,03-05-2006,845828,Tamil Nadu,1,4,21,11,37,Pass
Aditya Reddy,08-05-2005,897313,Delhi,6,22,24,7,59,Fail
Peter Khan,14-11-2005,705911,Odisha,24,9,7,22,62,Pass
Yash Sharma,20-10-2005,388596,Maharashtra,18,1,2,3,24,Fail
Aditya Pillai,21-01-2006,322706,Rajasthan,19,7,2,6,34,Pass
Farhan Khan,18-01-2006,534311,Odisha,18,3,13,1,35,Pass
Paul Sharma,18-02-2005,322335,Tamil Nadu,7,21,0,20,48,Fail
Aryan Fernandes,26-06-2005,422752,Rajasthan,13,20,17,3,53,Pass
Aryan Verma,25-02-2005,835061,Bihar,18,8,7,5,38,Pass
Farhan Khan,21-05-2005,592413,Haryana,4,7,9,4,24,Fail
Krishna Mehta,27-12-2004,258857,Bihar,10,20,6,7,43,Pass
Aarav Chopra,19-01-2005,278156,Gujarat,8,19,14,12,53,Fail
Gurpreet Sharma,09-11-2005,896989,Jammu & Kashmir + Ladakh,16,12,17,14,59,Pass
Aarav Fernandes,07-03-2006,458532,Madhya Pradesh,18,4,24,7,53,Pass
Rohan D'Souza,08-05-2005,210056,Bihar,12,17,19,22,70,Pass
Ishaan Fernandes,24-01-2005,827643,Maharashtra,1,4,13,11,29,Fail
Kunal Pillai,30-11-2005,157262,Delhi,23,7,8,21,59,Fail
Balbir Singh,04-04-2005,125412,Andhra Pradesh,13,3,0,9,25,Pass
Paul D'Souza,28-02-2006,105297,Andhra Pradesh,15,12,22,1,50,Pass
Raj Pillai,13-11-2004,201213,West Bengal,4,3,10,7,24,Fail
Kunal Mehta,19-09-2005,797434,Punjab,20,24,24,11,79,Pass
Kunal Pillai,24-02-2005,202820,Rajasthan,17,11,23,22,73,Fail
Raj Mehta,09-03-2005,342007,Kerala,2,7,3,12,24,Pass
Manpreet Pillai,03-08-2005,839660,Rajasthan,21,13,6,24,64,Fail
Krishna Fernandes,28-03-2006,857490,Uttar Pradesh,21,11,3,3,38,Fail
John Verma,08-01-2006,342777,Bihar,19,6,1,1,27,Pass
Harjeet Pillai,07-07-2005,538155,Bihar,23,12,22,11,68,Pass
Raj Pillai,04-06-2005,338524,Himachal Pradesh,17,7,5,2,31,Pass
Rohan Fernandes,25-03-2006,775495,Gujarat,7,8,19,5,39,Fail
Raj Khan,12-11-2004,690995,West Bengal,13,17,19,7,56,Fail
Yash Pillai,22-11-2004,319542,Madhya Pradesh,1,12,2,14,29,Pass
Aryan Khan,08-06-2005,703471,Delhi,17,22,0,2,41,Fail
Krishna Fernandes,09-11-2005,489165,Gujarat,14,22,19,3,58,Fail
Aarav Sharma,06-03-2006,370851,Bihar,5,20,1,18,44,Pass
Zaid Fernandes,09-03-2005,658623,Jharkhand,3,12,9,8,32,Pass
Yash Mehta,13-06-2005,537508,Uttar Pradesh,3,9,13,17,42,Fail
Aryan Pillai,17-01-2006,763010,Madhya Pradesh,20,4,1,19,44,Pass
Imran Singh,22-04-2005,313562,Bihar,15,22,5,11,53,Pass
Raj Mehta,01-07-2005,513991,Maharashtra,21,2,14,18,55,Fail
Gurpreet Khan,07-05-2005,598428,Tamil Nadu,19,2,22,19,62,Pass
Gurpreet Khan,25-12-2005,509047,Tamil Nadu,7,7,5,2,21,Pass
Aryan D'Souza,18-01-2005,723413,West Bengal,20,24,24,17,85,Fail
Vivaan Reddy,22-01-2005,669595,Uttarakhand,20,24,1,12,57,Fail
Raj Singh,31-01-2005,861568,Bihar,21,22,8,11,62,Pass
Yash Sharma,26-11-2004,667301,West Bengal,17,3,7,15,42,Fail
Ishaan Verma,14-09-2005,758461,Arunachal Pradesh,10,7,24,22,63,Fail
Vivaan Mehta,25-02-2005,463085,Bihar,12,17,2,19,50,Pass
Aarav D'Souza,28-04-2006,735161,Jharkhand,21,4,20,10,55,Pass
Yash Reddy,03-06-2005,953635,Uttar Pradesh,24,12,10,2,48,Fail
Krishna Pillai,23-04-2006,314735,Maharashtra,9,7,17,3,36,Fail
Krishna Khan,27-11-2005,729133,Uttar Pradesh,13,17,12,0,42,Fail
Aditya Khan,14-05-2005,580779,Jharkhand,17,4,10,23,54,Pass
Yash Mehta,03-10-2005,919484,Bihar,15,0,6,14,35,Pass
Krishna Fernandes,05-08-2005,529068,Maharashtra,10,24,20,8,62,Fail
Vivaan D'Souza,18-09-2005,340974,West Bengal,0,10,8,22,40,Fail
Aarav Khan,17-10-2005,832585,Assam,4,5,21,21,51,Pass
Vivaan Verma,24-03-2006,822274,West Bengal,20,9,8,0,37,Fail
Raj Verma,03-08-2005,578370,Telangana,4,17,1,15,37,Fail
Aditya Reddy,24-09-2005,230831,Andhra Pradesh,17,21,8,14,60,Pass
Raj Singh,07-05-2006,551394,Odisha,16,19,18,23,76,Pass
Aditya Singh,03-06-2005,687889,Chhattisgarh,0,11,17,18,46,Fail
Harjeet Mehta,04-12-2005,209483,Telangana,19,16,6,23,64,Fail
Manpreet Sharma,03-11-2005,839408,Madhya Pradesh,12,8,17,8,45,Pass
John Sharma,04-02-2006,535615,Maharashtra,8,3,15,16,42,Fail
Raj D'Souza,25-12-2005,312792,Rajasthan,13,10,12,19,54,Pass
Kunal Khan,28-11-2005,939766,Bihar,6,16,16,6,44,Pass
Aditya Pillai,22-12-2004,653288,Madhya Pradesh,22,0,9,2,33,Pass
Yash Mehta,05-07-2005,890742,Rajasthan,23,10,10,15,58,Pass
Ishaan Mehta,02-04-2006,887944,Daman & Diu / D&N Haveli,22,10,3,18,53,Fail
Imran Singh,19-08-2005,401662,Uttarakhand,20,1,6,24,51,Fail
Yash Khan,31-03-2006,811135,West Bengal,5,19,24,17,65,Fail
Aryan Chopra,27-02-2005,238888,Tamil Nadu,3,11,11,1,26,Pass
Paul Chopra,14-03-2005,274872,Uttar Pradesh,0,15,2,17,34,Fail
Aryan Sharma,29-01-2005,947668,Chhattisgarh,10,20,4,1,35,Fail
Raj Fernandes,23-03-2005,583619,Andhra Pradesh,16,19,9,13,57,Pass
Rohan Singh,30-09-2005,396745,Delhi,3,5,14,20,42,Fail
Manpreet Reddy,04-12-2005,695583,West Bengal,24,16,10,8,58,Fail
Ishaan D'Souza,16-10-2005,827022,Chhattisgarh,0,10,9,8,27,Fail
Rohan Verma,18-07-2005,131926,Maharashtra,22,20,8,14,64,Fail
Kunal Reddy,23-11-2005,476293,Tamil Nadu,9,4,21,6,40,Pass
Manpreet Sharma,01-01-2005,539184,Uttar Pradesh,14,24,4,12,54,Fail
Aditya Mehta,24-12-2005,752471,Uttarakhand,21,6,9,13,49,Fail
Krishna Singh,19-05-2005,554530,Himachal Pradesh,18,1,7,11,37,Pass
David Reddy,06-02-2005,649097,Bihar,20,8,7,9,44,Pass
Rehan Mehta,15-09-2005,137864,Uttar Pradesh,23,16,10,0,49,Fail
Sukhwinder Singh,20-03-2005,301733,Uttarakhand,20,6,3,24,53,Fail
Harjeet Verma,09-05-2006,482919,Uttarakhand,21,4,19,17,61,Fail
Vivaan Fernandes,27-04-2005,755439,Jammu & Kashmir + Ladakh,15,15,15,22,67,Pass
Aryan D'Souza,13-03-2006,335643,Madhya Pradesh,13,4,21,24,62,Pass
Aarav Khan,16-05-2005,147773,Bihar,13,15,12,5,45,Pass
Aarav Khan,25-08-2005,783721,Rajasthan,13,21,20,19,73,Fail
Harjeet Sharma,19-02-2006,525572,Rajasthan,12,20,6,24,62,Fail
Aryan Mehta,12-04-2006,152672,Madhya Pradesh,12,18,5,8,43,Pass
Manpreet Chopra,11-05-2005,244894,Himachal Pradesh,10,18,10,24,62,Pass
Gurpreet Verma,16-11-2004,809005,Maharashtra,5,16,23,21,65,Fail
Vivaan D'Souza,02-11-2005,600644,Uttar Pradesh,9,8,21,8,46,Fail
Kunal Mehta,01-12-2005,624160,Karnataka,5,23,22,23,73,Fail
Manpreet Reddy,18-12-2004,891247,Madhya Pradesh,5,4,21,10,40,Pass
David Fernandes,09-05-2005,732771,Kerala,23,0,17,12,52,Pass
Ishaan Pillai,26-03-2006,187944,Andhra Pradesh,4,4,17,8,33,Pass
Paul Chopra,11-05-2005,658353,Karnataka,11,1,21,20,53,Pass
Vivaan Chopra,26-11-2005,662625,Himachal Pradesh,14,3,9,23,49,Pass
Aarav Mehta,11-12-2005,450697,Rajasthan,12,1,8,9,30,Pass
Yash Khan,28-11-2004,109645,Tamil Nadu,5,0,22,23,50,Fail
Raj Fernandes,12-03-2006,472857,Uttar Pradesh,18,1,2,11,32,Fail
Aditya Fernandes,09-01-2005,129098,Chhattisgarh,17,1,10,7,35,Fail
Sukhwinder Fernandes,21-12-2004,823651,Jharkhand,3,9,16,24,52,Pass
Rohan Verma,19-06-2005,957788,Rajasthan,6,0,24,12,42,Pass
Aditya Pillai,15-06-2005,407591,Haryana,12,12,17,14,55,Fail
Aditya Verma,23-02-2005,356897,Haryana,11,13,16,20,60,Fail
Vivaan Singh,04-12-2005,112343,Bihar,19,7,5,22,53,Pass
Ishaan Mehta,22-01-2006,694433,Jammu & Kashmir + Ladakh,20,22,23,4,69,Fail
Ishaan Verma,15-11-2005,999712,Maharashtra,3,12,21,14,50,Fail
Kunal Pillai,22-05-2005,792262,Rajasthan,11,9,14,22,56,Pass
Aryan Sharma,25-09-2005,845481,Jammu & Kashmir + Ladakh,4,6,20,15,45,Pass
Yash Pillai,13-09-2005,644381,Assam,1,4,24,22,51,Pass
Aryan Mehta,23-03-2006,718569,Jharkhand,16,2,5,2,25,Pass
Gurpreet Sharma,25-02-2005,176769,Uttarakhand,18,16,4,13,51,Fail
Vivaan Chopra,15-03-2005,598078,Gujarat,19,3,13,16,51,Fail
Kunal Chopra,09-12-2004,283873,Madhya Pradesh,19,4,19,10,52,Pass
Aryan Reddy,23-11-2005,151034,Madhya Pradesh,7,16,11,9,43,Pass
Krishna Singh,31-01-2006,407344,Rajasthan,13,9,8,13,43,Pass
Rehan Khan,27-04-2006,374471,Madhya Pradesh,18,4,16,11,49,Pass
Kunal Verma,27-02-2006,107771,Haryana,9,17,12,12,50,Fail
Krishna Chopra,19-02-2005,606797,Nagaland,17,24,18,8,67,Fail
Aryan Chopra,23-04-2005,736585,Haryana,23,10,24,14,71,Fail
Ayaan Verma,27-01-2005,339472,Bihar,4,2,24,23,53,Pass
Raj Chopra,24-08-2005,986427,Rajasthan,4,20,6,4,34,Pass
Aarav D'Souza,14-03-2005,402947,Punjab,17,1,4,11,33,Pass
Ishaan Reddy,28-11-2005,465210,Andhra Pradesh,7,11,14,21,53,Pass
Farhan Singh,24-01-2006,159923,Himachal Pradesh,1,16,2,14,33,Pass
Mathew Verma,14-10-2005,657758,Bihar,22,23,6,0,51,Pass
Manpreet Pillai,23-02-2005,501586,Nagaland,6,16,11,19,52,Fail
Manpreet Fernandes,10-06-2005,983844,Jammu & Kashmir + Ladakh,13,20,23,14,70,Fail
Aditya Pillai,05-05-2006,737081,Delhi,11,16,12,17,56,Fail
Peter Pillai,11-02-2005,854436,Punjab,9,7,2,3,21,Pass
Sukhwinder Reddy,29-07-2005,645284,Madhya Pradesh,21,13,6,9,49,Fail
Manpreet Mehta,30-08-2005,219468,Maharashtra,13,15,18,21,67,Fail
Sukhwinder Khan,13-06-2005,404550,Rajasthan,3,23,16,6,48,Pass
Aryan D'Souza,23-05-2005,151181,Haryana,1,2,10,23,36,Fail
Raj Sharma,02-12-2005,518799,Odisha,5,4,7,7,23,Pass
Aryan Singh,22-04-2006,492563,Maharashtra,23,12,14,2,51,Fail
Kunal Chopra,18-02-2005,806708,Tamil Nadu,3,13,21,2,39,Pass
Yash Singh,23-12-2005,778621,West Bengal,16,6,14,4,40,Fail
Aditya D'Souza,31-07-2005,501536,Bihar,8,0,5,17,30,Pass
Vivaan Mehta,14-10-2005,599067,Tamil Nadu,2,1,2,13,18,Pass
Krishna Fernandes,16-11-2004,625405,Kerala,9,13,7,8,37,Pass
Yash D'Souza,09-12-2004,558852,Rajasthan,14,23,0,11,48,Pass
Vivaan Verma,15-02-2005,748758,Uttar Pradesh,14,7,14,9,44,Fail
Sukhwinder Pillai,17-08-2005,946610,Haryana,11,3,7,24,45,Fail
Kunal Khan,17-09-2005,676572,Bihar,18,11,9,24,62,Pass
Krishna D'Souza,13-08-2005,936210,Uttar Pradesh,3,11,14,24,52,Fail
Sukhwinder Mehta,20-10-2005,539964,Madhya Pradesh,17,2,4,11,34,Fail
Raj Fernandes,18-03-2006,897905,Himachal Pradesh,3,0,17,18,38,Pass
Aryan D'Souza,27-05-2005,196496,Maharashtra,17,6,0,23,46,Fail
Aryan Mehta,01-09-2005,731874,Uttar Pradesh,6,12,20,2,40,Fail
Aryan Chopra,22-02-2005,244080,Punjab,23,20,16,16,75,Pass
Aditya D'Souza,06-01-2006,306654,Bihar,13,19,22,9,63,Pass
Manpreet D'Souza,24-11-2004,109319,Chhattisgarh,10,9,7,6,32,Fail
Aarav Fernandes,08-04-2005,288957,Bihar,20,19,18,3,60,Pass
Aryan Verma,14-12-2004,645960,Gujarat,19,18,9,9,55,Fail
David Chopra,13-05-2005,831056,West Bengal,10,21,9,6,46,Fail
Ishaan Fernandes,08-03-2006,371091,Punjab,21,23,5,4,53,Pass
Krishna Mehta,23-05-2005,617709,Tamil Nadu,6,23,8,3,40,Pass
Aarav Sharma,26-11-2004,622495,Telangana,23,20,0,15,58,Fail
Harjeet Reddy,27-08-2005,525780,Andhra Pradesh,18,15,7,4,44,Pass
Balbir Reddy,10-01-2006,682375,Rajasthan,4,4,4,22,34,Pass
Ishaan Singh,18-08-2005,933966,Odisha,4,16,14,22,56,Pass
Paul Chopra,26-11-2005,700519,Rajasthan,6,13,14,7,40,Pass
Ishaan Reddy,24-06-2005,508750,Tamil Nadu,3,7,8,20,38,Pass
Ishaan Mehta,08-05-2005,932229,Rajasthan,3,17,14,22,56,Pass
Aarav D'Souza,01-12-2005,306393,Odisha,0,18,0,20,38,Pass
Aryan Sharma,03-01-2006,250651,Jammu & Kashmir + Ladakh,24,6,6,11,47,Pass
Krishna D'Souza,23-06-2005,767083,West Bengal,14,10,15,23,62,Fail
Aarav Singh,11-02-2005,360228,Maharashtra,9,18,4,16,47,Fail
Rohan Verma,19-09-2005,991994,Rajasthan,11,17,15,9,52,Pass
Aditya Mehta,02-01-2005,864163,Andhra Pradesh,9,20,24,2,55,Pass
Raj D'Souza,13-04-2005,632904,Bihar,14,10,21,15,60,Pass
Harjeet Mehta,21-10-2005,906265,Meghalaya,18,16,5,17,56,Fail
Yash Khan,23-02-2006,902869,Telangana,23,4,10,21,58,Fail
Krishna Reddy,25-10-2005,584967,Bihar,14,2,4,3,23,Pass
Aryan Verma,25-02-2005,172813,Uttar Pradesh,12,19,19,4,54,Fail
Aryan Fernandes,21-06-2005,611277,Tripura,24,9,5,17,55,Fail
Aryan Singh,06-06-2005,544502,Andhra Pradesh,23,11,6,5,45,Pass
Ishaan Singh,12-08-2005,540795,Bihar,11,11,8,13,43,Pass
Manpreet Reddy,14-04-2006,100676,Telangana,15,12,13,17,57,Fail
Harjeet Singh,09-03-2006,719636,Rajasthan,12,6,23,21,62,Fail
Rohan Chopra,06-08-2005,346339,Haryana,18,18,15,24,75,Fail
Harjeet Verma,03-02-2006,302685,Rajasthan,21,10,24,9,64,Fail
Yash Pillai,19-04-2006,287190,Bihar,21,12,16,22,71,Pass
Sukhwinder Chopra,08-06-2005,234117,Chhattisgarh,9,1,1,20,31,Fail
Yash Singh,03-06-2005,579594,Gujarat,22,23,9,7,61,Fail
Vivaan Mehta,06-01-2005,406161,Karnataka,6,21,11,18,56,Pass
Kunal Fernandes,04-05-2005,371384,Manipur,7,11,7,18,43,Fail
Yash Mehta,03-10-2005,893663,Mizoram,12,14,17,18,61,Fail
Kunal Chopra,11-04-2006,577130,Bihar,19,13,5,23,60,Pass
Rohan Chopra,23-01-2006,598461,Rajasthan,1,12,3,12,28,Pass
Kunal Mehta,18-03-2005,895328,Punjab,15,3,15,1,34,Pass
Aryan D'Souza,08-12-2005,201269,Uttar Pradesh,12,9,4,0,25,Fail
Ishaan Verma,05-11-2005,769410,Telangana,22,18,19,13,72,Fail
Ishaan Khan,18-03-2006,694982,Delhi,24,23,18,5,70,Fail
Manpreet Khan,01-02-2005,381095,Jharkhand,6,2,7,18,33,Pass
Vivaan Sharma,27-11-2005,215696,West Bengal,21,11,3,16,51,Fail
Peter Pillai,27-07-2005,888419,Tamil Nadu,2,19,21,21,63,Fail
Mathew Reddy,17-12-2004,330868,Rajasthan,11,17,20,14,62,Fail
Aryan Chopra,23-12-2005,420929,Uttar Pradesh,15,22,21,6,64,Fail
Kunal Mehta,11-02-2005,564627,Jharkhand,23,4,18,15,60,Pass
Aryan Chopra,27-02-2005,240139,Rajasthan,18,18,6,8,50,Pass
Kunal Chopra,06-08-2005,741524,Haryana,0,20,13,19,52,Fail
Sukhwinder Khan,15-12-2004,658541,Rajasthan,1,13,23,6,43,Pass
Gurpreet Sharma,23-11-2004,912393,Uttarakhand,21,18,5,24,68,Fail
Ishaan Sharma,06-01-2006,669439,Rajasthan,15,7,15,9,46,Pass
Balbir Khan,31-07-2005,167688,Tripura,4,1,17,10,32,Fail
Gurpreet Chopra,23-09-2005,333756,Uttar Pradesh,8,23,7,2,40,Fail
Manpreet Mehta,06-12-2004,880152,Bihar,21,24,23,11,79,Pass
Krishna Singh,07-12-2004,416689,West Bengal,2,15,16,13,46,Fail
Rehan Singh,22-02-2005,740779,Bihar,0,24,10,2,36,Pass
Aditya Chopra,14-07-2005,693866,Bihar,14,6,9,18,47,Pass
Aditya Verma,31-12-2004,776554,Rajasthan,7,14,3,10,34,Pass
Aditya Chopra,02-01-2006,722296,Gujarat,11,22,0,0,33,Fail
Aditya Sharma,25-01-2006,905368,Chhattisgarh,11,19,14,7,51,Fail
Sukhwinder Mehta,06-02-2006,423192,Rajasthan,6,19,14,17,56,Pass
Krishna Fernandes,13-05-2005,811830,Karnataka,10,12,10,1,33,Pass
Manpreet Reddy,09-12-2005,632363,Madhya Pradesh,6,12,7,7,32,Fail
Krishna Pillai,13-04-2006,988134,West Bengal,14,12,0,2,28,Fail
Paul Fernandes,05-07-2005,926865,Rajasthan,16,5,2,23,46,Pass
Kunal Singh,29-12-2005,146858,Bihar,12,22,23,24,81,Pass
Aditya Fernandes,08-04-2006,404368,Telangana,6,15,12,16,49,Fail
Yash Verma,13-05-2005,497784,West Bengal,15,20,14,6,55,Fail
Aryan Chopra,31-01-2005,755277,Madhya Pradesh,3,4,2,18,27,Fail
Paul Khan,25-12-2004,779525,Rajasthan,21,20,14,6,61,Fail
Kunal Reddy,23-12-2005,363210,Karnataka,23,10,6,15,54,Pass
Gurpreet Sharma,03-05-2005,311761,Telangana,16,24,9,17,66,Fail
Aarav Fernandes,26-11-2004,960174,Haryana,18,8,3,10,39,Fail
Yash Fernandes,01-09-2005,245857,Andhra Pradesh,4,8,13,0,25,Pass
Sukhwinder D'Souza,17-08-2005,837186,Odisha,14,12,23,7,56,Pass
Aditya Verma,27-02-2006,981997,Bihar,20,7,10,10,47,Pass
Rohan Pillai,08-07-2005,579098,Uttar Pradesh,16,19,10,21,66,Fail
Gurpreet Verma,17-11-2005,708582,West Bengal,0,18,1,3,22,Fail
David Reddy,22-01-2005,725124,Chhattisgarh,22,17,13,2,54,Fail
Ishaan D'Souza,11-12-2005,292456,Odisha,15,24,23,4,66,Pass
Aditya Reddy,26-01-2005,405258,Rajasthan,1,19,13,24,57,Pass
Yash Singh,02-11-2005,482996,Delhi,17,13,5,12,47,Fail
Gurpreet Sharma,26-07-2005,157701,Tripura,18,8,21,9,56,Fail
Aditya Singh,21-05-2005,821310,Madhya Pradesh,8,1,0,7,16,Fail
Raj Singh,10-06-2005,898466,Arunachal Pradesh,3,9,13,5,30,Fail
Zaid Verma,04-08-2005,392869,Madhya Pradesh,5,8,23,3,39,Fail
Kunal Pillai,15-01-2006,349344,Punjab,4,11,10,22,47,Pass
Manpreet Reddy,08-12-2005,843008,Uttar Pradesh,16,12,7,6,41,Fail
Yash Fernandes,20-08-2005,247742,Manipur,6,12,17,10,45,Fail
Gurpreet Khan,28-04-2006,161886,West Bengal,19,24,12,11,66,Fail
Raj Sharma,22-02-2005,596224,Tamil Nadu,20,20,10,8,58,Fail
Aryan Pillai,24-04-2005,877916,Rajasthan,13,23,16,6,58,Pass
Raj Mehta,23-02-2005,860539,West Bengal,12,13,7,6,38,Fail
Ishaan Verma,11-02-2006,657245,West Bengal,2,5,8,24,39,Fail
Imran Mehta,16-04-2005,414352,West Bengal,15,6,19,22,62,Fail
Gurpreet Chopra,28-09-2005,343938,Gujarat,6,11,16,7,40,Fail
Krishna Sharma,28-08-2005,480352,Odisha,17,15,1,23,56,Pass
Rohan Mehta,07-01-2005,173217,Chhattisgarh,19,19,15,16,69,Fail
Peter Khan,08-12-2005,151796,West Bengal,14,16,5,7,42,Fail
Vivaan Fernandes,25-11-2005,954853,Haryana,15,2,2,0,19,Fail
Aryan Reddy,01-01-2006,866182,Rajasthan,19,16,10,4,49,Pass
Krishna Fernandes,19-02-2006,315743,West Bengal,18,5,20,14,57,Fail
Ishaan Verma,18-07-2005,241164,Chhattisgarh,6,15,20,0,41,Fail
Aryan Chopra,09-01-2006,367343,Assam,2,12,3,14,31,Pass
Krishna Singh,22-09-2005,143013,Nagaland,18,13,19,6,56,Fail
Balbir Verma,21-12-2005,515392,Nagaland,15,12,2,23,52,Fail
Yash Singh,24-05-2005,112345,Odisha,20,0,18,10,48,Pass
Kunal Verma,04-01-2006,202977,Maharashtra,23,8,15,9,55,Fail
Kunal Reddy,04-06-2005,500632,Punjab,5,13,13,23,54,Pass
David Singh,21-11-2004,104273,Uttar Pradesh,19,19,7,0,45,Fail
Kunal Khan,06-04-2006,294869,Telangana,11,23,24,1,59,Fail
Balbir Sharma,24-09-2005,161134,Punjab,11,21,3,9,44,Pass
Vivaan Fernandes,04-03-2006,246370,Rajasthan,14,12,22,19,67,Fail
Aarav Chopra,16-04-2005,923186,Uttar Pradesh,20,19,7,4,50,Fail
Aditya Reddy,28-11-2005,381512,Uttar Pradesh,12,4,13,2,31,Fail
Aarav Pillai,10-09-2005,876034,Punjab,16,2,13,19,50,Pass
Rohan Fernandes,14-12-2005,253065,Andhra Pradesh,20,21,19,5,65,Pass
Raj Reddy,09-03-2006,321785,Madhya Pradesh,10,15,9,10,44,Fail
David Khan,04-12-2005,641186,Andhra Pradesh,11,8,12,2,33,Pass
Harjeet Khan,18-10-2005,579487,Rajasthan,4,9,15,11,39,Pass
Aarav Verma,08-02-2006,224752,Uttar Pradesh,7,23,16,10,56,Fail
Vivaan Verma,28-11-2004,799273,Maharashtra,2,17,18,10,47,Fail
Vivaan Mehta,09-08-2005,821084,Chhattisgarh,1,24,0,3,28,Fail
Sukhwinder Reddy,29-09-2005,699964,Andhra Pradesh,15,19,2,18,54,Pass
Krishna Reddy,22-07-2005,323699,West Bengal,2,16,11,24,53,Fail
Ishaan Singh,24-07-2005,402216,West Bengal,2,23,9,8,42,Fail
Vivaan D'Souza,15-12-2004,342124,Tamil Nadu,8,6,24,7,45,Fail
Yash D'Souza,13-08-2005,533991,Maharashtra,5,24,5,8,42,Fail
Balbir Verma,14-12-2004,227146,Odisha,24,2,1,8,35,Pass
Manpreet Reddy,25-01-2006,541222,Odisha,23,6,0,1,30,Pass
Aditya Khan,23-03-2006,627455,Nagaland,14,8,14,6,42,Pass
Rohan Khan,04-02-2006,750771,Bihar,3,18,15,14,50,Pass
Harjeet Verma,21-07-2005,742403,Bihar,24,16,4,11,55,Pass
Rohan Chopra,23-06-2005,241483,West Bengal,22,5,6,1,34,Fail
Aryan Mehta,23-03-2005,206116,Madhya Pradesh,15,19,23,20,77,Fail
John Pillai,20-12-2005,282593,Assam,6,7,0,14,27,Pass
Manpreet Singh,07-06-2005,232355,West Bengal,6,14,6,5,31,Fail
Gurpreet Sharma,30-04-2006,516648,Uttar Pradesh,2,9,18,7,36,Fail
Raj Mehta,08-12-2004,769115,Kerala,7,21,23,11,62,Pass
Ishaan Khan,07-09-2005,754049,Telangana,14,5,1,4,24,Fail
Aditya Fernandes,09-12-2005,253269,Tripura,21,22,3,9,55,Fail
Raj Reddy,25-01-2006,317367,Delhi,20,3,18,22,63,Fail
Farhan Fernandes,11-06-2005,734580,Maharashtra,14,20,6,13,53,Fail
Balbir Chopra,26-03-2005,621030,Madhya Pradesh,11,19,20,21,71,Fail
Kunal Pillai,11-02-2006,951560,Rajasthan,4,19,9,3,35,Pass
Gurpreet Pillai,06-02-2005,162735,Maharashtra,4,15,5,13,37,Fail
Ishaan Fernandes,04-10-2005,545723,Madhya Pradesh,0,2,16,19,37,Fail
Vivaan Reddy,31-01-2005,335655,Tamil Nadu,18,19,12,20,69,Pass
Raj Reddy,29-05-2005,647253,Uttarakhand,13,7,21,14,55,Fail
Raj Singh,27-03-2006,517343,Maharashtra,3,22,23,12,60,Fail
Krishna Singh,23-03-2006,908465,Andhra Pradesh,24,20,15,15,74,Pass
Gurpreet Khan,20-04-2005,882807,West Bengal,24,5,4,9,42,Fail
Gurpreet D'Souza,14-02-2006,284494,Gujarat,15,11,19,18,63,Fail
Ishaan Mehta,14-03-2005,290432,Odisha,6,2,20,18,46,Pass
Mathew Pillai,11-01-2005,967173,Uttar Pradesh,9,23,17,12,61,Fail
Vivaan Pillai,21-12-2005,807602,Maharashtra,6,16,23,3,48,Fail
Aditya D'Souza,26-11-2005,858952,Bihar,19,19,22,19,79,Pass
Yash Pillai,10-12-2004,723627,Tamil Nadu,13,18,8,17,56,Pass
Kunal Khan,09-11-2004,509904,Punjab,8,12,20,24,64,Pass
Aryan Verma,26-11-2004,820029,Punjab,21,24,12,20,77,Pass
Gurpreet Fernandes,08-04-2005,333883,Punjab,23,21,14,20,78,Pass
Krishna Khan,28-10-2005,969686,Arunachal Pradesh,24,13,3,18,58,Fail
Rohan Fernandes,30-12-2004,793515,Chhattisgarh,24,24,9,17,74,Fail
Vivaan Fernandes,27-01-2005,273876,Andhra Pradesh,23,1,15,1,40,Pass
Aditya Singh,02-02-2005,886002,Tamil Nadu,19,22,9,10,60,Pass
Krishna Sharma,27-04-2006,181312,Karnataka,12,4,24,11,51,Pass
Mathew Sharma,03-05-2006,495222,Chhattisgarh,4,23,5,10,42,Fail
Rohan Chopra,30-12-2005,102582,Andhra Pradesh,9,15,9,23,56,Pass
Aditya Mehta,12-01-2005,211946,West Bengal,21,0,6,4,31,Fail
Peter Singh,23-04-2005,651971,Gujarat,4,14,15,20,53,Fail
Gurpreet Sharma,05-03-2006,222167,Bihar,21,23,23,0,67,Pass
Ayaan Sharma,05-08-2005,884961,Bihar,13,13,22,3,51,Pass
Vivaan Pillai,15-04-2006,918325,Chhattisgarh,22,10,22,18,72,Fail
Krishna Chopra,29-12-2005,253732,Bihar,18,9,0,10,37,Pass
Peter Mehta,06-11-2005,652392,Kerala,20,10,14,12,56,Pass
Rohan Sharma,24-09-2005,187716,Gujarat,23,5,7,9,44,Fail
Sukhwinder Fernandes,12-01-2005,878484,Punjab,5,20,12,4,41,Pass
Kunal Verma,17-11-2005,526990,Andhra Pradesh,21,9,22,9,61,Pass
Rohan Fernandes,27-06-2005,791344,Rajasthan,8,22,2,22,54,Pass
Aryan Mehta,08-04-2006,760760,Haryana,23,6,13,11,53,Fail
Kunal Reddy,17-10-2005,928767,West Bengal,20,21,22,24,87,Fail
Ishaan Reddy,10-06-2005,319388,Madhya Pradesh,6,16,4,20,46,Fail
Ishaan Fernandes,26-12-2004,740907,Madhya Pradesh,4,2,10,3,19,Fail
Raj Chopra,12-10-2005,447429,Rajasthan,14,7,3,7,31,Pass
Vivaan Reddy,24-08-2005,574750,Odisha,22,17,1,0,40,Pass
Kunal Fernandes,19-03-2006,659110,Maharashtra,20,6,17,13,56,Fail
Yash Singh,03-08-2005,685066,West Bengal,23,0,6,13,42,Fail
Ishaan Verma,05-12-2004,315002,Jharkhand,3,4,0,12,19,Pass
Vivaan Singh,18-10-2005,362946,Telangana,5,17,15,12,49,Fail
Kunal Sharma,28-03-2005,277936,Punjab,2,24,6,20,52,Pass
Vivaan Khan,07-03-2006,722912,Uttar Pradesh,24,2,19,10,55,Fail
Vivaan Sharma,28-12-2004,333023,Bihar,12,6,18,16,52,Pass
Krishna Fernandes,04-12-2004,959458,Bihar,24,15,23,23,85,Pass
Kunal Reddy,07-10-2005,675678,Gujarat,20,0,9,17,46,Fail
Rohan D'Souza,31-07-2005,626425,Andhra Pradesh,9,13,17,17,56,Pass
Kunal Fernandes,05-01-2005,230735,Haryana,23,2,7,22,54,Fail
Aarav Khan,07-12-2005,902157,Uttar Pradesh,2,11,17,0,30,Fail
Vivaan Pillai,24-11-2005,754314,Jammu & Kashmir + Ladakh,5,9,6,6,26,Pass
Yash Singh,13-04-2005,862292,Gujarat,4,24,19,12,59,Fail
Aryan Chopra,15-11-2005,769201,Maharashtra,13,17,12,15,57,Fail
Vivaan Mehta,22-06-2005,564310,Jammu & Kashmir + Ladakh,2,23,20,20,65,Pass
Aditya Sharma,16-02-2006,459434,Kerala,15,6,8,22,51,Pass
Rehan Verma,02-03-2005,500892,Maharashtra,14,20,1,6,41,Fail
Vivaan Mehta,11-11-2005,226659,Madhya Pradesh,17,6,11,21,55,Fail
Raj Chopra,25-03-2005,586379,Telangana,8,9,12,22,51,Fail
Peter Pillai,17-11-2004,433385,Chhattisgarh,23,8,14,13,58,Fail
Yash Reddy,05-01-2006,865316,Assam,16,8,18,3,45,Pass
Kunal Pillai,31-12-2004,863895,Tamil Nadu,2,24,16,11,53,Fail
Vivaan Fernandes,23-06-2005,417285,Bihar,4,7,18,24,53,Pass
Aarav Pillai,24-07-2005,839776,Punjab,8,9,7,10,34,Pass
Kunal Fernandes,26-05-2005,358686,Tamil Nadu,8,3,6,8,25,Pass
Mathew Singh,18-11-2004,524767,Meghalaya,21,10,6,4,41,Pass
Aditya Khan,05-12-2004,722274,Karnataka,5,3,7,21,36,Pass
Krishna Fernandes,25-04-2006,975001,Haryana,4,9,2,7,22,Fail
Balbir Verma,13-12-2004,524804,Bihar,11,10,0,20,41,Pass
Yash D'Souza,07-05-2006,836744,Assam,10,20,1,13,44,Pass
Kunal D'Souza,05-03-2005,945883,Uttarakhand,24,7,18,2,51,Fail
Ishaan Fernandes,12-02-2005,741760,Uttar Pradesh,8,15,8,5,36,Fail
Aryan D'Souza,10-02-2005,413721,Odisha,7,16,10,0,33,Pass
Vivaan Pillai,05-08-2005,687775,West Bengal,21,10,8,10,49,Fail
Vivaan Singh,23-04-2006,874466,Kerala,4,11,11,20,46,Pass
Rehan Singh,01-02-2006,708200,Manipur,21,3,21,2,47,Fail
Kunal Chopra,23-05-2005,586570,Uttar Pradesh,15,15,6,3,39,Fail
Raj Mehta,11-11-2005,214940,Karnataka,15,2,18,19,54,Pass
Rohan Verma,01-12-2005,152998,Uttar Pradesh,8,7,7,7,29,Fail
Aryan Reddy,25-03-2005,158506,Kerala,7,1,5,11,24,Pass
Manpreet Chopra,01-03-2005,647149,Gujarat,0,4,14,2,20,Fail
Yash Sharma,07-11-2005,627300,Uttar Pradesh,21,21,9,24,75,Fail
Rohan Sharma,28-04-2006,864849,Rajasthan,0,2,15,20,37,Pass
Raj Khan,07-01-2005,713501,Gujarat,10,18,18,9,55,Fail
Aarav Sharma,18-03-2005,233287,Maharashtra,13,1,0,22,36,Fail
Aditya Verma,01-05-2005,152823,Himachal Pradesh,8,19,6,2,35,Pass
Balbir Singh,10-12-2005,374086,Maharashtra,0,23,19,18,60,Fail
Aditya Chopra,22-09-2005,282034,Bihar,2,7,8,3,20,Pass
Ishaan Fernandes,12-09-2005,600270,Tamil Nadu,12,16,2,10,40,Pass
Farhan Chopra,06-12-2004,818750,Jharkhand,7,15,14,3,39,Pass
Rohan Sharma,16-07-2005,266826,Madhya Pradesh,19,20,8,20,67,Fail
Peter Sharma,23-02-2005,362094,Haryana,22,7,9,7,45,Fail
Rohan Verma,28-12-2005,766295,Maharashtra,3,21,21,0,45,Fail
Aditya Chopra,03-04-2005,886972,Rajasthan,13,21,3,23,60,Fail
Yash Fernandes,08-01-2006,131805,Maharashtra,24,11,15,2,52,Fail
Vivaan Khan,23-11-2004,614324,West Bengal,6,8,21,5,40,Fail
Mathew Reddy,08-05-2005,844657,Madhya Pradesh,15,23,19,23,80,Fail
Farhan Sharma,16-03-2005,434734,Uttar Pradesh,0,15,17,12,44,Fail
Yash Chopra,24-01-2005,710966,Rajasthan,1,20,17,21,59,Pass
Aditya Sharma,19-03-2005,793763,Tamil Nadu,2,16,6,0,24,Pass
Manpreet Verma,10-11-2005,787774,Madhya Pradesh,15,7,18,5,45,Fail
Rohan Pillai,05-07-2005,304906,Chhattisgarh,12,6,9,10,37,Fail
Rohan Sharma,20-02-2006,735528,West Bengal,18,7,1,1,27,Fail
Peter Reddy,09-02-2006,407343,Maharashtra,22,22,19,15,78,Fail
Aryan Singh,21-12-2005,257189,Himachal Pradesh,19,11,20,15,65,Pass
Rehan Chopra,17-01-2006,896740,Uttar Pradesh,15,16,0,12,43,Fail
Aarav Mehta,23-01-2005,915577,Delhi,18,16,23,1,58,Fail
Aditya Reddy,07-11-2005,756385,Jharkhand,13,24,23,1,61,Pass
Rohan Reddy,16-12-2005,410132,Punjab,14,22,22,20,78,Pass
Ishaan Pillai,17-10-2005,730892,Odisha,21,4,22,7,54,Pass
Kunal Chopra,06-10-2005,370988,Punjab,24,22,17,11,74,Pass
Yash Fernandes,03-10-2005,295640,West Bengal,15,22,15,2,54,Fail
Vivaan Khan,18-01-2006,221632,Jammu & Kashmir + Ladakh,9,13,12,15,49,Pass
Yash Chopra,06-12-2004,531318,Madhya Pradesh,16,15,1,11,43,Fail
Aditya Chopra,13-11-2004,415341,Uttar Pradesh,3,20,4,2,29,Fail
Aryan Pillai,08-01-2006,642954,Jammu & Kashmir + Ladakh,4,15,16,16,51,Pass
Aarav D'Souza,20-03-2006,578204,Bihar,4,21,14,23,62,Pass
Aarav Mehta,11-12-2005,828691,Rajasthan,21,24,3,17,65,Fail
Raj Pillai,22-04-2005,772974,Uttar Pradesh,5,0,19,0,24,Fail
Vivaan Khan,26-06-2005,310193,Punjab,12,8,2,9,31,Pass
Krishna Pillai,01-01-2005,790159,Maharashtra,6,2,7,19,34,Fail
Ishaan D'Souza,12-09-2005,448139,Tamil Nadu,8,9,15,10,42,Pass
Yash Pillai,29-01-2005,915581,Uttar Pradesh,10,16,13,12,51,Fail
Aryan D'Souza,02-08-2005,573772,Chhattisgarh,23,21,7,24,75,Fail
Vivaan Singh,03-02-2006,803635,Punjab,7,12,10,17,46,Pass
Yash D'Souza,04-12-2004,791460,Bihar,14,23,21,12,70,Pass
Kunal Singh,18-10-2005,491195,Telangana,23,3,18,2,46,Fail
Ishaan Fernandes,27-07-2005,463843,Delhi,22,13,14,24,73,Fail
Gurpreet Khan,02-02-2006,340578,Madhya Pradesh,2,12,14,23,51,Fail
Kunal Pillai,15-05-2005,657785,Rajasthan,16,5,20,1,42,Pass
Krishna Chopra,07-08-2005,227130,Chhattisgarh,5,5,5,12,27,Fail
Ishaan Verma,23-06-2005,287109,West Bengal,19,11,21,21,72,Fail
Manpreet D'Souza,01-12-2005,945707,Haryana,22,0,21,2,45,Fail
Paul Verma,14-04-2006,260096,Tamil Nadu,17,1,11,3,32,Pass
Krishna Verma,26-03-2005,430501,West Bengal,8,17,8,16,49,Fail
Yash Reddy,08-05-2005,303147,Uttar Pradesh,15,12,15,13,55,Fail
Aryan Chopra,04-03-2006,666830,Haryana,7,15,16,15,53,Fail
Sukhwinder Chopra,25-01-2006,188648,Uttarakhand,19,18,12,17,66,Fail
Aarav Singh,20-09-2005,279151,Karnataka,5,1,2,6,14,Pass
Aditya Singh,04-06-2005,190339,Maharashtra,17,9,8,10,44,Fail
Rohan D'Souza,09-01-2005,330915,Telangana,17,14,1,2,34,Fail
Manpreet Reddy,24-12-2004,926170,Rajasthan,1,18,1,6,26,Pass
Harjeet Fernandes,16-02-2005,572772,Telangana,22,21,16,19,78,Fail
Manpreet Chopra,04-06-2005,438606,Rajasthan,14,14,11,20,59,Pass
Ishaan D'Souza,04-07-2005,337032,Punjab,15,0,10,21,46,Pass
Manpreet Fernandes,13-11-2005,507085,Bihar,5,8,22,18,53,Pass
Rohan D'Souza,29-04-2006,251956,Assam,11,16,13,6,46,Pass
Raj Mehta,06-11-2005,545658,Haryana,14,8,12,12,46,Fail
Harjeet Mehta,04-02-2006,423164,Chhattisgarh,21,7,23,1,52,Fail
Aditya Reddy,03-08-2005,732568,Uttar Pradesh,9,3,8,23,43,Fail
Ishaan Khan,24-12-2005,350584,Kerala,23,15,23,15,76,Fail
Ishaan Chopra,31-08-2005,828123,Punjab,7,13,9,9,38,Pass
Aarav D'Souza,17-05-2005,319439,Tamil Nadu,5,11,24,16,56,Pass
Rohan Pillai,28-03-2005,456039,Himachal Pradesh,9,18,19,21,67,Pass
Kunal Verma,23-12-2004,566243,Kerala,0,21,18,0,39,Pass
Mathew Chopra,27-03-2005,544141,Bihar,7,14,15,18,54,Pass
David Sharma,30-01-2005,194634,Rajasthan,6,7,4,8,25,Pass
Rehan Sharma,09-09-2005,133414,Rajasthan,14,0,23,2,39,Pass
Aarav D'Souza,22-08-2005,484938,Punjab,12,24,0,22,58,Pass
Krishna Pillai,19-02-2006,831562,Kerala,12,11,22,21,66,Pass
Manpreet Reddy,24-02-2006,660398,Punjab,7,13,11,4,35,Pass
Gurpreet Verma,24-05-2005,118411,Tamil Nadu,18,5,20,18,61,Pass
Peter Verma,29-05-2005,549770,Uttarakhand,23,9,22,19,73,Fail
Harjeet Fernandes,21-12-2004,504004,Assam,2,6,6,17,31,Pass
Aditya Fernandes,18-11-2005,182535,Chhattisgarh,20,22,15,18,75,Fail
Rohan Pillai,08-10-2005,594252,Maharashtra,8,7,18,6,39,Fail
Gurpreet Sharma,04-02-2005,231373,West Bengal,16,12,12,0,40,Fail
Rohan Sharma,08-06-2005,812239,Rajasthan,20,0,6,15,41,Pass
Gurpreet Pillai,28-12-2005,420444,Haryana,1,24,14,22,61,Fail
Manpreet Pillai,20-05-2005,328372,Assam,16,21,12,19,68,Pass
Vivaan Khan,15-03-2005,724507,West Bengal,13,17,5,21,56,Fail
Sukhwinder Khan,02-01-2005,650504,Mizoram,10,16,9,11,46,Fail
Peter Khan,07-04-2005,684818,Uttar Pradesh,7,0,19,17,43,Fail
Vivaan Singh,17-08-2005,122001,Bihar,22,7,1,12,42,Pass
Yash Sharma,31-07-2005,817721,Manipur,1,10,4,17,32,Fail
Kunal Singh,05-04-2005,264008,Uttar Pradesh,13,11,3,14,41,Fail
Raj Chopra,15-02-2006,288041,Nagaland,16,17,20,11,64,Fail
Rohan Singh,17-07-2005,704051,Madhya Pradesh,16,10,21,12,59,Fail
Balbir Singh,15-11-2005,836021,Gujarat,18,7,8,12,45,Fail
Aditya Verma,19-06-2005,576796,Rajasthan,12,10,21,7,50,Pass
Ishaan Fernandes,12-03-2006,852869,Rajasthan,14,15,22,23,74,Pass
Raj Mehta,06-01-2006,176680,Uttarakhand,5,11,18,10,44,Fail
Vivaan Reddy,09-01-2006,347301,Karnataka,4,1,3,4,12,Pass
Rohan D'Souza,13-11-2004,790303,Maharashtra,14,2,2,4,22,Fail
Ishaan Reddy,20-01-2006,517524,Rajasthan,22,20,24,18,84,Pass
Rohan D'Souza,14-03-2006,599840,Rajasthan,11,5,7,10,33,Pass
Balbir Khan,20-03-2005,774904,Uttar Pradesh,16,10,1,23,50,Fail
Sukhwinder Chopra,11-02-2006,862842,Assam,0,12,16,7,35,Pass
Harjeet Reddy,18-04-2006,575712,Uttar Pradesh,0,21,14,8,43,Fail
Rohan Khan,07-12-2004,785341,Uttarakhand,21,21,8,11,61,Fail
Krishna Sharma,12-04-2005,342587,Haryana,12,24,12,3,51,Fail
Yash Verma,18-06-2005,143499,Uttar Pradesh,23,11,0,23,57,Fail
Rohan Verma,28-11-2004,313836,Bihar,4,16,3,11,34,Pass
Gurpreet D'Souza,10-08-2005,142420,Tamil Nadu,21,9,16,18,64,Fail
Krishna Verma,01-05-2006,123476,Delhi,7,24,4,22,57,Fail
Krishna Reddy,21-02-2005,299222,Haryana,19,2,8,24,53,Fail
Yash D'Souza,14-05-2005,897299,Uttar Pradesh,5,8,20,13,46,Fail
Krishna Fernandes,29-08-2005,472077,Jharkhand,17,7,8,9,41,Pass
David Verma,04-11-2005,467630,Punjab,1,8,14,3,26,Pass
Manpreet Chopra,18-02-2006,469875,Rajasthan,5,8,17,6,36,Pass
Aarav D'Souza,16-10-2005,522035,Bihar,7,9,14,17,47,Pass
Mathew Singh,20-12-2005,781469,Maharashtra,24,12,1,13,50,Fail
John Reddy,19-01-2005,227653,Tamil Nadu,6,13,4,15,38,Pass
Harjeet Fernandes,08-08-2005,478931,West Bengal,5,8,15,19,47,Fail
Mathew Fernandes,14-12-2004,650565,West Bengal,19,9,21,9,58,Fail
Aditya Chopra,17-07-2005,269340,Odisha,18,18,21,7,64,Pass
Rohan Sharma,01-12-2005,713956,Odisha,5,8,3,10,26,Pass
Manpreet Mehta,01-05-2005,818250,Assam,21,22,10,13,66,Pass
Vivaan Fernandes,23-10-2005,360107,Chhattisgarh,13,0,6,19,38,Fail
Raj Pillai,21-04-2005,885957,Andhra Pradesh,12,19,3,16,50,Pass
Aarav Verma,11-11-2005,471160,Telangana,13,23,19,3,58,Fail
Harjeet Chopra,19-11-2005,356306,Andhra Pradesh,24,8,13,11,56,Pass
Aditya D'Souza,21-03-2006,259421,Uttarakhand,21,20,22,0,63,Fail
Rohan Fernandes,20-09-2005,119770,Kerala,5,17,5,22,49,Pass
Kunal Sharma,03-05-2005,451907,West Bengal,21,16,3,0,40,Fail
Vivaan Reddy,05-04-2005,542851,Himachal Pradesh,15,24,3,1,43,Pass
Manpreet Singh,02-05-2006,886197,Tamil Nadu,20,12,17,0,49,Fail
Rehan Verma,04-01-2006,200707,Karnataka,15,23,22,19,79,Fail
Manpreet Singh,24-12-2004,418183,West Bengal,4,7,0,3,14,Fail
Rohan Fernandes,27-02-2005,911602,Maharashtra,18,3,14,7,42,Fail
Ishaan Chopra,31-05-2005,567643,West Bengal,13,8,12,13,46,Fail
Aarav D'Souza,22-11-2005,775786,Rajasthan,21,6,5,21,53,Pass
Rohan Mehta,06-04-2006,445533,Odisha,10,2,13,3,28,Pass
Rohan Mehta,24-12-2005,837519,Bihar,7,13,17,19,56,Pass
Aditya Mehta,30-01-2006,238775,Karnataka,10,4,13,2,29,Pass
Rohan Chopra,03-02-2006,881319,Himachal Pradesh,20,15,24,0,59,Pass
Aryan Reddy,27-01-2005,681531,Odisha,9,22,6,24,61,Pass
Aarav D'Souza,17-09-2005,458616,Bihar,2,10,12,20,44,Pass
Ishaan Chopra,26-05-2005,741950,Tamil Nadu,0,21,12,4,37,Pass
Aditya Khan,27-03-2005,804909,Jammu & Kashmir + Ladakh,8,12,23,24,67,Pass
Vivaan Khan,12-09-2005,449015,Haryana,12,21,22,10,65,Fail
Balbir Pillai,06-08-2005,656313,Chhattisgarh,22,0,5,23,50,Fail
Krishna Reddy,28-01-2006,606652,Uttarakhand,15,8,16,13,52,Fail
Aditya Singh,28-02-2005,714782,Bihar,5,7,12,16,40,Pass
Yash Chopra,02-03-2005,936437,Rajasthan,4,16,7,7,34,Pass
Ishaan D'Souza,10-01-2006,585221,West Bengal,9,21,24,10,64,Fail
Harjeet Fernandes,23-10-2005,815872,Odisha,19,5,15,18,57,Pass
Krishna Reddy,03-09-2005,617237,Maharashtra,1,19,6,8,34,Fail
Aditya Chopra,15-01-2006,723325,Odisha,15,3,7,2,27,Pass
Raj Chopra,23-01-2005,460692,Haryana,23,20,22,4,69,Fail
Ishaan Fernandes,19-03-2006,590750,Maharashtra,15,24,10,20,69,Fail
Ayaan Mehta,01-12-2005,604726,Karnataka,21,5,13,17,56,Pass
Vivaan D'Souza,15-04-2006,541295,Madhya Pradesh,8,7,7,9,31,Fail
Yash Pillai,22-07-2005,247084,Maharashtra,11,4,14,7,36,Fail
Ishaan Pillai,20-06-2005,483824,Bihar,19,18,14,11,62,Pass
Sukhwinder Singh,14-05-2005,908341,Haryana,5,9,7,4,25,Fail
Krishna Reddy,14-01-2005,113072,Rajasthan,20,0,16,2,38,Pass
Vivaan Pillai,09-03-2006,836840,Uttar Pradesh,13,4,20,10,47,Fail
Kunal Mehta,11-04-2005,941829,Karnataka,1,20,1,21,43,Pass
Krishna Singh,26-11-2005,453568,Punjab,20,8,12,14,54,Pass
Balbir Verma,04-11-2005,333897,Arunachal Pradesh,11,2,0,24,37,Fail
Ishaan Pillai,06-12-2004,152144,Bihar,23,23,14,12,72,Pass
Yash Verma,29-01-2005,155393,Assam,14,10,12,0,36,Pass
Sukhwinder D'Souza,15-01-2006,484715,Haryana,23,11,6,10,50,Fail
Gurpreet Reddy,14-11-2004,612542,Uttar Pradesh,2,20,2,15,39,Fail
Krishna Khan,18-12-2004,507919,Delhi,6,19,9,7,41,Fail
Harjeet Singh,02-12-2005,965322,Bihar,15,23,22,8,68,Pass
Gurpreet Fernandes,06-04-2005,736738,Andhra Pradesh,20,10,14,14,58,Pass
Kunal Fernandes,25-03-2006,249708,Karnataka,2,10,6,8,26,Pass
Aryan Khan,22-04-2005,467777,Rajasthan,18,0,16,23,57,Pass
Balbir Chopra,02-05-2005,124423,Uttar Pradesh,3,4,15,7,29,Fail
Farhan Mehta,11-12-2004,828264,Jharkhand,11,14,18,16,59,Pass
Ishaan Mehta,13-01-2005,623420,Jharkhand,24,0,9,4,37,Pass
Yash Mehta,26-11-2004,796639,Tamil Nadu,18,3,21,4,46,Fail
Aditya Singh,01-03-2005,516401,Telangana,7,23,20,22,72,Fail
Yash Singh,27-05-2005,956480,Rajasthan,15,0,17,24,56,Pass
Paul Singh,30-03-2005,489909,Haryana,8,2,19,7,36,Fail
Rohan Reddy,28-03-2006,619066,Punjab,1,0,21,16,38,Pass
Raj Fernandes,18-09-2005,759716,Tripura,1,10,15,22,48,Fail
Harjeet Reddy,08-01-2005,224246,Assam,1,15,5,3,24,Pass
Balbir D'Souza,22-10-2005,838934,Andhra Pradesh,14,6,24,12,56,Pass
Ishaan Pillai,06-04-2005,298102,Andhra Pradesh,13,8,8,17,46,Pass
Krishna Pillai,17-11-2004,540114,West Bengal,19,11,9,7,46,Fail
Aarav Sharma,01-04-2006,776371,Uttar Pradesh,24,19,9,3,55,Fail
Aryan D'Souza,23-03-2005,573537,Himachal Pradesh,21,17,22,5,65,Pass
David Khan,27-12-2004,223789,Rajasthan,7,19,11,20,57,Pass
David Pillai,30-04-2006,357227,Jharkhand,2,19,24,15,60,Pass
Rohan Singh,19-02-2006,535915,Assam,12,11,12,15,50,Pass
Rohan Mehta,22-04-2005,605936,Madhya Pradesh,18,14,11,6,49,Fail
Yash D'Souza,19-04-2006,991972,Gujarat,21,18,19,8,66,Fail
Gurpreet Pillai,21-03-2006,989961,Jammu & Kashmir + Ladakh,19,1,20,20,60,Pass
Peter Fernandes,17-05-2005,139176,Bihar,12,9,17,9,47,Pass
Balbir Mehta,27-01-2006,779412,Tamil Nadu,8,3,8,18,37,Pass
David Chopra,20-10-2005,259180,Uttar Pradesh,5,21,17,15,58,Fail
Aryan Mehta,07-04-2006,924077,Uttar Pradesh,9,9,11,5,34,Fail
Kunal D'Souza,26-08-2005,157440,Rajasthan,22,22,13,18,75,Fail
Gurpreet Mehta,19-12-2005,209883,Bihar,17,14,19,2,52,Pass
Yash Khan,27-02-2006,881300,Telangana,17,21,14,2,54,Fail
John Chopra,12-09-2005,132321,Uttar Pradesh,18,13,22,0,53,Fail
Yash Reddy,01-09-2005,969671,Uttar Pradesh,20,23,21,15,79,Fail
Sukhwinder Chopra,05-03-2005,188191,Madhya Pradesh,13,16,12,0,41,Fail
Paul Fernandes,11-01-2006,907494,Meghalaya,16,24,24,10,74,Pass
Kunal Pillai,12-04-2005,859334,Odisha,16,12,5,0,33,Pass
Aditya Chopra,13-03-2006,447902,Haryana,21,13,17,16,67,Fail
Kunal Singh,08-12-2005,329738,Uttar Pradesh,12,20,8,14,54,Fail
Balbir Reddy,14-02-2006,461499,Punjab,10,5,2,19,36,Pass
Aryan D'Souza,25-01-2006,111811,Andhra Pradesh,22,20,3,24,69,Pass
Aarav Fernandes,01-07-2005,461436,Haryana,8,13,20,4,45,Fail
Vivaan D'Souza,11-01-2005,740158,Madhya Pradesh,3,20,9,19,51,Fail
Manpreet D'Souza,07-09-2005,737030,Maharashtra,21,4,0,2,27,Fail
Rohan Pillai,16-04-2005,876360,Bihar,4,19,6,0,29,Pass
Vivaan Pillai,09-11-2004,152245,Bihar,10,0,4,7,21,Pass
Krishna Mehta,23-11-2005,573380,Tamil Nadu,24,6,0,19,49,Fail
Rohan Khan,28-10-2005,786015,Uttar Pradesh,6,9,1,0,16,Fail
Kunal Khan,13-06-2005,279786,Himachal Pradesh,22,18,2,10,52,Pass
Vivaan Verma,26-12-2004,526147,Odisha,6,17,18,11,52,Pass
Rohan Pillai,23-12-2004,371208,Maharashtra,22,1,3,0,26,Fail
Aditya Fernandes,15-06-2005,650641,Assam,0,22,12,15,49,Pass
Ishaan Sharma,27-03-2005,490219,Uttarakhand,18,2,2,24,46,Fail
Aditya Fernandes,20-12-2005,167327,Uttarakhand,17,11,18,1,47,Fail
Kunal Sharma,14-01-2006,680435,Uttar Pradesh,22,10,10,15,57,Fail
Harjeet Pillai,07-04-2005,777235,Uttar Pradesh,8,24,2,2,36,Fail
Paul Singh,05-12-2004,729859,Rajasthan,12,1,7,22,42,Pass
Krishna Fernandes,11-04-2006,867464,Puducherry,21,16,1,23,61,Fail
Vivaan D'Souza,15-03-2006,647885,Maharashtra,21,22,5,12,60,Fail
Krishna Singh,20-03-2005,752322,Nagaland,1,22,3,3,29,Pass
Raj Verma,25-04-2005,206531,Sikkim,6,2,4,3,15,Fail
Raj Fernandes,26-01-2005,261856,West Bengal,13,5,18,20,56,Fail
Rohan Verma,19-11-2005,659237,Odisha,15,0,15,4,34,Pass
Kunal Fernandes,23-12-2004,383307,West Bengal,14,1,16,3,34,Fail
Rohan D'Souza,30-05-2005,398822,Uttar Pradesh,1,11,14,0,26,Fail
Sukhwinder Pillai,06-04-2006,384059,Tamil Nadu,0,3,10,15,28,Pass
Ishaan Chopra,10-06-2005,672931,Rajasthan,11,17,24,22,74,Pass
Krishna D'Souza,12-10-2005,481246,Rajasthan,16,12,23,11,62,Fail
Yash Sharma,21-10-2005,898067,West Bengal,16,2,14,19,51,Fail
Kunal Khan,06-11-2005,378228,Assam,22,16,1,5,44,Pass
Sukhwinder Verma,19-09-2005,553135,Uttar Pradesh,7,0,2,22,31,Fail
Aarav Sharma,21-03-2005,844904,Haryana,14,10,24,8,56,Fail
Rohan Reddy,01-11-2005,772696,Rajasthan,19,21,0,14,54,Pass
Raj Sharma,05-12-2005,993495,Uttar Pradesh,10,22,6,4,42,Fail
Harjeet Chopra,07-03-2006,974155,Maharashtra,11,3,10,23,47,Fail
Aditya Khan,17-04-2006,487322,Uttar Pradesh,24,18,1,22,65,Fail
Aryan Reddy,31-08-2005,201561,Madhya Pradesh,15,9,14,24,62,Fail
Krishna D'Souza,17-02-2006,792929,Rajasthan,5,4,0,4,13,Pass
Aryan D'Souza,18-05-2005,310652,Maharashtra,5,1,17,8,31,Fail
Ishaan Sharma,22-10-2005,762996,Delhi,13,18,2,1,34,Fail
Aarav Khan,29-08-2005,821381,Punjab,16,0,14,14,44,Pass
Rehan Mehta,08-11-2004,439657,Maharashtra,0,16,12,22,50,Fail
Aarav Verma,04-10-2005,616315,Maharashtra,15,3,13,1,32,Fail
Harjeet D'Souza,01-12-2005,173537,Andhra Pradesh,10,10,3,14,37,Pass
Vivaan Fernandes,23-10-2005,962310,Bihar,21,9,15,12,57,Pass
Rehan Pillai,22-05-2005,531231,Maharashtra,18,2,7,6,33,Fail
Rohan Reddy,22-09-2005,652748,Jharkhand,0,20,20,15,55,Pass
Aryan Singh,08-04-2005,971795,Jharkhand,3,12,11,3,29,Pass
David Singh,03-02-2006,687023,West Bengal,14,2,4,1,21,Fail
Kunal Sharma,15-04-2005,338938,Jharkhand,4,2,10,16,32,Pass
Aditya D'Souza,26-02-2005,270862,Uttarakhand,21,21,9,5,56,Fail
Kunal Khan,20-03-2005,122022,Bihar,11,14,10,7,42,Pass
Rohan Chopra,26-12-2004,654206,Uttar Pradesh,5,3,13,7,28,Fail
Krishna Sharma,22-07-2005,767375,Punjab,3,8,17,10,38,Pass
Yash Reddy,26-08-2005,863180,Haryana,8,9,5,7,29,Fail
Yash Verma,26-09-2005,949662,Andhra Pradesh,5,13,4,20,42,Pass
Aditya Pillai,21-12-2005,720353,Uttar Pradesh,22,19,14,3,58,Fail
Rohan Fernandes,04-12-2004,912984,Madhya Pradesh,4,2,10,19,35,Fail
Kunal Mehta,28-12-2005,454442,Rajasthan,22,3,21,24,70,Fail
Yash Sharma,13-03-2005,844432,Bihar,13,11,15,14,53,Pass
Harjeet Verma,22-02-2005,205965,Rajasthan,19,0,11,9,39,Pass
Ishaan Fernandes,18-06-2005,262724,Assam,5,6,7,10,28,Pass
Aditya Reddy,02-02-2005,712123,Andhra Pradesh,12,24,23,5,64,Pass
Aditya Sharma,19-12-2004,483850,West Bengal,13,5,7,7,32,Fail
Rohan Pillai,15-01-2005,258348,Bihar,8,15,13,9,45,Pass
Gurpreet Khan,30-12-2004,424013,Uttarakhand,18,6,0,21,45,Fail
Gurpreet Reddy,05-03-2006,157797,Jammu & Kashmir + Ladakh,9,13,9,2,33,Pass
Paul Verma,28-01-2006,362632,Rajasthan,23,20,12,15,70,Fail
Mathew Sharma,02-05-2006,356615,West Bengal,15,11,21,18,65,Fail
John Pillai,03-02-2005,506393,Gujarat,5,22,15,20,62,Fail
Aditya Khan,14-01-2005,436142,Andhra Pradesh,9,3,2,22,36,Pass
Raj Verma,30-03-2005,924725,Tripura,7,15,5,18,45,Fail
Krishna Fernandes,09-01-2006,763995,West Bengal,23,20,13,17,73,Fail
Aryan Fernandes,04-10-2005,651053,Tripura,13,20,4,10,47,Fail
Aditya Fernandes,02-09-2005,468587,Jammu & Kashmir + Ladakh,21,17,6,2,46,Pass
Harjeet Reddy,05-01-2006,378817,Jammu & Kashmir + Ladakh,6,14,19,5,44,Pass
Aryan Reddy,27-03-2005,841534,Assam,13,22,8,11,54,Pass
Vivaan Khan,04-05-2006,879396,Madhya Pradesh,21,8,24,22,75,Fail
Aarav Mehta,05-06-2005,865065,Madhya Pradesh,14,6,22,22,64,Fail
Zaid Chopra,01-06-2005,710067,Bihar,8,6,23,1,38,Pass
Aryan Verma,06-02-2006,961318,Rajasthan,18,0,14,21,53,Pass
Manpreet Khan,25-11-2004,801019,Bihar,21,18,12,6,57,Pass
Aarav Pillai,07-02-2006,625708,Rajasthan,17,18,12,13,60,Fail
Kunal Khan,06-07-2005,152673,Karnataka,5,9,22,24,60,Pass
Aditya Sharma,07-07-2005,738472,Uttar Pradesh,21,5,7,3,36,Fail
Vivaan D'Souza,15-04-2006,603126,Punjab,9,17,4,0,30,Pass
Aryan Chopra,26-05-2005,761830,West Bengal,4,17,21,7,49,Fail
Ishaan Fernandes,05-11-2005,909505,Haryana,8,5,22,19,54,Fail
Raj Singh,12-03-2005,424591,Karnataka,9,21,3,19,52,Pass
Balbir Verma,08-10-2005,730840,Andhra Pradesh,15,15,9,2,41,Pass
Raj Mehta,21-01-2005,733829,Madhya Pradesh,14,24,2,17,57,Fail
Imran Singh,19-03-2005,668714,Rajasthan,19,0,2,24,45,Pass
Aditya D'Souza,27-01-2006,737874,Bihar,13,5,23,16,57,Pass
Aditya Reddy,28-12-2004,448303,Uttar Pradesh,17,9,15,5,46,Fail
Rehan Mehta,12-04-2005,784654,Bihar,3,5,4,22,34,Pass
Aditya D'Souza,30-04-2006,155787,Jharkhand,8,21,9,23,61,Pass
Vivaan Khan,02-04-2005,698102,Rajasthan,23,3,13,16,55,Pass
Rohan Chopra,30-11-2005,749017,Jharkhand,4,1,22,18,45,Pass
Raj Reddy,04-09-2005,933483,Haryana,4,20,5,19,48,Fail
Aryan Pillai,11-08-2005,691104,West Bengal,5,16,3,15,39,Fail
Yash Chopra,23-02-2005,946257,Assam,11,5,14,10,40,Pass
Sukhwinder Mehta,09-04-2006,500335,Maharashtra,16,24,2,21,63,Fail
Ayaan Verma,28-04-2005,747805,Punjab,17,8,21,15,61,Pass
Gurpreet Chopra,08-04-2005,772995,Madhya Pradesh,2,24,16,23,65,Fail
Harjeet Khan,17-01-2006,442176,Gujarat,14,4,12,20,50,Fail
Aditya Fernandes,02-05-2006,990282,Assam,16,22,4,22,64,Pass
Gurpreet Reddy,19-12-2005,548320,Madhya Pradesh,23,22,17,5,67,Fail
Yash Reddy,11-01-2006,130574,West Bengal,23,20,19,24,86,Fail
Yash Khan,22-01-2005,321890,Andhra Pradesh,7,8,17,16,48,Pass
Rehan Khan,12-12-2004,402630,West Bengal,21,5,23,23,72,Fail
Harjeet Verma,06-11-2005,844213,Uttar Pradesh,15,22,16,9,62,Fail
Rohan D'Souza,13-03-2006,836357,Andhra Pradesh,16,9,2,15,42,Pass
Peter D'Souza,14-10-2005,163980,Kerala,8,14,2,21,45,Pass
Aditya Fernandes,20-07-2005,342666,Maharashtra,12,24,11,13,60,Fail
Harjeet Chopra,28-04-2005,479900,Uttar Pradesh,17,21,0,6,44,Fail
Rohan Singh,02-05-2006,865357,Maharashtra,11,7,21,9,48,Fail
David Khan,20-02-2006,930884,Madhya Pradesh,3,10,2,20,35,Fail
Raj Khan,01-09-2005,953910,West Bengal,7,1,2,8,18,Fail
Vivaan D'Souza,16-06-2005,449135,Karnataka,20,24,10,23,77,Fail
Aryan D'Souza,08-12-2004,831032,Arunachal Pradesh,4,4,24,1,33,Fail
Raj Pillai,18-05-2005,982634,Uttar Pradesh,22,15,16,15,68,Fail
Vivaan Mehta,21-05-2005,808342,West Bengal,24,3,13,3,43,Fail
Raj Mehta,27-07-2005,445223,West Bengal,16,11,13,5,45,Fail
Krishna Chopra,25-11-2005,151855,West Bengal,22,12,6,10,50,Fail
Rohan Sharma,11-05-2005,331862,Gujarat,6,3,19,24,52,Fail
Vivaan Sharma,28-06-2005,996561,Tripura,23,2,3,12,40,Fail
Zaid D'Souza,08-03-2006,663890,Madhya Pradesh,16,23,2,0,41,Fail
Raj Reddy,12-09-2005,227419,Kerala,7,2,0,20,29,Pass
Krishna Pillai,12-09-2005,195930,Bihar,6,3,21,12,42,Pass
Peter Reddy,10-03-2006,190567,Telangana,22,13,10,12,57,Fail
David Reddy,05-04-2005,703647,Madhya Pradesh,12,6,20,15,53,Fail
Aryan D'Souza,08-03-2005,329682,West Bengal,7,24,3,11,45,Fail
Aditya Khan,19-04-2006,814714,Telangana,0,20,14,0,34,Fail
Aryan Verma,18-02-2005,931188,Chhattisgarh,7,19,5,5,36,Fail
Vivaan Pillai,22-01-2005,676234,Bihar,23,8,2,16,49,Pass
Krishna Sharma,14-03-2006,991355,Madhya Pradesh,8,6,15,3,32,Fail
John Pillai,25-10-2005,723319,Rajasthan,1,24,21,7,53,Pass
Manpreet Fernandes,13-07-2005,612919,Uttar Pradesh,8,6,8,6,28,Fail
Ishaan Singh,19-12-2005,618298,Madhya Pradesh,10,4,10,16,40,Fail
Yash Reddy,19-03-2006,147538,Chhattisgarh,10,23,7,5,45,Fail
Sukhwinder Singh,18-08-2005,648971,Rajasthan,3,10,21,1,35,Pass
Kunal Khan,13-12-2004,255708,Madhya Pradesh,7,13,3,3,26,Fail
Mathew Pillai,29-04-2005,328155,Tamil Nadu,12,7,14,19,52,Fail
Raj Fernandes,21-02-2006,405406,Maharashtra,3,5,9,15,32,Fail
Aryan Fernandes,13-04-2006,737064,Assam,0,20,18,12,50,Pass
Ishaan Mehta,14-01-2005,622687,Telangana,0,17,14,16,47,Fail
Aryan Reddy,28-12-2004,962120,Punjab,8,4,11,3,26,Pass
Aryan Pillai,06-04-2006,249310,Tamil Nadu,11,17,1,11,40,Pass
Vivaan Mehta,18-12-2004,196383,Rajasthan,20,7,4,2,33,Pass
Sukhwinder Sharma,09-02-2005,713938,Madhya Pradesh,11,16,15,7,49,Fail
Sukhwinder Reddy,21-05-2005,169253,Uttar Pradesh,22,1,20,7,50,Fail
Krishna Verma,11-10-2005,107924,Bihar,9,3,21,10,43,Pass
Vivaan Singh,20-06-2005,369394,Maharashtra,2,2,6,15,25,Fail
Peter Singh,01-10-2005,696061,Uttar Pradesh,18,12,15,4,49,Fail
Sukhwinder Khan,03-06-2005,845831,Punjab,3,22,11,15,51,Pass
Kunal D'Souza,16-11-2004,655050,Bihar,3,2,10,10,25,Pass
Harjeet Chopra,02-12-2005,522953,Uttar Pradesh,14,8,19,11,52,Fail
Raj Mehta,21-01-2006,219340,Rajasthan,23,22,14,23,82,Pass
Krishna Reddy,04-02-2005,945071,Andhra Pradesh,19,15,4,10,48,Pass
Yash Fernandes,18-12-2005,237596,Uttar Pradesh,21,8,1,3,33,Fail
Farhan Sharma,11-01-2005,575918,Punjab,18,5,4,16,43,Pass
Aarav Reddy,16-04-2006,132133,Jharkhand,5,6,24,14,49,Pass
Krishna Sharma,16-12-2005,547480,Tamil Nadu,8,19,7,0,34,Pass
Aditya Singh,28-02-2005,661848,Uttar Pradesh,11,1,10,5,27,Fail
Aditya Chopra,13-11-2004,535951,West Bengal,16,2,9,13,40,Fail
Yash Sharma,29-11-2005,620490,Haryana,23,5,20,22,70,Fail
Ishaan Sharma,24-06-2005,669788,Chhattisgarh,10,7,19,16,52,Fail
Kunal Fernandes,04-05-2005,491807,Tamil Nadu,21,1,20,24,66,Pass
Rohan Singh,25-01-2006,260449,Maharashtra,11,9,21,16,57,Fail
Sukhwinder Reddy,15-08-2005,689760,Uttar Pradesh,11,10,7,2,30,Fail
Mathew Khan,15-11-2004,526114,Haryana,24,9,16,17,66,Fail
Aryan Reddy,09-05-2005,729908,Uttar Pradesh,18,2,10,15,45,Fail
Yash Chopra,14-10-2005,665622,Tamil Nadu,22,1,3,7,33,Pass
Mathew Singh,10-04-2005,190574,Tamil Nadu,3,13,18,4,38,Pass
Balbir Chopra,24-03-2006,510528,Uttar Pradesh,22,0,17,1,40,Fail
Aryan Reddy,27-07-2005,388296,Haryana,23,5,21,16,65,Fail
Farhan Khan,27-03-2006,947290,Jharkhand,17,2,10,19,48,Pass
David D'Souza,05-11-2005,482812,Madhya Pradesh,5,15,19,14,53,Fail
Sukhwinder Khan,23-08-2005,407186,Jammu & Kashmir + Ladakh,1,14,20,18,53,Pass
Vivaan Verma,01-12-2004,318412,Telangana,22,22,7,15,66,Fail
Raj Verma,07-09-2005,445416,Madhya Pradesh,19,23,1,8,51,Fail
Aryan Pillai,28-07-2005,772671,West Bengal,21,3,2,11,37,Fail
Rohan Khan,27-10-2005,351888,Rajasthan,2,0,12,3,17,Pass
Aarav Reddy,04-05-2005,627015,Madhya Pradesh,11,12,3,6,32,Fail
Harjeet Chopra,28-04-2006,808709,Madhya Pradesh,13,0,21,11,45,Fail
Balbir Fernandes,28-02-2006,994467,West Bengal,5,14,9,8,36,Fail
Aditya Fernandes,13-04-2006,414195,Bihar,16,5,10,24,55,Pass
Ishaan Fernandes,02-12-2005,821264,Tripura,11,9,20,10,50,Fail
Aryan Sharma,17-12-2004,205821,Rajasthan,24,19,0,7,50,Pass
Raj Sharma,30-05-2005,781633,Punjab,22,9,12,20,63,Pass
Mathew Sharma,18-01-2005,922630,West Bengal,0,8,21,21,50,Fail
Peter Chopra,30-01-2005,885676,Maharashtra,4,22,3,22,51,Fail
Sukhwinder Khan,06-03-2005,442701,Tamil Nadu,12,12,12,12,48,Fail
Krishna Sharma,08-03-2006,787955,Madhya Pradesh,21,7,7,19,54,Fail
Aryan Pillai,03-09-2005,181581,Andhra Pradesh,19,24,16,4,63,Pass
Aryan Sharma,03-01-2006,695375,Rajasthan,1,10,12,9,32,Pass
Ishaan Sharma,27-04-2005,458327,Maharashtra,5,2,1,9,17,Fail
Harjeet Reddy,21-09-2005,423222,West Bengal,10,1,9,21,41,Fail
Gurpreet Reddy,25-02-2006,314538,Tamil Nadu,18,17,15,18,68,Fail
Manpreet Sharma,25-03-2005,333896,West Bengal,15,23,16,8,62,Fail
Kunal Singh,03-06-2005,970757,Meghalaya,23,10,15,13,61,Fail
Ishaan Singh,01-01-2005,726054,Rajasthan,12,8,3,11,34,Pass
Farhan D'Souza,08-10-2005,460395,Andhra Pradesh,11,4,24,18,57,Pass
David Khan,13-09-2005,372582,Bihar,11,2,20,12,45,Pass
Krishna Sharma,27-08-2005,523266,Tamil Nadu,21,6,2,11,40,Pass
Rohan Fernandes,15-03-2006,173053,Tamil Nadu,0,1,3,4,8,Pass
Ishaan Chopra,23-10-2005,883837,Maharashtra,4,10,11,0,25,Fail
Zaid D'Souza,27-02-2006,333211,Jharkhand,9,10,22,5,46,Pass
Raj Sharma,05-10-2005,779537,Maharashtra,2,7,13,23,45,Fail
Yash Sharma,24-01-2005,246231,Maharashtra,15,17,13,23,68,Fail
Rohan Singh,09-01-2005,339643,Bihar,4,8,17,10,39,Pass
Balbir Mehta,05-12-2004,117384,Bihar,23,18,17,2,60,Pass
Raj Chopra,25-06-2005,525355,Maharashtra,2,8,23,11,44,Fail
Krishna Fernandes,30-06-2005,484674,Tamil Nadu,24,4,11,18,57,Pass
Vivaan Fernandes,22-06-2005,761322,Jharkhand,3,11,1,24,39,Pass
Sukhwinder Verma,11-12-2004,786513,Haryana,14,22,11,21,68,Fail
Sukhwinder Reddy,02-01-2005,851386,Himachal Pradesh,11,0,12,13,36,Pass
Krishna Pillai,23-01-2006,653911,Madhya Pradesh,3,23,16,1,43,Fail
Balbir Sharma,22-02-2005,373382,Himachal Pradesh,21,21,20,22,84,Pass
David Khan,03-04-2006,264892,Gujarat,6,7,7,22,42,Fail
Mathew Mehta,14-08-2005,825531,Kerala,5,7,16,19,47,Pass
Aryan D'Souza,16-11-2004,658069,Uttar Pradesh,5,18,2,9,34,Fail
Peter Sharma,13-02-2006,556344,Manipur,12,3,21,15,51,Fail
Gurpreet Khan,19-05-2005,924930,Delhi,11,13,20,14,58,Fail
Krishna Chopra,03-12-2004,304448,Tamil Nadu,10,7,15,18,50,Fail
Krishna Chopra,02-03-2006,961524,Haryana,20,17,13,7,57,Fail
Vivaan Singh,11-08-2005,825887,Rajasthan,17,7,20,14,58,Pass
Gurpreet Reddy,18-04-2006,380975,Madhya Pradesh,5,1,10,7,23,Fail
Zaid Singh,23-04-2005,472418,Haryana,14,21,0,6,41,Fail
Peter Chopra,20-02-2005,725776,Arunachal Pradesh,24,0,9,15,48,Fail
Ishaan Verma,02-04-2006,957629,Telangana,16,21,7,11,55,Fail
Krishna Fernandes,17-05-2005,968228,Odisha,3,4,6,24,37,Pass
Kunal Singh,04-05-2005,813538,Rajasthan,4,6,17,3,30,Pass
Aditya Fernandes,30-12-2004,554044,Rajasthan,18,8,18,7,51,Pass
Peter Pillai,09-03-2005,525712,West Bengal,9,15,17,17,58,Fail
Aditya Pillai,22-10-2005,941550,Maharashtra,13,21,11,22,67,Fail
Yash Chopra,13-07-2005,835439,Madhya Pradesh,16,17,7,1,41,Fail
Kunal Pillai,06-06-2005,293534,Andhra Pradesh,1,15,22,16,54,Pass
Krishna Verma,03-05-2005,814739,Maharashtra,12,12,7,11,42,Fail
Kunal Khan,27-12-2004,678787,Maharashtra,5,16,16,22,59,Fail
Ishaan Sharma,31-10-2005,942099,Gujarat,6,2,4,12,24,Fail
Harjeet Mehta,12-05-2005,169591,Uttar Pradesh,2,10,18,24,54,Fail
Aarav Chopra,27-11-2004,387006,Kerala,23,3,14,22,62,Pass
Ishaan Mehta,21-04-2005,987686,Rajasthan,4,24,5,3,36,Pass
Rehan Khan,07-03-2005,704975,Uttar Pradesh,15,7,2,24,48,Fail
David Singh,31-05-2005,485160,Jharkhand,17,12,6,11,46,Pass
Gurpreet Mehta,18-02-2005,204640,Uttarakhand,23,15,23,13,74,Fail
Rohan D'Souza,27-07-2005,564975,Tripura,2,12,8,22,44,Fail
Vivaan Fernandes,17-06-2005,634068,West Bengal,8,17,17,0,42,Fail
Aarav Sharma,25-12-2005,440303,Rajasthan,22,19,19,4,64,Fail
Yash Pillai,06-04-2006,575197,Uttar Pradesh,22,8,7,1,38,Fail
Aryan D'Souza,26-03-2006,386410,Andhra Pradesh,17,6,12,6,41,Pass
Krishna Khan,15-02-2005,935914,Tamil Nadu,5,22,6,21,54,Fail
Aryan Mehta,17-11-2005,956706,Maharashtra,11,10,14,20,55,Fail
Raj Verma,21-11-2005,735099,Assam,9,22,11,4,46,Pass
Raj Reddy,27-06-2005,708529,Bihar,10,20,8,23,61,Pass
Raj Singh,25-02-2006,445107,Rajasthan,19,12,12,6,49,Pass
Vivaan Sharma,07-06-2005,595788,Andhra Pradesh,10,17,14,4,45,Pass
Imran Verma,02-10-2005,719949,Punjab,5,20,20,23,68,Pass
Aarav Sharma,15-04-2005,388025,Rajasthan,8,13,16,8,45,Pass
Ayaan Singh,28-09-2005,919626,Rajasthan,12,23,12,12,59,Pass
Ayaan Singh,03-02-2005,993854,Jammu & Kashmir + Ladakh,5,0,6,21,32,Pass
Gurpreet D'Souza,25-10-2005,286479,Bihar,23,4,16,19,62,Pass
Mathew Singh,19-11-2004,500259,Andhra Pradesh,23,0,20,11,54,Pass
Ishaan Fernandes,26-04-2006,111912,Uttar Pradesh,7,16,10,0,33,Fail
Gurpreet Verma,20-03-2005,424482,Bihar,20,1,8,15,44,Pass
Harjeet Verma,15-08-2005,111698,Madhya Pradesh,14,21,16,19,70,Fail
Aditya Reddy,02-10-2005,281933,Gujarat,19,6,1,14,40,Fail
Zaid Khan,01-01-2006,852005,West Bengal,9,1,7,14,31,Fail
Kunal Pillai,29-08-2005,200534,Bihar,0,5,22,5,32,Pass
Farhan Mehta,20-04-2006,897744,Punjab,3,3,11,23,40,Pass
Aditya Reddy,08-02-2006,617260,Rajasthan,4,3,0,23,30,Pass
Gurpreet Khan,18-08-2005,251793,Maharashtra,8,23,20,12,63,Fail
Krishna Verma,02-12-2005,269815,Uttar Pradesh,6,4,14,3,27,Fail
Ishaan Chopra,12-11-2004,596225,Rajasthan,20,22,2,20,64,Fail
Sukhwinder Reddy,23-12-2004,648972,Maharashtra,4,0,3,7,14,Fail
Zaid Sharma,20-02-2005,620320,Gujarat,16,12,2,0,30,Fail
Vivaan Pillai,13-01-2005,819682,Delhi,14,1,22,17,54,Fail
Vivaan Pillai,22-04-2005,531070,Bihar,24,9,0,19,52,Pass
Peter Chopra,27-11-2004,613845,Chhattisgarh,8,3,3,18,32,Fail
Yash D'Souza,19-11-2005,894522,West Bengal,4,21,19,2,46,Fail
Paul Khan,19-03-2006,711142,Assam,22,1,13,8,44,Pass
Mathew Mehta,16-09-2005,309169,Manipur,14,3,13,22,52,Fail
John Reddy,15-02-2005,141093,Odisha,13,15,7,9,44,Pass
Kunal Chopra,11-04-2005,924409,Rajasthan,23,12,8,6,49,Pass
Raj Sharma,30-06-2005,450835,Rajasthan,22,2,15,23,62,Fail
Balbir Verma,24-01-2006,738746,Bihar,7,3,19,15,44,Pass
Yash D'Souza,24-11-2005,406824,Telangana,19,11,10,0,40,Fail
Aarav D'Souza,18-02-2005,807902,Kerala,23,6,17,22,68,Fail
Vivaan Khan,09-03-2005,222350,Uttar Pradesh,24,9,17,1,51,Fail
Gurpreet Singh,03-12-2005,254258,Uttar Pradesh,14,20,18,5,57,Fail
Balbir Pillai,16-04-2005,376166,Maharashtra,12,3,11,24,50,Fail
Krishna Mehta,17-01-2006,259206,Delhi,20,11,13,11,55,Fail
Raj Chopra,09-12-2004,856973,Gujarat,3,15,14,23,55,Fail
Peter Khan,28-06-2005,124420,Rajasthan,23,2,23,23,71,Fail
Ishaan Sharma,08-12-2005,596215,Uttar Pradesh,17,7,13,4,41,Fail
Yash Fernandes,31-03-2006,110720,Andhra Pradesh,16,1,24,8,49,Pass
Rohan Fernandes,21-02-2006,191957,West Bengal,18,18,12,20,68,Fail
Rehan Sharma,25-12-2004,713229,Uttar Pradesh,23,14,0,24,61,Fail
Ishaan D'Souza,14-11-2004,116400,Goa,10,7,5,15,37,Fail
Balbir Reddy,13-04-2006,685924,Bihar,5,24,8,0,37,Pass
Raj D'Souza,30-08-2005,778050,Chhattisgarh,16,0,23,17,56,Fail
Aarav Pillai,26-01-2005,542556,West Bengal,7,14,24,22,67,Fail
Krishna D'Souza,05-05-2006,541162,Chhattisgarh,5,16,10,22,53,Fail
Aryan Chopra,30-09-2005,157306,Madhya Pradesh,15,21,15,14,65,Fail
David Pillai,01-07-2005,329127,Andhra Pradesh,18,11,18,13,60,Pass
Harjeet Pillai,29-06-2005,829956,Madhya Pradesh,18,1,21,6,46,Fail
Aarav Chopra,24-03-2006,239756,Karnataka,12,19,18,21,70,Fail
Kunal Verma,20-11-2004,453721,West Bengal,5,19,22,6,52,Fail
Kunal Singh,01-02-2005,230595,Madhya Pradesh,3,5,21,9,38,Fail
Imran Khan,17-11-2004,286650,Rajasthan,6,0,14,22,42,Pass
Farhan Verma,06-01-2005,912131,Madhya Pradesh,3,23,6,24,56,Fail
Kunal Verma,12-01-2006,659993,Uttar Pradesh,15,15,5,20,55,Fail
Aditya Mehta,06-11-2005,276926,Rajasthan,23,19,5,10,57,Pass
Harjeet Sharma,18-08-2005,929971,Maharashtra,13,15,11,8,47,Fail
Ishaan Mehta,31-03-2005,318066,Mizoram,19,15,6,14,54,Fail
Yash D'Souza,29-05-2005,602269,Karnataka,24,7,7,4,42,Pass
Kunal D'Souza,04-06-2005,716660,Jammu & Kashmir + Ladakh,7,0,19,18,44,Pass
Gurpreet Verma,22-02-2005,869594,Madhya Pradesh,10,19,3,22,54,Fail
Ishaan Mehta,13-06-2005,593569,Kerala,5,12,23,14,54,Pass
Rohan Sharma,20-12-2004,453548,Telangana,4,19,14,1,38,Fail
Mathew Khan,18-12-2005,171420,West Bengal,19,22,10,14,65,Fail
Vivaan Chopra,24-12-2005,992750,Uttar Pradesh,10,18,1,3,32,Fail
Aarav Sharma,03-02-2006,205715,Madhya Pradesh,18,4,24,20,66,Fail
Peter Singh,10-04-2005,383693,Bihar,4,23,17,15,59,Pass
David Pillai,09-11-2005,778172,West Bengal,8,6,5,8,27,Fail
Aarav Reddy,26-01-2005,247478,Andhra Pradesh,12,8,3,22,45,Pass
Aarav Mehta,26-04-2006,657730,Assam,20,22,20,19,81,Pass
John Sharma,30-04-2005,460921,West Bengal,8,3,10,17,38,Fail
Sukhwinder Mehta,18-02-2005,874226,Rajasthan,16,22,4,22,64,Fail
Paul Chopra,23-11-2005,497968,Assam,24,4,9,24,61,Pass
Harjeet Pillai,25-05-2005,159818,Uttar Pradesh,3,12,1,10,26,Fail
Rohan Chopra,16-03-2005,155072,Punjab,6,2,4,7,19,Pass
Gurpreet Mehta,21-02-2006,747761,Uttar Pradesh,12,8,7,15,42,Fail
Krishna Singh,28-05-2005,322162,Bihar,4,9,9,24,46,Pass
Krishna Fernandes,11-08-2005,714789,Punjab,1,13,17,16,47,Pass
Manpreet D'Souza,15-10-2005,947078,Odisha,21,11,2,14,48,Pass
Mathew Singh,04-09-2005,353230,Maharashtra,24,2,15,0,41,Fail
Aryan Singh,10-04-2005,280016,Tamil Nadu,13,23,18,18,72,Pass
Vivaan Verma,21-01-2005,773824,Jammu & Kashmir + Ladakh,24,4,18,15,61,Pass
Vivaan Mehta,07-12-2004,467101,Tripura,23,7,23,9,62,Fail
Vivaan Pillai,28-04-2005,676675,Punjab,22,4,4,7,37,Pass
Yash Chopra,31-03-2005,328314,Madhya Pradesh,9,23,19,23,74,Fail
Harjeet Verma,26-02-2005,398285,Bihar,8,2,10,17,37,Pass
Krishna Sharma,19-07-2005,971463,Bihar,11,14,15,19,59,Pass
Zaid Mehta,16-02-2005,222327,West Bengal,12,10,12,24,58,Fail
Rohan Sharma,04-04-2006,334207,Haryana,7,20,24,13,64,Fail
Aditya Verma,07-08-2005,658291,Gujarat,10,24,1,5,40,Fail
Yash Chopra,13-03-2006,990016,Kerala,0,11,10,12,33,Pass
Aditya Khan,25-07-2005,919163,Madhya Pradesh,6,18,24,7,55,Fail
Aryan Reddy,24-04-2005,842303,Tamil Nadu,3,10,1,18,32,Pass
Sukhwinder Verma,08-02-2005,819271,Uttar Pradesh,2,8,5,4,19,Fail
Gurpreet Sharma,15-02-2006,971751,Kerala,3,2,17,8,30,Pass
Krishna Verma,02-02-2006,455623,Punjab,20,21,20,5,66,Pass
Manpreet Mehta,23-02-2006,983956,Punjab,4,3,9,12,28,Pass
John D'Souza,24-03-2005,436952,Maharashtra,20,6,12,10,48,Fail
Paul Singh,05-01-2006,586299,West Bengal,9,0,7,15,31,Fail
Aditya Fernandes,13-06-2005,714874,Madhya Pradesh,17,13,7,15,52,Fail
Yash Khan,09-12-2005,645352,Madhya Pradesh,23,2,13,5,43,Fail
Gurpreet Fernandes,31-01-2006,733128,Punjab,11,21,0,13,45,Pass
Aditya Reddy,21-09-2005,513567,Jammu & Kashmir + Ladakh,10,20,3,13,46,Pass
Aryan D'Souza,04-10-2005,753872,Odisha,24,16,20,9,69,Pass
Peter Singh,06-02-2006,251516,Bihar,5,3,21,15,44,Pass
Imran Verma,02-03-2005,780763,Jharkhand,12,13,16,2,43,Pass
Mathew Pillai,30-03-2006,435904,Bihar,15,13,15,3,46,Pass
Aryan Mehta,22-05-2005,685675,Punjab,24,8,17,2,51,Pass
Balbir Pillai,27-09-2005,552677,Gujarat,1,17,13,8,39,Fail
Kunal Mehta,01-06-2005,301526,Tamil Nadu,24,22,10,12,68,Fail
Kunal Singh,16-01-2006,496005,Bihar,3,12,10,9,34,Pass
Manpreet D'Souza,02-05-2006,405999,Tamil Nadu,16,3,12,10,41,Pass
Vivaan Khan,05-11-2005,361366,Jammu & Kashmir + Ladakh,23,22,10,12,67,Pass
Kunal Verma,15-11-2005,360086,Jharkhand,15,8,8,10,41,Pass
Imran Singh,24-03-2006,755293,Uttar Pradesh,23,17,12,24,76,Fail
Aarav Sharma,20-01-2005,199348,Maharashtra,4,2,23,1,30,Fail
Kunal Sharma,18-02-2006,972452,Uttar Pradesh,12,16,0,11,39,Fail
Krishna Khan,16-08-2005,118289,Bihar,18,17,24,21,80,Pass
Aarav Pillai,13-11-2005,292147,Kerala,24,1,1,23,49,Pass
Aryan Mehta,02-10-2005,981882,Odisha,4,18,13,4,39,Pass
Aarav Reddy,26-09-2005,644633,Maharashtra,5,2,15,11,33,Fail
Aarav Mehta,18-12-2005,655826,Rajasthan,17,2,23,9,51,Pass
Raj Pillai,17-01-2006,309128,Madhya Pradesh,19,17,5,19,60,Fail
Vivaan Verma,04-08-2005,954932,Tamil Nadu,4,11,5,18,38,Pass
Aditya Reddy,05-04-2005,725105,Maharashtra,23,3,19,2,47,Fail
Krishna Sharma,15-01-2005,858970,West Bengal,16,23,1,2,42,Fail
Kunal Chopra,23-12-2004,284682,Kerala,21,14,0,18,53,Pass
Aditya Verma,11-01-2005,637770,Karnataka,14,21,9,24,68,Fail
Balbir D'Souza,17-02-2005,302233,Uttar Pradesh,12,10,19,10,51,Fail
Sukhwinder Khan,03-04-2005,203918,Assam,2,0,2,2,6,Pass
Paul Chopra,13-04-2005,433435,Telangana,1,5,20,10,36,Fail
Aarav Sharma,09-01-2006,508987,Madhya Pradesh,20,23,9,21,73,Fail
Aditya Chopra,29-11-2005,913715,Rajasthan,2,19,13,13,47,Pass
Manpreet Khan,05-12-2004,678531,Haryana,0,17,10,4,31,Fail
Sukhwinder Mehta,14-01-2006,700596,Punjab,22,23,16,0,61,Pass
Ayaan Fernandes,28-03-2005,998076,Uttar Pradesh,10,12,12,15,49,Fail
Aarav D'Souza,25-11-2005,339827,Andhra Pradesh,3,15,4,18,40,Pass
Yash Mehta,02-01-2006,330628,Rajasthan,23,20,22,2,67,Fail
Vivaan D'Souza,18-12-2004,387273,Gujarat,8,2,17,20,47,Fail
Aryan Mehta,10-07-2005,782215,Karnataka,1,10,16,19,46,Pass
Aarav Chopra,11-10-2005,878390,Assam,10,10,20,23,63,Pass
Aditya Pillai,21-04-2005,342862,Himachal Pradesh,4,16,12,22,54,Pass
John Verma,25-12-2004,716731,Madhya Pradesh,15,18,9,0,42,Fail
Rohan Khan,11-01-2005,304802,Bihar,18,19,5,2,44,Pass
Mathew D'Souza,13-06-2005,888543,Maharashtra,4,1,9,4,18,Fail
Krishna Sharma,14-05-2005,806715,Andhra Pradesh,8,21,23,18,70,Pass
Gurpreet Reddy,02-04-2006,320706,Bihar,9,0,17,3,29,Pass
Rohan Fernandes,06-12-2004,553678,Tamil Nadu,17,13,8,13,51,Pass
Harjeet Khan,15-03-2006,998355,Uttar Pradesh,4,22,13,18,57,Fail
Sukhwinder Chopra,09-09-2005,829929,West Bengal,16,14,20,6,56,Fail
Harjeet Verma,04-03-2005,957446,Manipur,2,7,9,24,42,Fail
Manpreet Sharma,12-02-2006,343799,West Bengal,3,10,7,0,20,Fail
John Reddy,10-05-2005,828390,Uttar Pradesh,5,2,4,8,19,Fail
Aditya Pillai,20-01-2005,361381,Jharkhand,3,23,8,7,41,Pass
Vivaan Mehta,01-01-2006,766757,Haryana,12,8,23,2,45,Fail
Aditya Verma,24-06-2005,976303,Madhya Pradesh,15,12,1,1,29,Fail
Aryan Verma,23-02-2006,861426,Bihar,3,13,14,17,47,Pass
Aryan Fernandes,27-07-2005,454928,Odisha,9,5,9,7,30,Pass
Zaid Reddy,18-06-2005,367703,Punjab,6,2,22,22,52,Pass
John Chopra,21-02-2005,440290,Andhra Pradesh,0,8,6,3,17,Pass
Manpreet Verma,18-12-2005,348897,West Bengal,7,21,16,3,47,Fail
Ishaan Mehta,13-04-2005,906094,Madhya Pradesh,1,12,4,9,26,Fail
Krishna Fernandes,17-04-2006,933164,Madhya Pradesh,21,12,16,20,69,Fail
Aryan Singh,26-08-2005,631738,Haryana,16,16,3,20,55,Fail
Kunal Pillai,15-08-2005,532108,West Bengal,0,12,18,14,44,Fail
Mathew Chopra,29-03-2005,294816,Himachal Pradesh,6,18,24,7,55,Pass
Balbir Reddy,02-04-2006,172756,Rajasthan,15,21,21,24,81,Pass
Aryan Pillai,13-04-2005,914371,Jammu & Kashmir + Ladakh,11,14,21,13,59,Pass
Ayaan Fernandes,06-12-2004,214303,Madhya Pradesh,15,1,12,13,41,Fail
Aryan Khan,06-05-2005,346450,Gujarat,16,8,6,13,43,Fail
Aditya Chopra,16-07-2005,292683,Uttar Pradesh,4,19,16,1,40,Fail
Aryan Singh,22-01-2005,309491,Maharashtra,21,4,19,15,59,Fail
Gurpreet Mehta,27-09-2005,501136,Uttar Pradesh,9,8,5,22,44,Fail
Raj Sharma,12-02-2005,306719,Chhattisgarh,4,19,0,15,38,Fail
Sukhwinder Pillai,24-02-2005,988579,Uttar Pradesh,0,12,23,4,39,Fail
Aarav Singh,13-02-2005,570256,Kerala,19,4,3,0,26,Pass
Gurpreet Khan,03-02-2005,418162,Jharkhand,2,11,22,12,47,Pass
Aarav Fernandes,21-08-2005,500779,Jammu & Kashmir + Ladakh,11,16,8,12,47,Pass
Raj D'Souza,01-06-2005,469234,Himachal Pradesh,21,3,4,11,39,Pass
Vivaan Verma,06-04-2006,854888,Maharashtra,21,18,18,10,67,Fail
Aryan D'Souza,10-07-2005,492872,Uttar Pradesh,10,9,0,0,19,Fail
Aryan Chopra,05-12-2004,201427,Odisha,11,16,20,5,52,Pass
Aditya Chopra,29-04-2005,690802,Haryana,10,10,12,18,50,Fail
Balbir Chopra,09-03-2005,149485,Rajasthan,4,12,5,20,41,Pass
Kunal Singh,17-06-2005,396306,Uttar Pradesh,13,22,14,15,64,Fail
Raj Reddy,05-02-2006,107704,Jammu & Kashmir + Ladakh,2,19,11,16,48,Pass
Raj Reddy,07-12-2004,858372,Punjab,9,9,17,3,38,Pass
Kunal Verma,05-01-2005,968376,Jharkhand,1,11,21,22,55,Pass
Farhan Mehta,20-11-2005,323512,Tamil Nadu,18,24,13,2,57,Pass
Kunal Fernandes,03-02-2006,828391,Karnataka,15,24,20,21,80,Fail
Krishna D'Souza,09-04-2005,635090,Karnataka,14,3,3,12,32,Pass
John Fernandes,20-04-2005,782174,Himachal Pradesh,12,7,21,13,53,Pass
Krishna Mehta,24-03-2006,615974,Maharashtra,4,18,3,11,36,Fail
Ishaan Chopra,01-09-2005,783929,Himachal Pradesh,0,24,9,6,39,Pass
Raj D'Souza,12-02-2005,511137,Uttar Pradesh,19,6,20,14,59,Fail
Raj Chopra,13-03-2006,295983,Maharashtra,4,8,19,11,42,Fail
Rohan Sharma,20-11-2004,605188,Uttar Pradesh,22,18,2,10,52,Fail
Yash D'Souza,01-08-2005,630187,Delhi,10,22,21,17,70,Fail
Aarav Khan,12-01-2005,274202,Bihar,22,10,13,8,53,Pass
Manpreet Pillai,17-04-2005,509125,Madhya Pradesh,10,6,14,3,33,Fail
Ishaan Verma,20-03-2005,567128,Rajasthan,6,14,8,11,39,Pass
Manpreet Singh,15-11-2004,765977,Bihar,16,22,1,10,49,Pass
Ishaan Mehta,31-03-2005,369746,Bihar,24,17,4,11,56,Pass
Aryan Pillai,20-12-2005,229970,Madhya Pradesh,7,20,11,23,61,Fail
Aditya Verma,24-01-2006,844818,Maharashtra,3,19,20,14,56,Fail
Aarav Verma,08-04-2005,685637,Haryana,15,4,0,17,36,Fail
Krishna Fernandes,03-09-2005,642371,Maharashtra,22,20,23,7,72,Fail
Aditya Reddy,06-02-2006,147923,Telangana,0,15,17,19,51,Fail
Aryan Khan,09-12-2004,612008,Bihar,2,13,21,18,54,Pass
Aarav Verma,29-10-2005,581419,Punjab,19,0,12,19,50,Pass
Peter Verma,18-11-2005,197618,Bihar,17,20,23,3,63,Pass
Raj Sharma,19-03-2006,757388,Haryana,12,19,3,12,46,Fail
Ayaan Khan,23-12-2005,251969,Andhra Pradesh,20,18,1,21,60,Pass
Harjeet Chopra,22-02-2006,824391,Haryana,7,24,10,12,53,Fail
Manpreet D'Souza,02-01-2005,922160,Maharashtra,23,16,5,17,61,Fail
Rohan Sharma,08-12-2005,558902,West Bengal,10,10,12,10,42,Fail
Gurpreet Reddy,25-10-2005,701449,Odisha,3,17,10,12,42,Pass
David Mehta,28-09-2005,164795,Rajasthan,17,2,14,20,53,Pass
Kunal Singh,27-04-2006,583325,Odisha,13,11,9,17,50,Pass
David Singh,25-02-2006,969903,Punjab,4,16,3,10,33,Pass
Vivaan Reddy,02-11-2005,689295,Haryana,1,6,0,6,13,Fail
Harjeet Singh,19-03-2006,591921,Punjab,21,2,13,2,38,Pass
Aditya Mehta,15-09-2005,705250,Bihar,16,1,1,18,36,Pass
Vivaan Khan,05-04-2006,547625,Uttar Pradesh,12,19,13,18,62,Fail
Krishna Sharma,29-09-2005,321149,Karnataka,10,21,7,16,54,Pass
Krishna Mehta,17-04-2005,372649,Rajasthan,19,14,20,2,55,Pass
Krishna Verma,01-12-2005,700021,Maharashtra,16,11,18,11,56,Fail
Vivaan Fernandes,23-12-2004,772550,Bihar,10,1,20,9,40,Pass
Farhan Singh,06-01-2006,639270,Uttar Pradesh,17,14,17,19,67,Fail
Ishaan Verma,02-05-2005,853610,West Bengal,24,9,7,9,49,Fail
Vivaan Mehta,24-06-2005,750964,Madhya Pradesh,2,2,18,12,34,Fail
Balbir D'Souza,19-02-2006,338045,West Bengal,12,4,11,19,46,Fail
Gurpreet Mehta,15-12-2004,269957,Gujarat,11,17,9,18,55,Fail
Sukhwinder Chopra,02-12-2005,549613,Odisha,22,14,2,16,54,Pass
Rehan Reddy,01-02-2005,649191,Jharkhand,23,20,19,3,65,Fail
Manpreet Khan,23-04-2005,478155,Uttarakhand,8,9,8,3,28,Fail
Ayaan Singh,07-07-2005,547606,Rajasthan,18,1,14,0,33,Pass
Yash Chopra,12-12-2004,772305,Kerala,12,20,16,8,56,Pass
Ishaan Mehta,15-04-2005,487980,Rajasthan,17,20,8,15,60,Fail
Rohan Verma,29-04-2005,354231,Jharkhand,0,8,11,19,38,Pass
Imran Fernandes,07-11-2005,941198,Kerala,1,23,2,7,33,Pass
Kunal Mehta,13-01-2005,871087,Bihar,23,15,8,0,46,Pass
Vivaan Verma,28-10-2005,367124,Kerala,1,15,0,3,19,Pass
Vivaan D'Souza,27-12-2005,424268,Uttar Pradesh,8,12,11,15,46,Fail
Sukhwinder Pillai,07-09-2005,893241,Manipur,8,8,10,18,44,Fail
Yash Singh,18-06-2005,351246,Uttar Pradesh,21,6,19,24,70,Fail
Raj Mehta,25-04-2006,711076,Uttar Pradesh,0,2,2,7,11,Fail
Kunal Pillai,01-03-2006,446085,Odisha,11,2,1,11,25,Pass
Sukhwinder Pillai,28-10-2005,522266,Odisha,10,15,0,19,44,Pass
Kunal Mehta,26-05-2005,500724,Uttar Pradesh,2,18,11,3,34,Fail
Yash Khan,07-02-2005,666302,Haryana,24,21,23,7,75,Fail
Vivaan Mehta,21-04-2005,239757,Maharashtra,7,11,1,21,40,Fail
Zaid Mehta,24-08-2005,191928,Telangana,3,12,8,2,25,Fail
Aryan Khan,30-12-2004,606653,Manipur,6,4,22,11,43,Fail
Kunal Mehta,10-12-2004,354000,Tamil Nadu,21,24,22,8,75,Pass
Yash Reddy,21-08-2005,632412,Delhi,3,0,19,18,40,Fail
Ishaan Chopra,10-11-2004,251595,Tamil Nadu,11,22,4,12,49,Fail
Krishna Singh,07-02-2005,158663,Arunachal Pradesh,19,7,17,1,44,Fail
Yash D'Souza,08-11-2005,427310,West Bengal,21,5,15,21,62,Fail
Balbir Fernandes,13-03-2005,266430,Punjab,15,18,12,13,58,Pass
Ayaan Singh,13-05-2005,864424,Himachal Pradesh,6,7,5,4,22,Pass
Aditya Fernandes,17-01-2006,989791,Rajasthan,12,3,4,13,32,Pass
Rohan Pillai,20-04-2005,633162,Uttarakhand,16,19,1,7,43,Fail
Rohan D'Souza,22-11-2004,912186,Arunachal Pradesh,8,5,9,13,35,Fail
Yash Fernandes,09-12-2005,206543,Jammu & Kashmir + Ladakh,16,4,3,1,24,Pass
Aarav Fernandes,12-04-2006,839419,Assam,18,8,14,12,52,Pass
Ayaan D'Souza,09-08-2005,942421,Karnataka,13,7,7,17,44,Pass
Ishaan Chopra,01-01-2005,231087,Gujarat,4,10,17,3,34,Fail
Gurpreet Pillai,22-10-2005,630403,Punjab,0,12,18,0,30,Pass
Krishna Pillai,25-05-2005,831757,Chhattisgarh,17,8,8,12,45,Fail
Aryan Singh,20-04-2006,827032,Uttarakhand,11,17,22,0,50,Fail
Rohan Singh,28-03-2006,610386,Tamil Nadu,16,15,10,19,60,Pass
Aryan Verma,09-11-2004,903787,Gujarat,22,2,18,15,57,Fail
Peter Mehta,09-11-2005,371636,Rajasthan,13,8,10,5,36,Pass
Gurpreet Fernandes,05-02-2005,829352,Uttar Pradesh,17,10,11,22,60,Fail
Aryan Singh,25-01-2005,440434,Jharkhand,8,10,9,3,30,Pass
Harjeet Verma,02-03-2006,427542,Jharkhand,22,15,9,22,68,Fail
Aarav Khan,01-04-2006,887769,West Bengal,7,22,0,0,29,Fail
Vivaan Khan,21-01-2006,851195,Kerala,21,10,12,2,45,Pass
Balbir Pillai,27-07-2005,730685,Karnataka,16,22,3,21,62,Pass
Kunal Chopra,19-03-2006,214634,Rajasthan,5,22,2,9,38,Pass
Vivaan Pillai,09-07-2005,854293,Rajasthan,15,18,2,1,36,Pass
Balbir Singh,15-07-2005,831018,Himachal Pradesh,12,21,23,2,58,Pass
Raj Khan,07-05-2006,420300,Haryana,9,10,12,7,38,Fail
Krishna Khan,23-04-2006,421189,Uttar Pradesh,9,15,16,19,59,Fail
Krishna Pillai,01-04-2005,697568,Maharashtra,3,13,23,23,62,Fail
Rohan Sharma,11-11-2005,470371,Uttar Pradesh,3,8,3,23,37,Fail
Rohan Verma,13-08-2005,497345,Madhya Pradesh,1,20,5,20,46,Fail
Aryan Sharma,28-12-2004,221574,Punjab,16,15,1,12,44,Pass
Aditya Pillai,02-02-2006,571954,Maharashtra,10,11,2,16,39,Fail
Ishaan Singh,24-12-2004,914040,Uttar Pradesh,0,24,10,24,58,Fail
Paul Khan,16-03-2005,969809,Madhya Pradesh,14,3,14,16,47,Fail
Krishna Mehta,21-04-2006,145626,Bihar,2,23,7,4,36,Pass
Kunal Khan,11-12-2005,428109,Assam,2,9,12,13,36,Pass
Sukhwinder Verma,19-06-2005,749387,Bihar,19,22,15,13,69,Pass
Aditya D'Souza,12-10-2005,336608,West Bengal,8,15,7,1,31,Fail
Kunal Sharma,21-11-2004,632366,Delhi,9,12,8,2,31,Fail
Gurpreet Mehta,01-08-2005,650045,Rajasthan,15,9,23,22,69,Fail
John Reddy,05-04-2005,751927,Andhra Pradesh,21,11,14,11,57,Pass
Aryan Reddy,14-05-2005,162533,Andhra Pradesh,14,5,4,3,26,Pass
Aryan Khan,03-04-2006,197132,Jharkhand,10,6,19,15,50,Pass
Aditya Reddy,14-04-2006,600230,Rajasthan,3,21,13,11,48,Pass
Krishna Fernandes,23-01-2005,559561,Odisha,2,0,14,12,28,Pass
Manpreet Mehta,14-05-2005,315145,Madhya Pradesh,7,6,10,12,35,Fail
Balbir Verma,02-05-2006,574611,Rajasthan,6,11,3,22,42,Pass
David Singh,26-11-2004,879822,Haryana,15,21,11,7,54,Fail
John Verma,27-05-2005,979005,Jharkhand,6,3,10,17,36,Pass
Yash Verma,25-12-2005,940646,Andhra Pradesh,0,15,13,23,51,Pass
Aryan D'Souza,21-06-2005,497511,Bihar,1,0,13,16,30,Pass
Aditya Pillai,03-08-2005,598009,Chhattisgarh,5,11,19,16,51,Fail
Balbir Reddy,25-10-2005,579391,Gujarat,4,15,10,20,49,Fail
Yash Khan,22-07-2005,565799,Bihar,15,19,6,15,55,Pass
Harjeet Mehta,15-03-2006,896592,Bihar,9,14,17,22,62,Pass
Balbir Verma,21-02-2006,330104,Tamil Nadu,24,10,3,17,54,Fail
Ishaan Khan,29-07-2005,499922,Madhya Pradesh,19,22,18,6,65,Fail
Rohan Chopra,25-05-2005,753747,Kerala,19,21,24,11,75,Fail
Mathew Fernandes,27-07-2005,839444,Haryana,9,8,17,18,52,Fail
Raj Singh,25-02-2005,599196,Haryana,2,11,23,7,43,Fail
Vivaan Mehta,06-01-2005,127119,Uttar Pradesh,23,11,9,4,47,Fail
Kunal Pillai,21-02-2006,878820,West Bengal,9,23,23,14,69,Fail
Manpreet Khan,25-11-2004,204890,Andhra Pradesh,5,24,16,21,66,Pass
Vivaan Pillai,09-04-2005,556095,Kerala,18,4,0,1,23,Pass
Vivaan Sharma,31-08-2005,105544,Rajasthan,24,14,24,5,67,Fail
John Chopra,16-03-2006,177130,Uttar Pradesh,18,16,9,4,47,Fail
Yash Mehta,18-03-2005,239535,Maharashtra,10,5,6,1,22,Fail
Mathew Pillai,16-01-2006,620338,Madhya Pradesh,17,15,15,8,55,Fail
Aryan Sharma,09-05-2006,427721,Punjab,0,10,14,8,32,Pass
Kunal Chopra,20-08-2005,781049,Bihar,2,24,23,9,58,Pass
Balbir Verma,24-03-2006,379529,Haryana,24,6,11,24,65,Fail
Rohan Fernandes,03-12-2004,393686,Madhya Pradesh,1,14,4,16,35,Fail
Krishna D'Souza,09-05-2006,319916,Delhi,7,2,19,10,38,Fail
Kunal Fernandes,21-12-2004,113409,Madhya Pradesh,3,20,10,18,51,Fail
Ishaan Khan,31-05-2005,414144,Odisha,9,8,14,17,48,Pass
Raj Pillai,13-04-2006,445329,Jharkhand,19,24,16,1,60,Pass
Aarav Reddy,29-11-2004,355307,Maharashtra,2,16,22,20,60,Fail
Aarav Verma,24-02-2005,244875,Chhattisgarh,13,20,4,1,38,Fail
Sukhwinder Sharma,13-08-2005,606307,Rajasthan,1,13,2,22,38,Pass
Yash Singh,21-01-2005,886319,West Bengal,18,0,6,10,34,Fail
Aditya Pillai,15-09-2005,987535,Tripura,0,22,6,7,35,Fail
Manpreet Sharma,08-11-2004,766533,Rajasthan,4,8,19,21,52,Pass
Krishna Sharma,03-12-2004,107724,Haryana,16,22,16,4,58,Fail
Manpreet Fernandes,30-01-2005,167461,Kerala,23,6,12,10,51,Pass
Farhan Singh,13-08-2005,532910,Uttarakhand,13,19,6,19,57,Fail
Ishaan Reddy,27-11-2005,836338,Rajasthan,9,21,1,6,37,Pass
Sukhwinder Pillai,24-12-2004,777210,Karnataka,12,2,3,3,20,Pass
Peter Singh,30-12-2004,344926,Andhra Pradesh,7,15,8,14,44,Pass
Raj Sharma,11-08-2005,828689,Madhya Pradesh,5,18,12,18,53,Fail
Gurpreet Mehta,30-09-2005,320293,Rajasthan,21,24,11,13,69,Fail
Raj Fernandes,28-02-2006,355570,Andaman & Nicobar,16,6,2,14,38,Pass
Ishaan D'Souza,13-05-2005,324255,Jharkhand,7,16,22,19,64,Pass
Rohan Pillai,20-01-2006,449797,Uttar Pradesh,24,0,3,3,30,Fail
Harjeet Fernandes,12-10-2005,652641,Himachal Pradesh,13,0,14,8,35,Pass
Kunal D'Souza,09-09-2005,498524,Bihar,2,9,14,1,26,Pass
Aarav Mehta,30-04-2006,811422,Haryana,9,22,16,11,58,Fail
David Fernandes,25-04-2006,988188,Bihar,6,7,17,15,45,Pass
Aarav Fernandes,23-06-2005,360036,Rajasthan,22,20,2,6,50,Pass
Ayaan Verma,22-07-2005,620542,Bihar,8,9,20,4,41,Pass
Krishna Pillai,18-04-2006,587161,Karnataka,12,2,22,12,48,Pass
Gurpreet Pillai,13-02-2005,964432,Kerala,14,7,10,8,39,Pass
Krishna Pillai,30-01-2006,139230,Tamil Nadu,1,20,16,16,53,Fail
Paul Pillai,05-10-2005,885785,Bihar,20,12,24,17,73,Pass
Ishaan Verma,11-03-2006,825202,Uttar Pradesh,10,24,15,23,72,Fail
Harjeet Khan,23-01-2005,205168,Tamil Nadu,3,5,17,19,44,Pass
Vivaan Singh,31-01-2005,988111,Bihar,22,23,18,20,83,Pass
Raj Sharma,24-07-2005,377952,Gujarat,2,2,21,21,46,Fail
Gurpreet Verma,12-05-2005,852321,Uttar Pradesh,13,1,24,10,48,Fail
Balbir Mehta,24-05-2005,858800,Karnataka,5,21,10,16,52,Pass
Rohan Mehta,20-02-2005,246125,Assam,2,11,13,16,42,Pass
Aditya Chopra,11-05-2005,218879,Punjab,19,24,24,18,85,Pass
Aryan Verma,12-01-2005,947815,Odisha,21,14,22,4,61,Fail
Manpreet Verma,22-03-2005,112709,Jammu & Kashmir + Ladakh,11,10,3,24,48,Pass
Aryan Sharma,10-01-2006,986621,Punjab,16,17,21,7,61,Pass
Kunal Sharma,02-10-2005,948544,Rajasthan,24,13,14,2,53,Pass
Sukhwinder Fernandes,20-02-2005,745582,Gujarat,14,19,21,17,71,Fail
David Singh,16-03-2006,667249,Rajasthan,12,9,0,24,45,Pass
Krishna Singh,14-11-2005,697898,Haryana,15,6,9,11,41,Fail
Aryan Sharma,25-04-2005,635319,Jharkhand,4,17,14,10,45,Pass
Krishna Verma,07-06-2005,601242,Meghalaya,3,9,4,23,39,Pass
Aditya Khan,08-05-2005,758895,Haryana,21,19,1,8,49,Fail
Ishaan D'Souza,06-12-2005,900503,Maharashtra,11,24,5,2,42,Fail
Zaid Khan,09-10-2005,898696,Tamil Nadu,6,15,13,19,53,Fail
Yash D'Souza,01-03-2005,416506,Punjab,3,5,8,16,32,Pass
Balbir Pillai,24-12-2005,132018,Andhra Pradesh,14,17,13,4,48,Pass
Harjeet Verma,17-03-2006,816196,Odisha,0,4,4,8,16,Pass
Vivaan Fernandes,01-03-2006,929731,Odisha,6,16,6,21,49,Fail
Ishaan Khan,22-11-2005,642576,Gujarat,24,23,13,13,73,Fail
Kunal Reddy,05-04-2005,869738,Haryana,7,6,21,21,55,Fail
John Chopra,20-05-2005,862558,Bihar,13,5,0,19,37,Pass
Peter Khan,21-10-2005,319529,Karnataka,10,12,15,19,56,Pass
Harjeet Verma,25-11-2004,990300,Andhra Pradesh,14,6,17,21,58,Pass
John Pillai,18-01-2006,977890,Uttar Pradesh,19,1,6,19,45,Fail
Raj Reddy,18-01-2005,512710,Punjab,12,5,3,16,36,Pass
Vivaan Pillai,15-03-2006,322296,Maharashtra,6,20,17,16,59,Fail
Raj Chopra,08-01-2005,319848,Andhra Pradesh,6,2,14,11,33,Pass
Raj Reddy,01-03-2006,601148,Kerala,15,7,24,2,48,Pass
Rohan Singh,07-04-2006,559771,Kerala,5,10,11,8,34,Pass
Krishna Sharma,29-11-2004,755764,Uttar Pradesh,8,0,10,18,36,Fail
Aarav Khan,04-04-2006,808541,Uttarakhand,3,1,22,9,35,Fail
Harjeet D'Souza,05-06-2005,847372,Bihar,8,13,6,1,28,Pass
Mathew Sharma,13-12-2004,189583,Uttarakhand,12,9,4,13,38,Fail
Aryan Mehta,31-10-2005,567023,Karnataka,16,12,19,10,57,Pass
John Pillai,26-04-2005,809232,Gujarat,10,18,13,8,49,Fail
John Reddy,07-04-2006,948008,Tamil Nadu,24,6,14,17,61,Pass
Aditya Sharma,31-12-2005,240539,Rajasthan,10,19,4,15,48,Pass
Krishna Mehta,20-01-2006,564451,Karnataka,4,16,5,20,45,Pass
Balbir Fernandes,17-02-2006,324394,Bihar,10,11,4,15,40,Pass
Aryan Fernandes,18-12-2005,840259,Uttar Pradesh,20,10,16,13,59,Fail
Rohan Sharma,26-03-2005,910064,Jammu & Kashmir + Ladakh,0,7,24,13,44,Pass
Yash Singh,14-03-2006,292673,Madhya Pradesh,19,2,23,6,50,Fail
Balbir Mehta,23-12-2005,941604,Karnataka,13,10,10,14,47,Pass
Kunal Pillai,19-06-2005,376843,Madhya Pradesh,13,10,2,3,28,Fail
Aarav Sharma,09-11-2005,114453,Gujarat,0,12,13,18,43,Fail
Gurpreet Sharma,15-02-2005,620414,Kerala,15,4,12,3,34,Pass
Harjeet Chopra,18-01-2005,663485,Bihar,14,15,7,7,43,Pass
Farhan D'Souza,25-04-2005,918577,Odisha,1,8,17,21,47,Fail
Aryan Khan,01-09-2005,103020,West Bengal,14,6,15,24,59,Fail
Yash Singh,31-12-2004,944700,Kerala,0,2,20,6,28,Pass
Krishna D'Souza,29-07-2005,365812,Haryana,20,6,12,0,38,Fail
Kunal Reddy,22-11-2004,745645,Haryana,22,6,4,15,47,Fail
John Sharma,14-11-2005,194964,Haryana,13,20,23,15,71,Fail
Aditya Singh,20-05-2005,707301,Uttarakhand,3,20,14,11,48,Fail
Harjeet Chopra,27-01-2006,882042,Uttar Pradesh,22,12,20,5,59,Fail
Aarav Singh,19-10-2005,892355,Tamil Nadu,8,3,8,19,38,Pass
Peter Reddy,01-11-2005,816765,Chhattisgarh,5,24,11,13,53,Fail
Vivaan Chopra,03-01-2006,153708,Bihar,17,10,6,15,48,Pass
Gurpreet Pillai,03-05-2006,262548,Uttar Pradesh,16,8,3,12,39,Fail
Aditya Pillai,18-06-2005,494033,Madhya Pradesh,16,9,8,23,56,Fail
Rohan Mehta,08-08-2005,320829,Rajasthan,6,6,5,14,31,Pass
Aarav Reddy,04-08-2005,217475,Assam,14,10,17,16,57,Fail
Paul Verma,25-09-2005,874128,Madhya Pradesh,0,0,24,4,28,Fail
Yash Sharma,14-06-2005,573601,Gujarat,17,21,0,3,41,Fail
Krishna Khan,24-04-2005,681580,Madhya Pradesh,22,16,21,17,76,Fail
Balbir Mehta,31-01-2006,391852,Punjab,3,10,21,20,54,Pass
Manpreet Chopra,11-04-2005,244953,Haryana,14,23,24,3,64,Fail
Gurpreet Chopra,16-06-2005,178442,Madhya Pradesh,2,8,24,19,53,Fail
Rohan Reddy,25-12-2004,884248,Delhi,19,17,22,23,81,Fail
Aryan Chopra,09-02-2006,103582,Maharashtra,4,13,12,2,31,Fail
Vivaan Fernandes,01-04-2006,518056,Uttarakhand,4,17,9,2,32,Fail
Aarav D'Souza,05-07-2005,361549,Tripura,5,23,10,15,53,Fail
Rehan D'Souza,13-09-2005,370436,Uttar Pradesh,12,6,7,23,48,Fail
Aarav Chopra,16-06-2005,712830,Maharashtra,5,9,19,19,52,Fail
Kunal D'Souza,19-10-2005,464269,Karnataka,24,0,6,4,34,Pass
Kunal Pillai,12-11-2004,972339,Rajasthan,18,2,4,5,29,Pass
Krishna D'Souza,02-08-2005,196440,Rajasthan,10,9,17,18,54,Pass
Aryan Khan,17-01-2006,333200,Uttar Pradesh,0,9,7,3,19,Fail
Gurpreet Verma,15-10-2005,576531,Uttar Pradesh,24,0,5,18,47,Fail
Paul Reddy,03-01-2005,346106,Chhattisgarh,22,3,4,11,40,Fail
Farhan D'Souza,30-05-2005,538386,Maharashtra,5,17,8,16,46,Fail
John Khan,05-05-2006,765205,Assam,21,8,10,1,40,Fail
Raj Mehta,16-12-2004,266076,Haryana,14,20,0,15,49,Fail
Raj Verma,07-12-2005,309143,Bihar,11,23,7,3,44,Pass
Rohan Singh,02-03-2005,130512,Andhra Pradesh,16,0,19,15,50,Pass
John Mehta,04-06-2005,754787,Maharashtra,15,17,21,20,73,Fail
Peter Reddy,30-03-2006,674191,Rajasthan,8,24,22,8,62,Fail
Sukhwinder Verma,09-10-2005,782646,Uttarakhand,11,21,14,1,47,Fail
Aarav Khan,10-01-2006,131371,Uttar Pradesh,15,15,14,17,61,Fail
Aditya Sharma,22-06-2005,504144,Uttar Pradesh,15,8,8,24,55,Fail
Ishaan D'Souza,25-03-2006,738869,Gujarat,18,22,20,19,79,Fail
Krishna Verma,27-12-2005,978896,Maharashtra,20,11,18,18,67,Fail
Aarav Sharma,29-04-2006,111497,Tamil Nadu,6,11,1,21,39,Pass
Raj Khan,17-11-2004,841345,Rajasthan,19,23,24,10,76,Pass
Rohan Chopra,02-07-2005,281043,Kerala,16,2,17,12,47,Pass
Manpreet Reddy,24-11-2005,711355,Punjab,6,1,7,6,20,Pass
Imran Reddy,25-11-2005,983953,Andhra Pradesh,3,24,17,6,50,Pass
Farhan Reddy,15-06-2005,506272,Madhya Pradesh,18,16,19,14,67,Fail
Aryan D'Souza,01-02-2006,524271,Andhra Pradesh,22,2,7,8,39,Pass
Yash Pillai,08-12-2004,274672,Telangana,8,24,20,4,56,Fail
Vivaan Mehta,13-11-2005,315679,Tripura,14,9,14,15,52,Fail
Rehan Mehta,01-01-2006,123605,West Bengal,9,6,10,5,30,Fail
Peter Reddy,01-03-2005,908332,Haryana,10,24,4,5,43,Fail
Aryan Sharma,11-05-2005,132682,Tamil Nadu,22,23,14,15,74,Pass
Krishna Verma,23-03-2006,610962,Jammu & Kashmir + Ladakh,11,15,6,6,38,Pass
Raj Mehta,11-12-2005,767730,Punjab,13,12,22,1,48,Pass
Ishaan Verma,26-09-2005,449749,Rajasthan,16,24,1,20,61,Fail
Ishaan Chopra,18-12-2004,465733,Tamil Nadu,14,8,7,8,37,Pass
Aryan Verma,25-07-2005,735904,Jharkhand,22,12,23,6,63,Pass
Aryan Pillai,02-08-2005,215245,Uttar Pradesh,21,4,17,15,57,Fail
Rehan Pillai,12-04-2005,162754,Jharkhand,5,1,5,7,18,Pass
Raj Pillai,22-03-2006,194507,West Bengal,19,11,16,16,62,Fail
Balbir Sharma,29-04-2005,126570,Tamil Nadu,15,9,4,11,39,Pass
Aarav D'Souza,23-04-2006,130927,Maharashtra,19,6,1,20,46,Fail
Ishaan Pillai,22-09-2005,419061,Meghalaya,16,23,1,20,60,Fail
John Sharma,04-03-2006,760246,Bihar,6,14,5,14,39,Pass
Sukhwinder Reddy,11-02-2005,108598,Uttarakhand,0,14,11,6,31,Fail
Sukhwinder Fernandes,02-02-2005,991130,Uttar Pradesh,21,0,14,0,35,Fail
Vivaan D'Souza,16-02-2005,142215,Rajasthan,1,10,20,22,53,Pass
Mathew Pillai,11-03-2006,209168,Arunachal Pradesh,18,2,14,6,40,Fail
Aarav Sharma,24-12-2004,680147,Tamil Nadu,22,16,3,12,53,Fail
Ishaan Khan,22-04-2006,651352,Gujarat,10,24,11,3,48,Fail
Yash Reddy,11-04-2006,871484,Bihar,10,9,17,8,44,Pass
Gurpreet Fernandes,21-12-2005,505799,Maharashtra,8,1,3,0,12,Fail
Rohan Chopra,16-07-2005,832966,Punjab,1,8,21,20,50,Pass
Peter Khan,04-10-2005,449115,Rajasthan,23,19,0,20,62,Fail
Ishaan Pillai,22-05-2005,257421,Madhya Pradesh,7,10,11,22,50,Fail
Ishaan Fernandes,13-05-2005,105240,Telangana,13,18,21,1,53,Fail
Manpreet Sharma,04-04-2006,265962,Punjab,3,23,4,8,38,Pass
John Reddy,04-05-2005,813736,Uttar Pradesh,7,10,0,19,36,Fail
Balbir Verma,05-12-2004,183725,Maharashtra,24,9,23,5,61,Fail
David Khan,01-01-2005,155765,Uttar Pradesh,9,1,7,22,39,Fail
Raj Sharma,06-02-2005,840080,West Bengal,24,20,9,21,74,Fail
Sukhwinder Reddy,23-03-2005,451344,Jharkhand,10,23,8,21,62,Pass
Aarav Singh,06-05-2006,241689,Madhya Pradesh,22,5,21,19,67,Fail
David Sharma,28-04-2005,930816,Assam,16,6,2,24,48,Fail
Rohan Singh,19-04-2006,752324,Haryana,6,5,7,18,36,Fail
Krishna Reddy,30-08-2005,926514,Telangana,24,20,0,0,44,Fail
Vivaan Verma,11-09-2005,182611,Karnataka,0,23,13,0,36,Pass
Yash Mehta,31-05-2005,254251,West Bengal,6,9,7,4,26,Fail
Aarav Fernandes,13-12-2004,395971,Meghalaya,5,1,19,18,43,Pass
David Reddy,04-05-2005,706090,Uttar Pradesh,12,21,17,20,70,Fail
Rohan D'Souza,19-11-2004,777801,Uttar Pradesh,1,9,17,4,31,Fail
Peter D'Souza,27-02-2005,867176,Himachal Pradesh,4,21,7,10,42,Pass
Manpreet D'Souza,25-02-2005,133731,Assam,8,19,7,3,37,Fail
Kunal D'Souza,02-01-2005,365347,Rajasthan,17,10,19,15,61,Fail
Peter Fernandes,20-12-2004,951265,Uttar Pradesh,19,12,8,6,45,Fail
Mathew Mehta,02-12-2005,567747,Uttarakhand,12,6,0,23,41,Fail
Ishaan Khan,06-12-2004,434093,Madhya Pradesh,12,7,8,6,33,Fail
Vivaan Khan,16-06-2005,546729,Uttar Pradesh,5,18,19,0,42,Fail
Ishaan Reddy,03-06-2005,974334,Haryana,1,2,6,11,20,Fail
Balbir D'Souza,29-06-2005,697705,Madhya Pradesh,18,11,7,11,47,Fail
Rohan Singh,01-12-2005,372043,Karnataka,18,22,2,17,59,Pass
Imran Reddy,28-07-2005,118215,Uttar Pradesh,22,8,11,15,56,Fail
Imran Verma,04-04-2006,800828,West Bengal,14,16,4,23,57,Fail
Krishna Khan,14-09-2005,275292,Punjab,21,15,7,8,51,Pass
Vivaan Sharma,05-01-2006,404049,Andhra Pradesh,9,18,8,15,50,Pass
Manpreet Mehta,30-06-2005,715987,Bihar,4,17,15,24,60,Pass
Aarav D'Souza,02-03-2006,311205,Uttar Pradesh,9,10,9,16,44,Fail
Vivaan Sharma,14-11-2005,324010,Maharashtra,19,2,9,18,48,Fail
Krishna Pillai,03-05-2005,510094,Madhya Pradesh,0,10,10,2,22,Fail
Balbir Mehta,20-10-2005,470987,Uttar Pradesh,17,4,6,9,36,Fail
Ishaan Verma,15-01-2006,973499,Rajasthan,23,7,20,13,63,Fail
Kunal Reddy,15-01-2006,625925,Assam,9,15,20,1,45,Fail
Gurpreet Sharma,22-04-2006,318155,Maharashtra,10,16,5,5,36,Fail
Ishaan Fernandes,23-10-2005,813620,Punjab,1,12,22,9,44,Pass
Yash Fernandes,26-11-2004,551675,Assam,15,1,22,0,38,Fail
Yash Singh,14-03-2005,175938,Chhattisgarh,7,24,15,15,61,Fail
Aarav Sharma,12-04-2005,888535,Bihar,24,11,11,16,62,Pass
Aarav Pillai,12-02-2005,763064,Haryana,11,22,10,5,48,Fail
Aryan Reddy,07-04-2005,644870,Jammu & Kashmir + Ladakh,2,12,16,23,53,Pass
Aditya Mehta,11-08-2005,914438,Jharkhand,24,8,21,23,76,Fail
Rehan Reddy,25-12-2005,357410,Punjab,6,7,18,22,53,Pass
Krishna Verma,29-04-2006,632442,Bihar,10,10,11,20,51,Pass
Mathew Reddy,14-02-2006,860736,Bihar,21,6,24,24,75,Pass
Rohan Verma,18-03-2006,633461,Bihar,6,11,24,22,63,Pass
Raj Khan,30-01-2005,466513,Bihar,11,22,13,3,49,Pass
Harjeet Singh,15-09-2005,192945,Tamil Nadu,10,14,15,18,57,Pass
Kunal Chopra,10-06-2005,448337,Bihar,6,13,7,24,50,Pass
Peter Pillai,19-02-2006,765032,Tamil Nadu,18,0,20,8,46,Fail
Balbir Verma,27-03-2005,547924,Kerala,21,5,4,19,49,Pass
Kunal Mehta,23-01-2006,363884,Uttar Pradesh,4,22,20,24,70,Fail
Krishna Fernandes,13-08-2005,308685,Jharkhand,8,0,7,14,29,Pass
Yash Reddy,26-12-2005,233779,Delhi,15,5,7,23,50,Fail
Aditya Mehta,08-03-2005,936562,Tamil Nadu,24,23,4,1,52,Fail
Rohan Mehta,27-02-2006,151578,Chhattisgarh,19,11,1,8,39,Fail
Aditya Pillai,19-09-2005,203638,Puducherry,21,24,7,3,55,Fail
Vivaan Mehta,22-05-2005,626451,Maharashtra,17,20,12,18,67,Fail
Paul Verma,11-03-2005,338753,Rajasthan,13,19,15,13,60,Fail
Kunal Sharma,03-01-2006,732314,Jammu & Kashmir + Ladakh,20,1,6,13,40,Pass
Balbir Chopra,27-10-2005,535160,Jharkhand,24,17,21,24,86,Fail
Krishna Singh,10-01-2005,437818,Bihar,0,3,16,1,20,Pass
Aditya Sharma,10-02-2006,554938,Rajasthan,16,8,7,5,36,Pass
Peter Singh,23-11-2004,317445,West Bengal,8,6,14,11,39,Fail
Aryan Fernandes,30-01-2006,329564,Maharashtra,12,9,21,5,47,Fail
Kunal Fernandes,28-08-2005,991167,Andhra Pradesh,4,12,18,10,44,Pass
Mathew Mehta,26-04-2006,825329,Rajasthan,5,0,11,19,35,Pass
Aditya D'Souza,24-07-2005,754139,Rajasthan,13,19,9,21,62,Fail
Aditya Verma,31-05-2005,445114,West Bengal,13,15,24,6,58,Fail
Aditya Sharma,08-05-2006,143135,Jammu & Kashmir + Ladakh,2,9,12,5,28,Pass
Kunal D'Souza,31-05-2005,886070,Telangana,20,12,4,7,43,Fail
Gurpreet Mehta,20-06-2005,202787,Karnataka,8,2,23,19,52,Pass
Aditya Verma,25-02-2005,486873,Madhya Pradesh,21,23,20,3,67,Fail
Vivaan Reddy,11-11-2005,734608,Maharashtra,13,19,17,10,59,Fail
Aditya D'Souza,28-10-2005,289883,Gujarat,14,15,16,15,60,Fail
Aryan Chopra,08-06-2005,221320,Haryana,11,19,13,0,43,Fail
Gurpreet Khan,09-01-2006,769926,Andhra Pradesh,9,22,18,11,60,Pass
Ishaan Pillai,20-12-2004,427624,Punjab,10,9,18,6,43,Pass
Aryan Verma,08-08-2005,500011,Punjab,13,12,21,8,54,Pass
Rohan Reddy,05-04-2005,940147,Punjab,12,9,2,21,44,Pass
Ishaan Sharma,21-11-2005,706675,Assam,11,4,18,13,46,Fail
Manpreet Reddy,07-04-2005,695547,Bihar,19,22,16,0,57,Pass
Yash Verma,24-06-2005,566157,Andhra Pradesh,5,21,7,4,37,Pass
Aditya Verma,20-05-2005,607620,Tamil Nadu,14,17,23,14,68,Fail
Paul Verma,24-10-2005,812425,Bihar,9,4,0,23,36,Pass
Vivaan Khan,04-10-2005,153201,Punjab,24,2,6,19,51,Pass
Krishna Pillai,10-12-2005,415628,Punjab,17,7,20,21,65,Pass
Rohan D'Souza,05-12-2004,874656,Rajasthan,18,16,22,19,75,Fail
Rohan Sharma,07-02-2006,358439,Maharashtra,20,5,1,4,30,Fail
Aditya Khan,05-05-2005,703317,Uttar Pradesh,14,23,3,16,56,Fail
Yash Khan,07-08-2005,369406,Punjab,8,17,16,2,43,Pass
Yash Fernandes,16-03-2005,404872,Odisha,12,13,2,2,29,Pass
Manpreet D'Souza,21-04-2005,971010,Maharashtra,1,21,22,4,48,Fail
Zaid Pillai,21-12-2004,994536,Daman & Diu / D&N Haveli,16,19,21,14,70,Fail
Aryan Sharma,27-01-2005,515746,Bihar,6,0,23,24,53,Pass
Kunal Mehta,15-03-2006,190595,West Bengal,2,11,13,8,34,Fail
Vivaan Reddy,06-03-2006,771431,Himachal Pradesh,8,12,22,22,64,Pass
Aryan Sharma,29-03-2005,905077,Rajasthan,9,17,16,1,43,Pass
Manpreet Khan,30-01-2006,396534,Bihar,2,7,13,11,33,Pass
Raj Fernandes,15-03-2006,439715,Gujarat,18,12,15,24,69,Fail
John Reddy,31-05-2005,974577,Uttar Pradesh,8,12,24,22,66,Fail
Aryan Singh,22-04-2005,532688,Rajasthan,11,5,14,17,47,Pass
Kunal Fernandes,30-07-2005,348957,Bihar,0,13,12,9,34,Pass
Sukhwinder Reddy,02-01-2006,526304,Jharkhand,15,12,6,9,42,Pass
Manpreet Fernandes,27-02-2006,384374,Madhya Pradesh,2,8,18,4,32,Fail
Aarav Mehta,20-04-2006,989250,Gujarat,4,14,18,20,56,Fail
Yash D'Souza,03-08-2005,904481,Andhra Pradesh,5,4,14,24,47,Pass
Paul Reddy,28-10-2005,904360,Bihar,20,9,4,16,49,Pass
Gurpreet Mehta,13-12-2005,663126,Kerala,20,20,2,7,49,Pass
Sukhwinder Chopra,25-05-2005,814057,Puducherry,13,23,20,24,80,Pass
Vivaan Khan,24-11-2004,230855,Andhra Pradesh,0,16,9,3,28,Pass
Zaid Sharma,29-12-2005,653906,Uttarakhand,24,9,21,11,65,Fail
Kunal D'Souza,05-06-2005,155637,Madhya Pradesh,17,23,24,22,86,Fail
Vivaan Pillai,06-05-2006,966012,West Bengal,5,23,24,0,52,Fail
John Reddy,28-11-2004,617670,Odisha,12,18,17,2,49,Fail
David D'Souza,12-04-2006,260087,Maharashtra,1,1,11,4,17,Fail
Raj Khan,21-12-2005,175229,Delhi,6,6,16,1,29,Fail
Vivaan Chopra,04-02-2006,357035,Himachal Pradesh,0,2,13,15,30,Pass
Aarav D'Souza,10-12-2004,792254,Telangana,0,9,5,4,18,Fail
Raj Reddy,26-11-2005,509768,Maharashtra,8,18,24,24,74,Fail
Ishaan Mehta,28-10-2005,654779,West Bengal,22,14,4,19,59,Fail
Raj Verma,02-05-2005,987979,Rajasthan,5,24,3,2,34,Pass
Vivaan Khan,24-08-2005,870069,Odisha,19,1,2,9,31,Pass
Balbir Sharma,15-03-2005,733393,Andhra Pradesh,0,5,9,12,26,Pass
Aryan Fernandes,14-10-2005,842358,Uttar Pradesh,1,13,17,21,52,Fail
Gurpreet Verma,21-04-2005,471800,Uttar Pradesh,23,22,24,9,78,Fail
Balbir Khan,31-05-2005,545036,Tripura,13,15,0,12,40,Fail
Aarav Khan,25-05-2005,311467,West Bengal,23,4,14,22,63,Fail
Mathew Pillai,30-11-2004,875248,Jharkhand,19,0,22,12,53,Pass
Raj Pillai,06-01-2005,471443,Bihar,7,14,13,19,53,Pass
Aryan Verma,27-11-2004,401333,Uttar Pradesh,18,7,3,23,51,Fail
Aarav Chopra,21-12-2005,342077,Meghalaya,12,22,8,6,48,Fail
Aarav Sharma,15-10-2005,120909,Chhattisgarh,24,4,6,23,57,Fail
Raj Verma,03-03-2006,112876,Bihar,14,13,9,8,44,Pass
Aditya Singh,31-07-2005,282042,Madhya Pradesh,11,24,23,6,64,Fail
Imran Mehta,19-10-2005,145326,Madhya Pradesh,22,3,2,17,44,Fail
Krishna Pillai,14-05-2005,554169,West Bengal,2,21,3,24,50,Fail
Rohan Pillai,01-12-2004,320063,Tamil Nadu,12,0,17,24,53,Fail
John Verma,03-11-2005,683482,Chhattisgarh,13,19,2,8,42,Fail
Yash Chopra,27-08-2005,215968,Tamil Nadu,18,9,3,5,35,Pass
Yash Khan,06-03-2006,801802,Punjab,3,5,0,4,12,Pass
Vivaan Pillai,22-09-2005,833412,Uttar Pradesh,8,12,5,8,33,Fail
Vivaan Chopra,15-07-2005,207844,Bihar,11,16,0,19,46,Pass
Aryan Mehta,01-02-2005,792132,Maharashtra,20,13,4,19,56,Fail
Manpreet Reddy,17-08-2005,985559,Jharkhand,23,16,19,17,75,Fail
Paul Fernandes,13-01-2006,689507,Haryana,17,12,1,21,51,Fail
Aryan Singh,28-12-2005,896125,Bihar,19,8,20,20,67,Pass
John Fernandes,15-01-2005,304828,Assam,13,15,21,13,62,Fail
Aarav Mehta,26-01-2005,627134,Telangana,5,13,10,9,37,Fail
Kunal Singh,17-07-2005,546961,Telangana,6,5,16,1,28,Fail
Raj D'Souza,23-02-2006,875042,Uttar Pradesh,23,4,16,9,52,Fail
Balbir Chopra,30-07-2005,618795,Rajasthan,6,18,1,10,35,Pass
Mathew Fernandes,18-09-2005,536992,Assam,2,24,2,18,46,Fail
Aarav Pillai,05-12-2005,566436,Tamil Nadu,10,2,23,8,43,Fail
Balbir Mehta,13-03-2006,733597,Madhya Pradesh,23,2,12,8,45,Fail
Aarav Mehta,06-01-2005,551548,Uttarakhand,15,15,16,0,46,Fail
Farhan Mehta,21-11-2005,218690,Maharashtra,18,18,22,21,79,Fail
Sukhwinder Verma,15-03-2006,915314,Uttarakhand,11,23,4,2,40,Fail
Aditya Pillai,12-10-2005,502589,Assam,20,17,10,22,69,Fail
Harjeet Khan,09-01-2006,281940,Jharkhand,15,20,16,1,52,Pass
Aryan Chopra,17-02-2006,456942,Tamil Nadu,19,17,10,17,63,Fail
Vivaan Reddy,08-01-2006,270702,West Bengal,23,14,10,21,68,Fail
Aditya Sharma,06-10-2005,125420,Chhattisgarh,15,9,5,5,34,Fail
Aryan D'Souza,22-06-2005,316124,Rajasthan,0,18,21,7,46,Pass
Ayaan Verma,23-11-2005,121503,Jammu & Kashmir + Ladakh,6,6,4,21,37,Pass
Harjeet Khan,12-12-2005,268522,Uttar Pradesh,19,9,22,0,50,Fail
Yash Khan,26-05-2005,559082,Bihar,17,10,16,15,58,Pass
Harjeet Chopra,16-08-2005,590774,West Bengal,14,9,10,16,49,Fail
Kunal Singh,03-05-2006,516688,Goa,6,12,2,20,40,Fail
Sukhwinder Khan,09-08-2005,179675,Uttar Pradesh,10,19,20,12,61,Fail
Aditya Fernandes,01-07-2005,544913,Madhya Pradesh,12,3,13,4,32,Fail
Aditya Fernandes,30-12-2004,964254,Bihar,22,16,14,24,76,Pass
Kunal Khan,13-12-2005,998299,Jammu & Kashmir + Ladakh,21,22,20,14,77,Fail
Rehan D'Souza,17-10-2005,157828,Bihar,16,8,20,22,66,Pass
Krishna D'Souza,16-02-2006,845453,Maharashtra,21,9,10,4,44,Fail
Rehan Pillai,27-05-2005,190541,Tamil Nadu,22,4,2,11,39,Pass
Aditya Singh,21-05-2005,173378,Madhya Pradesh,1,2,23,3,29,Fail
Krishna Fernandes,16-03-2006,181476,Haryana,1,2,3,12,18,Fail
Ishaan Pillai,26-07-2005,293185,Madhya Pradesh,13,13,3,14,43,Fail
Paul Mehta,17-03-2006,476259,Jharkhand,0,16,20,19,55,Pass
Harjeet Mehta,11-12-2004,940465,West Bengal,8,12,4,13,37,Fail
Balbir D'Souza,26-05-2005,290919,Telangana,8,9,22,9,48,Fail
Paul Khan,08-12-2005,337055,Punjab,2,0,3,18,23,Pass
Aarav Mehta,15-10-2005,324080,Gujarat,18,23,21,0,62,Fail
Yash D'Souza,20-01-2005,636336,Maharashtra,6,9,8,22,45,Fail
Aarav Mehta,20-09-2005,709138,Maharashtra,10,20,12,19,61,Fail
Vivaan Singh,07-03-2006,455863,Kerala,24,22,10,15,71,Fail
Vivaan Mehta,02-05-2005,402617,Odisha,14,21,0,6,41,Pass
Aryan Fernandes,02-04-2005,771873,West Bengal,3,0,2,19,24,Fail
Balbir Sharma,01-04-2005,964602,Telangana,4,5,3,17,29,Fail
Peter Pillai,03-01-2006,274364,Punjab,7,17,18,8,50,Pass
Imran Khan,28-01-2005,587054,Andhra Pradesh,8,24,0,7,39,Pass
Harjeet Fernandes,23-04-2005,166129,Bihar,11,9,5,19,44,Pass
Rohan Chopra,04-02-2006,135059,Karnataka,8,22,11,5,46,Pass
Yash Reddy,12-10-2005,926306,Uttar Pradesh,10,2,3,8,23,Fail
Rehan Reddy,18-01-2005,332705,Punjab,5,2,9,11,27,Pass
Manpreet D'Souza,18-12-2005,348574,Rajasthan,9,21,5,19,54,Pass
Rohan Pillai,18-06-2005,543382,Gujarat,16,21,4,8,49,Fail
Ishaan Singh,09-06-2005,329136,Bihar,2,9,19,0,30,Pass
Farhan Khan,04-10-2005,892279,Jharkhand,9,22,23,3,57,Pass
Yash Singh,18-12-2005,928031,Rajasthan,6,11,5,6,28,Pass
Kunal Chopra,17-08-2005,698221,Bihar,22,24,9,7,62,Pass
Aarav Sharma,25-07-2005,258947,Rajasthan,2,10,7,11,30,Pass
Kunal Chopra,02-12-2004,909203,West Bengal,23,3,4,4,34,Fail
Vivaan Fernandes,28-01-2005,449309,Madhya Pradesh,8,21,10,3,42,Fail
Peter Fernandes,21-07-2005,159959,Uttar Pradesh,11,22,13,11,57,Fail
Vivaan Fernandes,16-12-2005,444267,Uttar Pradesh,21,11,19,10,61,Fail
Yash Fernandes,01-09-2005,187642,Rajasthan,15,0,10,19,44,Pass
Yash Reddy,17-11-2004,702412,Chhattisgarh,3,22,15,4,44,Fail
Sukhwinder Chopra,29-08-2005,169952,Uttar Pradesh,15,13,18,1,47,Fail
Aryan Fernandes,04-01-2006,242956,Madhya Pradesh,5,23,20,14,62,Fail
John Verma,18-12-2005,579565,Bihar,12,18,15,11,56,Pass
Krishna Chopra,03-06-2005,232463,Madhya Pradesh,5,22,2,1,30,Fail
Rohan Mehta,28-03-2006,118093,Bihar,24,19,1,6,50,Pass
Vivaan D'Souza,03-04-2006,216008,Uttar Pradesh,0,21,10,6,37,Fail
Aryan Mehta,06-08-2005,291605,Maharashtra,22,16,15,4,57,Fail
Krishna Khan,21-01-2005,298906,Rajasthan,12,12,11,9,44,Pass
Raj Pillai,05-04-2006,429017,Mizoram,15,1,9,17,42,Pass
Rehan Verma,13-02-2005,170088,Uttar Pradesh,17,18,15,12,62,Fail
David Khan,08-01-2005,465057,Maharashtra,12,0,12,12,36,Fail
Aryan D'Souza,16-02-2005,172370,Telangana,8,1,15,15,39,Fail
Vivaan Khan,06-06-2005,982450,Uttar Pradesh,11,17,12,23,63,Fail
Vivaan Singh,14-02-2005,745805,Tamil Nadu,20,11,23,13,67,Fail
Aryan Mehta,22-10-2005,397533,Tamil Nadu,16,6,22,8,52,Fail
Aditya Sharma,06-03-2006,324592,Uttar Pradesh,23,9,18,21,71,Fail
Kunal Chopra,13-12-2005,366090,Madhya Pradesh,18,7,6,3,34,Fail
Vivaan Fernandes,20-12-2004,642947,Gujarat,6,4,14,15,39,Fail
Kunal Chopra,08-11-2004,465435,Jammu & Kashmir + Ladakh,13,16,19,22,70,Fail
Rohan Mehta,29-10-2005,245707,Bihar,15,1,12,2,30,Pass
Manpreet Singh,16-05-2005,273133,Andhra Pradesh,4,9,18,18,49,Pass
Vivaan Fernandes,10-04-2006,362474,Gujarat,1,5,4,12,22,Fail
Kunal Singh,24-01-2006,521973,Bihar,11,19,0,12,42,Pass
Mathew Khan,20-11-2005,818992,Haryana,2,16,24,10,52,Fail
Ishaan Singh,14-08-2005,374117,Himachal Pradesh,21,7,24,22,74,Fail
Aditya Sharma,15-07-2005,988798,Gujarat,12,16,21,13,62,Fail
Ishaan Chopra,05-10-2005,457742,Gujarat,3,3,17,12,35,Fail
Harjeet Singh,05-02-2005,853257,Telangana,9,8,14,12,43,Fail
Ishaan Pillai,07-12-2005,230212,Bihar,6,24,2,7,39,Pass
Farhan Khan,13-11-2005,990199,Uttar Pradesh,10,4,1,3,18,Fail
Ishaan Mehta,10-11-2005,179898,Maharashtra,20,24,13,22,79,Fail
Rohan Khan,26-03-2005,345545,Himachal Pradesh,12,6,6,15,39,Pass
Ishaan D'Souza,20-02-2006,752972,Odisha,22,8,6,22,58,Fail
Aditya Verma,29-01-2006,473999,Uttarakhand,9,2,16,16,43,Fail
Harjeet Chopra,21-06-2005,208305,Rajasthan,6,12,15,18,51,Pass
Yash Verma,26-11-2005,898235,Delhi,20,1,17,18,56,Fail
Ishaan Mehta,29-01-2005,899285,Karnataka,9,9,11,10,39,Pass
Yash Fernandes,25-01-2006,608876,Assam,17,18,9,21,65,Fail
Krishna Verma,07-12-2005,857888,Bihar,7,10,23,10,50,Pass
John Mehta,18-12-2005,750459,Madhya Pradesh,20,9,13,19,61,Fail
Rohan D'Souza,10-12-2005,604293,Karnataka,4,2,21,19,46,Pass
Aryan Fernandes,31-03-2006,613299,Maharashtra,6,23,17,4,50,Fail
Kunal D'Souza,15-04-2005,445598,Uttar Pradesh,3,14,10,3,30,Fail
Rohan Reddy,18-10-2005,487427,Manipur,16,2,14,14,46,Fail
Aryan Mehta,03-04-2006,161995,Bihar,24,3,23,15,65,Pass
Ishaan Fernandes,09-03-2006,779148,Rajasthan,7,13,22,23,65,Fail
Gurpreet Singh,06-03-2006,477842,Haryana,6,6,20,10,42,Fail
Ishaan Mehta,02-01-2005,418561,Bihar,19,24,1,17,61,Pass
Ishaan Reddy,29-12-2005,348271,Rajasthan,23,18,20,6,67,Fail
Aditya Reddy,20-01-2005,147153,Punjab,14,12,24,8,58,Pass
Vivaan Fernandes,17-04-2005,137619,Mizoram,2,23,23,22,70,Fail
Zaid D'Souza,07-10-2005,966307,Maharashtra,22,16,14,4,56,Fail
Rohan Mehta,08-08-2005,691709,Himachal Pradesh,11,1,15,1,28,Pass
Aryan Verma,20-07-2005,864622,Uttar Pradesh,23,5,14,20,62,Fail
Ishaan Sharma,18-11-2004,512081,Bihar,24,0,14,21,59,Pass
Imran D'Souza,01-05-2005,180735,Delhi,7,12,16,9,44,Fail
Raj Mehta,22-05-2005,749228,Bihar,2,16,11,2,31,Pass
Yash Singh,04-04-2005,709267,Uttarakhand,7,20,7,3,37,Fail
Yash Mehta,25-11-2005,495158,Madhya Pradesh,19,22,21,2,64,Fail
Paul D'Souza,19-04-2006,675476,Chhattisgarh,22,0,5,14,41,Fail
Aarav Reddy,28-06-2005,871661,Jharkhand,15,23,24,7,69,Fail
Mathew Khan,29-11-2004,136739,Jammu & Kashmir + Ladakh,24,10,8,8,50,Pass
Aditya Sharma,25-10-2005,435495,Assam,22,24,17,23,86,Fail
Kunal Sharma,09-04-2005,176885,Assam,20,21,19,8,68,Fail
Aryan Chopra,12-03-2006,987243,Odisha,21,5,0,9,35,Pass
Balbir Fernandes,19-04-2006,194007,Gujarat,10,14,15,13,52,Fail
Ishaan Singh,01-11-2005,310451,Andhra Pradesh,5,10,16,17,48,Pass
Raj Sharma,25-05-2005,953154,Punjab,9,3,15,12,39,Pass
Rohan Mehta,23-12-2005,417470,Andhra Pradesh,23,10,9,11,53,Pass
David Pillai,04-10-2005,431778,Tamil Nadu,3,6,10,16,35,Pass
Imran Pillai,04-10-2005,332738,Telangana,14,23,11,17,65,Fail
Aryan D'Souza,19-04-2006,911384,Maharashtra,19,9,22,21,71,Fail
Gurpreet Pillai,29-11-2005,279752,Odisha,24,19,24,6,73,Fail
Sukhwinder Singh,09-01-2005,823122,Uttarakhand,7,14,11,0,32,Fail
Krishna Fernandes,30-05-2005,478608,West Bengal,10,20,1,23,54,Fail
Rohan Chopra,17-01-2005,467898,Rajasthan,7,11,5,15,38,Pass
Krishna Singh,13-04-2005,264909,Chhattisgarh,8,1,0,20,29,Fail
Vivaan Reddy,08-03-2006,652285,Chhattisgarh,10,1,13,0,24,Fail
David Sharma,13-02-2006,120047,Uttarakhand,3,23,1,14,41,Fail
Raj Sharma,24-12-2004,205743,Uttar Pradesh,8,13,19,22,62,Fail
Kunal Reddy,20-11-2005,803389,Odisha,2,14,4,20,40,Pass
Vivaan Reddy,08-05-2006,570164,Bihar,9,2,12,14,37,Pass
Yash Sharma,05-03-2006,970448,Punjab,21,17,23,19,80,Pass
Gurpreet Verma,25-01-2006,926776,Punjab,7,9,3,2,21,Pass
Aarav D'Souza,04-02-2006,959363,Maharashtra,1,16,9,20,46,Fail
Raj Pillai,13-02-2006,458657,Uttar Pradesh,3,19,7,16,45,Fail
Mathew D'Souza,28-08-2005,428010,Andhra Pradesh,6,16,0,23,45,Pass
Aarav Verma,23-11-2005,621189,Haryana,18,10,3,0,31,Fail
Aryan Singh,02-03-2006,134948,Jharkhand,23,10,20,8,61,Pass
David Verma,30-09-2005,385967,Uttar Pradesh,15,22,17,17,71,Fail
Ishaan Khan,04-01-2006,464113,Rajasthan,9,14,9,17,49,Pass
Aarav Sharma,06-03-2006,607875,Bihar,0,17,8,5,30,Pass
Aditya D'Souza,10-03-2005,601704,West Bengal,22,13,8,6,49,Fail
Farhan Chopra,17-12-2004,136982,Mizoram,10,10,10,21,51,Fail
Aarav Khan,16-12-2004,445779,Uttar Pradesh,22,0,4,0,26,Fail
Yash Chopra,09-12-2005,594867,Tamil Nadu,18,24,10,4,56,Pass
Sukhwinder Mehta,07-12-2004,622420,Haryana,12,8,23,11,54,Fail
David Reddy,16-05-2005,735599,Uttarakhand,23,24,2,4,53,Fail
Aarav Sharma,11-12-2005,387138,Delhi,18,22,16,10,66,Fail
Harjeet Singh,13-03-2006,526574,Jharkhand,4,24,7,12,47,Pass
Rohan D'Souza,09-03-2006,955167,Tamil Nadu,10,2,4,9,25,Pass
Krishna Verma,07-04-2006,551950,Madhya Pradesh,14,17,7,1,39,Fail
Aarav Khan,06-06-2005,742650,Uttar Pradesh,19,1,6,6,32,Fail
Krishna Mehta,31-12-2005,157838,Haryana,12,9,16,1,38,Fail
Aryan Singh,02-09-2005,892685,Kerala,17,15,12,9,53,Pass
Aditya Verma,31-03-2005,630605,Chhattisgarh,11,21,3,22,57,Fail
Rehan Mehta,05-10-2005,567248,Haryana,1,11,16,22,50,Fail
Krishna Chopra,30-11-2004,951315,Madhya Pradesh,18,4,23,14,59,Fail
David Reddy,11-11-2004,291643,Maharashtra,1,4,23,7,35,Fail
Peter Pillai,15-08-2005,771871,Delhi,15,2,24,15,56,Fail
Aditya Verma,31-03-2006,364136,Karnataka,5,13,16,8,42,Pass
Aarav Khan,12-11-2005,621411,Punjab,10,7,2,23,42,Pass
Balbir Pillai,30-05-2005,299492,Andhra Pradesh,2,0,10,1,13,Pass
Manpreet Reddy,21-03-2005,189722,Bihar,7,0,3,15,25,Pass
Raj Reddy,01-04-2006,110334,Tamil Nadu,17,3,5,2,27,Pass
Yash Sharma,11-03-2006,811630,Punjab,20,16,8,21,65,Pass
Gurpreet Reddy,09-12-2005,954392,Uttar Pradesh,9,15,11,22,57,Fail
Yash Sharma,27-07-2005,147842,Uttarakhand,23,6,22,20,71,Fail
Aryan Verma,25-12-2005,182951,Delhi,18,17,5,21,61,Fail
Aryan Mehta,27-04-2005,955822,Maharashtra,7,2,9,1,19,Fail
Vivaan Reddy,06-12-2005,351295,Gujarat,16,6,1,7,30,Fail
Rehan Sharma,28-02-2005,337730,Jammu & Kashmir + Ladakh,0,13,15,14,42,Pass
Vivaan Fernandes,01-01-2005,870493,Haryana,8,19,11,0,38,Fail
Aarav D'Souza,19-07-2005,359748,Karnataka,8,5,13,17,43,Pass
Krishna D'Souza,28-08-2005,505464,Maharashtra,8,5,2,10,25,Fail
Ishaan Verma,08-10-2005,571530,Punjab,3,13,22,17,55,Pass
David Singh,07-08-2005,363736,Punjab,9,3,18,19,49,Pass
Aryan Reddy,23-03-2006,192660,Rajasthan,11,23,9,4,47,Pass
Raj Mehta,28-04-2005,997496,Odisha,17,15,20,18,70,Fail
Imran Khan,27-01-2006,349152,Manipur,21,3,24,11,59,Fail
Aryan Verma,26-12-2005,516301,Bihar,20,5,3,10,38,Pass
Kunal Fernandes,19-04-2005,176748,Karnataka,19,23,20,5,67,Pass
Ishaan Chopra,21-12-2005,966769,Bihar,0,15,11,15,41,Pass
Manpreet Fernandes,26-04-2005,803501,Rajasthan,19,23,23,13,78,Pass
Aarav Reddy,09-10-2005,637559,Assam,6,7,3,6,22,Fail
Rohan Verma,31-05-2005,207173,Karnataka,13,10,18,7,48,Pass
Vivaan Chopra,25-04-2005,526858,Assam,1,13,23,16,53,Fail
Aditya Reddy,12-07-2005,685262,Andhra Pradesh,24,11,10,20,65,Pass
Rohan Chopra,23-01-2005,980932,Bihar,17,14,5,4,40,Pass
Raj Verma,27-09-2005,636475,Madhya Pradesh,16,16,14,22,68,Fail
Ishaan D'Souza,03-05-2005,455789,Bihar,20,14,18,8,60,Pass
Farhan Fernandes,17-03-2006,834531,Punjab,10,2,22,23,57,Pass
Ishaan Mehta,20-02-2005,758358,Uttar Pradesh,6,24,10,9,49,Fail
Yash Fernandes,26-12-2004,826810,Kerala,16,24,0,0,40,Pass
Ishaan Chopra,31-12-2005,413492,Maharashtra,15,21,6,17,59,Fail
Paul Chopra,10-11-2004,293277,Uttar Pradesh,1,8,15,10,34,Fail
Peter Khan,06-12-2004,721027,Rajasthan,14,18,13,13,58,Pass
Ishaan Khan,27-11-2004,646426,Uttarakhand,3,9,16,13,41,Fail
Vivaan Pillai,18-11-2004,338150,Uttarakhand,18,12,7,10,47,Fail
Aditya Fernandes,19-08-2005,197943,Manipur,4,20,6,1,31,Fail
Raj Reddy,10-06-2005,355454,Uttar Pradesh,1,17,12,16,46,Fail
Rehan Khan,17-04-2005,556427,Delhi,20,20,21,16,77,Fail
David D'Souza,13-06-2005,341123,Madhya Pradesh,1,23,18,14,56,Fail
Yash Khan,14-04-2006,159083,Kerala,17,8,14,8,47,Pass
Krishna Pillai,20-08-2005,565652,Chhattisgarh,24,2,16,16,58,Fail
Yash Khan,11-02-2006,608438,Uttar Pradesh,6,14,7,16,43,Fail
Imran Reddy,03-03-2005,353519,Uttar Pradesh,7,8,17,1,33,Fail
David Mehta,20-04-2006,987019,West Bengal,6,17,12,12,47,Fail
Manpreet Mehta,01-01-2005,232470,Haryana,11,20,1,8,40,Fail
Krishna Chopra,06-04-2005,613526,West Bengal,13,0,12,15,40,Fail
Kunal Chopra,25-07-2005,512465,Rajasthan,22,13,20,19,74,Pass
Ishaan Fernandes,06-08-2005,941160,Telangana,18,12,23,19,72,Fail
Aditya Reddy,04-12-2004,105269,Maharashtra,16,17,5,13,51,Fail
Aditya Mehta,28-11-2005,236754,Punjab,7,18,2,23,50,Pass
Vivaan Verma,04-11-2005,586323,Rajasthan,15,17,14,4,50,Pass
Aditya D'Souza,04-09-2005,490157,Odisha,3,11,11,21,46,Fail
Ishaan Verma,05-02-2006,353200,Bihar,8,4,7,8,27,Pass
Yash Verma,10-12-2004,565856,Kerala,0,1,6,24,31,Pass
Vivaan Verma,17-04-2005,377099,Bihar,14,23,20,22,79,Pass
Harjeet Singh,01-12-2005,522081,Bihar,16,20,12,1,49,Pass
Ishaan Verma,08-03-2006,897824,Madhya Pradesh,23,10,16,13,62,Fail
Aarav Pillai,01-12-2005,415532,Haryana,7,24,17,14,62,Fail
Kunal Sharma,18-11-2004,626361,Tamil Nadu,19,11,0,14,44,Pass
Sukhwinder D'Souza,07-03-2005,543967,West Bengal,14,19,16,16,65,Fail
Rohan Reddy,16-03-2005,319260,Uttar Pradesh,7,18,14,18,57,Fail
Aditya Sharma,23-01-2006,381872,Madhya Pradesh,16,6,19,5,46,Fail
Vivaan Pillai,25-02-2006,189108,Madhya Pradesh,7,6,7,17,37,Fail
Aarav Pillai,01-03-2006,386166,Haryana,14,2,1,5,22,Fail
Krishna Reddy,11-03-2005,166277,Bihar,2,23,5,18,48,Pass
Kunal D'Souza,11-03-2006,694134,Madhya Pradesh,19,1,4,6,30,Fail
Kunal Chopra,29-09-2005,378891,Madhya Pradesh,21,14,21,1,57,Fail
Yash Chopra,07-05-2005,661116,Telangana,19,23,8,12,62,Fail
Vivaan Sharma,19-04-2006,494284,Andhra Pradesh,5,2,7,8,22,Pass
Paul Khan,11-01-2006,319144,Bihar,13,24,7,2,46,Pass
Kunal Sharma,02-01-2005,184004,Jharkhand,17,23,16,3,59,Pass
Paul Chopra,12-12-2004,492342,Uttar Pradesh,21,9,12,14,56,Fail
Kunal Sharma,02-03-2006,146853,Jharkhand,22,6,0,0,28,Pass
Manpreet Mehta,25-12-2004,670993,Haryana,14,6,20,19,59,Fail
Aryan Mehta,08-05-2006,750810,Tamil Nadu,7,16,2,9,34,Pass
Raj Pillai,22-12-2005,324485,Bihar,15,17,19,5,56,Pass
Raj Chopra,30-03-2006,798287,Madhya Pradesh,23,8,9,13,53,Fail
Rohan Sharma,10-07-2005,337919,Madhya Pradesh,23,1,7,23,54,Fail
Balbir Sharma,15-12-2004,294535,Maharashtra,7,11,8,24,50,Fail
Yash Sharma,08-09-2005,478220,Chhattisgarh,21,23,22,17,83,Fail
Krishna D'Souza,03-07-2005,306888,Uttarakhand,2,5,15,2,24,Fail
Yash Reddy,29-05-2005,306384,Rajasthan,8,13,0,21,42,Pass
Aryan Khan,30-11-2005,677437,Punjab,9,7,6,6,28,Pass
Krishna Singh,28-11-2004,289244,Madhya Pradesh,21,7,14,13,55,Fail
Kunal Verma,01-10-2005,290791,Maharashtra,6,18,21,7,52,Fail
Kunal Khan,25-11-2005,732974,Rajasthan,12,3,10,1,26,Pass
Balbir D'Souza,15-11-2005,277958,Karnataka,17,16,15,13,61,Pass
Ishaan Chopra,02-05-2006,763091,Tamil Nadu,17,16,7,3,43,Fail
Balbir Chopra,16-05-2005,545286,Maharashtra,10,15,22,18,65,Fail
Kunal Pillai,05-12-2005,726619,Punjab,22,7,8,14,51,Pass
Manpreet Singh,04-05-2005,592334,Uttar Pradesh,0,17,15,20,52,Fail
Aarav Khan,08-03-2006,443321,West Bengal,21,19,23,3,66,Fail
Kunal Singh,04-02-2005,254972,West Bengal,3,8,16,6,33,Fail
Balbir Verma,08-12-2004,870275,West Bengal,10,17,1,9,37,Fail
Kunal Chopra,31-07-2005,549467,Rajasthan,15,9,9,24,57,Pass
Yash Pillai,12-12-2005,198779,Uttar Pradesh,18,15,22,20,75,Fail
Ishaan Reddy,05-04-2006,988655,Uttar Pradesh,18,8,1,13,40,Fail
Raj Reddy,10-07-2005,172953,Maharashtra,7,22,15,11,55,Fail
Aryan Fernandes,15-04-2005,723443,Maharashtra,9,9,15,12,45,Fail
Aryan Verma,29-11-2004,831311,Rajasthan,22,17,12,21,72,Fail
Harjeet Chopra,11-03-2005,331647,Punjab,23,22,7,15,67,Pass
Krishna Chopra,12-04-2005,119392,Jharkhand,22,19,23,9,73,Fail
Aryan Pillai,06-03-2005,669854,Uttar Pradesh,12,1,10,19,42,Fail
Aryan Khan,12-03-2006,571205,Uttar Pradesh,22,13,4,3,42,Fail
Krishna Khan,14-06-2005,505006,Andhra Pradesh,13,20,4,1,38,Pass
Raj Fernandes,14-11-2005,502653,Bihar,14,5,4,4,27,Pass
Aryan Chopra,18-10-2005,431293,Maharashtra,4,18,13,13,48,Fail
Vivaan Chopra,13-05-2005,420055,Andhra Pradesh,1,20,24,2,47,Pass
Peter Verma,05-05-2005,479530,Bihar,10,18,15,1,44,Pass
Kunal Singh,17-11-2005,643134,Tamil Nadu,9,0,23,23,55,Fail
Aarav Khan,16-10-2005,371519,Rajasthan,22,7,11,0,40,Pass
Aryan Sharma,20-01-2005,374487,Rajasthan,24,1,0,3,28,Pass
Manpreet D'Souza,03-12-2004,638337,Rajasthan,19,1,0,18,38,Pass
Rohan Khan,19-02-2006,136360,West Bengal,5,17,8,21,51,Fail
Aditya Singh,29-07-2005,968017,Madhya Pradesh,4,4,21,17,46,Fail
Peter Singh,07-05-2005,856964,Bihar,2,2,24,17,45,Pass
Raj Sharma,24-02-2005,367061,Gujarat,3,7,7,23,40,Fail
Harjeet D'Souza,28-12-2005,906014,Chhattisgarh,21,2,20,20,63,Fail
Sukhwinder Mehta,08-12-2005,135507,Tamil Nadu,19,23,18,24,84,Pass
Kunal Fernandes,04-05-2006,810448,Andhra Pradesh,23,7,3,9,42,Pass
Sukhwinder Pillai,23-12-2005,856553,Jammu & Kashmir + Ladakh,8,11,1,23,43,Pass
Aarav Khan,31-12-2004,967355,Telangana,6,7,14,10,37,Fail
Krishna Reddy,06-05-2005,439735,Maharashtra,10,9,18,0,37,Fail
Aarav Reddy,09-06-2005,969191,Uttarakhand,23,22,13,23,81,Fail
Aarav D'Souza,08-04-2006,574742,Madhya Pradesh,11,5,17,11,44,Fail
Aarav Chopra,26-12-2005,901963,West Bengal,24,24,11,9,68,Fail
Manpreet Verma,12-02-2005,259714,Kerala,0,21,8,17,46,Pass
Yash Fernandes,06-01-2005,903713,Bihar,20,20,14,3,57,Pass
Rohan Sharma,12-12-2005,479577,Maharashtra,10,21,15,24,70,Fail
Ishaan Singh,13-12-2005,395336,Maharashtra,12,3,4,17,36,Fail
Kunal Singh,19-04-2006,664498,Rajasthan,1,19,18,8,46,Pass
Aarav Khan,25-03-2006,669727,Tamil Nadu,13,8,16,6,43,Fail
Vivaan Singh,29-01-2005,703428,Telangana,11,0,13,11,35,Fail
Rohan Pillai,04-01-2006,396027,Delhi,19,8,17,8,52,Fail
Vivaan Chopra,13-03-2005,858009,Daman & Diu / D&N Haveli,22,23,16,23,84,Fail
Rohan Reddy,16-03-2006,292303,Karnataka,24,21,16,21,82,Fail
Rohan Verma,25-07-2005,429261,Andhra Pradesh,15,21,15,23,74,Pass
John Mehta,02-12-2004,298995,Bihar,8,23,9,1,41,Pass
Aarav Fernandes,15-05-2005,208766,Jharkhand,11,5,6,10,32,Pass
Aarav D'Souza,22-03-2005,583270,Andhra Pradesh,12,23,16,15,66,Pass
Peter D'Souza,19-08-2005,180845,Assam,5,2,16,12,35,Fail
Vivaan Sharma,24-11-2005,482878,Bihar,7,20,20,8,55,Pass
Aryan Mehta,08-11-2005,380737,Bihar,15,13,7,17,52,Pass
Balbir Fernandes,21-11-2005,183440,Odisha,19,7,19,22,67,Fail
Vivaan Reddy,29-07-2005,833020,Punjab,12,6,1,0,19,Pass
Aditya Chopra,05-03-2005,453076,Uttar Pradesh,3,13,17,4,37,Fail
Aarav Reddy,14-04-2005,719123,Bihar,1,10,12,21,44,Pass
Kunal Sharma,25-11-2005,323181,Maharashtra,23,9,14,8,54,Fail
Aditya Verma,30-10-2005,566302,Punjab,4,4,2,22,32,Pass
Aryan Chopra,26-08-2005,376126,Andhra Pradesh,22,21,8,16,67,Pass
Yash Reddy,06-03-2005,569991,Telangana,7,11,11,23,52,Fail
Aryan Mehta,10-03-2006,765614,Madhya Pradesh,0,1,17,5,23,Fail
Gurpreet Fernandes,12-04-2005,112520,Madhya Pradesh,16,0,9,7,32,Fail
Ishaan Chopra,20-02-2005,774645,Maharashtra,22,17,16,12,67,Fail
Mathew Pillai,19-12-2004,534653,Assam,9,6,23,4,42,Fail
Zaid Reddy,21-01-2006,575312,Tamil Nadu,3,1,21,20,45,Fail
Gurpreet Fernandes,17-04-2006,986049,Madhya Pradesh,21,7,12,1,41,Fail
Yash Singh,09-04-2006,923386,Bihar,14,24,6,0,44,Pass
David D'Souza,24-01-2006,910328,Haryana,21,6,18,15,60,Fail
Ishaan Khan,03-06-2005,648903,Karnataka,13,21,23,22,79,Fail
Imran Fernandes,06-09-2005,485226,Assam,15,18,20,13,66,Fail
Zaid D'Souza,08-08-2005,416145,Telangana,5,2,11,2,20,Fail
Aditya Reddy,30-03-2005,579859,Kerala,19,16,15,19,69,Fail
Raj Sharma,04-05-2006,564550,West Bengal,24,20,16,2,62,Fail
Aarav D'Souza,21-08-2005,122403,Delhi,13,4,12,5,34,Fail
Krishna Pillai,29-06-2005,315040,Maharashtra,17,9,18,22,66,Fail
Krishna Verma,06-05-2006,908434,Rajasthan,13,2,17,15,47,Pass
Yash Khan,28-11-2004,166812,West Bengal,13,0,18,13,44,Fail
Kunal Singh,17-07-2005,688339,Punjab,21,15,23,23,82,Pass
Raj Chopra,10-12-2005,417193,Maharashtra,14,10,13,18,55,Fail
Aryan Mehta,02-10-2005,719740,Tamil Nadu,24,14,8,15,61,Pass
Vivaan Singh,06-10-2005,114441,Karnataka,4,14,19,5,42,Pass
Manpreet Fernandes,26-12-2004,904949,Telangana,18,17,5,0,40,Fail
Harjeet Fernandes,02-05-2005,321285,Karnataka,21,20,14,9,64,Pass
Sukhwinder Singh,31-08-2005,695876,Maharashtra,1,1,24,21,47,Fail
Ishaan Reddy,11-08-2005,808851,Punjab,12,21,15,16,64,Pass
Rohan Pillai,16-05-2005,529477,Gujarat,0,0,20,13,33,Fail
Ishaan Verma,10-07-2005,619220,Gujarat,23,23,11,21,78,Fail
Aditya Fernandes,14-02-2005,727072,West Bengal,20,19,1,21,61,Fail
Farhan Sharma,23-12-2005,724405,Delhi,17,7,12,7,43,Fail
Zaid Chopra,09-05-2006,166765,Uttarakhand,15,5,2,7,29,Fail
Aarav Pillai,27-04-2006,788921,Madhya Pradesh,4,2,16,17,39,Fail
Aryan Khan,13-01-2006,176573,Bihar,21,11,20,7,59,Pass
Peter D'Souza,27-07-2005,456577,Chhattisgarh,24,17,5,19,65,Fail
Aditya Sharma,29-11-2005,119718,Tamil Nadu,15,15,14,22,66,Pass
Aditya Singh,07-11-2005,347525,Maharashtra,3,17,16,10,46,Fail
Aarav Pillai,05-12-2005,295647,Uttar Pradesh,16,10,10,23,59,Fail
Kunal Chopra,13-07-2005,291190,Odisha,12,11,8,3,34,Pass
Krishna Fernandes,19-03-2005,796203,Madhya Pradesh,9,19,20,20,68,Fail
Aryan Sharma,11-05-2005,882712,Andhra Pradesh,5,9,4,20,38,Pass
Sukhwinder D'Souza,27-12-2005,215073,Maharashtra,6,18,20,16,60,Fail
Kunal Mehta,19-02-2006,924295,Haryana,14,17,20,22,73,Fail
Harjeet Fernandes,07-01-2005,729203,Tamil Nadu,21,22,7,23,73,Pass
Kunal Fernandes,06-05-2005,902757,Bihar,4,1,19,13,37,Pass
Kunal Pillai,23-07-2005,165165,West Bengal,19,15,20,6,60,Fail
Imran D'Souza,22-06-2005,121036,Bihar,7,13,9,21,50,Pass
Ishaan Singh,19-12-2004,189236,Tamil Nadu,3,1,14,5,23,Pass
John Verma,29-12-2005,142405,Madhya Pradesh,4,23,12,10,49,Fail
Vivaan D'Souza,10-05-2005,782580,Jammu & Kashmir + Ladakh,10,12,9,0,31,Pass
Harjeet Pillai,15-01-2006,569276,Bihar,20,12,24,6,62,Pass
Paul D'Souza,21-10-2005,479861,Karnataka,2,4,23,6,35,Pass
Krishna Mehta,12-04-2006,261252,Rajasthan,15,2,23,4,44,Pass
Aditya Chopra,22-07-2005,251978,Jharkhand,18,9,16,23,66,Pass
David Sharma,24-03-2005,394048,Tamil Nadu,2,5,7,10,24,Pass
John Chopra,30-03-2005,786188,Rajasthan,24,4,19,8,55,Pass
Vivaan Singh,06-05-2006,729899,Karnataka,18,15,0,18,51,Pass
Gurpreet Verma,28-12-2005,817068,Uttar Pradesh,23,18,11,10,62,Fail
David Singh,16-12-2004,698988,Uttar Pradesh,1,3,24,5,33,Fail
Aarav Singh,19-09-2005,900933,West Bengal,2,23,23,5,53,Fail
Aarav Chopra,05-08-2005,930800,Odisha,22,22,10,5,59,Fail
Aryan Singh,31-12-2004,954652,West Bengal,0,17,10,2,29,Fail
Gurpreet Mehta,11-08-2005,302335,Jammu & Kashmir + Ladakh,17,2,2,5,26,Pass
Balbir D'Souza,24-06-2005,245224,Himachal Pradesh,10,18,22,4,54,Fail
Aryan Pillai,24-01-2005,109897,Haryana,19,7,5,10,41,Fail
Sukhwinder Khan,05-02-2006,771436,Uttar Pradesh,24,23,0,9,56,Fail
Ishaan Chopra,22-01-2005,951909,Madhya Pradesh,5,22,3,24,54,Fail
Krishna Chopra,04-03-2005,860038,Madhya Pradesh,10,13,23,11,57,Fail
Manpreet Singh,08-04-2006,899298,Bihar,6,21,22,23,72,Pass
Rohan Pillai,22-07-2005,317382,Bihar,22,2,13,21,58,Pass
Kunal Chopra,22-02-2005,907653,Uttar Pradesh,5,5,4,22,36,Fail
Manpreet Chopra,22-07-2005,209491,Punjab,10,21,23,13,67,Pass
Rohan Khan,07-03-2005,920335,Punjab,21,17,9,10,57,Pass
Vivaan Verma,28-02-2005,581046,Bihar,17,12,5,24,58,Pass
Manpreet Khan,04-08-2005,823142,Bihar,17,0,20,10,47,Pass
Kunal D'Souza,05-05-2005,153377,Rajasthan,8,12,5,13,38,Pass
Aryan Chopra,02-03-2005,917526,Madhya Pradesh,16,3,5,6,30,Fail
Kunal Fernandes,22-11-2004,140913,Uttarakhand,19,0,1,24,44,Fail
Manpreet Chopra,04-09-2005,212943,Maharashtra,17,14,3,3,37,Fail
Harjeet Verma,17-08-2005,379820,Punjab,2,6,5,0,13,Pass
Harjeet Pillai,09-03-2005,270337,Telangana,10,22,11,15,58,Fail
Aryan Reddy,01-02-2005,212556,Kerala,24,7,18,23,72,Fail
Aryan Khan,01-02-2005,100849,Gujarat,3,9,4,4,20,Fail
Manpreet Verma,26-04-2005,752403,Himachal Pradesh,12,4,14,4,34,Pass
Aarav Singh,09-11-2004,600465,Maharashtra,13,22,1,23,59,Fail
Aarav Reddy,20-07-2005,811893,Karnataka,7,6,5,8,26,Pass
Aryan Mehta,15-03-2006,617513,Uttarakhand,2,14,0,7,23,Fail
Aditya Reddy,07-05-2006,505954,Rajasthan,14,10,11,18,53,Pass
Harjeet Reddy,23-04-2006,875181,Haryana,14,19,7,23,63,Fail
Ishaan Fernandes,10-09-2005,886122,Maharashtra,10,4,17,24,55,Fail
Rohan Reddy,03-09-2005,934196,Gujarat,10,0,4,19,33,Fail
Raj Chopra,28-04-2005,146519,Madhya Pradesh,2,20,10,14,46,Fail
Sukhwinder Mehta,06-04-2006,550027,Madhya Pradesh,19,14,20,7,60,Fail
Raj Fernandes,10-04-2005,189741,Bihar,13,18,10,13,54,Pass
Aditya Pillai,19-04-2005,153909,Karnataka,20,13,0,6,39,Pass
Aryan Sharma,16-11-2005,960619,Rajasthan,13,23,1,23,60,Fail
Aditya Singh,02-03-2005,811291,Rajasthan,1,24,6,10,41,Pass
Yash Singh,17-02-2006,821454,Odisha,19,0,23,12,54,Fail
Krishna Khan,23-04-2006,118338,West Bengal,13,7,22,11,53,Fail
Mathew Verma,08-03-2005,219810,Maharashtra,13,23,5,21,62,Fail
Rohan D'Souza,22-10-2005,336414,Uttar Pradesh,0,15,9,17,41,Fail
Raj Fernandes,18-03-2005,923022,West Bengal,23,9,20,16,68,Fail
Vivaan D'Souza,03-04-2006,622995,Andhra Pradesh,4,11,11,5,31,Pass
Rohan D'Souza,08-11-2004,754899,Maharashtra,11,21,6,13,51,Fail
David Pillai,10-05-2005,593113,Punjab,15,24,21,11,71,Pass
Rohan Khan,24-08-2005,670038,Tripura,17,17,14,1,49,Fail
Rehan Singh,24-01-2005,412319,Madhya Pradesh,5,7,6,18,36,Fail
Raj Chopra,28-02-2005,595128,Meghalaya,11,9,7,23,50,Fail
Ishaan Singh,15-02-2006,428475,Uttar Pradesh,23,17,18,7,65,Fail
Aditya Reddy,22-08-2005,337013,Punjab,13,5,8,21,47,Pass
Balbir Singh,19-06-2005,366968,Uttar Pradesh,3,21,7,23,54,Fail
Mathew Fernandes,15-02-2005,408859,Punjab,24,19,0,23,66,Pass
Vivaan Reddy,04-03-2005,914456,Maharashtra,13,5,21,6,45,Fail
Ishaan Singh,07-01-2006,199313,Punjab,18,10,16,13,57,Pass
Harjeet Khan,26-03-2005,365298,Assam,5,18,18,3,44,Fail
Raj Sharma,11-10-2005,636699,Uttar Pradesh,13,7,14,4,38,Fail
Rohan Singh,10-12-2004,488727,Uttar Pradesh,16,0,13,10,39,Fail
Gurpreet Verma,10-06-2005,329972,Bihar,16,9,11,15,51,Pass
David D'Souza,17-02-2006,112615,Madhya Pradesh,19,10,24,6,59,Fail
John Reddy,21-10-2005,728263,Tamil Nadu,9,2,24,4,39,Pass
Aryan Singh,06-09-2005,227450,Karnataka,5,7,17,20,49,Pass
Yash Mehta,04-05-2005,711051,Uttar Pradesh,19,6,24,17,66,Fail
Manpreet Mehta,28-06-2005,848458,Uttar Pradesh,8,6,18,1,33,Fail
Ishaan Sharma,10-05-2005,119118,Gujarat,1,13,6,13,33,Fail
Sukhwinder Khan,14-01-2006,648848,Rajasthan,23,8,21,15,67,Fail
Aditya Khan,07-05-2006,382490,Madhya Pradesh,8,17,5,12,42,Fail
Raj D'Souza,31-03-2005,137258,West Bengal,22,10,15,23,70,Fail
Rohan Singh,18-11-2005,676142,Tamil Nadu,22,14,1,8,45,Fail
Harjeet Singh,03-03-2006,242138,Jharkhand,10,16,12,16,54,Pass
Aarav Sharma,03-05-2006,474665,Madhya Pradesh,24,9,24,5,62,Fail
Vivaan Khan,15-10-2005,383045,Kerala,6,2,13,2,23,Pass
Mathew Pillai,11-10-2005,108709,Uttar Pradesh,3,8,22,1,34,Fail
Balbir Khan,04-11-2005,184034,Uttar Pradesh,4,4,11,3,22,Fail
Kunal Khan,23-01-2006,250728,Rajasthan,23,24,8,23,78,Pass
Raj Pillai,08-08-2005,727420,Jharkhand,8,1,15,1,25,Pass
Kunal Chopra,17-04-2005,936202,Tamil Nadu,3,8,9,5,25,Pass
Rohan D'Souza,14-03-2006,454918,Rajasthan,20,10,18,18,66,Fail
Manpreet D'Souza,24-11-2004,147752,Jammu & Kashmir + Ladakh,0,23,10,19,52,Pass
Yash D'Souza,10-11-2005,653249,Himachal Pradesh,6,9,3,1,19,Pass
Aarav Singh,26-09-2005,682522,Delhi,13,0,5,6,24,Fail
Aarav D'Souza,27-01-2005,333438,Uttar Pradesh,11,1,4,8,24,Fail
Gurpreet Mehta,29-09-2005,905242,Uttar Pradesh,14,0,19,19,52,Fail
Rohan Sharma,05-10-2005,265777,Uttar Pradesh,9,0,4,13,26,Fail
Ishaan Fernandes,30-01-2006,478287,Telangana,23,21,12,20,76,Fail
Ishaan Mehta,21-03-2006,596833,Uttarakhand,18,9,7,13,47,Fail
Aarav Pillai,14-04-2006,440344,Odisha,10,11,12,22,55,Fail
Yash Sharma,04-01-2006,448087,Jharkhand,8,11,16,10,45,Pass
Yash Chopra,07-07-2005,691326,Madhya Pradesh,23,8,19,22,72,Fail
Yash Khan,07-01-2006,834185,Uttar Pradesh,5,23,9,9,46,Fail
John Mehta,22-09-2005,723265,Bihar,18,18,9,12,57,Pass
Kunal Sharma,19-03-2005,797468,Tamil Nadu,24,24,14,1,63,Fail
Vivaan Fernandes,13-04-2005,159411,West Bengal,17,17,8,4,46,Fail
Ishaan Khan,14-03-2006,188902,Madhya Pradesh,19,20,3,8,50,Fail
Aditya Khan,03-06-2005,286860,Uttar Pradesh,17,10,19,7,53,Fail
Mathew Mehta,30-12-2005,667944,Karnataka,9,21,14,9,53,Pass
Manpreet Fernandes,22-01-2005,786766,Punjab,10,15,6,19,50,Pass
Vivaan Khan,02-01-2006,386942,Madhya Pradesh,21,18,3,17,59,Fail
Aryan Fernandes,12-11-2004,619263,Rajasthan,8,11,10,16,45,Pass
Peter Khan,29-12-2004,517635,Bihar,7,12,11,2,32,Pass
Peter Singh,28-11-2004,433629,Haryana,2,4,23,10,39,Fail
Kunal Mehta,14-06-2005,900722,Bihar,16,1,24,21,62,Pass
Kunal Mehta,24-11-2005,580416,Punjab,20,19,5,23,67,Pass
Gurpreet Sharma,02-04-2005,427745,Bihar,22,11,9,2,44,Pass
Rohan Singh,27-09-2005,744939,Rajasthan,19,24,22,0,65,Fail
Vivaan Fernandes,24-12-2004,472348,Assam,13,4,23,21,61,Fail
Peter Reddy,15-04-2005,632300,Gujarat,13,17,12,7,49,Fail
Kunal Fernandes,14-07-2005,495665,Tamil Nadu,21,10,9,17,57,Pass
Krishna Mehta,26-05-2005,912702,Uttar Pradesh,22,3,24,12,61,Fail
Ishaan Fernandes,04-04-2005,331283,Rajasthan,3,3,0,4,10,Pass
Yash Pillai,16-04-2006,117109,Bihar,10,23,11,3,47,Pass
Ishaan Reddy,18-08-2005,886333,Bihar,20,13,14,3,50,Pass
Raj Reddy,06-08-2005,385595,Uttar Pradesh,21,18,15,2,56,Fail
Peter Mehta,10-04-2005,535410,Kerala,12,23,18,4,57,Pass
Rohan Singh,30-04-2006,412070,Uttar Pradesh,15,19,18,14,66,Fail
Vivaan Chopra,19-03-2005,123277,West Bengal,1,2,21,9,33,Fail
Vivaan Chopra,19-07-2005,526179,Madhya Pradesh,0,13,4,2,19,Fail
Rohan Reddy,24-11-2005,403198,Maharashtra,18,18,7,9,52,Fail
Ishaan Verma,16-08-2005,966356,Andhra Pradesh,6,7,21,10,44,Pass
Aryan Verma,23-01-2005,557906,West Bengal,7,20,20,10,57,Fail
Vivaan Singh,29-01-2006,116567,Punjab,6,6,20,16,48,Pass
Rohan D'Souza,18-03-2005,444618,Bihar,14,21,17,20,72,Pass
John Verma,27-03-2005,655254,Uttar Pradesh,20,9,3,22,54,Fail
Aryan Reddy,27-06-2005,803752,Assam,15,24,12,14,65,Fail
Rohan Fernandes,17-11-2005,928157,Punjab,8,3,13,9,33,Pass
Aryan D'Souza,19-04-2005,157337,Madhya Pradesh,21,18,23,8,70,Fail
Raj D'Souza,14-02-2006,492351,Gujarat,6,8,22,19,55,Fail
Balbir Fernandes,28-09-2005,151561,Himachal Pradesh,6,2,8,0,16,Pass
John Singh,05-08-2005,898996,Haryana,5,9,23,23,60,Fail
Sukhwinder Reddy,20-03-2006,829428,Karnataka,13,16,12,4,45,Pass
Vivaan Singh,06-09-2005,463681,Jharkhand,22,16,11,15,64,Pass
Aarav Mehta,05-05-2005,997750,Rajasthan,14,17,10,16,57,Pass
Yash Reddy,25-02-2005,975281,Rajasthan,8,6,21,14,49,Pass
Gurpreet Khan,03-12-2004,209246,Tamil Nadu,22,5,4,11,42,Pass
Rohan Sharma,13-12-2005,128943,West Bengal,20,10,12,13,55,Fail
Aarav Chopra,10-05-2005,109768,Odisha,0,8,14,9,31,Pass
Rohan Fernandes,12-04-2005,630280,Gujarat,24,17,8,19,68,Fail
Vivaan Verma,23-02-2005,954191,Gujarat,22,5,24,2,53,Fail
Paul Reddy,11-08-2005,986601,Uttar Pradesh,9,12,15,0,36,Fail
Sukhwinder Singh,24-04-2005,708205,Bihar,3,0,18,6,27,Pass
Raj Verma,14-08-2005,626750,Jammu & Kashmir + Ladakh,9,1,19,21,50,Pass
Kunal D'Souza,11-06-2005,491034,Rajasthan,22,10,2,24,58,Pass
Harjeet Sharma,18-04-2006,952928,Haryana,9,11,7,16,43,Fail
Gurpreet Verma,04-08-2005,178078,Bihar,4,16,22,22,64,Pass
Ishaan Khan,30-11-2005,300346,Tripura,22,12,3,7,44,Fail
Paul Mehta,28-05-2005,876725,Himachal Pradesh,9,23,11,12,55,Pass
Raj Fernandes,25-05-2005,445967,Uttar Pradesh,20,8,8,23,59,Fail
Balbir Reddy,03-01-2006,945057,Rajasthan,12,14,11,4,41,Pass
Aryan Verma,22-09-2005,405425,Jharkhand,13,10,21,11,55,Pass
Imran Pillai,12-03-2006,227208,Kerala,13,20,4,20,57,Pass
Vivaan Verma,26-09-2005,914680,Maharashtra,20,14,5,21,60,Fail
Aarav Verma,24-01-2006,969160,Bihar,20,8,11,4,43,Pass
Krishna Singh,11-10-2005,555231,Tamil Nadu,22,9,16,1,48,Fail
Ishaan Verma,20-11-2005,690701,Odisha,17,6,1,23,47,Fail
Gurpreet D'Souza,09-04-2006,193726,Tamil Nadu,0,4,13,11,28,Pass
Aditya Chopra,01-04-2006,815364,Punjab,2,24,21,18,65,Pass
Aarav Fernandes,24-02-2005,723948,Rajasthan,12,6,5,19,42,Pass
Aditya Reddy,06-02-2005,109133,Bihar,19,11,5,15,50,Pass
Balbir Reddy,14-01-2006,403296,Bihar,15,14,3,5,37,Pass
Aditya Reddy,12-02-2005,883702,Tamil Nadu,20,3,9,11,43,Fail
Gurpreet Fernandes,06-04-2006,765235,Telangana,17,0,15,6,38,Fail
Rohan D'Souza,02-03-2005,529399,Rajasthan,19,13,11,22,65,Fail
Aarav Mehta,26-09-2005,408073,Kerala,3,1,14,19,37,Pass
Raj Sharma,17-10-2005,349179,Himachal Pradesh,11,1,0,20,32,Pass
Krishna Chopra,19-04-2006,326926,Haryana,5,19,18,11,53,Fail
Peter Singh,06-05-2005,622251,Arunachal Pradesh,2,23,12,8,45,Fail
Balbir Pillai,15-03-2005,574529,Telangana,2,11,21,11,45,Fail
Kunal Reddy,07-12-2005,695007,Maharashtra,16,16,14,23,69,Fail
Raj Khan,21-08-2005,150483,Jammu & Kashmir + Ladakh,24,9,23,13,69,Fail
Krishna Reddy,28-03-2005,681854,Haryana,21,11,4,24,60,Fail
John Singh,10-03-2005,114023,Andhra Pradesh,9,10,9,19,47,Pass
Raj Reddy,28-07-2005,748552,Andhra Pradesh,4,7,10,23,44,Pass
Aditya Chopra,18-09-2005,433897,Maharashtra,7,7,4,3,21,Fail
Ishaan Singh,08-03-2005,842636,Madhya Pradesh,8,0,12,22,42,Fail
Yash Verma,14-01-2006,778517,Rajasthan,4,16,20,3,43,Pass
Raj Fernandes,29-04-2006,464528,Gujarat,0,22,6,23,51,Fail
Krishna Pillai,14-11-2005,320551,Kerala,23,19,12,8,62,Pass
Krishna D'Souza,19-05-2005,363791,West Bengal,11,5,13,13,42,Fail
Yash Sharma,17-03-2006,410158,Tripura,19,0,1,6,26,Fail
Aarav Verma,16-07-2005,321736,Uttar Pradesh,12,16,15,13,56,Fail
Rohan Sharma,13-10-2005,276373,Jharkhand,18,17,1,21,57,Pass
Rehan Mehta,02-01-2005,124313,Bihar,6,20,14,14,54,Pass
Harjeet Verma,18-12-2004,384519,West Bengal,12,21,20,4,57,Fail
Harjeet Fernandes,29-07-2005,778518,West Bengal,12,10,20,23,65,Fail
Yash Sharma,16-11-2004,399023,West Bengal,9,8,21,15,53,Fail
Aditya Singh,28-04-2005,859838,Kerala,5,11,24,1,41,Pass
Aditya Pillai,18-05-2005,339171,Rajasthan,18,7,12,3,40,Pass
Paul Mehta,12-01-2005,852219,Chhattisgarh,20,3,10,13,46,Fail
Harjeet Singh,30-11-2004,414135,Bihar,17,19,19,20,75,Pass
Aryan Sharma,16-02-2005,834763,Chhattisgarh,11,3,0,0,14,Fail
Peter Pillai,03-03-2005,729114,Haryana,1,6,22,0,29,Fail
Manpreet Khan,01-07-2005,481220,Gujarat,1,18,17,8,44,Fail
Aryan Khan,16-05-2005,492376,Rajasthan,4,16,3,16,39,Pass
Rohan Verma,31-05-2005,264797,Haryana,13,5,24,17,59,Fail
Ishaan Singh,11-05-2005,183570,Andhra Pradesh,15,5,5,7,32,Pass
Zaid Singh,05-02-2006,646493,Punjab,13,24,19,2,58,Pass
Kunal Fernandes,25-06-2005,610686,Madhya Pradesh,2,13,14,21,50,Fail
Raj Reddy,11-07-2005,173197,Bihar,9,14,11,17,51,Pass
Rohan Chopra,21-11-2004,466700,Delhi,10,0,7,24,41,Fail
Krishna Khan,03-10-2005,887595,Nagaland,0,12,3,10,25,Pass
Kunal Chopra,06-05-2006,674964,Jharkhand,4,22,13,13,52,Fail
Krishna Khan,01-08-2005,420188,West Bengal,10,14,7,10,41,Fail
Vivaan D'Souza,22-03-2006,140370,Uttar Pradesh,5,14,6,0,25,Fail
Paul Fernandes,25-07-2005,273555,Punjab,18,1,6,7,32,Pass
Aryan Pillai,26-04-2005,267747,Uttar Pradesh,10,5,24,1,40,Fail
Aryan Chopra,25-12-2004,280540,Maharashtra,9,9,7,0,25,Fail
David Singh,13-11-2005,394323,Bihar,12,5,20,6,43,Pass
Vivaan Pillai,17-04-2005,458143,Karnataka,8,8,11,18,45,Pass
Aditya D'Souza,15-01-2005,672398,Kerala,8,5,2,22,37,Pass
Aarav Sharma,19-02-2006,403104,Bihar,5,5,18,4,32,Pass
John Fernandes,09-12-2004,561046,Rajasthan,3,15,12,0,30,Pass
Ayaan Singh,15-03-2005,155942,Kerala,15,20,9,8,52,Pass
Yash Verma,05-07-2005,495336,West Bengal,16,24,13,18,71,Fail
Ishaan Sharma,08-05-2005,559765,Madhya Pradesh,13,5,23,5,46,Fail
Kunal Verma,09-11-2005,634412,Tamil Nadu,22,10,19,21,72,Pass
Vivaan Pillai,08-08-2005,244126,Uttar Pradesh,8,21,9,15,53,Fail
Manpreet Mehta,21-01-2006,412156,Bihar,16,3,1,5,25,Pass
Yash Mehta,30-12-2005,656233,Rajasthan,11,24,14,3,52,Pass
Aarav Reddy,21-12-2004,788452,Bihar,17,19,11,3,50,Pass
Sukhwinder Chopra,23-01-2006,202781,Jharkhand,3,20,12,18,53,Pass
Ishaan Singh,03-12-2004,736392,Nagaland,5,11,20,10,46,Fail
Sukhwinder D'Souza,18-11-2005,653719,Andhra Pradesh,1,5,13,15,34,Pass
Aditya Verma,17-08-2005,601437,Tamil Nadu,21,3,7,7,38,Pass
Ishaan Mehta,23-07-2005,986148,Assam,18,17,13,9,57,Fail
Krishna D'Souza,29-11-2005,966034,Bihar,21,7,21,16,65,Pass
Balbir Mehta,25-01-2006,826934,Tamil Nadu,20,5,21,9,55,Fail
David Fernandes,14-01-2006,501742,Bihar,12,12,17,20,61,Pass
Aditya Fernandes,18-10-2005,155331,Sikkim,4,0,22,23,49,Fail
Krishna Pillai,01-01-2006,891394,Andhra Pradesh,11,19,2,8,40,Pass
Kunal Fernandes,01-05-2005,280113,West Bengal,13,11,2,13,39,Fail
Raj Chopra,28-03-2005,616615,Tamil Nadu,5,7,12,12,36,Pass
Aditya Mehta,05-04-2005,205646,Chhattisgarh,12,9,2,1,24,Fail
Raj Mehta,01-08-2005,787729,Andhra Pradesh,8,11,2,21,42,Pass
Raj Khan,29-11-2004,312065,Assam,19,3,22,9,53,Fail
Aryan Sharma,12-10-2005,540791,Bihar,21,18,13,9,61,Pass
Ishaan Chopra,30-04-2006,480073,Gujarat,6,17,14,11,48,Fail
Yash Reddy,07-02-2005,443788,Bihar,5,18,23,3,49,Pass
Vivaan Pillai,16-12-2005,231114,Bihar,13,14,15,17,59,Pass
Raj D'Souza,26-03-2006,420368,Maharashtra,12,23,7,4,46,Fail
Sukhwinder Pillai,16-04-2005,463981,Punjab,2,18,21,18,59,Pass
Ishaan Fernandes,19-09-2005,361004,Tamil Nadu,15,21,2,22,60,Pass
Ishaan Reddy,10-07-2005,239670,Bihar,13,0,18,0,31,Pass
Aryan Sharma,03-12-2005,968172,Jammu & Kashmir + Ladakh,14,4,4,6,28,Pass
Rohan Khan,26-03-2006,225682,Rajasthan,13,7,12,5,37,Pass
Yash D'Souza,10-01-2006,576259,West Bengal,5,0,21,7,33,Fail
Balbir Khan,02-04-2005,297052,Uttarakhand,1,2,2,20,25,Fail
Peter Fernandes,11-11-2005,821468,Rajasthan,0,22,24,18,64,Fail
Raj Verma,19-10-2005,209876,Chhattisgarh,7,15,5,11,38,Fail
Aarav Pillai,25-03-2006,464001,Himachal Pradesh,0,13,21,23,57,Pass
Raj Chopra,11-07-2005,364335,Bihar,3,15,5,6,29,Pass
Ishaan Sharma,25-03-2006,678440,Andhra Pradesh,8,1,16,9,34,Pass
Imran Chopra,17-04-2006,844998,Andhra Pradesh,3,18,3,1,25,Pass
Yash Singh,13-01-2006,378528,Jharkhand,4,13,23,14,54,Pass
Kunal Verma,27-02-2005,475688,Maharashtra,16,4,10,4,34,Fail
Ishaan Sharma,22-08-2005,209093,Uttar Pradesh,2,9,11,22,44,Fail
Ishaan Singh,04-05-2005,177818,Bihar,3,24,7,11,45,Pass
Kunal Singh,18-11-2005,568135,Tamil Nadu,14,24,17,9,64,Fail
Sukhwinder Singh,06-12-2004,769801,Punjab,3,15,7,23,48,Pass
Farhan Singh,05-01-2006,294685,Uttar Pradesh,3,18,15,9,45,Fail
Krishna Reddy,30-12-2004,822251,Uttar Pradesh,17,13,23,5,58,Fail
Vivaan Verma,21-05-2005,166899,Maharashtra,23,17,17,2,59,Fail
Aarav Khan,23-06-2005,523594,Uttar Pradesh,6,13,15,15,49,Fail
Vivaan Reddy,11-07-2005,542596,Andhra Pradesh,14,0,8,11,33,Pass
Krishna Chopra,04-03-2005,894651,Uttar Pradesh,23,5,8,3,39,Fail
Balbir Mehta,03-09-2005,214632,Madhya Pradesh,3,19,16,12,50,Fail
Aryan Pillai,28-02-2006,760950,Odisha,22,10,6,21,59,Fail
Manpreet Khan,04-10-2005,253822,Bihar,8,9,4,8,29,Pass
Aditya Sharma,31-07-2005,141755,Kerala,24,3,12,3,42,Pass
Vivaan Fernandes,15-04-2006,244547,Rajasthan,2,22,0,8,32,Pass
Krishna Khan,18-02-2005,396918,Punjab,7,16,9,5,37,Pass
Balbir Reddy,28-02-2006,951865,Bihar,2,0,6,20,28,Pass
Aryan Pillai,20-06-2005,871106,Jammu & Kashmir + Ladakh,16,13,23,8,60,Pass
Aryan D'Souza,16-12-2004,128914,Delhi,1,8,11,6,26,Fail
Manpreet Singh,29-12-2005,408900,West Bengal,9,5,21,19,54,Fail
Paul Sharma,04-06-2005,322693,Maharashtra,9,6,17,24,56,Fail
Rohan Khan,16-01-2006,338782,Bihar,2,2,24,5,33,Pass
Sukhwinder Sharma,05-01-2006,673003,Rajasthan,9,9,10,22,50,Pass
Kunal D'Souza,14-03-2005,271714,Mizoram,22,5,8,1,36,Pass
Ishaan Reddy,12-04-2005,503997,Punjab,22,3,21,20,66,Pass
Kunal Verma,14-03-2006,589656,Andhra Pradesh,0,21,14,7,42,Pass
Krishna Mehta,27-05-2005,292169,Odisha,23,3,6,21,53,Fail
Yash Sharma,26-05-2005,595737,West Bengal,12,1,18,5,36,Fail
Ishaan D'Souza,17-12-2005,571625,Haryana,4,5,10,5,24,Fail
Kunal D'Souza,16-04-2006,816579,Bihar,14,24,18,0,56,Pass
Peter Singh,05-08-2005,405483,Maharashtra,5,19,7,18,49,Fail
Raj Fernandes,17-11-2005,499148,Maharashtra,2,17,14,11,44,Fail
Kunal D'Souza,11-11-2005,123269,Bihar,11,15,3,3,32,Pass
Krishna Chopra,12-01-2006,847551,Tamil Nadu,8,20,21,4,53,Fail
Ishaan Singh,05-08-2005,590016,Gujarat,14,2,16,18,50,Fail
Kunal Reddy,07-12-2005,943068,Bihar,21,6,14,16,57,Pass
Aarav Reddy,20-10-2005,586623,West Bengal,3,5,7,22,37,Fail
Balbir D'Souza,15-11-2004,936461,Rajasthan,18,11,19,7,55,Pass
Yash Pillai,06-10-2005,928860,Bihar,11,15,2,21,49,Pass
Aryan D'Souza,17-07-2005,701806,Rajasthan,1,9,0,13,23,Pass
Imran Khan,19-08-2005,923227,Kerala,22,5,1,18,46,Pass
Zaid D'Souza,28-11-2005,329343,West Bengal,23,19,21,3,66,Fail
Vivaan D'Souza,08-03-2005,116498,Bihar,22,21,10,7,60,Pass
Raj Mehta,28-01-2005,214298,Madhya Pradesh,24,24,0,24,72,Fail
Aryan Mehta,22-07-2005,892563,Punjab,16,23,0,23,62,Pass
Vivaan D'Souza,04-09-2005,807267,Bihar,12,22,11,19,64,Pass
Aarav Fernandes,24-07-2005,344408,Bihar,23,24,19,16,82,Pass
Aryan Mehta,24-04-2006,533276,Telangana,13,21,1,6,41,Fail
Balbir Reddy,20-04-2005,584918,Jharkhand,6,18,20,3,47,Pass
Aryan Singh,25-01-2005,400107,Andhra Pradesh,22,8,6,17,53,Pass
Aryan Sharma,17-01-2006,950727,Assam,16,24,7,15,62,Fail
Paul Fernandes,17-01-2005,270351,Maharashtra,10,4,16,20,50,Fail
Krishna Khan,16-06-2005,287295,Jharkhand,7,18,24,2,51,Pass
Krishna Pillai,02-04-2006,376161,Assam,14,15,20,23,72,Fail
Yash Pillai,19-02-2006,713812,Jharkhand,18,12,1,2,33,Pass
Krishna Reddy,31-01-2005,494848,Uttar Pradesh,9,9,21,1,40,Fail
Aryan Chopra,18-10-2005,120592,Haryana,5,1,9,19,34,Fail
Sukhwinder Verma,23-12-2004,245534,Punjab,9,4,13,24,50,Pass
Raj Mehta,26-01-2005,684989,Bihar,24,24,1,11,60,Pass
Balbir Pillai,30-06-2005,352698,Rajasthan,0,6,10,16,32,Pass
Aditya Chopra,01-01-2005,713250,Karnataka,8,8,14,10,40,Pass
Balbir Pillai,21-12-2005,742694,Bihar,0,20,9,9,38,Pass
Raj Pillai,13-09-2005,508240,Maharashtra,13,21,18,8,60,Fail
Aryan Verma,21-04-2005,698240,Rajasthan,15,16,7,16,54,Pass
Aditya Khan,30-07-2005,436552,Jharkhand,21,22,6,9,58,Pass
Yash Chopra,13-11-2004,122966,Uttar Pradesh,6,1,2,6,15,Fail
Kunal Sharma,28-08-2005,513500,West Bengal,22,15,19,23,79,Fail
Sukhwinder Singh,19-03-2006,795378,Odisha,23,9,9,10,51,Fail
Rohan D'Souza,07-07-2005,445115,Assam,2,17,12,20,51,Fail
Rehan Reddy,01-07-2005,685643,Telangana,8,21,24,14,67,Fail
Gurpreet Singh,05-10-2005,286761,Tamil Nadu,21,3,20,23,67,Fail
Vivaan D'Souza,29-03-2006,877069,Himachal Pradesh,23,19,11,3,56,Pass
Rohan Mehta,15-05-2005,661872,Uttar Pradesh,17,16,20,12,65,Fail
Manpreet Fernandes,23-12-2005,756651,Bihar,22,7,1,17,47,Pass
Rohan Verma,01-11-2005,170140,Tamil Nadu,20,2,16,18,56,Pass
Balbir Sharma,30-09-2005,777352,Andhra Pradesh,5,16,9,6,36,Pass
Yash D'Souza,18-02-2006,837750,Rajasthan,23,13,15,3,54,Pass
Aditya Fernandes,10-06-2005,874019,Bihar,0,22,14,0,36,Pass
Aarav Fernandes,01-01-2006,520831,Rajasthan,20,21,0,23,64,Fail
Krishna Reddy,06-04-2005,128143,Jharkhand,7,4,11,17,39,Pass
Vivaan Verma,15-05-2005,119292,Mizoram,11,14,11,17,53,Fail
Yash Reddy,02-02-2005,922743,Tamil Nadu,13,16,6,0,35,Pass
Balbir D'Souza,24-04-2005,149516,Uttar Pradesh,12,12,5,8,37,Fail
Aryan Chopra,11-01-2006,732962,Bihar,11,21,17,21,70,Pass
Aryan Chopra,14-04-2005,130562,Bihar,15,9,11,16,51,Pass
Aarav Khan,04-05-2006,907859,Punjab,11,24,0,12,47,Pass
Yash Pillai,20-12-2004,546155,Madhya Pradesh,24,9,22,17,72,Fail
Rohan D'Souza,22-11-2004,973131,Maharashtra,22,20,17,18,77,Fail
Gurpreet Pillai,03-07-2005,128010,Bihar,13,16,1,13,43,Pass
Ayaan Chopra,20-09-2005,791175,Punjab,14,22,11,24,71,Pass
Aryan Singh,14-09-2005,947997,Jharkhand,13,17,8,5,43,Pass
Vivaan D'Souza,14-04-2005,834371,Haryana,0,20,3,23,46,Fail
Yash Mehta,20-06-2005,542059,Maharashtra,6,22,15,1,44,Fail
Kunal Verma,05-02-2005,228458,Jharkhand,18,5,1,22,46,Pass
Krishna Fernandes,23-08-2005,728689,Uttarakhand,15,14,2,22,53,Fail
Raj Khan,01-11-2005,513856,Tamil Nadu,4,24,11,23,62,Pass
Peter Verma,20-03-2005,281667,Haryana,14,7,19,9,49,Fail
Manpreet Fernandes,08-08-2005,422311,Bihar,5,18,10,11,44,Pass
Aditya Singh,27-02-2006,123864,Chhattisgarh,5,22,21,20,68,Fail
Vivaan Reddy,04-02-2005,258753,Uttar Pradesh,5,17,11,24,57,Fail
Paul Chopra,27-03-2005,380003,Uttar Pradesh,22,22,15,8,67,Fail
Yash Mehta,08-02-2005,905404,Rajasthan,8,1,22,2,33,Pass
Vivaan Reddy,21-03-2006,394230,Gujarat,8,2,24,17,51,Fail
Aditya Sharma,21-02-2005,759589,West Bengal,4,17,17,7,45,Fail
David Mehta,06-11-2005,180123,Assam,20,7,5,13,45,Fail
Raj Khan,02-02-2005,985309,Haryana,7,14,24,17,62,Fail
Sukhwinder Fernandes,26-12-2005,697640,Uttar Pradesh,21,19,2,17,59,Fail
Rohan Sharma,03-02-2005,878042,Madhya Pradesh,9,9,1,14,33,Fail
Aarav Reddy,30-07-2005,745213,Andhra Pradesh,18,15,6,10,49,Pass
Ishaan Mehta,15-04-2006,806522,Uttarakhand,19,8,18,6,51,Fail
Aarav Sharma,02-08-2005,316165,Haryana,13,17,11,19,60,Fail
Ishaan Mehta,31-12-2005,884769,Punjab,15,24,19,18,76,Pass
Harjeet Mehta,18-04-2005,543441,Rajasthan,24,21,16,0,61,Fail
Gurpreet Khan,16-12-2004,800786,Telangana,16,3,11,9,39,Fail
Aryan Fernandes,05-07-2005,237257,Andhra Pradesh,12,7,22,21,62,Pass
Krishna Reddy,20-03-2005,308410,Rajasthan,2,2,17,3,24,Pass
Kunal D'Souza,01-04-2006,737768,Haryana,17,14,1,19,51,Fail
Aditya Khan,17-04-2005,251261,Bihar,20,21,19,3,63,Pass
Imran Chopra,15-01-2006,377979,West Bengal,0,7,11,6,24,Fail
John Fernandes,10-04-2006,473744,Bihar,6,10,17,16,49,Pass
Yash Fernandes,25-10-2005,130781,Assam,7,12,1,3,23,Fail
Ishaan Mehta,03-08-2005,405663,Tamil Nadu,17,24,20,3,64,Fail
Sukhwinder Mehta,25-02-2006,685510,Bihar,21,23,15,7,66,Pass
Raj Reddy,21-07-2005,320001,Uttar Pradesh,7,7,0,23,37,Fail
Harjeet Singh,25-12-2005,584342,Karnataka,12,18,17,14,61,Pass
Vivaan Reddy,03-03-2005,305380,Jammu & Kashmir + Ladakh,7,7,11,12,37,Pass
Balbir Sharma,17-12-2004,535539,Haryana,24,9,2,12,47,Fail
Ishaan Verma,11-11-2005,754173,Gujarat,22,22,16,23,83,Fail
Aarav Chopra,08-05-2005,764610,West Bengal,24,11,3,13,51,Fail
Rohan Singh,26-08-2005,991819,Delhi,17,2,16,18,53,Fail
Yash Khan,30-08-2005,138787,Maharashtra,0,22,12,4,38,Fail
Gurpreet Chopra,21-04-2005,989650,Gujarat,12,9,12,12,45,Fail
Aryan Mehta,17-07-2005,286753,Madhya Pradesh,7,3,14,7,31,Fail
Aryan D'Souza,23-03-2006,154245,Uttarakhand,19,18,4,16,57,Fail
Ishaan Singh,04-01-2006,677470,Uttar Pradesh,13,20,15,15,63,Fail
Yash Khan,18-02-2006,111829,Maharashtra,9,13,22,3,47,Fail
Krishna Mehta,08-06-2005,323678,Gujarat,1,0,0,6,7,Fail
Harjeet Singh,10-12-2005,464992,Madhya Pradesh,19,16,5,21,61,Fail
Mathew Singh,29-11-2004,202797,Andhra Pradesh,1,22,18,2,43,Pass
Harjeet Sharma,09-07-2005,127437,Uttarakhand,6,18,0,11,35,Fail
Gurpreet Mehta,06-12-2005,452215,Punjab,22,1,20,8,51,Pass
Mathew Mehta,25-09-2005,577444,Gujarat,17,16,10,6,49,Fail
Rohan Khan,02-03-2005,900137,Madhya Pradesh,0,0,20,18,38,Fail
Ishaan Verma,20-09-2005,677597,Uttar Pradesh,10,3,24,7,44,Fail
Yash Khan,16-04-2005,237829,Maharashtra,12,4,7,14,37,Fail
Rohan Khan,06-01-2005,559992,Gujarat,0,12,4,20,36,Fail
Ishaan Fernandes,04-03-2006,368131,Rajasthan,9,0,5,24,38,Pass
Ishaan Verma,10-01-2005,721558,Uttar Pradesh,17,7,21,10,55,Fail
Vivaan Fernandes,30-05-2005,345201,Andhra Pradesh,18,7,24,18,67,Pass
Aryan Verma,05-03-2006,301696,West Bengal,6,12,7,14,39,Fail
Krishna Mehta,25-06-2005,241587,Andhra Pradesh,3,8,4,10,25,Pass
Sukhwinder Fernandes,10-02-2005,232559,Madhya Pradesh,19,4,19,24,66,Fail
Ishaan Mehta,18-06-2005,912908,West Bengal,10,15,22,11,58,Fail
Kunal Verma,08-04-2005,279201,Uttar Pradesh,10,12,9,2,33,Fail
Zaid Chopra,21-08-2005,953267,Maharashtra,24,7,7,13,51,Fail
Balbir Khan,04-09-2005,334193,Uttar Pradesh,1,23,20,23,67,Fail
Kunal Khan,03-05-2006,645548,Bihar,7,15,1,14,37,Pass
Kunal Pillai,06-03-2006,582151,Punjab,5,7,12,1,25,Pass
Balbir Pillai,17-01-2006,999244,Kerala,19,20,24,24,87,Pass
Manpreet Reddy,06-04-2006,794330,Haryana,7,23,24,14,68,Fail
Manpreet Mehta,05-09-2005,880275,Tamil Nadu,6,9,18,19,52,Fail
Vivaan Sharma,06-05-2005,760523,Bihar,7,3,23,4,37,Pass
Aryan Sharma,19-02-2005,892029,Uttar Pradesh,11,16,12,17,56,Fail
Aryan D'Souza,15-09-2005,964059,Telangana,5,23,3,21,52,Fail
Aditya Sharma,11-04-2005,156310,Gujarat,7,13,20,9,49,Fail
Raj D'Souza,06-01-2006,563550,Tamil Nadu,8,13,1,6,28,Pass
Kunal D'Souza,01-01-2006,718877,Punjab,18,2,19,15,54,Pass
Ishaan D'Souza,18-02-2006,479251,Uttar Pradesh,20,8,24,22,74,Fail
Rohan Sharma,03-06-2005,605344,Andhra Pradesh,8,20,13,23,64,Pass
Manpreet Mehta,27-04-2006,618826,Jammu & Kashmir + Ladakh,8,9,6,12,35,Pass
Aditya Sharma,28-06-2005,749601,Telangana,10,8,18,5,41,Fail
Krishna Verma,16-12-2005,717063,Telangana,7,17,17,10,51,Fail
Raj Mehta,21-02-2005,482431,Gujarat,24,20,24,19,87,Fail
David Pillai,12-04-2006,580892,Jharkhand,10,9,14,6,39,Pass
Balbir Chopra,05-01-2006,255827,Rajasthan,16,8,5,4,33,Pass
Ishaan Verma,26-02-2005,183710,Uttar Pradesh,23,24,19,3,69,Fail
Zaid Verma,29-11-2005,578487,Maharashtra,21,24,0,1,46,Fail
Rohan Fernandes,02-10-2005,247968,Karnataka,18,15,22,9,64,Pass
Rohan Sharma,04-04-2006,907851,Tamil Nadu,11,0,8,13,32,Pass
Gurpreet Pillai,07-08-2005,237685,Uttar Pradesh,12,20,17,15,64,Fail
Krishna Pillai,12-05-2005,507571,Karnataka,14,2,12,15,43,Pass
Ishaan Pillai,20-08-2005,968041,Haryana,4,21,0,20,45,Fail
Yash Verma,08-06-2005,216771,Uttar Pradesh,15,6,3,6,30,Fail
Zaid Mehta,28-03-2006,596487,Uttar Pradesh,1,18,2,4,25,Fail
Aryan Mehta,27-03-2005,977295,Rajasthan,6,16,10,2,34,Pass
Kunal Fernandes,02-12-2004,691392,Karnataka,15,12,12,15,54,Pass
Vivaan Fernandes,19-12-2005,619088,Delhi,4,15,6,15,40,Fail
Kunal Reddy,19-01-2005,895981,Odisha,12,17,18,19,66,Fail
Raj Reddy,09-11-2005,133081,Delhi,23,14,22,15,74,Fail
Raj Khan,19-04-2006,519432,Uttar Pradesh,7,18,23,24,72,Fail
Sukhwinder Singh,26-12-2005,934209,Punjab,17,8,6,21,52,Pass
Krishna Verma,25-07-2005,406054,Bihar,24,2,12,0,38,Pass
Vivaan Sharma,13-11-2004,576836,Himachal Pradesh,20,5,17,16,58,Pass
John Khan,27-09-2005,533268,West Bengal,3,6,22,10,41,Fail
Rohan Verma,20-12-2005,766426,West Bengal,15,15,18,18,66,Fail
Raj Reddy,20-11-2004,183246,Jammu & Kashmir + Ladakh,12,9,21,19,61,Pass
Rohan Mehta,01-03-2005,249214,Gujarat,17,7,16,11,51,Fail
Manpreet Fernandes,15-06-2005,773311,Uttar Pradesh,16,5,2,12,35,Fail
Rohan Mehta,15-10-2005,897059,Uttar Pradesh,20,9,24,2,55,Fail
Manpreet D'Souza,20-02-2005,801929,Maharashtra,14,7,22,14,57,Fail
Vivaan Verma,20-11-2005,349924,Uttar Pradesh,11,13,13,14,51,Fail
Raj Sharma,22-03-2006,787018,Uttarakhand,0,21,14,21,56,Fail
Krishna Chopra,13-03-2005,320112,Andhra Pradesh,12,12,22,7,53,Pass
Balbir Reddy,10-11-2004,232106,Gujarat,0,9,4,6,19,Fail
Farhan Fernandes,20-10-2005,911907,Chhattisgarh,12,13,10,6,41,Fail
Farhan Fernandes,26-01-2005,505041,Bihar,4,11,22,0,37,Pass
Rohan Verma,23-03-2005,589817,Bihar,23,18,24,4,69,Pass
Gurpreet Reddy,17-02-2006,449501,Uttarakhand,13,18,8,15,54,Fail
Aditya Verma,22-08-2005,736120,Karnataka,0,18,10,0,28,Pass
Aarav Sharma,16-10-2005,711878,Uttar Pradesh,6,3,21,6,36,Fail
Peter Khan,24-10-2005,493238,Jharkhand,9,16,17,21,63,Pass
Aditya Chopra,06-02-2006,728962,Uttarakhand,4,15,17,18,54,Fail
Vivaan Pillai,09-12-2005,530227,Haryana,7,18,7,16,48,Fail
Imran Pillai,10-07-2005,135476,Haryana,24,10,7,15,56,Fail
Raj Verma,20-01-2005,986735,Gujarat,18,7,22,6,53,Fail
Ishaan Khan,20-07-2005,175112,Punjab,18,1,9,10,38,Pass
Rohan Verma,02-05-2006,441736,Jharkhand,16,24,1,2,43,Pass
Aryan Fernandes,13-02-2005,382710,Maharashtra,5,12,7,23,47,Fail
Raj Pillai,05-12-2004,507372,Tamil Nadu,8,14,17,4,43,Fail
Sukhwinder Sharma,18-09-2005,110573,Tamil Nadu,15,7,18,18,58,Fail
Krishna D'Souza,24-02-2006,322462,Maharashtra,15,9,15,8,47,Fail
Harjeet Fernandes,06-01-2005,611586,Punjab,15,13,3,11,42,Pass
Yash Chopra,10-10-2005,201460,Uttar Pradesh,21,2,11,15,49,Fail
Ishaan Khan,20-05-2005,537741,Maharashtra,7,12,24,23,66,Fail
Krishna Fernandes,17-02-2006,891149,Jharkhand,3,22,11,11,47,Pass
Yash Chopra,13-11-2005,317383,Rajasthan,15,16,16,5,52,Pass
Aarav Verma,26-05-2005,883122,Bihar,14,1,20,21,56,Pass
Gurpreet Chopra,28-01-2005,920109,Punjab,23,15,22,14,74,Pass
Zaid Sharma,05-11-2005,653921,Tripura,17,10,18,14,59,Fail
David Pillai,04-02-2006,151341,Uttar Pradesh,23,13,7,24,67,Fail
Yash Pillai,27-11-2004,941762,Punjab,13,0,2,12,27,Pass
Kunal D'Souza,13-07-2005,221615,Goa,6,16,17,5,44,Fail
Sukhwinder Sharma,07-01-2005,744848,Gujarat,17,11,18,9,55,Fail
Rohan Reddy,28-02-2006,636024,Bihar,6,8,21,20,55,Pass
Vivaan Pillai,20-03-2006,549642,Haryana,5,5,22,23,55,Fail
Yash Fernandes,19-11-2005,768911,Maharashtra,15,12,7,18,52,Fail
Kunal Mehta,15-09-2005,472774,Andhra Pradesh,16,18,22,13,69,Pass
Yash Sharma,28-04-2005,127692,Maharashtra,13,7,7,15,42,Fail
Kunal D'Souza,18-05-2005,177024,Haryana,0,7,18,18,43,Fail
Rohan Chopra,27-01-2005,499542,Tamil Nadu,0,16,18,7,41,Pass
Balbir Fernandes,03-12-2005,494946,Odisha,17,20,20,15,72,Fail
Zaid Mehta,15-11-2005,933977,Kerala,8,23,13,3,47,Pass
Ayaan Pillai,20-01-2006,120723,Bihar,6,21,4,12,43,Pass
Harjeet Singh,26-04-2005,413785,Karnataka,2,6,5,23,36,Pass
Ishaan Reddy,24-05-2005,558054,Kerala,14,14,23,1,52,Pass
Ishaan Chopra,19-05-2005,788372,Madhya Pradesh,15,9,18,18,60,Fail
Ishaan Pillai,09-12-2005,360133,Jharkhand,8,19,16,24,67,Pass
Yash D'Souza,03-06-2005,343101,Uttar Pradesh,12,18,7,4,41,Fail
Vivaan Fernandes,19-05-2005,434545,Tamil Nadu,6,3,17,12,38,Pass
Rohan Verma,31-07-2005,645550,Punjab,8,0,6,21,35,Pass
Ishaan Verma,25-12-2005,628781,Bihar,21,21,21,6,69,Pass
Aarav Singh,08-07-2005,743254,Delhi,7,5,3,11,26,Fail
Krishna Verma,29-01-2006,817717,Jharkhand,12,13,18,2,45,Pass
Aditya Chopra,07-09-2005,535628,Uttar Pradesh,15,4,13,15,47,Fail
Harjeet Chopra,02-12-2005,508557,Gujarat,2,2,3,6,13,Fail
Kunal Chopra,18-11-2004,181197,Gujarat,16,24,22,12,74,Fail
Rohan Verma,04-10-2005,917379,Bihar,18,18,22,6,64,Pass
John Khan,01-01-2006,631475,Punjab,1,16,14,21,52,Pass
Balbir Singh,18-11-2004,435361,Andhra Pradesh,19,24,17,9,69,Pass
Aryan Reddy,30-03-2005,268866,Madhya Pradesh,14,8,22,23,67,Fail
Sukhwinder Khan,11-03-2005,442540,Madhya Pradesh,7,16,10,21,54,Fail
Rohan D'Souza,02-04-2006,585239,Punjab,20,3,18,22,63,Pass
Krishna Verma,03-03-2006,656002,Bihar,21,5,0,14,40,Pass
Kunal Reddy,20-10-2005,518667,Madhya Pradesh,20,3,22,24,69,Fail
Kunal Sharma,20-03-2006,149198,Uttar Pradesh,4,10,23,17,54,Fail
Manpreet Fernandes,23-02-2006,600992,Punjab,16,8,14,8,46,Pass
David Sharma,28-07-2005,481826,Bihar,17,13,8,19,57,Pass
Yash Khan,13-03-2005,584065,Bihar,7,11,3,23,44,Pass
Vivaan Verma,19-03-2005,319320,Bihar,16,14,0,11,41,Pass
Aarav Khan,07-03-2006,179097,Rajasthan,6,15,1,18,40,Pass
Kunal Chopra,16-04-2005,663920,Jharkhand,19,24,4,24,71,Fail
Ishaan Mehta,23-09-2005,835106,Maharashtra,13,18,5,10,46,Fail
Kunal Reddy,03-03-2006,487099,Uttar Pradesh,8,11,16,3,38,Fail
Yash Khan,16-02-2006,280477,Maharashtra,1,21,4,21,47,Fail
Aryan Pillai,06-12-2004,161606,Uttar Pradesh,13,6,13,7,39,Fail
Krishna Reddy,08-11-2004,215256,Madhya Pradesh,10,1,10,0,21,Fail
Vivaan Verma,07-01-2005,534938,Madhya Pradesh,18,18,7,6,49,Fail
Zaid Sharma,11-07-2005,171095,Madhya Pradesh,12,20,5,22,59,Fail
Harjeet Reddy,30-04-2005,247467,Andhra Pradesh,12,1,22,15,50,Pass
Aarav Singh,11-08-2005,440119,Madhya Pradesh,3,24,10,17,54,Fail
Ishaan Singh,20-03-2005,181840,Punjab,20,15,4,12,51,Pass
Rohan Verma,11-02-2006,413656,Punjab,21,10,17,20,68,Pass
Rohan Pillai,09-10-2005,709112,Uttar Pradesh,0,14,3,18,35,Fail
Aarav Khan,10-03-2006,867088,Punjab,10,18,12,22,62,Pass
Raj Pillai,03-04-2006,841660,Rajasthan,9,22,12,21,64,Fail
Aditya Verma,02-04-2005,229398,Assam,17,14,20,19,70,Fail
Yash Mehta,08-04-2006,726286,Maharashtra,13,6,24,21,64,Fail
Aditya D'Souza,10-11-2005,668810,Maharashtra,12,1,3,10,26,Fail
Ishaan Fernandes,17-09-2005,603468,West Bengal,6,15,7,14,42,Fail
Manpreet Chopra,20-04-2005,978278,Assam,23,10,14,19,66,Fail
Imran Fernandes,30-09-2005,616666,Rajasthan,23,22,16,17,78,Pass
Yash Reddy,23-10-2005,626016,Bihar,18,3,1,10,32,Pass
Yash Khan,18-03-2006,414499,Uttar Pradesh,5,13,13,8,39,Fail
Raj D'Souza,04-08-2005,265684,Karnataka,19,2,22,5,48,Pass
Vivaan Singh,02-06-2005,938313,Uttar Pradesh,4,18,1,1,24,Fail
Peter Mehta,30-08-2005,773074,Madhya Pradesh,13,24,0,22,59,Fail
Ishaan Chopra,08-11-2005,258997,Karnataka,15,16,4,10,45,Pass
Aditya Mehta,20-09-2005,285122,Mizoram,19,4,8,10,41,Pass
Harjeet Verma,18-10-2005,421826,Madhya Pradesh,16,1,8,10,35,Fail
Aditya Fernandes,25-05-2005,584655,Maharashtra,2,19,7,18,46,Fail
Krishna Chopra,02-09-2005,303469,Uttar Pradesh,16,24,22,18,80,Fail
Aarav D'Souza,25-04-2006,269228,Karnataka,17,7,5,11,40,Pass
Krishna Pillai,16-09-2005,327498,Maharashtra,0,20,22,0,42,Fail
Paul Fernandes,17-09-2005,298718,Uttar Pradesh,6,24,19,5,54,Fail
Krishna Fernandes,19-02-2006,455932,Odisha,20,8,24,12,64,Fail
Yash Chopra,09-04-2005,472551,Maharashtra,10,0,13,10,33,Fail
Ishaan Verma,10-10-2005,189910,Andhra Pradesh,4,19,3,2,28,Pass
John Fernandes,11-12-2004,101494,Bihar,7,21,20,4,52,Pass
Aarav Khan,22-06-2005,924488,Karnataka,4,20,8,11,43,Pass
Imran Reddy,15-03-2005,213231,Karnataka,12,20,23,23,78,Fail
Peter Sharma,24-02-2005,309338,Maharashtra,16,21,18,23,78,Fail
Rohan Mehta,02-01-2005,730972,Uttar Pradesh,10,24,23,24,81,Fail
Ishaan Sharma,27-03-2006,290819,Jharkhand,16,8,10,22,56,Pass
Aryan Chopra,27-01-2005,948247,Tamil Nadu,1,11,23,7,42,Pass
Kunal D'Souza,05-11-2005,621638,Maharashtra,5,17,23,3,48,Fail
Imran Sharma,07-01-2005,366488,Bihar,23,3,8,4,38,Pass
Rohan Mehta,24-01-2006,336054,Tamil Nadu,12,18,11,8,49,Fail
Manpreet Mehta,06-05-2006,378095,Gujarat,9,3,18,19,49,Fail
John Fernandes,17-02-2005,478996,Karnataka,19,6,19,12,56,Pass
Rohan D'Souza,28-03-2005,401920,Bihar,10,9,7,7,33,Pass
Yash Verma,23-12-2005,440046,Telangana,0,3,19,8,30,Fail
Aryan D'Souza,25-10-2005,945944,Jharkhand,22,8,16,1,47,Pass
Rohan Verma,26-01-2006,979769,Bihar,19,4,4,8,35,Pass
Ishaan Chopra,10-10-2005,116796,Bihar,14,13,0,20,47,Pass
Vivaan Mehta,17-03-2006,372697,Uttar Pradesh,14,22,0,17,53,Fail
Farhan D'Souza,11-06-2005,507547,Rajasthan,5,18,11,2,36,Pass
Peter Fernandes,15-12-2004,584964,Punjab,9,14,14,0,37,Pass
Harjeet Reddy,13-10-2005,693319,Odisha,16,15,18,20,69,Fail
Yash Mehta,09-01-2005,869122,Uttarakhand,22,8,11,17,58,Fail
Vivaan Chopra,26-05-2005,994506,Uttar Pradesh,21,11,0,1,33,Fail
David Fernandes,29-08-2005,970331,Rajasthan,1,13,11,20,45,Pass
Kunal Reddy,17-09-2005,792155,Maharashtra,3,12,24,24,63,Fail
Rehan Fernandes,14-12-2004,979620,Chhattisgarh,0,14,14,1,29,Fail
Raj Reddy,24-04-2005,868898,Uttar Pradesh,9,5,16,20,50,Fail
Manpreet Sharma,04-01-2006,134477,Tamil Nadu,13,19,7,3,42,Pass
Balbir Pillai,25-01-2005,793988,Rajasthan,8,24,8,2,42,Pass
Rohan Mehta,18-12-2005,214775,West Bengal,20,24,17,1,62,Fail
Imran Singh,04-03-2005,275846,Punjab,1,22,12,9,44,Pass
Aryan D'Souza,05-09-2005,414279,Bihar,11,7,15,5,38,Pass
Mathew Singh,04-06-2005,720106,Telangana,23,10,5,4,42,Fail
Ishaan D'Souza,22-03-2005,248614,Bihar,22,13,6,1,42,Pass
David Pillai,09-11-2005,580554,Maharashtra,9,18,7,4,38,Fail
Aryan Verma,14-04-2005,519409,Tamil Nadu,3,18,13,8,42,Pass
Krishna Sharma,15-06-2005,350862,Chhattisgarh,6,8,18,16,48,Fail
Imran Chopra,10-01-2005,805028,West Bengal,1,5,5,21,32,Fail
Mathew Khan,07-08-2005,794412,Rajasthan,3,3,16,5,27,Pass
Gurpreet Reddy,24-12-2005,654492,Madhya Pradesh,24,2,21,0,47,Fail
Aditya Sharma,24-03-2005,313036,Bihar,7,11,18,6,42,Pass
Krishna Singh,09-08-2005,149736,Haryana,21,16,9,17,63,Fail
Raj Fernandes,07-12-2005,730467,Uttar Pradesh,11,17,19,15,62,Fail
Rohan Reddy,03-09-2005,539330,Punjab,4,13,12,10,39,Pass
John Verma,30-04-2005,956662,Haryana,19,5,20,5,49,Fail
Kunal D'Souza,21-02-2006,782559,Tamil Nadu,21,20,10,15,66,Pass
Ishaan Mehta,14-10-2005,138764,Uttar Pradesh,14,6,4,5,29,Fail
Aryan Pillai,02-04-2005,726787,Karnataka,2,24,2,22,50,Pass
Raj Chopra,22-07-2005,280387,Andhra Pradesh,23,7,3,8,41,Pass
Aryan Chopra,25-04-2005,173503,Uttarakhand,5,10,4,9,28,Fail
Kunal Reddy,30-11-2004,621173,Chhattisgarh,19,16,9,17,61,Fail
Rehan Reddy,13-07-2005,243083,Tamil Nadu,13,20,11,8,52,Fail
Aarav Verma,08-11-2004,537684,Bihar,4,20,19,8,51,Pass
Kunal Singh,20-09-2005,801565,Delhi,14,12,10,21,57,Fail
Kunal Mehta,02-10-2005,130469,Bihar,4,14,17,19,54,Pass
Kunal Verma,04-11-2005,322691,Uttar Pradesh,22,13,1,13,49,Fail
Zaid Reddy,05-10-2005,909873,Uttar Pradesh,12,13,0,1,26,Fail
Aryan Chopra,25-03-2005,283116,Daman & Diu / D&N Haveli,23,10,6,13,52,Fail
Aditya Singh,20-06-2005,968342,Punjab,24,17,21,7,69,Pass
Aarav Khan,19-08-2005,639668,Bihar,18,4,0,19,41,Pass
Sukhwinder Mehta,01-09-2005,738812,Maharashtra,18,2,21,2,43,Fail
Aryan Khan,17-03-2005,832841,Tamil Nadu,18,12,18,8,56,Pass
Ishaan Mehta,01-04-2005,888603,Bihar,14,4,9,21,48,Pass
Paul Chopra,10-11-2005,866986,Gujarat,10,0,1,20,31,Fail
Kunal Chopra,16-03-2005,466173,Uttarakhand,19,23,1,10,53,Fail
Rohan Chopra,07-04-2005,890314,Haryana,5,18,7,11,41,Fail
Rohan Chopra,14-04-2005,344664,Jammu & Kashmir + Ladakh,18,4,10,6,38,Pass
Mathew D'Souza,04-05-2005,501215,West Bengal,10,14,8,9,41,Fail
Yash Sharma,06-07-2005,271652,Uttar Pradesh,20,4,24,3,51,Fail
Rohan Singh,04-04-2006,723267,Haryana,8,23,3,16,50,Fail
Balbir D'Souza,14-06-2005,576028,Bihar,0,15,17,22,54,Pass
Aarav Fernandes,03-07-2005,700444,Haryana,15,11,5,21,52,Fail
Ishaan Pillai,21-02-2005,388834,Jharkhand,22,3,16,11,52,Pass
Kunal Sharma,20-06-2005,152797,West Bengal,12,7,9,20,48,Fail
Harjeet Fernandes,18-03-2006,348221,Kerala,24,23,16,11,74,Fail
Manpreet Fernandes,05-03-2006,804480,Rajasthan,13,7,21,13,54,Pass
Harjeet Reddy,01-12-2004,806993,Jharkhand,6,3,21,17,47,Pass
Rohan Singh,06-03-2005,837981,Maharashtra,22,24,1,22,69,Fail
Peter D'Souza,01-05-2005,122194,Telangana,22,7,22,18,69,Fail
Raj Reddy,23-01-2006,103809,Himachal Pradesh,8,17,20,24,69,Fail
Manpreet Reddy,16-02-2006,876657,Uttar Pradesh,18,24,8,14,64,Fail
Kunal Chopra,02-07-2005,319702,Tamil Nadu,23,9,13,5,50,Fail
Aarav Pillai,29-04-2006,763224,Nagaland,11,2,21,8,42,Pass
Kunal Sharma,19-05-2005,680655,Uttarakhand,16,7,18,4,45,Fail
Yash Pillai,25-06-2005,436583,West Bengal,24,0,12,16,52,Fail
Sukhwinder Mehta,26-09-2005,442705,West Bengal,16,24,3,11,54,Fail
Aarav Fernandes,24-04-2006,980900,Madhya Pradesh,18,22,1,14,55,Fail
Aarav Mehta,05-06-2005,884598,Chhattisgarh,18,21,24,17,80,Fail
Gurpreet Fernandes,21-12-2005,645052,Jammu & Kashmir + Ladakh,8,19,12,9,48,Pass
Rohan Mehta,08-11-2005,758390,Punjab,6,6,4,14,30,Pass
Aditya Singh,28-01-2006,131353,West Bengal,20,21,6,7,54,Fail
Aryan Sharma,30-06-2005,992998,Punjab,1,24,8,8,41,Pass
Zaid Sharma,22-10-2005,210461,Telangana,6,24,7,12,49,Fail
Yash Singh,11-02-2005,713538,Gujarat,14,22,23,18,77,Fail
Yash Chopra,05-07-2005,879731,Telangana,23,15,9,24,71,Fail
Krishna D'Souza,07-06-2005,586590,Uttar Pradesh,11,20,18,17,66,Fail
Yash Fernandes,02-03-2006,339189,Bihar,20,0,13,3,36,Pass
Rohan Singh,01-06-2005,697485,Punjab,14,13,5,23,55,Pass
Harjeet Pillai,01-09-2005,892898,Tamil Nadu,21,3,1,17,42,Pass
Rehan Sharma,03-02-2005,133409,Assam,11,0,10,24,45,Fail
Ishaan D'Souza,07-09-2005,370632,Punjab,12,4,3,0,19,Pass
Yash Singh,18-08-2005,437451,Andhra Pradesh,16,6,10,6,38,Pass
Mathew Mehta,28-12-2004,676249,Uttar Pradesh,9,18,18,12,57,Fail
Kunal Reddy,14-12-2005,682056,Maharashtra,4,9,0,7,20,Fail
Raj Sharma,12-01-2006,614573,Maharashtra,14,14,7,15,50,Fail
Harjeet Mehta,04-03-2006,877950,Bihar,3,19,21,8,51,Pass
Aditya Khan,23-07-2005,674211,Uttarakhand,2,12,1,22,37,Fail
Rohan Fernandes,06-09-2005,429542,Jharkhand,5,6,21,16,48,Pass
Raj Sharma,01-07-2005,921885,Bihar,15,11,17,6,49,Pass
Raj Singh,19-07-2005,156281,Rajasthan,3,5,10,24,42,Pass
Rohan Singh,16-01-2006,696236,Maharashtra,5,21,3,8,37,Fail
Rehan Khan,06-12-2004,824062,Uttar Pradesh,7,12,22,10,51,Fail
Kunal Reddy,31-07-2005,466816,Kerala,22,13,1,14,50,Pass
Aryan Reddy,20-05-2005,105575,Chhattisgarh,12,16,6,21,55,Fail
Aryan Chopra,10-10-2005,114476,West Bengal,8,17,0,9,34,Fail
Zaid Sharma,26-02-2005,528682,Madhya Pradesh,3,14,18,13,48,Fail
Manpreet Khan,16-12-2005,368805,Maharashtra,3,13,18,14,48,Fail
Aryan Reddy,28-01-2005,268592,Odisha,17,23,12,5,57,Fail
Imran Sharma,04-04-2006,604975,Haryana,7,16,19,12,54,Fail
Balbir D'Souza,05-11-2005,821909,Gujarat,1,2,23,16,42,Fail
Vivaan Pillai,11-07-2005,281159,Rajasthan,19,11,17,12,59,Pass
Ishaan Reddy,17-02-2005,992325,Andhra Pradesh,0,14,14,19,47,Pass
Ayaan Singh,15-02-2006,337987,Kerala,15,7,19,19,60,Pass
Sukhwinder Khan,18-04-2006,687589,West Bengal,14,15,19,20,68,Fail
Yash D'Souza,18-11-2005,990211,Madhya Pradesh,24,14,18,2,58,Fail
Raj Fernandes,02-03-2006,266000,Punjab,16,11,0,18,45,Pass
Manpreet Verma,14-11-2004,415647,Tamil Nadu,18,8,10,10,46,Fail
Krishna Verma,03-03-2005,883825,West Bengal,13,5,14,15,47,Fail
Vivaan Reddy,28-11-2004,893518,Karnataka,18,11,11,10,50,Pass
Rohan Verma,30-12-2005,243679,Maharashtra,20,17,5,18,60,Fail
Ishaan Singh,27-07-2005,970428,West Bengal,14,20,15,14,63,Fail
Manpreet Singh,14-03-2006,300599,Telangana,14,5,23,16,58,Fail
Aarav Fernandes,02-03-2005,151786,Madhya Pradesh,5,22,22,1,50,Fail
Aarav Pillai,06-11-2005,652134,Punjab,10,22,12,16,60,Pass
Vivaan Verma,27-09-2005,262288,Uttar Pradesh,7,14,9,23,53,Fail
Aarav Reddy,04-01-2005,496412,Himachal Pradesh,20,4,22,24,70,Fail
Aditya D'Souza,27-12-2005,285164,Andhra Pradesh,16,18,3,15,52,Pass
Aryan Singh,02-02-2006,224120,Punjab,23,6,18,1,48,Pass
Kunal Fernandes,14-11-2004,381636,Tamil Nadu,14,4,13,21,52,Fail
Harjeet Singh,22-01-2006,769176,Bihar,0,2,6,6,14,Pass
Kunal Mehta,03-05-2006,542692,Uttar Pradesh,17,12,0,21,50,Fail
Yash Mehta,16-05-2005,387816,Rajasthan,11,10,13,22,56,Pass
Manpreet D'Souza,25-05-2005,509012,Andhra Pradesh,14,12,24,21,71,Pass
Aditya Fernandes,30-11-2005,880791,Bihar,0,5,7,16,28,Pass
Krishna D'Souza,13-04-2006,110366,Bihar,24,9,18,18,69,Pass
Kunal Pillai,18-09-2005,229556,Maharashtra,18,18,8,5,49,Fail
Ishaan Pillai,18-08-2005,263931,Madhya Pradesh,5,20,2,18,45,Fail
Aarav Chopra,05-02-2006,856807,Bihar,12,16,0,16,44,Pass
Aarav Chopra,23-11-2004,895762,Karnataka,0,12,9,10,31,Pass
Vivaan Sharma,04-02-2006,806168,Daman & Diu / D&N Haveli,19,7,9,19,54,Fail
Aditya Pillai,21-07-2005,319062,Maharashtra,5,16,16,15,52,Fail
Raj Reddy,15-02-2005,793375,Kerala,21,20,3,11,55,Pass
Vivaan Fernandes,12-10-2005,837135,Haryana,7,23,8,1,39,Fail
Vivaan D'Souza,25-11-2004,877577,West Bengal,2,15,22,1,40,Fail
Kunal D'Souza,29-03-2006,699260,Assam,10,17,19,21,67,Fail
Rohan Pillai,26-04-2005,574096,Jammu & Kashmir + Ladakh,17,0,16,20,53,Pass
Rohan Sharma,25-10-2005,962053,Gujarat,18,19,24,14,75,Fail
Rohan Pillai,01-12-2005,212620,Uttar Pradesh,18,4,1,0,23,Fail
Raj Mehta,13-05-2005,461441,Odisha,13,18,9,2,42,Pass
Raj Fernandes,16-06-2005,154040,Karnataka,7,0,7,12,26,Pass
Manpreet Sharma,11-04-2005,308425,Karnataka,18,15,23,4,60,Pass
Vivaan Reddy,17-01-2006,502085,Chhattisgarh,8,0,6,21,35,Fail
Aryan Khan,17-07-2005,452616,Andhra Pradesh,2,5,21,19,47,Pass
Aarav Pillai,08-05-2005,310899,Tamil Nadu,24,2,3,4,33,Pass
Vivaan Chopra,18-03-2005,906109,Tamil Nadu,1,6,3,18,28,Pass
Vivaan Khan,08-03-2006,177211,Uttar Pradesh,17,19,22,1,59,Fail
Paul D'Souza,01-04-2005,181420,Bihar,0,4,20,3,27,Pass
Aryan Pillai,05-02-2006,600354,Tamil Nadu,21,3,10,7,41,Pass
Sukhwinder Reddy,09-07-2005,845046,Punjab,22,22,1,8,53,Pass
Vivaan Khan,26-02-2005,574170,Maharashtra,18,9,8,9,44,Fail
Raj D'Souza,31-03-2006,447629,Uttar Pradesh,4,10,9,23,46,Fail
Aditya Chopra,25-11-2005,478872,Bihar,22,2,8,24,56,Pass
Ishaan Fernandes,23-01-2006,539074,Bihar,22,5,22,8,57,Pass
Aditya Chopra,18-11-2004,907595,Madhya Pradesh,5,8,21,3,37,Fail
Zaid Khan,23-12-2004,963805,Maharashtra,10,2,9,3,24,Fail
Balbir Singh,16-03-2005,847446,Punjab,14,23,13,20,70,Pass
Krishna Verma,16-10-2005,981892,West Bengal,20,16,15,9,60,Fail
Ayaan Reddy,05-02-2005,522518,Rajasthan,3,17,8,7,35,Pass
Ishaan Fernandes,11-03-2005,445401,Maharashtra,3,15,11,19,48,Fail
Vivaan D'Souza,19-03-2006,825334,Madhya Pradesh,24,1,0,20,45,Fail
Ayaan Pillai,24-04-2006,125550,Tamil Nadu,8,13,14,3,38,Pass
Paul Sharma,02-01-2005,341149,Tamil Nadu,12,0,11,7,30,Pass
Raj Verma,06-08-2005,264691,Telangana,12,12,2,23,49,Fail
John Verma,16-07-2005,102864,Himachal Pradesh,9,24,4,11,48,Pass
Aarav Sharma,27-06-2005,643560,Gujarat,14,6,23,1,44,Fail
Peter Pillai,22-01-2006,562547,West Bengal,22,18,20,1,61,Fail
Aryan Khan,17-02-2006,936972,Odisha,8,5,19,23,55,Fail
Aarav Mehta,22-01-2005,445444,Haryana,17,16,10,5,48,Fail
Kunal Verma,10-01-2006,918062,Rajasthan,10,20,5,14,49,Pass
Raj Singh,05-02-2006,982544,Tamil Nadu,17,10,8,12,47,Pass
Yash Singh,23-11-2004,628554,West Bengal,18,21,7,13,59,Fail
Rohan D'Souza,10-12-2004,318086,Madhya Pradesh,0,0,16,16,32,Fail
Aryan Pillai,14-12-2005,502787,Kerala,11,13,6,16,46,Pass
Vivaan Mehta,07-05-2005,436114,Madhya Pradesh,18,0,3,3,24,Fail
John Singh,19-02-2005,637224,Tamil Nadu,14,1,11,23,49,Fail
Aditya Fernandes,17-11-2005,707297,Uttar Pradesh,9,2,17,7,35,Fail
Mathew D'Souza,30-12-2004,643113,Tamil Nadu,23,7,7,24,61,Pass
Balbir Pillai,04-06-2005,470539,Bihar,19,7,15,24,65,Pass
Krishna Reddy,05-01-2005,454244,West Bengal,9,16,5,14,44,Fail
Krishna Sharma,11-12-2004,227327,Tamil Nadu,17,24,5,18,64,Fail
Raj Verma,21-08-2005,160194,Madhya Pradesh,22,9,18,19,68,Fail
Ishaan Verma,05-04-2005,730405,Tamil Nadu,21,12,15,16,64,Fail
Rehan Singh,22-09-2005,525691,Bihar,11,19,16,8,54,Pass
Gurpreet Pillai,27-11-2004,373873,Punjab,11,7,15,14,47,Pass
Mathew Singh,10-01-2005,917258,Punjab,6,5,6,3,20,Pass
John Fernandes,06-08-2005,987595,West Bengal,23,14,18,23,78,Fail
Manpreet Verma,31-05-2005,319403,Tamil Nadu,10,18,24,6,58,Fail
Kunal Sharma,26-04-2006,476996,Haryana,8,7,14,20,49,Fail
Sukhwinder Sharma,28-10-2005,120384,Maharashtra,6,12,7,13,38,Fail
Paul Verma,09-08-2005,589186,Haryana,10,6,8,4,28,Fail
Sukhwinder Mehta,22-07-2005,553212,Tamil Nadu,21,15,3,12,51,Pass
Harjeet D'Souza,28-07-2005,155289,Puducherry,13,0,8,4,25,Pass
Raj Sharma,08-12-2004,795433,Bihar,9,10,19,5,43,Pass
Vivaan Mehta,09-08-2005,514671,Maharashtra,13,13,4,12,42,Fail
Raj Pillai,04-01-2005,216227,Andhra Pradesh,19,22,13,4,58,Pass
Raj Khan,28-12-2005,277185,Haryana,0,7,1,9,17,Fail
Ishaan Mehta,27-04-2006,662452,Madhya Pradesh,23,10,8,13,54,Fail
Aryan D'Souza,31-01-2005,709074,Punjab,8,23,4,11,46,Pass
David Verma,26-08-2005,764768,Jammu & Kashmir + Ladakh,19,17,18,3,57,Pass
Ayaan D'Souza,03-02-2005,733343,Jharkhand,0,17,9,3,29,Pass
Vivaan Khan,29-11-2005,651323,Andhra Pradesh,0,0,8,21,29,Pass
Aryan Fernandes,06-11-2005,915877,Bihar,2,14,13,12,41,Pass
Gurpreet Pillai,26-07-2005,107601,West Bengal,9,22,22,2,55,Fail
Raj Mehta,21-03-2006,531932,Bihar,24,1,16,18,59,Pass
Balbir Sharma,31-07-2005,798892,Uttar Pradesh,20,18,11,24,73,Fail
Krishna Fernandes,02-04-2006,956338,Karnataka,14,2,7,3,26,Pass
Vivaan Sharma,30-01-2006,404670,Gujarat,12,0,20,1,33,Fail
Yash Chopra,04-12-2004,998496,Telangana,13,8,7,17,45,Fail
Yash Mehta,10-01-2005,245518,Rajasthan,4,22,13,9,48,Pass
Ishaan Verma,20-11-2005,672489,Jammu & Kashmir + Ladakh,3,23,7,18,51,Pass
Kunal Pillai,10-07-2005,644559,Odisha,8,20,15,13,56,Fail
Vivaan Sharma,23-07-2005,150034,Bihar,16,17,0,0,33,Pass
Balbir Reddy,30-10-2005,559956,Himachal Pradesh,8,20,19,9,56,Pass
Rohan Pillai,14-03-2005,221257,Rajasthan,10,19,16,11,56,Pass
Raj Pillai,05-03-2006,933864,Tamil Nadu,9,2,8,13,32,Pass
David Khan,02-12-2005,637644,Rajasthan,7,9,15,0,31,Pass
Krishna D'Souza,04-06-2005,880132,Gujarat,1,13,7,5,26,Fail
Raj Sharma,25-11-2005,392781,Karnataka,8,6,17,24,55,Pass
Yash D'Souza,25-02-2006,618164,Uttar Pradesh,21,6,11,18,56,Fail
Aryan Singh,29-12-2005,724290,Karnataka,6,5,14,18,43,Pass
David Fernandes,08-11-2005,109437,Karnataka,6,21,17,10,54,Pass
Balbir D'Souza,16-12-2005,332512,Madhya Pradesh,22,22,1,7,52,Fail
Harjeet Singh,25-01-2006,574237,Jharkhand,0,11,11,6,28,Pass
Vivaan Khan,03-03-2006,495709,Uttar Pradesh,7,1,7,11,26,Fail
Kunal Singh,05-03-2005,917542,Jharkhand,16,24,6,13,59,Pass
Aryan D'Souza,26-02-2005,956029,Bihar,22,21,24,12,79,Pass
Vivaan Reddy,03-06-2005,152808,Odisha,13,13,0,12,38,Pass
Aryan Singh,15-04-2006,464559,Uttar Pradesh,24,9,8,22,63,Fail
Paul Fernandes,11-03-2005,948534,Uttar Pradesh,3,5,17,13,38,Fail
Vivaan Chopra,15-12-2004,346330,Punjab,5,7,4,3,19,Pass
Harjeet Mehta,11-08-2005,474455,West Bengal,16,13,24,18,71,Fail
Aryan Fernandes,11-12-2004,651154,West Bengal,9,15,19,21,64,Fail
Aarav D'Souza,16-04-2006,637202,Delhi,23,16,14,23,76,Fail
Mathew D'Souza,24-11-2004,909611,Bihar,8,0,6,24,38,Pass
Krishna Sharma,10-01-2006,247689,Assam,15,20,0,6,41,Fail
Ishaan Reddy,22-08-2005,992196,Uttar Pradesh,9,7,23,11,50,Fail
Balbir Pillai,11-03-2006,428761,West Bengal,23,21,20,5,69,Fail
Vivaan Singh,22-02-2006,488317,Punjab,10,5,13,10,38,Pass
David Verma,01-06-2005,361585,Haryana,1,8,19,16,44,Fail
Kunal Fernandes,03-12-2004,319879,Andhra Pradesh,1,21,10,24,56,Pass
Aditya Chopra,10-12-2005,124090,Andhra Pradesh,11,18,12,0,41,Pass
Raj Pillai,23-01-2006,616918,Punjab,16,3,18,5,42,Pass
Raj Khan,21-07-2005,886871,Chhattisgarh,4,18,9,2,33,Fail
Zaid Singh,09-11-2004,785372,Gujarat,21,16,17,24,78,Fail
Krishna Chopra,27-02-2005,429104,Rajasthan,3,22,7,6,38,Pass
Ishaan Singh,16-03-2006,723504,Uttar Pradesh,23,19,2,19,63,Fail
Rohan Sharma,15-02-2005,592640,Delhi,4,22,0,6,32,Fail
Aarav Reddy,12-03-2006,850382,Kerala,13,13,11,12,49,Pass
Vivaan Khan,10-11-2005,692887,Uttar Pradesh,12,22,10,17,61,Fail
Sukhwinder Sharma,25-04-2005,364639,Uttar Pradesh,4,16,22,17,59,Fail
Krishna Reddy,26-12-2005,759244,Goa,7,9,6,10,32,Fail
Aditya Pillai,02-06-2005,600643,Tamil Nadu,19,11,3,22,55,Fail
Rohan Fernandes,15-02-2005,228840,Gujarat,19,7,16,13,55,Fail
Mathew Pillai,04-02-2005,191361,Punjab,13,11,20,23,67,Pass
Manpreet Verma,11-12-2005,329140,West Bengal,14,1,24,11,50,Fail
Ishaan Mehta,26-02-2006,711773,Punjab,12,1,1,24,38,Pass
Vivaan Reddy,19-11-2004,300060,West Bengal,2,2,1,1,6,Fail
Aryan Fernandes,10-08-2005,765635,Sikkim,24,6,16,22,68,Fail
Kunal Chopra,17-11-2005,389363,Assam,1,23,12,4,40,Fail
Ishaan Reddy,11-09-2005,954762,Bihar,10,8,19,24,61,Pass
Aditya Pillai,10-12-2005,330843,Bihar,16,10,9,21,56,Pass
Krishna Verma,10-06-2005,615601,Manipur,0,20,14,12,46,Fail
Yash Chopra,27-03-2005,933190,Andhra Pradesh,12,8,2,16,38,Pass
Harjeet Chopra,29-09-2005,367822,Maharashtra,20,18,22,11,71,Fail
Aditya Pillai,18-11-2005,426648,Haryana,11,11,18,8,48,Fail
Aditya Reddy,28-01-2005,774857,Rajasthan,22,19,2,13,56,Pass
Aarav Pillai,15-03-2005,149348,Karnataka,8,22,4,22,56,Pass
Ishaan Singh,21-03-2006,649222,Telangana,4,20,23,0,47,Fail
Aditya Verma,16-12-2004,125501,Rajasthan,18,12,15,8,53,Pass
Sukhwinder Mehta,23-02-2005,109685,Madhya Pradesh,13,17,22,0,52,Fail
Krishna Fernandes,03-03-2005,172864,Jammu & Kashmir + Ladakh,5,24,16,21,66,Pass
Sukhwinder Khan,18-02-2006,910840,Odisha,13,20,14,3,50,Fail
John Khan,02-03-2005,574690,Bihar,7,19,3,1,30,Pass
Vivaan Sharma,24-12-2004,402494,Punjab,23,20,15,21,79,Pass
Yash Pillai,28-02-2006,362815,Uttar Pradesh,24,13,15,24,76,Fail
Aryan Khan,24-06-2005,364648,Bihar,16,20,23,11,70,Pass
Kunal Sharma,06-05-2005,307501,Kerala,24,11,14,12,61,Pass
Aarav Verma,05-02-2005,622215,West Bengal,8,14,11,0,33,Fail
Kunal D'Souza,25-12-2005,534706,Kerala,11,4,18,21,54,Pass
Sukhwinder Singh,28-08-2005,767529,Tamil Nadu,8,5,17,21,51,Pass
Raj Chopra,15-07-2005,916806,Madhya Pradesh,13,23,23,11,70,Fail
Yash Pillai,13-04-2006,680227,Andhra Pradesh,7,1,7,11,26,Pass
Vivaan Chopra,16-02-2005,254803,Bihar,15,13,23,20,71,Pass
Manpreet Singh,07-04-2006,308046,West Bengal,4,1,10,16,31,Fail
Rohan Fernandes,06-01-2005,566965,Telangana,7,2,6,18,33,Fail
David Pillai,11-12-2004,172340,Punjab,8,23,14,20,65,Pass
Aarav Reddy,16-04-2006,522898,Gujarat,22,5,6,8,41,Fail
Paul Pillai,26-04-2006,924914,Odisha,16,6,13,0,35,Pass
Paul Verma,23-12-2005,690765,Gujarat,11,11,11,15,48,Fail
Vivaan D'Souza,25-08-2005,245571,Telangana,18,1,3,23,45,Fail
Rohan D'Souza,24-03-2006,817044,Karnataka,16,13,18,24,71,Fail
Ishaan Fernandes,04-03-2006,960196,Gujarat,1,2,17,7,27,Fail
Aryan D'Souza,18-03-2006,878554,Arunachal Pradesh,5,11,21,9,46,Fail
Peter D'Souza,06-06-2005,495858,West Bengal,5,20,20,17,62,Fail
Vivaan Sharma,25-10-2005,379368,Andhra Pradesh,15,13,1,14,43,Pass
Aarav Mehta,19-06-2005,257260,Bihar,24,1,12,2,39,Pass
Aarav D'Souza,17-04-2006,959354,Bihar,7,7,1,17,32,Pass
Aarav Mehta,19-04-2005,951908,Karnataka,24,3,1,2,30,Pass
Manpreet Verma,25-06-2005,117398,Bihar,13,22,14,5,54,Pass
Mathew Chopra,28-12-2005,946916,Uttar Pradesh,16,2,4,21,43,Fail
Krishna Verma,18-09-2005,393550,Tamil Nadu,23,6,13,17,59,Pass
Manpreet Verma,31-10-2005,714615,Mizoram,1,6,12,15,34,Pass
Aarav D'Souza,25-02-2005,412567,Rajasthan,3,11,9,0,23,Pass
Harjeet Chopra,01-09-2005,323564,Tripura,15,7,22,5,49,Fail
Krishna Sharma,26-04-2006,717853,Karnataka,23,14,20,7,64,Pass
Mathew Verma,14-08-2005,268701,Bihar,3,9,6,12,30,Pass
Gurpreet D'Souza,03-01-2006,168401,Uttar Pradesh,12,6,19,22,59,Fail
Ishaan Chopra,06-04-2005,538808,Gujarat,9,5,19,21,54,Fail
Gurpreet Singh,19-09-2005,338180,Uttar Pradesh,18,13,8,14,53,Fail
Harjeet Khan,05-05-2005,470280,Madhya Pradesh,3,0,16,18,37,Fail
Ishaan Verma,06-07-2005,713639,Bihar,20,9,1,12,42,Pass
Yash Sharma,02-07-2005,346173,Uttar Pradesh,9,17,13,8,47,Fail
Farhan Khan,08-10-2005,396052,Maharashtra,21,12,8,3,44,Fail
Gurpreet Khan,03-04-2005,549749,Maharashtra,12,3,10,4,29,Fail
Vivaan Fernandes,14-08-2005,876510,Rajasthan,7,2,5,18,32,Pass
Krishna Reddy,31-12-2005,870208,Uttarakhand,8,10,16,21,55,Fail
Aryan D'Souza,06-09-2005,685569,West Bengal,23,16,12,7,58,Fail
Sukhwinder Khan,08-11-2004,278475,Telangana,19,24,22,13,78,Fail
Rohan Sharma,11-03-2005,812147,Telangana,10,4,4,3,21,Fail
Manpreet Verma,26-07-2005,839697,Uttar Pradesh,6,24,15,7,52,Fail
Paul Sharma,09-08-2005,494194,West Bengal,17,9,18,5,49,Fail
Peter Pillai,10-01-2005,833705,Andhra Pradesh,20,15,20,1,56,Pass
Kunal Khan,04-03-2005,853325,Rajasthan,9,9,22,8,48,Pass
Rohan Singh,14-02-2005,371185,Tamil Nadu,13,2,24,17,56,Pass
Mathew Pillai,30-12-2005,314456,Maharashtra,13,14,22,18,67,Fail
Vivaan D'Souza,16-10-2005,718010,Uttar Pradesh,20,19,23,14,76,Fail
Aryan D'Souza,22-08-2005,472612,Madhya Pradesh,4,18,18,8,48,Fail
Aditya Sharma,29-11-2004,570206,Rajasthan,23,7,17,9,56,Pass
Aarav D'Souza,19-03-2006,721919,West Bengal,14,10,19,16,59,Fail
Harjeet Khan,29-12-2004,438369,Bihar,9,13,13,21,56,Pass
Yash D'Souza,19-01-2006,465365,Andhra Pradesh,9,1,9,8,27,Pass
Gurpreet Khan,29-03-2006,148129,Bihar,22,9,11,1,43,Pass
John Verma,30-04-2005,509561,Uttar Pradesh,24,11,2,10,47,Fail
Aarav Pillai,17-07-2005,380451,Bihar,3,20,20,16,59,Pass
Raj Reddy,10-12-2004,736029,Uttarakhand,23,8,13,9,53,Fail
Vivaan Fernandes,19-09-2005,737445,Chhattisgarh,9,23,17,16,65,Fail
Aarav Pillai,13-09-2005,514042,West Bengal,16,21,9,14,60,Fail
Mathew Chopra,12-11-2005,583725,Madhya Pradesh,1,19,5,21,46,Fail
Kunal Singh,18-01-2006,852754,Andhra Pradesh,15,19,21,8,63,Pass
David Mehta,19-09-2005,229857,Andhra Pradesh,17,11,2,1,31,Pass
Aditya Verma,25-02-2005,300473,Maharashtra,13,5,24,22,64,Fail
Balbir Chopra,21-10-2005,149584,Punjab,21,24,0,21,66,Pass
Yash Singh,15-04-2006,931798,Goa,5,12,5,23,45,Fail
Vivaan Verma,24-11-2005,513033,Delhi,14,13,17,9,53,Fail
Peter Fernandes,29-11-2004,519139,Uttar Pradesh,1,16,14,5,36,Fail
Ayaan Pillai,03-01-2005,632330,Tamil Nadu,5,10,17,22,54,Fail
Harjeet Sharma,08-10-2005,517739,Maharashtra,21,12,8,9,50,Fail
Harjeet Mehta,19-01-2005,595297,Manipur,24,3,21,5,53,Fail
Rohan Pillai,05-05-2006,957769,Madhya Pradesh,24,15,5,2,46,Fail
Yash Singh,17-12-2005,140523,Rajasthan,4,18,7,21,50,Pass
Aryan Pillai,03-03-2005,979654,Tamil Nadu,13,3,1,10,27,Pass
Aarav Sharma,30-12-2005,176543,Rajasthan,0,11,16,22,49,Pass
Sukhwinder Fernandes,04-12-2005,605620,Delhi,23,1,17,9,50,Fail
Kunal D'Souza,18-11-2005,866708,Maharashtra,22,20,15,22,79,Fail
Krishna Pillai,10-08-2005,438055,Tripura,9,17,17,9,52,Fail
Balbir Mehta,11-06-2005,479758,Jammu & Kashmir + Ladakh,12,6,5,14,37,Pass
Sukhwinder Reddy,13-04-2005,741076,Gujarat,16,7,18,11,52,Fail
Raj Mehta,03-01-2005,601403,Uttar Pradesh,24,7,0,1,32,Fail
Aarav Sharma,05-12-2004,148806,Gujarat,24,9,11,23,67,Fail
Aarav Sharma,26-06-2005,719894,Rajasthan,17,14,10,20,61,Fail
Kunal Sharma,10-08-2005,931049,Assam,23,20,4,10,57,Fail
Vivaan Fernandes,16-10-2005,611237,Odisha,23,16,23,10,72,Fail
Vivaan Khan,11-11-2005,681333,West Bengal,18,0,24,1,43,Fail
Raj Verma,17-09-2005,602123,Uttarakhand,12,21,2,6,41,Fail
Peter Pillai,16-04-2005,513299,Uttar Pradesh,20,17,7,9,53,Fail
Kunal Sharma,14-11-2005,717386,Telangana,6,13,8,11,38,Fail
Ishaan Pillai,23-11-2004,867379,Rajasthan,9,1,8,7,25,Pass
Kunal Fernandes,13-05-2005,452942,Tamil Nadu,5,4,17,13,39,Pass
Ishaan Sharma,10-05-2005,748119,Jharkhand,3,23,12,22,60,Fail
Ishaan Chopra,28-04-2006,415823,Uttar Pradesh,5,10,13,13,41,Fail
Kunal Mehta,02-02-2006,547090,Andhra Pradesh,7,13,21,5,46,Pass
Aryan Verma,14-03-2005,694595,Odisha,18,23,2,21,64,Fail
Yash Chopra,09-10-2005,109501,Odisha,5,18,3,9,35,Pass
Raj Pillai,19-12-2004,797436,Bihar,20,8,21,20,69,Pass
Kunal Verma,22-04-2006,677651,Uttar Pradesh,23,9,21,9,62,Fail
Krishna Reddy,31-12-2004,962348,Karnataka,12,6,4,20,42,Pass
Aryan Khan,31-07-2005,465368,Bihar,12,10,21,12,55,Pass
Yash Mehta,26-02-2006,302296,Rajasthan,5,3,20,22,50,Pass
Krishna Khan,29-01-2006,590296,Bihar,10,10,12,2,34,Pass
Sukhwinder Fernandes,19-01-2005,485085,Rajasthan,22,19,7,7,55,Pass
Ishaan Chopra,28-04-2005,275509,Assam,15,2,1,20,38,Fail
Yash Singh,15-11-2005,235232,Gujarat,17,6,13,15,51,Fail
Raj Chopra,27-08-2005,407390,Rajasthan,16,4,7,5,32,Pass
Ishaan Mehta,29-11-2004,957624,Uttar Pradesh,17,19,8,1,45,Fail
Kunal Pillai,12-02-2006,705604,Madhya Pradesh,22,22,12,3,59,Fail
Vivaan Verma,12-03-2005,388076,West Bengal,10,8,6,11,35,Fail
Manpreet Chopra,20-04-2005,488229,Tamil Nadu,19,21,7,1,48,Fail
Ayaan Reddy,03-04-2005,393101,Tamil Nadu,1,14,10,15,40,Pass
Rohan Fernandes,28-10-2005,314593,Bihar,16,6,8,17,47,Pass
Ishaan Fernandes,18-07-2005,409947,Telangana,3,4,15,18,40,Fail
Vivaan Khan,08-12-2004,422710,Haryana,2,2,8,0,12,Fail
Aditya Sharma,29-10-2005,314528,Tamil Nadu,19,10,4,1,34,Pass
Vivaan Singh,17-03-2005,228350,Kerala,7,19,21,18,65,Pass
Yash Sharma,16-12-2005,172268,Andhra Pradesh,22,2,15,9,48,Pass
Aarav Chopra,07-10-2005,784464,Gujarat,9,15,23,19,66,Fail
Vivaan Khan,30-12-2005,702857,Uttar Pradesh,2,6,23,12,43,Fail
David Khan,26-01-2005,283960,Delhi,16,2,14,16,48,Fail
Yash Sharma,04-05-2005,369332,Uttar Pradesh,21,4,0,7,32,Fail
Aditya Reddy,25-04-2005,410885,West Bengal,0,4,18,5,27,Fail
Ishaan Reddy,12-03-2006,714594,Karnataka,15,14,24,9,62,Pass
Vivaan Khan,04-02-2005,966696,Uttar Pradesh,12,11,1,12,36,Fail
Sukhwinder Singh,28-02-2005,268346,Chhattisgarh,12,13,2,9,36,Fail
Aryan D'Souza,20-03-2006,771755,Gujarat,20,6,5,18,49,Fail
Sukhwinder Mehta,22-02-2005,914579,Karnataka,10,7,13,15,45,Pass
Aarav Singh,07-02-2005,960165,Punjab,17,15,10,15,57,Pass
Kunal Fernandes,15-09-2005,735305,Telangana,21,10,7,3,41,Fail
Krishna Fernandes,09-07-2005,510426,Madhya Pradesh,1,5,10,15,31,Fail
Kunal Fernandes,17-01-2006,230345,Haryana,7,16,16,10,49,Fail
Peter Chopra,22-11-2005,276994,Madhya Pradesh,19,18,9,1,47,Fail
Raj Singh,15-02-2006,342790,Madhya Pradesh,12,11,14,3,40,Fail
Aarav Fernandes,25-11-2004,824278,West Bengal,19,11,23,8,61,Fail
Krishna Verma,14-03-2005,409127,Haryana,8,13,22,13,56,Fail
Aarav Mehta,18-02-2005,870295,Rajasthan,8,14,4,0,26,Pass
Gurpreet Verma,24-04-2005,123093,Bihar,11,5,4,5,25,Pass
Aarav Sharma,10-01-2005,830024,Delhi,19,4,3,14,40,Fail
Rohan Fernandes,10-12-2004,270340,Maharashtra,20,3,8,3,34,Fail
Raj Singh,09-12-2004,323481,Madhya Pradesh,10,12,16,3,41,Fail
Harjeet Khan,15-07-2005,118484,Maharashtra,6,3,22,17,48,Fail
Rohan Verma,26-07-2005,505734,West Bengal,3,11,8,17,39,Fail
Vivaan Reddy,07-03-2005,179344,Kerala,5,10,12,1,28,Pass
Raj Mehta,28-11-2005,197293,Uttar Pradesh,0,9,17,21,47,Fail
David Pillai,16-01-2006,982639,Telangana,3,13,13,16,45,Fail
John Mehta,18-06-2005,379119,Maharashtra,5,7,3,17,32,Fail
Ishaan Khan,07-03-2005,732667,West Bengal,6,8,23,10,47,Fail
Mathew Mehta,18-01-2006,773350,Telangana,3,17,16,0,36,Fail
Vivaan Fernandes,07-01-2005,153878,Rajasthan,5,14,10,23,52,Pass
Vivaan Chopra,27-08-2005,114836,Bihar,21,19,9,23,72,Pass
Aarav Verma,19-03-2006,171798,Bihar,15,20,11,24,70,Pass
Ishaan Singh,22-07-2005,563439,Maharashtra,12,24,5,11,52,Fail
Ishaan Singh,06-02-2006,231590,Uttar Pradesh,4,2,18,16,40,Fail
Kunal Fernandes,21-09-2005,503461,Karnataka,23,21,6,7,57,Pass
Raj D'Souza,25-04-2006,313128,Gujarat,7,11,20,24,62,Fail
Vivaan Verma,01-11-2005,752770,Uttar Pradesh,9,14,6,24,53,Fail
Krishna Singh,28-04-2006,817688,Delhi,21,24,8,18,71,Fail
Zaid Reddy,11-02-2005,315562,Delhi,10,2,14,11,37,Fail
Rehan D'Souza,15-12-2004,458204,Bihar,10,9,18,4,41,Pass
Raj Chopra,19-12-2005,885255,Punjab,5,13,11,22,51,Pass
Yash D'Souza,18-02-2006,108565,Punjab,10,22,15,10,57,Pass
Vivaan Chopra,22-11-2005,375588,Rajasthan,18,19,2,3,42,Pass
Raj Verma,10-05-2005,301577,Rajasthan,6,6,24,0,36,Pass
Kunal Verma,19-02-2005,726597,Jharkhand,21,4,18,11,54,Pass
Aryan Singh,17-01-2006,942991,Punjab,19,18,3,6,46,Pass
Manpreet D'Souza,10-04-2005,998444,Kerala,17,13,10,15,55,Pass
Mathew Verma,17-12-2005,460287,Haryana,22,21,11,10,64,Fail
Aarav Mehta,15-10-2005,106704,Punjab,4,23,18,7,52,Pass
Krishna Singh,05-03-2006,736263,Madhya Pradesh,6,5,23,9,43,Fail
Rohan D'Souza,14-02-2005,136423,Andhra Pradesh,5,2,6,23,36,Pass
Krishna Verma,08-06-2005,562243,Gujarat,17,1,17,19,54,Fail
Kunal Khan,22-02-2006,247317,Haryana,16,8,12,19,55,Fail
Yash Mehta,13-09-2005,210322,Bihar,14,16,0,3,33,Pass
Rohan Pillai,08-03-2006,513430,Uttar Pradesh,6,10,11,12,39,Fail
Sukhwinder Reddy,24-04-2005,609721,Maharashtra,6,3,11,10,30,Fail
Krishna Chopra,02-05-2006,602497,Rajasthan,5,16,7,1,29,Pass
Aditya Reddy,10-05-2005,184367,Jharkhand,11,7,15,7,40,Pass
Aditya Khan,21-05-2005,714920,Maharashtra,4,23,3,17,47,Fail
Aryan Singh,14-08-2005,981433,Punjab,17,21,9,0,47,Fail
Aryan Verma,20-02-2005,601011,Meghalaya,8,14,4,21,47,Fail
Ishaan Chopra,14-01-2006,846954,Odisha,12,22,12,6,52,Fail
Rohan Verma,07-03-2005,664569,Rajasthan,2,12,12,17,43,Pass
Yash Reddy,02-01-2005,116129,West Bengal,9,13,17,23,62,Fail
Aryan Sharma,12-07-2005,162975,Maharashtra,9,20,11,7,47,Fail
Aryan Mehta,09-02-2005,207672,Tamil Nadu,12,22,16,23,73,Pass
Kunal Pillai,26-04-2005,136261,Punjab,14,23,9,22,68,Fail
Yash Sharma,08-09-2005,414975,West Bengal,5,21,7,7,40,Fail
Ishaan Fernandes,13-04-2006,189144,Punjab,16,24,7,5,52,Fail
Kunal Pillai,31-05-2005,620597,Telangana,6,14,7,1,28,Fail
John Chopra,01-04-2006,180361,Rajasthan,22,11,18,3,54,Pass
Balbir Khan,30-12-2004,583903,Uttar Pradesh,18,18,16,4,56,Fail
Kunal Mehta,17-05-2005,439350,Uttar Pradesh,19,10,24,20,73,Fail
Sukhwinder Verma,10-04-2006,800306,Delhi,8,6,16,23,53,Fail
John D'Souza,17-04-2006,279510,Karnataka,8,7,13,13,41,Pass
Kunal Pillai,09-12-2005,802731,Madhya Pradesh,13,6,16,18,53,Fail
Aarav Fernandes,12-04-2006,801034,Madhya Pradesh,0,2,21,24,47,Fail
Ishaan Singh,04-05-2005,534577,Rajasthan,20,6,5,23,54,Pass
Gurpreet Mehta,01-06-2005,345349,Tamil Nadu,6,13,2,1,22,Pass
Imran Sharma,20-03-2006,801235,Maharashtra,13,16,23,6,58,Fail
Kunal Fernandes,18-04-2005,811623,Uttar Pradesh,21,19,23,0,63,Fail
Imran Chopra,23-01-2006,649328,Maharashtra,13,17,11,18,59,Fail
Kunal Pillai,02-05-2006,262736,Tamil Nadu,18,18,5,5,46,Fail
Krishna Verma,26-11-2004,980875,Jharkhand,0,2,22,15,39,Pass
Mathew Verma,21-11-2004,940278,Telangana,22,10,21,10,63,Fail
Vivaan Singh,01-03-2005,199972,Uttar Pradesh,20,10,20,24,74,Fail
Ishaan Fernandes,21-12-2005,895031,Bihar,0,1,10,10,21,Pass
Manpreet Mehta,12-08-2005,479830,Haryana,23,5,13,6,47,Fail
Aryan Fernandes,22-03-2005,549899,Goa,5,1,13,12,31,Fail
Yash Chopra,21-12-2004,517499,Chhattisgarh,4,3,6,24,37,Fail
Aryan Singh,09-07-2005,161319,Haryana,10,23,15,2,50,Fail
Yash Pillai,06-02-2006,225829,Haryana,3,6,24,14,47,Fail
Aditya Verma,08-08-2005,144480,Haryana,12,5,17,3,37,Fail
Raj Chopra,10-07-2005,132400,Haryana,1,22,23,19,65,Fail
Harjeet Chopra,07-03-2006,840575,West Bengal,14,6,4,6,30,Fail
Gurpreet Pillai,01-02-2005,495562,Bihar,8,6,5,22,41,Pass
Rohan Mehta,15-08-2005,554818,Maharashtra,12,11,8,8,39,Fail
Krishna Khan,05-03-2005,717677,Himachal Pradesh,17,1,15,0,33,Pass
Kunal Khan,29-03-2005,817451,Uttarakhand,20,16,18,1,55,Fail
Vivaan Fernandes,02-11-2005,416134,Maharashtra,24,5,23,1,53,Fail
Rohan D'Souza,27-01-2006,668468,Maharashtra,23,1,7,11,42,Fail
Raj D'Souza,23-10-2005,554155,Haryana,18,19,3,20,60,Fail
Ishaan Pillai,27-01-2005,332761,Delhi,10,9,1,4,24,Fail
Rohan Verma,29-12-2004,774831,Bihar,23,19,8,19,69,Pass
Aryan Sharma,14-11-2005,848281,Chhattisgarh,10,6,0,16,32,Fail
Vivaan Sharma,12-11-2004,658759,Maharashtra,3,9,1,20,33,Fail
Raj Reddy,20-06-2005,902010,Rajasthan,1,23,13,1,38,Pass
Rohan Pillai,02-03-2005,151379,Andhra Pradesh,7,21,22,18,68,Pass
Rohan Sharma,23-11-2004,474333,Uttar Pradesh,13,21,18,14,66,Fail
Ishaan Mehta,30-01-2006,686729,Bihar,21,9,5,6,41,Pass
Kunal Mehta,19-04-2006,666460,West Bengal,19,22,19,17,77,Fail
Yash Chopra,30-06-2005,775931,Chhattisgarh,8,24,19,22,73,Fail
Paul Chopra,04-10-2005,733883,Himachal Pradesh,20,6,5,10,41,Pass
Ishaan Reddy,19-01-2005,975321,Chhattisgarh,4,5,4,11,24,Fail
Kunal Fernandes,10-12-2004,171492,Gujarat,5,10,17,11,43,Fail
Vivaan Verma,26-06-2005,784641,Rajasthan,22,7,21,14,64,Fail
Aryan Fernandes,17-01-2005,720220,Chhattisgarh,0,14,0,14,28,Fail
Vivaan Pillai,02-02-2005,732006,West Bengal,18,10,18,23,69,Fail
Manpreet Reddy,08-03-2005,588929,Rajasthan,18,7,3,5,33,Pass
Mathew Verma,06-03-2005,374641,Tamil Nadu,23,11,18,15,67,Fail
Raj Reddy,18-04-2006,179629,West Bengal,24,24,15,17,80,Fail
Aarav Verma,09-09-2005,968915,Madhya Pradesh,2,9,6,1,18,Fail
Aarav Pillai,16-11-2004,116269,Maharashtra,12,3,10,12,37,Fail
Peter Chopra,04-01-2005,935632,Haryana,24,9,24,18,75,Fail
Aryan Reddy,28-11-2005,716066,Andhra Pradesh,7,10,11,9,37,Pass
Kunal Singh,16-04-2005,755804,Rajasthan,11,1,23,9,44,Pass
David Pillai,25-09-2005,913326,Uttar Pradesh,3,11,10,24,48,Fail
Vivaan Mehta,20-01-2006,946835,Jharkhand,20,12,9,0,41,Pass
Manpreet Khan,02-02-2006,350426,Madhya Pradesh,23,11,21,14,69,Fail
Ishaan Fernandes,23-05-2005,670418,Jammu & Kashmir + Ladakh,2,8,10,4,24,Pass
Aditya Sharma,09-06-2005,402166,Uttar Pradesh,24,17,14,19,74,Fail
Aryan Pillai,31-07-2005,597650,Andhra Pradesh,7,24,16,6,53,Pass
Vivaan Pillai,06-12-2004,921893,West Bengal,11,20,13,16,60,Fail
Ishaan Singh,17-11-2004,643323,Rajasthan,4,6,15,10,35,Pass
Aditya Mehta,13-07-2005,115655,Maharashtra,13,19,13,11,56,Fail
Ayaan Chopra,03-02-2006,405185,Uttar Pradesh,2,5,0,21,28,Fail
Manpreet Sharma,31-12-2004,541545,Uttar Pradesh,1,6,18,18,43,Fail
Harjeet Pillai,04-04-2006,244839,Madhya Pradesh,10,3,14,20,47,Fail
Aryan Khan,21-07-2005,340643,Tamil Nadu,22,14,15,14,65,Pass
Krishna Sharma,15-06-2005,782860,Telangana,10,12,9,7,38,Fail
Aryan D'Souza,29-12-2005,700309,Tripura,21,12,5,9,47,Fail
Rohan Mehta,03-01-2006,671283,Andhra Pradesh,20,11,19,9,59,Pass
Raj Pillai,28-03-2006,646140,Assam,20,22,8,4,54,Fail
Kunal D'Souza,11-12-2005,278927,Punjab,19,18,20,7,64,Fail
Vivaan Reddy,23-08-2005,838876,Uttar Pradesh,23,6,4,3,36,Fail
Aarav Pillai,06-04-2005,300732,Telangana,22,21,1,15,59,Fail
Manpreet Khan,27-12-2005,427582,Tamil Nadu,18,21,9,20,68,Fail
Ishaan Chopra,18-11-2005,383296,Delhi,9,5,15,17,46,Fail
Sukhwinder Sharma,25-05-2005,788914,Rajasthan,11,10,24,0,45,Pass
Aryan Khan,08-04-2006,973249,Gujarat,23,8,0,22,53,Fail
Manpreet Reddy,08-06-2005,712888,Himachal Pradesh,5,14,21,18,58,Pass
Yash Reddy,01-11-2005,852497,West Bengal,17,22,17,18,74,Fail
Sukhwinder Reddy,23-01-2005,950118,Madhya Pradesh,17,5,22,5,49,Fail
John Sharma,09-08-2005,913950,Kerala,21,14,16,0,51,Pass
Harjeet Reddy,04-01-2005,915629,Madhya Pradesh,2,1,24,18,45,Fail
Gurpreet Mehta,30-05-2005,968646,Andhra Pradesh,13,5,9,17,44,Pass
Gurpreet Reddy,11-09-2005,171401,Kerala,20,12,21,10,63,Pass
Yash Verma,07-03-2006,209284,Bihar,19,4,19,8,50,Pass
Aditya Fernandes,09-03-2005,746268,Tamil Nadu,1,7,6,23,37,Pass
Yash Verma,02-02-2005,664500,Haryana,11,20,7,17,55,Fail
Harjeet Mehta,14-03-2005,572405,Punjab,23,17,6,16,62,Fail
Gurpreet Chopra,01-12-2005,608237,Uttar Pradesh,5,7,16,18,46,Fail
Yash Chopra,08-02-2005,751367,Bihar,13,14,16,2,45,Pass
Ishaan Fernandes,11-08-2005,662674,Delhi,15,3,13,8,39,Fail
Krishna Verma,13-08-2005,378231,Bihar,22,18,14,16,70,Pass
Manpreet D'Souza,19-12-2004,907529,Maharashtra,22,18,1,13,54,Fail
Ishaan Chopra,11-01-2006,212483,Kerala,17,0,11,9,37,Pass
Aarav Pillai,27-05-2005,973317,Punjab,13,24,5,8,50,Fail
Rohan Chopra,20-05-2005,166929,Assam,15,8,14,21,58,Fail
Aarav Fernandes,09-12-2004,181672,Rajasthan,24,22,11,16,73,Fail
Balbir Mehta,31-01-2005,172270,Gujarat,16,18,16,10,60,Fail
Gurpreet Fernandes,11-01-2006,524452,Rajasthan,2,10,6,23,41,Pass
Balbir Fernandes,30-08-2005,448543,Bihar,18,5,1,15,39,Pass
Kunal Mehta,17-05-2005,731154,Maharashtra,7,20,3,11,41,Fail
Peter Singh,18-07-2005,864537,Madhya Pradesh,5,4,7,10,26,Fail
Aditya D'Souza,10-04-2006,547537,Kerala,10,7,7,2,26,Pass
Yash Singh,24-02-2005,452152,Karnataka,24,8,10,10,52,Pass
Aarav Reddy,03-10-2005,666570,Maharashtra,21,14,15,16,66,Fail
Vivaan Fernandes,11-02-2005,744409,Rajasthan,23,2,6,23,54,Pass
Aryan Singh,03-06-2005,945808,Telangana,11,11,13,19,54,Fail
Aditya Singh,19-02-2005,193029,Telangana,14,13,11,19,57,Fail
John D'Souza,09-04-2006,269007,Tamil Nadu,23,11,3,24,61,Pass
Paul Khan,11-08-2005,745420,Chhattisgarh,10,15,6,8,39,Fail
Rohan Pillai,01-08-2005,947631,Assam,20,24,10,20,74,Fail
Aarav Pillai,15-07-2005,423731,Madhya Pradesh,15,3,7,5,30,Fail
Manpreet Singh,17-06-2005,194312,Karnataka,6,3,17,14,40,Pass
Raj Khan,27-08-2005,916226,Tamil Nadu,15,19,14,19,67,Fail
Paul Fernandes,31-03-2006,201117,Bihar,21,19,14,6,60,Pass
Vivaan Mehta,24-12-2005,541852,Chhattisgarh,17,21,19,2,59,Fail
Raj Pillai,03-01-2006,188439,Tamil Nadu,8,6,2,7,23,Pass
Ishaan Pillai,28-05-2005,619293,Karnataka,21,6,19,13,59,Pass
Vivaan Singh,30-03-2006,849483,Jharkhand,22,12,13,7,54,Pass
Balbir Sharma,30-03-2006,374705,Maharashtra,15,10,0,19,44,Fail
Aarav Fernandes,05-03-2006,544441,Andhra Pradesh,15,10,16,0,41,Pass
Aryan D'Souza,11-03-2006,622749,Maharashtra,4,20,16,19,59,Fail
Kunal Fernandes,24-03-2005,321417,Punjab,18,23,24,13,78,Pass
Aarav Fernandes,20-01-2005,821303,Telangana,22,9,4,13,48,Fail
Manpreet Chopra,20-10-2005,695655,Uttar Pradesh,2,20,23,20,65,Fail
Rohan Mehta,16-03-2005,270228,Assam,17,12,3,21,53,Fail
Aditya Singh,23-11-2004,316343,Andhra Pradesh,14,24,3,22,63,Pass
Raj Fernandes,26-12-2005,648649,Bihar,11,4,1,17,33,Pass
Aryan Singh,10-09-2005,445836,West Bengal,13,15,14,15,57,Fail
John Reddy,19-11-2005,987200,Rajasthan,12,2,24,18,56,Pass
Sukhwinder Reddy,21-02-2006,908115,Bihar,17,3,20,5,45,Pass
Peter Chopra,16-04-2006,216478,Bihar,10,2,18,21,51,Pass
Aditya Khan,01-12-2005,111113,Maharashtra,21,21,18,9,69,Fail
Aditya D'Souza,10-01-2006,815940,Maharashtra,4,14,23,22,63,Fail
Ishaan Verma,23-07-2005,186246,Bihar,5,12,15,18,50,Pass
Aarav Fernandes,18-01-2005,695898,Odisha,11,5,6,10,32,Pass
Kunal Sharma,22-02-2005,311102,Rajasthan,18,7,23,22,70,Fail
Rohan Chopra,31-10-2005,330455,Madhya Pradesh,1,18,24,13,56,Fail
Raj Chopra,28-02-2006,214131,Karnataka,9,7,16,15,47,Pass
Rohan Reddy,04-08-2005,714845,Rajasthan,12,0,17,10,39,Pass
Kunal Khan,30-03-2006,203318,Tamil Nadu,6,23,5,24,58,Fail
Aryan Khan,19-02-2006,508521,Andhra Pradesh,1,11,7,15,34,Pass
Aryan Mehta,17-02-2005,626167,Rajasthan,15,3,23,12,53,Pass
Aarav D'Souza,11-03-2006,597453,Uttar Pradesh,18,9,14,4,45,Fail
Raj Pillai,24-09-2005,330043,Chhattisgarh,3,14,1,0,18,Fail
Balbir Khan,04-01-2005,938160,Delhi,17,20,12,5,54,Fail
Yash Sharma,04-01-2005,993458,Haryana,19,0,1,9,29,Fail
Aarav D'Souza,23-04-2006,771339,Haryana,22,18,11,12,63,Fail
Rohan Khan,16-03-2005,167881,Telangana,15,1,19,14,49,Fail
Aryan Mehta,07-06-2005,175489,Rajasthan,24,11,24,24,83,Pass
Ishaan Verma,12-11-2004,579612,Nagaland,16,15,0,1,32,Pass
Yash Mehta,12-09-2005,416928,Karnataka,24,10,7,4,45,Pass
Rohan Reddy,22-03-2005,983964,Haryana,19,23,3,18,63,Fail
Manpreet Pillai,13-05-2005,437254,Bihar,8,11,6,14,39,Pass
Aarav Reddy,11-03-2006,744465,Haryana,0,19,14,7,40,Fail
Rehan Fernandes,11-09-2005,339746,Rajasthan,7,3,12,0,22,Pass
John D'Souza,09-05-2005,605401,Uttar Pradesh,10,18,14,6,48,Fail
David Reddy,03-12-2005,806447,Bihar,7,6,21,11,45,Pass
Aryan Reddy,11-04-2005,778332,Jharkhand,4,14,16,13,47,Pass
Ishaan Sharma,15-04-2006,900489,Assam,3,3,2,9,17,Fail
Aryan D'Souza,20-05-2005,536049,Haryana,24,12,3,8,47,Fail
Manpreet Reddy,01-02-2005,983756,West Bengal,1,9,21,12,43,Fail
Kunal Singh,22-01-2006,915048,Bihar,20,3,5,9,37,Pass
Harjeet Reddy,30-04-2005,621093,Maharashtra,11,18,6,13,48,Fail
Aryan Sharma,07-01-2005,533959,Bihar,8,1,4,3,16,Pass
Vivaan D'Souza,15-06-2005,758249,Haryana,0,23,23,6,52,Fail
Rohan Fernandes,14-01-2005,837468,Madhya Pradesh,11,22,17,11,61,Fail
Harjeet Chopra,21-04-2005,914413,Uttar Pradesh,17,8,22,15,62,Fail
Raj Singh,08-03-2005,450286,Jharkhand,19,18,3,12,52,Pass
Aarav Sharma,29-08-2005,834404,Tamil Nadu,5,13,12,14,44,Pass
Vivaan Mehta,03-03-2005,923807,Madhya Pradesh,22,17,16,19,74,Fail
Kunal Verma,28-03-2006,488906,West Bengal,10,5,11,0,26,Fail
Raj Verma,25-06-2005,734331,Uttar Pradesh,12,9,12,2,35,Fail
Aarav Sharma,27-04-2005,891423,Punjab,24,4,22,23,73,Fail
Yash D'Souza,19-02-2005,753487,Uttar Pradesh,23,4,23,2,52,Fail
Vivaan Mehta,16-08-2005,339907,Punjab,14,21,7,4,46,Fail
Aarav Verma,08-06-2005,317205,Chhattisgarh,8,6,17,15,46,Fail
Krishna Khan,05-08-2005,275641,Punjab,16,11,13,6,46,Fail
Ishaan Chopra,20-11-2005,836379,Uttar Pradesh,4,15,1,13,33,Fail
Aryan Mehta,05-07-2005,556863,Andhra Pradesh,23,8,17,2,50,Pass
Rohan Khan,23-05-2005,140156,Uttar Pradesh,15,16,16,14,61,Fail
Raj Verma,03-02-2005,968246,Kerala,6,23,19,2,50,Pass
Aryan Khan,16-07-2005,140521,Telangana,10,20,11,14,55,Fail
Paul Khan,28-04-2006,273317,Maharashtra,20,8,13,19,60,Fail
Zaid Fernandes,01-01-2005,224280,Gujarat,11,17,15,5,48,Fail
Vivaan Singh,13-01-2006,123238,Punjab,9,16,9,23,57,Fail
Vivaan Verma,04-08-2005,152502,Jharkhand,10,3,19,9,41,Pass
Mathew Fernandes,22-07-2005,578999,Tamil Nadu,4,11,7,18,40,Pass
Yash Fernandes,10-03-2005,472858,Bihar,1,12,0,2,15,Pass
Aryan Singh,12-10-2005,772414,Bihar,21,24,11,3,59,Pass
Kunal Reddy,01-02-2005,566210,Andhra Pradesh,19,17,17,4,57,Pass
Gurpreet Fernandes,25-06-2005,674340,Madhya Pradesh,4,15,19,9,47,Fail
Paul Khan,28-02-2005,678685,Uttar Pradesh,16,0,5,1,22,Fail
Vivaan Singh,19-02-2006,506550,Maharashtra,18,17,7,22,64,Fail
Kunal Chopra,04-02-2005,165564,Delhi,21,1,6,4,32,Fail
Balbir Fernandes,02-01-2006,962999,Maharashtra,7,20,13,24,64,Fail
Vivaan Singh,25-01-2006,785519,Uttar Pradesh,13,3,24,5,45,Fail
Farhan Pillai,03-01-2005,652537,Bihar,19,11,20,11,61,Pass
Aryan Mehta,19-04-2005,702446,Rajasthan,4,10,21,11,46,Pass
Sukhwinder Khan,05-05-2006,940439,Madhya Pradesh,24,5,2,10,41,Fail
Manpreet Pillai,05-09-2005,849802,Telangana,6,23,4,15,48,Fail
Krishna Khan,11-01-2006,727240,Maharashtra,4,2,9,11,26,Fail
Aryan Mehta,24-03-2006,761552,Karnataka,20,21,10,15,66,Pass
Rohan D'Souza,28-03-2006,770782,Maharashtra,4,15,20,3,42,Fail
Rohan Verma,07-05-2006,147224,West Bengal,8,7,15,2,32,Fail
Krishna Chopra,16-01-2005,458193,Delhi,13,13,6,21,53,Fail
Raj Verma,19-05-2005,373417,West Bengal,2,7,24,13,46,Fail
Ishaan Khan,13-08-2005,448282,Maharashtra,24,7,20,7,58,Fail
Vivaan Chopra,17-05-2005,745916,Madhya Pradesh,24,15,0,4,43,Fail
Rohan Khan,21-09-2005,846734,Rajasthan,12,1,5,7,25,Pass
John Pillai,17-03-2006,421711,Assam,8,21,14,13,56,Fail
Aryan Chopra,31-12-2004,529818,Delhi,8,16,16,22,62,Fail
Rohan D'Souza,11-05-2005,696807,Odisha,23,23,22,21,89,Pass
Kunal Fernandes,25-02-2006,418497,Uttarakhand,7,22,13,15,57,Fail
Aryan Fernandes,06-05-2005,254460,Assam,14,4,19,11,48,Fail
Gurpreet Khan,28-11-2004,829031,Puducherry,5,24,8,18,55,Fail
Ishaan Sharma,23-05-2005,500574,Madhya Pradesh,8,8,11,16,43,Fail
Vivaan Verma,22-11-2004,493304,Rajasthan,22,21,14,9,66,Fail
Ishaan Sharma,29-05-2005,556333,Arunachal Pradesh,6,11,4,13,34,Fail
Ishaan Singh,27-11-2005,404292,Kerala,6,18,19,16,59,Pass
Kunal Mehta,17-11-2004,398725,Uttar Pradesh,9,23,17,13,62,Fail
Aryan Fernandes,22-08-2005,451000,Andhra Pradesh,4,21,20,1,46,Pass
Kunal Khan,11-01-2005,150837,Uttarakhand,15,13,15,22,65,Fail
Balbir Mehta,22-12-2004,863815,Haryana,2,22,15,22,61,Fail
David Reddy,25-12-2005,591800,Punjab,3,8,14,15,40,Pass
Aarav Khan,30-03-2005,244211,Uttar Pradesh,8,3,19,12,42,Fail
Rohan Sharma,28-09-2005,194097,Gujarat,17,14,18,18,67,Fail
Harjeet Sharma,18-05-2005,443499,Bihar,9,21,9,21,60,Pass
Rohan D'Souza,24-11-2004,801540,Rajasthan,14,18,2,19,53,Pass
Aarav D'Souza,21-10-2005,577398,Punjab,2,6,9,24,41,Pass
Aditya Sharma,18-01-2006,922315,Uttar Pradesh,7,24,0,4,35,Fail
David Singh,04-01-2006,938481,West Bengal,23,6,3,0,32,Fail
Aryan Khan,23-08-2005,641094,Himachal Pradesh,8,12,10,1,31,Pass
Peter Khan,02-07-2005,876207,Andhra Pradesh,13,3,1,8,25,Pass
Krishna Chopra,11-02-2006,416067,Bihar,1,19,4,9,33,Pass
Kunal Chopra,13-03-2006,163908,Jharkhand,1,10,2,15,28,Pass
Yash Chopra,25-01-2005,996299,Telangana,11,0,16,7,34,Fail
David Reddy,30-10-2005,665771,West Bengal,23,24,8,18,73,Fail
Aditya Verma,25-04-2005,495585,Uttar Pradesh,10,8,6,6,30,Fail
Ishaan Verma,22-02-2006,384962,Bihar,8,11,9,12,40,Pass
Raj Singh,28-10-2005,511208,Andhra Pradesh,11,8,3,11,33,Pass
Aditya Singh,21-11-2004,528543,Uttar Pradesh,5,20,9,3,37,Fail
Aditya Khan,20-11-2005,279481,Uttar Pradesh,6,5,20,12,43,Fail
Kunal Pillai,22-09-2005,392881,Maharashtra,19,11,11,6,47,Fail
Rohan Sharma,19-10-2005,922616,Tamil Nadu,7,4,23,14,48,Fail
Rohan Sharma,05-11-2005,306541,Tamil Nadu,13,0,6,22,41,Pass
Krishna Reddy,29-09-2005,595578,Karnataka,9,12,23,5,49,Pass
Vivaan Pillai,03-02-2006,704802,Bihar,9,23,13,21,66,Pass
Ishaan Mehta,26-07-2005,676752,Tamil Nadu,21,14,15,15,65,Pass
Rohan Chopra,14-01-2005,779153,Haryana,20,2,24,22,68,Fail
Yash D'Souza,22-08-2005,661897,Gujarat,3,14,0,12,29,Fail
Krishna D'Souza,22-09-2005,846070,Tamil Nadu,21,17,12,17,67,Fail
Yash Singh,15-01-2006,873426,Kerala,5,23,6,10,44,Pass
Aryan Mehta,15-04-2005,556294,Uttar Pradesh,10,18,9,17,54,Fail
Manpreet Mehta,09-10-2005,516542,Meghalaya,22,2,20,21,65,Fail
Kunal Khan,16-04-2006,382591,Uttar Pradesh,19,8,23,23,73,Fail
Krishna Sharma,18-08-2005,145317,Tamil Nadu,4,9,5,7,25,Pass
Balbir Verma,26-03-2005,176349,Maharashtra,19,1,5,21,46,Fail
Rohan Reddy,04-08-2005,257820,Uttar Pradesh,16,5,24,11,56,Fail
Krishna Reddy,26-03-2006,616048,Madhya Pradesh,12,5,9,24,50,Fail
Vivaan Pillai,24-08-2005,184712,Chhattisgarh,18,23,14,15,70,Fail
Aarav Chopra,20-01-2005,214926,Mizoram,18,13,5,2,38,Pass
Yash D'Souza,13-12-2004,708470,Tamil Nadu,8,23,2,23,56,Pass
Vivaan Reddy,25-03-2005,749515,Haryana,13,11,3,6,33,Fail
Ishaan Verma,23-07-2005,463713,Maharashtra,23,15,22,16,76,Fail
Farhan Chopra,26-12-2004,185069,Bihar,12,15,18,3,48,Pass
John Reddy,23-03-2005,414714,Tripura,12,14,11,15,52,Fail
Raj Fernandes,13-03-2006,809532,Telangana,18,4,2,5,29,Fail
Vivaan Reddy,27-08-2005,713405,Madhya Pradesh,24,6,6,5,41,Fail
Raj Singh,01-07-2005,298557,Rajasthan,23,4,19,5,51,Pass
Balbir D'Souza,19-12-2005,930146,Haryana,4,22,4,5,35,Fail
Krishna Fernandes,01-05-2005,229504,Uttar Pradesh,22,21,22,15,80,Fail
Rohan Fernandes,12-11-2005,440849,Karnataka,22,12,18,12,64,Pass
Manpreet Singh,18-04-2006,277772,Haryana,19,20,1,15,55,Fail
Harjeet Reddy,05-08-2005,466111,Chhattisgarh,9,4,12,16,41,Fail
Manpreet Reddy,07-01-2006,236490,Haryana,13,6,11,1,31,Fail
Kunal Singh,09-02-2005,242552,Rajasthan,5,8,17,13,43,Pass
Kunal Mehta,06-12-2005,394345,Gujarat,1,22,21,23,67,Fail
Harjeet Chopra,14-12-2005,249923,Tamil Nadu,22,7,7,6,42,Pass
Sukhwinder Mehta,05-11-2005,233435,Punjab,24,14,6,21,65,Fail
John D'Souza,25-08-2005,564541,Assam,7,7,10,12,36,Fail
Ishaan Verma,29-06-2005,713851,Rajasthan,7,1,10,0,18,Pass
Aditya Khan,12-02-2005,946899,Uttar Pradesh,19,4,1,19,43,Fail
Kunal Khan,15-08-2005,408996,Maharashtra,18,24,3,3,48,Fail
Aditya Chopra,14-05-2005,203235,Himachal Pradesh,18,0,24,20,62,Pass
Aryan Chopra,20-08-2005,585324,Bihar,14,11,19,1,45,Pass
Balbir Chopra,06-12-2005,665223,Andhra Pradesh,13,13,13,8,47,Pass
Ishaan D'Souza,13-08-2005,548617,Tamil Nadu,9,20,21,17,67,Fail
Yash Reddy,10-07-2005,110103,Manipur,14,6,15,10,45,Fail
Mathew Verma,01-05-2006,763696,Punjab,19,20,22,9,70,Fail
Aryan Mehta,09-12-2004,634574,Haryana,17,21,12,4,54,Fail
Aryan Sharma,01-01-2006,386469,Jharkhand,8,2,24,4,38,Pass
Aditya Fernandes,25-06-2005,476223,Bihar,8,8,22,12,50,Pass
Raj Verma,24-03-2006,678615,Maharashtra,4,11,21,22,58,Fail
Aditya Mehta,04-07-2005,825624,Haryana,19,18,5,7,49,Fail
Rohan Reddy,26-05-2005,743407,Tamil Nadu,14,13,8,1,36,Pass
Harjeet Fernandes,08-04-2006,570055,Tamil Nadu,12,11,3,24,50,Fail
Kunal Mehta,15-01-2006,435794,Maharashtra,24,19,7,19,69,Fail
Yash Singh,12-11-2004,399156,Bihar,20,15,20,21,76,Pass
Krishna Khan,12-01-2005,389493,Maharashtra,0,8,1,15,24,Fail
Yash Pillai,21-10-2005,231958,Tamil Nadu,23,15,5,15,58,Fail
Aryan Sharma,22-01-2006,571149,Maharashtra,10,1,6,5,22,Fail
Ishaan Singh,29-09-2005,379218,Uttar Pradesh,21,0,18,8,47,Fail
Vivaan D'Souza,25-11-2005,663002,Andhra Pradesh,24,12,11,13,60,Pass
Balbir Mehta,10-05-2005,197857,Uttar Pradesh,22,18,22,8,70,Fail
Aryan Sharma,05-07-2005,307360,Nagaland,12,9,18,9,48,Fail
Kunal Chopra,02-03-2005,354521,Uttar Pradesh,8,8,19,18,53,Fail
Peter Chopra,29-09-2005,409361,Maharashtra,3,2,2,13,20,Fail
Raj Pillai,23-07-2005,587699,Maharashtra,5,21,24,6,56,Fail
Kunal Verma,02-02-2006,445491,Chhattisgarh,20,11,6,1,38,Fail
Aarav D'Souza,23-03-2006,718685,Andhra Pradesh,2,9,11,23,45,Pass
Peter Mehta,11-06-2005,180523,West Bengal,17,6,16,3,42,Fail
Aarav Pillai,09-09-2005,812596,Tamil Nadu,5,13,8,12,38,Pass
Raj Chopra,03-03-2005,333437,Maharashtra,11,16,1,8,36,Fail
Kunal Khan,28-02-2006,127622,Karnataka,6,8,10,0,24,Pass
Raj Mehta,06-01-2006,941318,Jharkhand,8,17,15,13,53,Pass
Mathew Mehta,16-11-2004,753070,Assam,15,12,16,11,54,Fail
Krishna Verma,23-10-2005,130046,Bihar,12,14,14,15,55,Pass
Aarav D'Souza,19-03-2006,428376,Himachal Pradesh,10,16,9,19,54,Pass
Sukhwinder Verma,23-02-2005,404704,Haryana,23,9,13,16,61,Fail
Yash D'Souza,12-12-2004,105194,Himachal Pradesh,17,4,21,21,63,Pass
Rohan Pillai,02-08-2005,287773,Andaman & Nicobar,11,4,12,24,51,Pass
Ayaan Chopra,13-04-2005,478701,Haryana,3,8,12,15,38,Fail
Yash Singh,19-02-2005,163261,Andhra Pradesh,11,8,0,24,43,Pass
Aryan D'Souza,13-07-2005,464911,Rajasthan,7,1,11,6,25,Pass
Aarav D'Souza,28-07-2005,315286,Punjab,2,24,20,4,50,Fail
Ishaan Pillai,12-04-2006,339206,Odisha,20,18,0,5,43,Pass
Mathew D'Souza,10-12-2004,157169,Uttar Pradesh,5,24,23,24,76,Fail
Rohan Pillai,14-11-2004,717469,Haryana,15,15,15,21,66,Fail
Krishna Fernandes,18-02-2006,566414,Bihar,12,6,23,0,41,Pass
Kunal Verma,03-08-2005,881572,Bihar,17,20,15,16,68,Pass
Raj Sharma,09-04-2006,179028,Bihar,23,15,12,1,51,Pass
Raj D'Souza,12-12-2005,485955,Karnataka,4,16,5,21,46,Pass
Mathew Fernandes,17-09-2005,105826,West Bengal,20,4,11,18,53,Fail
Aryan Reddy,31-03-2005,439307,Karnataka,0,10,2,10,22,Pass
Ishaan Singh,05-05-2006,595910,Odisha,0,1,1,8,10,Pass
Krishna Mehta,18-08-2005,371040,Maharashtra,1,13,12,17,43,Fail
Aryan Singh,07-05-2005,247032,Bihar,19,7,11,5,42,Pass
Yash Sharma,22-04-2005,895116,Telangana,4,9,12,12,37,Fail
Raj Singh,27-12-2005,574099,Maharashtra,17,10,24,23,74,Fail
David Reddy,11-12-2004,723187,Manipur,23,3,7,18,51,Fail
Rohan Singh,16-04-2005,220147,Rajasthan,1,11,5,2,19,Pass
Rohan D'Souza,23-10-2005,228297,Jammu & Kashmir + Ladakh,6,6,24,11,47,Pass
Aditya Khan,27-06-2005,670807,Bihar,20,21,19,4,64,Pass
Yash Chopra,17-08-2005,218773,Bihar,12,19,0,7,38,Pass
Gurpreet Verma,23-05-2005,268300,Uttar Pradesh,14,13,21,6,54,Fail
Aarav D'Souza,07-07-2005,445912,Uttar Pradesh,10,12,2,24,48,Fail
Aryan Verma,27-11-2004,317981,Bihar,8,10,9,16,43,Pass
Rohan Verma,09-12-2005,648159,Punjab,16,2,15,15,48,Fail
Aarav Pillai,05-06-2005,358691,Odisha,12,8,1,9,30,Pass
Mathew Reddy,06-01-2006,146688,Jammu & Kashmir + Ladakh,15,3,16,18,52,Pass
Harjeet Reddy,08-09-2005,413572,Rajasthan,15,21,6,7,49,Pass
Kunal Sharma,12-06-2005,649291,Uttar Pradesh,16,18,17,1,52,Fail
Harjeet Sharma,12-01-2006,306126,Andhra Pradesh,21,8,4,5,38,Pass
Balbir Fernandes,06-12-2004,798117,Chhattisgarh,1,24,7,13,45,Fail
Mathew Reddy,12-09-2005,702544,Punjab,7,8,13,8,36,Pass
Aarav Singh,10-09-2005,894202,Andhra Pradesh,24,13,22,4,63,Pass
Ishaan Verma,12-01-2005,387813,Bihar,11,2,15,13,41,Pass
Aditya Pillai,29-04-2005,626986,Bihar,4,20,9,12,45,Pass
Ishaan Mehta,04-04-2005,374252,Haryana,18,14,11,24,67,Fail
Rohan Verma,24-07-2005,107576,Uttarakhand,17,23,6,23,69,Fail
Ishaan Sharma,11-09-2005,147628,Tamil Nadu,2,9,13,10,34,Pass
Imran Verma,16-01-2006,218769,Uttar Pradesh,19,12,18,6,55,Fail
David D'Souza,23-01-2006,850108,Maharashtra,1,15,1,16,33,Fail
Manpreet Sharma,30-08-2005,414271,Rajasthan,0,16,3,11,30,Pass
Raj Chopra,20-02-2006,106110,Uttarakhand,17,6,21,2,46,Fail
Aditya D'Souza,18-11-2005,222715,Arunachal Pradesh,13,13,4,7,37,Fail
Vivaan Khan,06-12-2004,354346,Punjab,11,22,3,11,47,Fail
Aditya Pillai,03-04-2005,109537,Telangana,13,9,16,5,43,Fail
Aryan Chopra,03-03-2005,992437,Punjab,2,11,10,21,44,Pass
Vivaan Fernandes,09-08-2005,320687,Tamil Nadu,13,13,12,20,58,Fail
Kunal Fernandes,05-03-2005,566635,Uttar Pradesh,19,6,10,22,57,Fail
Vivaan Verma,02-07-2005,504837,Tamil Nadu,18,14,22,9,63,Fail
Aarav D'Souza,30-10-2005,507530,Tamil Nadu,1,5,0,22,28,Pass
David Sharma,08-08-2005,473103,Assam,12,9,13,1,35,Fail
Vivaan Fernandes,11-10-2005,857999,West Bengal,19,2,13,10,44,Fail
Aditya Mehta,26-04-2006,548845,Tamil Nadu,20,13,1,23,57,Pass
Aryan Reddy,05-06-2005,759647,Telangana,11,10,11,2,34,Fail
Rohan Singh,11-06-2005,419243,Haryana,11,10,10,23,54,Fail
Aarav Reddy,20-12-2004,438600,Tamil Nadu,15,0,3,4,22,Pass
John Pillai,30-03-2006,842404,Maharashtra,24,4,15,14,57,Fail
Yash Fernandes,11-12-2004,920937,Uttarakhand,13,2,16,15,46,Fail
Aditya Chopra,23-06-2005,478073,Tamil Nadu,6,8,17,16,47,Pass
Kunal Pillai,24-04-2006,668102,Madhya Pradesh,8,9,2,1,20,Fail
Vivaan Singh,01-02-2005,734071,Uttar Pradesh,13,5,9,16,43,Fail
Vivaan Verma,27-02-2006,852282,Bihar,16,20,4,19,59,Pass
Krishna Mehta,16-09-2005,224123,Haryana,6,3,17,19,45,Fail
David Sharma,17-07-2005,656268,Uttar Pradesh,18,9,14,0,41,Fail
Raj Pillai,15-01-2006,302053,Madhya Pradesh,20,16,3,9,48,Fail
Yash Sharma,23-11-2005,257858,Rajasthan,7,13,22,17,59,Pass
Raj Khan,07-06-2005,846002,Uttarakhand,8,24,10,17,59,Fail
Krishna Sharma,01-03-2005,748647,Andhra Pradesh,1,24,24,21,70,Pass
Rohan Pillai,15-01-2006,983580,Uttar Pradesh,7,19,11,16,53,Fail
Krishna Verma,18-04-2005,103223,Uttar Pradesh,4,8,14,19,45,Fail
Ishaan Pillai,08-04-2006,182687,Andhra Pradesh,2,23,8,9,42,Pass
Ishaan Khan,20-02-2005,763006,Andhra Pradesh,6,23,16,1,46,Pass
Ishaan Chopra,23-04-2006,638294,Uttar Pradesh,19,3,4,2,28,Fail
John Khan,29-11-2004,331563,Bihar,10,13,1,1,25,Pass
Aarav Verma,29-11-2004,327313,Uttar Pradesh,23,11,15,1,50,Fail
Kunal D'Souza,04-10-2005,614418,Rajasthan,20,20,20,5,65,Fail
Vivaan Singh,17-08-2005,485825,Uttar Pradesh,10,16,21,4,51,Fail
Harjeet Verma,18-03-2006,565118,Tamil Nadu,1,11,24,8,44,Pass
Ishaan Sharma,05-11-2005,180342,Rajasthan,9,15,0,20,44,Pass
Aarav Fernandes,19-12-2004,384204,Uttar Pradesh,22,17,5,18,62,Fail
Kunal Khan,08-04-2006,839930,Punjab,8,3,10,4,25,Pass
Mathew Singh,29-01-2005,773273,Uttar Pradesh,24,7,10,12,53,Fail
Mathew Singh,27-12-2005,232795,West Bengal,2,16,5,22,45,Fail
Peter Chopra,10-05-2005,760720,Tamil Nadu,17,6,9,14,46,Fail
Kunal Fernandes,02-10-2005,420167,Punjab,23,4,11,6,44,Pass
Imran Chopra,19-01-2005,144430,Uttar Pradesh,0,3,7,14,24,Fail
Ayaan Fernandes,29-12-2005,663631,Tamil Nadu,3,19,17,23,62,Pass
Ishaan Verma,23-03-2005,651136,Uttar Pradesh,1,21,10,4,36,Fail
Aarav Fernandes,13-11-2005,175227,Haryana,8,16,14,15,53,Fail
Yash Pillai,13-02-2005,949945,Chhattisgarh,8,3,15,22,48,Fail
Krishna Sharma,02-05-2005,862205,Assam,13,24,12,11,60,Fail
Rohan Mehta,25-11-2004,822978,Chhattisgarh,7,21,21,2,51,Fail
Ishaan Verma,18-01-2005,212111,Kerala,18,13,14,8,53,Pass
Manpreet Verma,05-09-2005,424998,West Bengal,6,11,14,20,51,Fail
Paul Pillai,30-03-2006,312154,Bihar,23,8,15,15,61,Pass
Ishaan Chopra,08-01-2006,152299,Bihar,22,14,11,5,52,Pass
Sukhwinder Sharma,11-04-2006,839654,Madhya Pradesh,24,18,6,21,69,Fail
Vivaan Fernandes,04-02-2005,667748,Bihar,6,1,16,14,37,Pass
Yash Chopra,15-03-2006,522930,Bihar,1,18,12,16,47,Pass
Manpreet D'Souza,24-09-2005,398215,Bihar,14,16,8,19,57,Pass
Aditya Verma,25-04-2006,312803,Punjab,2,16,9,15,42,Pass
John Singh,05-05-2005,270752,Odisha,19,17,5,20,61,Fail
Rohan Khan,12-08-2005,100847,Delhi,11,9,20,22,62,Fail
Aarav Mehta,31-01-2005,868304,Telangana,19,22,6,9,56,Fail
John Reddy,27-12-2004,518946,Maharashtra,13,12,21,8,54,Fail
Aarav Chopra,18-04-2005,795998,Andhra Pradesh,15,15,3,8,41,Pass
Sukhwinder Reddy,11-11-2004,537524,Tamil Nadu,1,10,22,1,34,Pass
Harjeet Sharma,28-10-2005,891879,Himachal Pradesh,16,24,2,2,44,Pass
Aditya Verma,09-02-2005,303152,Rajasthan,6,0,15,15,36,Pass
Ishaan Fernandes,10-04-2005,576551,Jharkhand,20,4,8,1,33,Pass
Aarav Pillai,29-01-2006,899863,Jharkhand,4,19,13,3,39,Fail
Rohan Reddy,19-09-2005,401135,Bihar,24,1,16,22,63,Pass
Aditya D'Souza,09-03-2005,322771,Nagaland,22,2,7,0,31,Pass
Vivaan Khan,15-11-2005,111044,Rajasthan,24,19,14,16,73,Fail
Ishaan Fernandes,10-11-2004,299411,Uttar Pradesh,3,17,19,5,44,Fail
Paul Mehta,17-07-2005,572594,Rajasthan,0,10,22,23,55,Pass
Raj Sharma,16-03-2006,849040,Tamil Nadu,10,22,17,4,53,Fail
Ishaan Chopra,24-03-2006,468972,Karnataka,21,0,5,7,33,Pass
Aarav Verma,14-10-2005,402455,Telangana,16,8,12,9,45,Fail
Aryan Reddy,12-03-2006,168716,Uttarakhand,12,8,14,4,38,Fail
Sukhwinder Pillai,05-07-2005,425775,Punjab,1,18,16,13,48,Fail
Ishaan Singh,27-11-2005,128641,Tamil Nadu,15,5,12,19,51,Pass
Yash Chopra,09-11-2005,249174,Uttar Pradesh,11,16,10,14,51,Fail
Harjeet Fernandes,28-01-2005,983100,Haryana,2,17,12,0,31,Fail
Gurpreet Fernandes,16-03-2006,498178,Uttar Pradesh,12,13,4,7,36,Fail
Yash Chopra,24-02-2006,341417,Rajasthan,11,3,8,5,27,Pass
Ishaan Mehta,22-09-2005,151552,Maharashtra,8,3,14,21,46,Fail
Yash Khan,29-01-2005,973925,Uttarakhand,5,24,8,18,55,Fail
Zaid Sharma,23-02-2006,268772,Tamil Nadu,12,6,3,21,42,Pass
Aditya Verma,23-10-2005,449967,Kerala,8,17,9,17,51,Pass
Kunal Fernandes,20-01-2005,411958,Uttar Pradesh,13,15,14,23,65,Fail
Yash Sharma,14-09-2005,107490,Punjab,0,16,10,23,49,Fail
Rohan Pillai,23-01-2005,933407,Uttar Pradesh,4,22,5,4,35,Fail
Kunal Verma,18-06-2005,817538,Jharkhand,3,16,24,16,59,Fail
David Fernandes,01-08-2005,457305,Telangana,11,15,4,9,39,Fail
Rehan Fernandes,13-10-2005,602734,Andhra Pradesh,1,19,23,12,55,Pass
John Reddy,26-11-2004,664622,Bihar,9,13,12,10,44,Pass
Raj Chopra,13-12-2004,917529,Mizoram,10,19,15,0,44,Pass
Rohan Pillai,26-12-2005,791041,Odisha,22,22,16,23,83,Pass
Krishna Verma,12-12-2005,982364,Bihar,13,15,19,4,51,Pass
Ishaan Khan,12-03-2006,963615,Haryana,23,4,14,7,48,Fail
Rohan Fernandes,13-12-2005,414695,Bihar,20,14,2,17,53,Pass
Aditya Sharma,27-04-2006,822762,Punjab,19,3,12,7,41,Pass
Kunal Verma,28-05-2005,449277,West Bengal,0,10,18,19,47,Fail
Peter Singh,15-10-2005,610113,Daman & Diu / D&N Haveli,14,1,8,7,30,Fail
Raj Fernandes,07-07-2005,517412,Himachal Pradesh,0,14,22,1,37,Pass
Sukhwinder Fernandes,07-05-2005,657108,Jharkhand,1,1,23,10,35,Pass
Kunal Reddy,24-08-2005,928592,Himachal Pradesh,12,19,6,12,49,Pass
Rohan D'Souza,31-12-2004,410588,Uttar Pradesh,7,15,18,15,55,Fail
Sukhwinder D'Souza,20-04-2005,647573,Tamil Nadu,7,17,16,6,46,Fail
Krishna Mehta,23-08-2005,983440,Madhya Pradesh,15,23,16,23,77,Fail
Yash Chopra,07-05-2005,515758,Tamil Nadu,21,22,16,9,68,Fail
Mathew Khan,09-11-2005,736766,Bihar,5,21,16,3,45,Pass
David Khan,23-10-2005,405367,Punjab,15,2,10,21,48,Fail
Raj Sharma,23-10-2005,192421,Uttar Pradesh,24,6,4,17,51,Fail
Balbir Reddy,10-10-2005,786628,Bihar,16,20,5,5,46,Pass
Farhan Pillai,25-08-2005,535146,Rajasthan,21,10,6,0,37,Pass
Mathew Reddy,26-06-2005,498655,Bihar,3,2,12,14,31,Pass
Yash Verma,06-03-2006,206774,Maharashtra,9,9,4,14,36,Fail
Vivaan Chopra,17-06-2005,528410,Assam,14,2,4,24,44,Fail
Raj Singh,21-12-2004,796215,West Bengal,20,15,17,14,66,Fail
Yash D'Souza,06-05-2005,407665,Punjab,2,11,22,4,39,Pass
Kunal D'Souza,14-01-2006,355320,West Bengal,21,14,5,14,54,Fail
Sukhwinder Mehta,21-02-2005,420610,Uttar Pradesh,20,21,12,3,56,Fail
Ishaan Chopra,10-02-2006,160650,Maharashtra,8,10,22,21,61,Fail
Aditya Reddy,04-11-2005,829274,Maharashtra,7,20,8,9,44,Fail
Yash Singh,02-04-2006,218391,Uttar Pradesh,14,23,12,24,73,Fail
Raj Khan,29-12-2005,590565,Rajasthan,19,0,13,22,54,Pass
Raj Reddy,25-11-2005,208737,Tamil Nadu,11,2,17,16,46,Fail
Ishaan Fernandes,28-05-2005,828741,Maharashtra,15,4,11,9,39,Fail
Vivaan Pillai,02-02-2006,911083,Haryana,2,5,3,19,29,Fail
Balbir Verma,01-03-2006,403091,Tamil Nadu,0,24,17,4,45,Fail
Rohan Reddy,05-03-2005,322636,Haryana,5,10,5,7,27,Fail
Raj Singh,18-06-2005,254362,Haryana,23,8,12,11,54,Fail
Aryan Fernandes,21-08-2005,469367,Bihar,3,12,2,8,25,Pass
Aditya Verma,09-04-2005,706483,Gujarat,22,10,21,2,55,Fail
Yash Pillai,09-01-2006,363456,Rajasthan,15,13,14,2,44,Pass
Gurpreet Singh,08-01-2005,172941,Uttar Pradesh,0,7,18,21,46,Fail
Yash Khan,06-12-2004,444771,Maharashtra,19,13,23,13,68,Fail
Zaid Khan,06-12-2004,976901,West Bengal,4,3,21,19,47,Fail
Krishna Reddy,20-04-2006,314921,Tamil Nadu,0,4,22,9,35,Pass
Balbir Pillai,10-06-2005,102302,Odisha,6,18,3,8,35,Pass
Rohan Khan,04-05-2006,354933,Andhra Pradesh,19,9,3,20,51,Pass
Yash Khan,05-01-2006,936266,Delhi,14,13,15,21,63,Fail
Sukhwinder Pillai,28-01-2005,239282,West Bengal,23,21,14,19,77,Fail
Raj Fernandes,14-03-2005,460181,Jammu & Kashmir + Ladakh,15,22,18,13,68,Fail
Vivaan Sharma,28-05-2005,157409,Telangana,6,9,24,14,53,Fail
Aditya Sharma,04-05-2005,911357,Jammu & Kashmir + Ladakh,9,2,10,6,27,Pass
Balbir Khan,18-11-2005,269641,Maharashtra,17,13,23,16,69,Fail
Vivaan D'Souza,02-02-2006,816179,Madhya Pradesh,21,7,16,3,47,Fail
Ishaan Pillai,04-04-2005,104834,Madhya Pradesh,13,19,21,6,59,Fail
Kunal Mehta,12-03-2005,697945,Rajasthan,14,4,9,2,29,Pass
Raj Mehta,12-11-2004,718331,Gujarat,9,22,11,13,55,Fail
Aarav Reddy,15-10-2005,577768,Andhra Pradesh,16,13,23,8,60,Pass
Krishna Mehta,10-07-2005,143875,Bihar,20,13,17,14,64,Pass
Vivaan Khan,02-01-2006,402421,Arunachal Pradesh,9,20,6,9,44,Fail
Yash Mehta,11-01-2005,312445,Delhi,9,13,5,21,48,Fail
Aditya Khan,03-05-2005,468130,West Bengal,16,17,5,2,40,Fail
Yash Verma,28-08-2005,544073,West Bengal,5,10,11,21,47,Fail
Imran Sharma,27-03-2006,707827,Uttar Pradesh,18,8,7,1,34,Fail
Kunal D'Souza,17-03-2006,200404,Uttar Pradesh,16,0,16,21,53,Fail
Rohan D'Souza,07-10-2005,359039,Jharkhand,0,21,6,13,40,Pass
Balbir Mehta,08-09-2005,390936,Uttar Pradesh,0,20,9,11,40,Fail
Yash Sharma,02-02-2005,986800,Uttar Pradesh,6,3,2,19,30,Fail
Rohan Fernandes,17-01-2005,230737,Andhra Pradesh,1,23,19,16,59,Pass
Kunal Chopra,16-06-2005,203647,Manipur,19,3,8,16,46,Fail
Rohan Pillai,20-01-2005,900595,Assam,6,23,18,10,57,Fail
Aryan Chopra,17-02-2006,569485,West Bengal,19,24,11,0,54,Fail
Gurpreet Singh,26-08-2005,263832,Gujarat,10,3,4,3,20,Fail
Kunal Chopra,21-05-2005,176986,Haryana,11,3,22,13,49,Fail
Krishna Fernandes,16-11-2004,341172,Bihar,8,22,19,24,73,Pass
Yash Fernandes,10-11-2004,914151,Maharashtra,10,6,4,21,41,Fail
John Chopra,23-03-2005,617067,Madhya Pradesh,4,24,7,21,56,Fail
Rohan D'Souza,08-01-2005,659646,Rajasthan,14,3,14,16,47,Pass
Aditya Khan,13-11-2004,168415,Haryana,1,6,18,20,45,Fail
Aryan Sharma,18-01-2006,874478,Punjab,5,23,8,19,55,Fail
Aarav Chopra,22-09-2005,332467,Uttar Pradesh,10,14,7,12,43,Fail
Manpreet Mehta,27-01-2005,123630,Bihar,8,7,3,18,36,Pass
Aryan Mehta,29-03-2005,608627,West Bengal,16,3,19,12,50,Fail
Raj Fernandes,23-01-2006,635174,Meghalaya,3,14,6,1,24,Pass
Peter D'Souza,11-10-2005,406626,Madhya Pradesh,12,12,6,20,50,Fail
Imran D'Souza,03-09-2005,919493,Gujarat,8,13,24,4,49,Fail
Aryan Singh,13-09-2005,713480,Assam,0,13,3,14,30,Fail
Aditya Sharma,15-11-2005,937953,Meghalaya,19,4,9,21,53,Fail
Krishna Chopra,23-09-2005,482842,Rajasthan,5,12,1,23,41,Pass
Krishna Verma,29-08-2005,736948,Bihar,12,23,8,24,67,Pass
Vivaan Singh,07-05-2005,293669,Madhya Pradesh,1,1,4,0,6,Fail
Aditya Verma,07-05-2005,717729,Kerala,21,18,0,15,54,Pass
Mathew Verma,17-02-2006,741018,Assam,1,11,16,7,35,Fail
Krishna Fernandes,01-01-2005,211967,Himachal Pradesh,4,9,10,20,43,Pass
John Verma,17-01-2005,588392,Jammu & Kashmir + Ladakh,23,21,13,22,79,Fail
Vivaan Reddy,25-06-2005,547489,Madhya Pradesh,1,10,11,17,39,Fail
Raj Chopra,01-03-2006,127987,Punjab,3,18,8,0,29,Pass
Aarav Pillai,18-11-2004,547404,Madhya Pradesh,4,1,3,7,15,Fail
Aarav Sharma,29-09-2005,141317,Chhattisgarh,7,20,15,13,55,Fail
Sukhwinder Fernandes,04-02-2005,267756,Chhattisgarh,1,12,24,4,41,Fail
Sukhwinder Singh,05-11-2005,457875,Assam,21,16,3,9,49,Fail
Balbir Chopra,12-04-2005,693337,Andhra Pradesh,12,9,7,16,44,Pass
Aditya Sharma,10-01-2006,110214,Madhya Pradesh,1,11,4,2,18,Fail
Aditya Pillai,07-09-2005,227314,West Bengal,0,21,1,4,26,Fail
Krishna Khan,29-11-2005,555925,Nagaland,24,5,0,17,46,Fail
Aryan D'Souza,31-12-2004,139874,Uttarakhand,4,12,15,15,46,Fail
Aditya Fernandes,01-06-2005,103038,Rajasthan,13,16,7,17,53,Pass
Krishna Khan,04-03-2006,946671,West Bengal,22,14,23,20,79,Fail
Yash Pillai,24-04-2006,473057,Chhattisgarh,14,18,14,16,62,Fail
Sukhwinder Chopra,09-12-2004,568184,Chhattisgarh,18,19,17,22,76,Fail
Yash Chopra,17-05-2005,464509,Madhya Pradesh,20,7,6,22,55,Fail
Krishna Singh,12-06-2005,328645,Uttar Pradesh,15,19,0,9,43,Fail
Raj Singh,11-07-2005,169656,Bihar,7,14,19,22,62,Pass
Aarav D'Souza,11-02-2005,811234,Bihar,5,13,23,1,42,Pass
Kunal Sharma,11-06-2005,354908,West Bengal,20,6,24,0,50,Fail
Vivaan Chopra,26-01-2005,895215,Rajasthan,8,15,16,2,41,Pass
Aditya Reddy,02-03-2006,636803,Madhya Pradesh,10,4,20,4,38,Fail
Manpreet Pillai,07-06-2005,261976,Telangana,7,21,23,9,60,Fail
Ishaan Chopra,28-04-2006,853281,Odisha,24,13,20,18,75,Fail
Aryan D'Souza,29-12-2004,865987,Madhya Pradesh,9,23,20,10,62,Fail
Aryan Khan,25-02-2006,280836,Maharashtra,17,24,24,5,70,Fail
Yash Chopra,23-01-2005,140694,Delhi,23,10,23,3,59,Fail
Raj D'Souza,04-04-2006,802875,Kerala,2,22,24,3,51,Pass
Aarav Verma,04-09-2005,284183,Bihar,4,20,3,21,48,Pass
Aryan Verma,22-04-2006,991802,Uttar Pradesh,24,24,14,7,69,Fail
Kunal Singh,04-06-2005,393942,Jharkhand,23,2,9,9,43,Pass
Balbir Verma,18-12-2005,789247,Andhra Pradesh,17,19,15,10,61,Pass
Yash Verma,08-05-2006,434729,Punjab,21,12,2,15,50,Fail
Yash Chopra,11-03-2006,815633,Madhya Pradesh,4,10,10,0,24,Fail
Krishna Mehta,08-09-2005,377396,Haryana,21,0,16,6,43,Fail
Rohan Sharma,22-05-2005,921444,Uttar Pradesh,23,15,13,6,57,Fail
Paul Fernandes,21-07-2005,612327,Chhattisgarh,12,15,24,24,75,Fail
Kunal Sharma,19-10-2005,583367,Odisha,24,4,8,1,37,Pass
Paul Chopra,10-11-2005,271429,Maharashtra,15,19,16,16,66,Fail
Vivaan Reddy,21-01-2006,484417,Odisha,4,10,15,5,34,Pass
Aarav Fernandes,28-11-2004,847845,Jammu & Kashmir + Ladakh,4,14,11,3,32,Pass
Manpreet Singh,15-10-2005,481521,Tamil Nadu,1,12,17,11,41,Pass
Paul Reddy,09-03-2006,695792,Madhya Pradesh,10,5,5,5,25,Fail
Kunal Sharma,01-12-2005,559723,Gujarat,23,15,14,9,61,Fail
Aryan Mehta,21-07-2005,665187,Bihar,12,7,22,23,64,Pass
Kunal Singh,12-08-2005,693600,Uttar Pradesh,0,8,16,10,34,Fail
Aryan Singh,05-10-2005,226625,Assam,3,21,10,13,47,Fail
Rohan Pillai,17-01-2006,531609,Andhra Pradesh,16,7,14,6,43,Pass
Raj Khan,09-12-2004,824201,Jharkhand,1,24,22,20,67,Pass
Farhan Fernandes,28-03-2006,418226,Maharashtra,24,22,18,13,77,Fail
Balbir Mehta,17-02-2006,321407,Rajasthan,2,10,9,19,40,Pass
Vivaan Sharma,22-05-2005,181518,Rajasthan,18,16,0,13,47,Pass
Ayaan Khan,17-07-2005,317997,Rajasthan,6,22,0,0,28,Pass
Ishaan Khan,31-01-2005,230483,Tamil Nadu,2,6,8,7,23,Pass
Aditya Verma,18-03-2005,364867,West Bengal,1,24,21,10,56,Fail
Krishna Singh,24-02-2006,174127,Andhra Pradesh,0,12,16,14,42,Pass
Aditya Reddy,28-05-2005,586880,Karnataka,10,15,8,21,54,Pass
Aarav Sharma,21-11-2004,165623,Karnataka,20,6,15,9,50,Pass
Ishaan D'Souza,26-04-2006,848389,Rajasthan,14,6,15,13,48,Pass
Gurpreet Pillai,02-08-2005,763693,Uttar Pradesh,1,3,15,1,20,Fail
Ishaan Reddy,07-04-2006,716901,Uttar Pradesh,16,8,7,0,31,Fail
Zaid Mehta,13-11-2004,797332,Rajasthan,7,16,14,9,46,Pass
Raj Verma,24-07-2005,122965,Haryana,3,22,10,18,53,Fail
Aryan Khan,13-03-2006,827170,Uttar Pradesh,5,5,6,13,29,Fail
Aryan Khan,05-01-2006,132093,Gujarat,11,4,1,10,26,Fail
Harjeet Verma,12-01-2006,385455,Madhya Pradesh,19,7,3,16,45,Fail
Aarav Sharma,28-04-2005,316861,Arunachal Pradesh,3,24,11,7,45,Fail
Rohan Reddy,13-05-2005,105593,Maharashtra,19,24,16,16,75,Fail
Aarav Singh,06-02-2005,538081,Uttar Pradesh,5,13,3,18,39,Fail
Raj Chopra,26-12-2005,288887,Maharashtra,1,0,21,17,39,Fail
Krishna D'Souza,04-08-2005,747858,Himachal Pradesh,21,23,0,18,62,Pass
Aryan Khan,09-09-2005,410991,Andhra Pradesh,1,5,24,14,44,Pass
Zaid D'Souza,30-03-2006,745664,Bihar,8,23,1,9,41,Pass
Aarav Pillai,07-12-2004,662819,Tamil Nadu,6,9,24,15,54,Fail
Vivaan Verma,24-12-2005,125294,Rajasthan,4,1,24,19,48,Pass
Mathew Pillai,01-02-2006,480780,Telangana,12,10,19,1,42,Fail
Aryan Verma,19-07-2005,762449,Maharashtra,23,8,24,11,66,Fail
Vivaan Chopra,02-03-2006,330107,Maharashtra,21,10,21,23,75,Fail
Kunal Sharma,11-01-2005,541781,Jharkhand,24,3,4,21,52,Pass
Ishaan Sharma,13-12-2004,576662,Punjab,14,14,8,24,60,Fail
Balbir Verma,05-04-2006,176235,Bihar,11,4,3,3,21,Pass
Aarav Singh,10-05-2005,343905,Delhi,0,17,0,18,35,Fail
Krishna Pillai,21-02-2005,998587,Maharashtra,7,7,20,18,52,Fail
Mathew Reddy,23-11-2005,491722,Rajasthan,4,22,13,17,56,Pass
Farhan Chopra,04-04-2005,817047,Punjab,21,18,8,9,56,Fail
Zaid D'Souza,06-12-2004,882838,Assam,3,20,13,18,54,Fail
Aditya Fernandes,02-12-2004,781576,Himachal Pradesh,1,18,8,0,27,Pass
Yash Fernandes,06-12-2004,825075,Tamil Nadu,14,5,12,2,33,Pass
Gurpreet Reddy,01-01-2005,545051,Madhya Pradesh,6,14,16,5,41,Fail
Aditya Sharma,28-12-2005,723250,Rajasthan,24,12,3,10,49,Pass
Mathew Pillai,01-11-2005,283014,Odisha,4,13,2,9,28,Pass
Vivaan Chopra,27-10-2005,745010,Rajasthan,24,18,18,12,72,Fail
Aryan Chopra,09-06-2005,445546,Rajasthan,17,17,1,24,59,Pass
Sukhwinder Chopra,17-03-2006,969441,Punjab,13,18,19,3,53,Fail
Farhan D'Souza,05-03-2006,880732,Rajasthan,16,5,14,9,44,Pass
Kunal Singh,09-05-2005,890764,Madhya Pradesh,11,7,23,4,45,Fail
Vivaan D'Souza,22-11-2005,139865,Uttar Pradesh,9,9,19,17,54,Fail
Balbir D'Souza,29-08-2005,642827,Bihar,22,23,0,11,56,Pass
Raj Fernandes,13-02-2005,946696,Uttar Pradesh,0,12,14,20,46,Fail
Rohan D'Souza,18-08-2005,850229,Uttar Pradesh,24,8,9,15,56,Fail
Manpreet Sharma,09-03-2006,578793,Tripura,1,5,19,8,33,Fail
Vivaan Sharma,01-01-2005,543530,Jammu & Kashmir + Ladakh,16,5,3,8,32,Pass
Aryan Mehta,02-03-2006,177825,Jammu & Kashmir + Ladakh,8,8,19,9,44,Pass
Raj Khan,25-11-2004,955069,Uttar Pradesh,23,9,0,15,47,Fail
Aryan Sharma,18-11-2005,411253,Tripura,0,11,2,0,13,Fail
Ishaan Fernandes,15-10-2005,587011,Punjab,20,3,14,10,47,Fail
Aryan Sharma,11-04-2006,876646,Madhya Pradesh,17,22,11,5,55,Fail
Gurpreet Pillai,24-10-2005,236173,Rajasthan,17,13,17,3,50,Pass
Raj D'Souza,13-06-2005,945508,Rajasthan,15,8,20,10,53,Pass
Krishna D'Souza,05-01-2005,346041,Haryana,19,21,24,23,87,Fail
Ayaan Sharma,25-11-2004,315517,Bihar,19,3,23,12,57,Pass
Paul Mehta,05-12-2005,197333,Uttarakhand,11,13,2,14,40,Fail
Ishaan Reddy,18-07-2005,895619,Bihar,8,5,2,10,25,Pass
Aryan Verma,22-03-2005,367830,Maharashtra,11,21,18,14,64,Fail
Rohan Fernandes,25-03-2005,687284,Jammu & Kashmir + Ladakh,24,3,11,24,62,Pass
Rohan Reddy,23-03-2005,448947,Odisha,0,7,19,15,41,Pass
Aryan Singh,24-12-2004,181075,Odisha,8,10,14,14,46,Fail
Raj Pillai,08-01-2006,335000,Bihar,2,15,16,23,56,Pass
Aryan Sharma,03-02-2006,344967,Andhra Pradesh,22,1,20,7,50,Pass
Aarav Singh,17-06-2005,540532,Madhya Pradesh,3,9,23,19,54,Fail
Rehan Chopra,21-08-2005,616330,Himachal Pradesh,3,18,16,0,37,Pass
Rohan Verma,26-11-2005,197473,Andhra Pradesh,22,9,2,24,57,Pass
Aarav Fernandes,08-12-2005,941871,West Bengal,5,24,3,12,44,Fail
Rohan Fernandes,21-03-2006,400962,West Bengal,19,18,12,0,49,Fail
Rehan Pillai,27-07-2005,311874,Bihar,17,7,3,11,38,Pass
Aryan Fernandes,15-12-2004,667986,Himachal Pradesh,12,1,1,10,24,Pass
Mathew Singh,05-01-2006,939675,Uttar Pradesh,12,7,7,6,32,Fail
Krishna Sharma,03-10-2005,732592,Meghalaya,3,22,3,8,36,Pass
Sukhwinder Fernandes,31-12-2005,609137,Assam,19,6,2,13,40,Fail
Aarav Khan,06-01-2006,712698,Himachal Pradesh,14,21,17,6,58,Fail
Aditya Chopra,28-06-2005,466015,Gujarat,14,22,1,11,48,Fail
Yash Mehta,28-12-2004,278273,Punjab,15,0,20,10,45,Fail
Rehan Reddy,10-03-2005,323081,Bihar,12,21,19,11,63,Pass
Rohan Pillai,15-04-2006,287660,Maharashtra,1,13,13,6,33,Fail
Manpreet Pillai,24-02-2005,300176,Odisha,15,21,5,23,64,Fail
Vivaan D'Souza,26-11-2005,305162,Rajasthan,0,14,22,11,47,Pass
Aditya Chopra,25-03-2005,407656,Bihar,14,11,6,9,40,Pass
Vivaan Verma,13-01-2006,420785,Arunachal Pradesh,17,8,15,23,63,Fail
Farhan Sharma,13-05-2005,467560,West Bengal,23,0,19,10,52,Fail
Aryan D'Souza,10-08-2005,580269,Uttar Pradesh,6,7,15,8,36,Fail
Aditya Chopra,17-02-2005,125254,Jharkhand,15,3,15,22,55,Pass
Aarav Singh,29-03-2006,378944,Delhi,1,23,21,18,63,Fail
Ishaan Fernandes,15-03-2006,422566,Bihar,8,14,19,23,64,Pass
Aditya Sharma,14-04-2005,944590,Uttar Pradesh,4,13,22,18,57,Fail
Aryan Verma,09-07-2005,705200,Maharashtra,17,16,14,12,59,Fail
Ishaan Singh,19-09-2005,169945,Rajasthan,16,13,16,10,55,Pass
Rohan Khan,04-02-2005,530118,Bihar,7,2,19,17,45,Pass
Aditya Sharma,10-03-2005,100535,Bihar,8,14,2,14,38,Pass
Ishaan Mehta,24-03-2005,642157,Karnataka,15,14,0,5,34,Pass
David Verma,18-12-2004,894007,Uttar Pradesh,7,14,4,15,40,Fail
Krishna Singh,15-03-2005,755740,West Bengal,24,20,0,5,49,Fail
John Verma,14-06-2005,604477,Uttar Pradesh,16,11,13,21,61,Fail
Balbir Chopra,02-04-2005,363652,Rajasthan,10,11,15,11,47,Pass
Manpreet Pillai,06-03-2006,553677,Karnataka,0,20,1,1,22,Pass
Aarav Chopra,11-06-2005,487123,Maharashtra,22,0,13,6,41,Fail
Kunal Chopra,19-01-2005,632036,Madhya Pradesh,21,22,5,16,64,Fail
Ishaan Mehta,28-02-2005,656924,Maharashtra,5,19,22,23,69,Fail
Ishaan Chopra,08-12-2005,983744,Telangana,3,0,10,14,27,Fail
Ishaan Fernandes,25-03-2005,324481,Jammu & Kashmir + Ladakh,14,7,22,21,64,Pass
Rohan Verma,15-12-2004,265274,Haryana,5,13,11,19,48,Fail
Aditya Pillai,17-04-2006,785193,Haryana,1,4,4,7,16,Fail
Vivaan Khan,02-05-2005,832032,Karnataka,20,18,6,1,45,Pass
Aarav Mehta,19-03-2006,138529,Telangana,17,16,14,20,67,Fail
Ishaan D'Souza,06-09-2005,316170,Uttar Pradesh,4,7,8,14,33,Fail
Aarav Khan,05-10-2005,499321,Bihar,15,2,3,4,24,Pass
Yash Pillai,07-10-2005,224244,Haryana,20,0,11,22,53,Fail
Gurpreet Verma,01-02-2005,343283,Maharashtra,6,14,13,4,37,Fail
Rohan Pillai,13-12-2004,667299,West Bengal,11,12,16,1,40,Fail
Harjeet Chopra,22-11-2004,791550,Maharashtra,1,20,3,2,26,Fail
Raj Pillai,22-06-2005,755965,Uttar Pradesh,13,24,17,5,59,Fail
Raj Reddy,12-02-2005,916923,Punjab,7,22,15,7,51,Fail
Manpreet Mehta,09-12-2004,972301,Madhya Pradesh,22,7,13,14,56,Fail
David D'Souza,13-02-2005,113488,Bihar,21,15,14,17,67,Pass
Kunal D'Souza,06-06-2005,735299,Haryana,4,11,18,3,36,Fail
Ishaan Khan,09-05-2005,915389,West Bengal,22,23,1,23,69,Fail
Yash Khan,13-05-2005,412764,Andhra Pradesh,13,1,10,9,33,Pass
Rohan Singh,01-11-2005,576871,Tamil Nadu,14,4,5,8,31,Pass
Vivaan Verma,23-02-2006,720720,Rajasthan,4,8,8,0,20,Pass
Aarav Reddy,19-12-2004,688195,Karnataka,9,13,4,8,34,Pass
Rohan D'Souza,28-02-2006,953236,Madhya Pradesh,12,4,22,15,53,Fail
Balbir D'Souza,02-08-2005,837807,Madhya Pradesh,3,1,4,1,9,Fail
Aarav Pillai,30-10-2005,262876,Uttar Pradesh,14,5,5,0,24,Fail
Vivaan Chopra,04-05-2005,458355,Uttar Pradesh,13,18,15,5,51,Fail
Gurpreet Verma,13-11-2004,263018,Haryana,8,23,3,20,54,Fail
David Khan,15-03-2006,825419,Gujarat,11,4,1,8,24,Fail
Rohan Sharma,04-10-2005,654623,Madhya Pradesh,13,12,16,17,58,Fail
Harjeet Pillai,26-08-2005,882958,Telangana,12,14,5,13,44,Fail
Paul Chopra,29-11-2005,578401,Madhya Pradesh,12,13,19,20,64,Fail
Yash Mehta,10-06-2005,217555,Haryana,12,0,14,24,50,Fail
Sukhwinder Chopra,14-08-2005,882325,Odisha,15,22,22,14,73,Fail
Aryan Fernandes,09-11-2005,960160,Rajasthan,10,23,17,6,56,Pass
Vivaan Singh,12-05-2005,581097,Gujarat,18,24,10,17,69,Fail
Harjeet Sharma,17-02-2006,407929,Uttar Pradesh,1,2,2,17,22,Fail
Manpreet Singh,25-12-2005,399155,Rajasthan,19,3,13,12,47,Pass
Peter Singh,29-05-2005,707614,Uttar Pradesh,16,13,2,20,51,Fail
Vivaan Fernandes,25-05-2005,915119,Bihar,8,17,12,13,50,Pass
David Reddy,30-03-2006,678862,Telangana,3,12,14,22,51,Fail
Ishaan D'Souza,23-06-2005,959590,Maharashtra,9,14,5,3,31,Fail
Aryan Khan,26-11-2005,131128,Rajasthan,0,13,14,19,46,Pass
Raj Mehta,31-03-2006,573677,Odisha,4,21,14,2,41,Pass
Raj Pillai,12-04-2005,612785,Bihar,12,16,8,10,46,Pass
Krishna Khan,26-10-2005,233683,Kerala,24,5,4,5,38,Pass
Ayaan Reddy,12-03-2006,258549,Kerala,7,6,16,12,41,Pass
Sukhwinder Khan,27-06-2005,122415,Punjab,12,19,19,10,60,Fail
Raj Mehta,18-11-2005,619753,Andhra Pradesh,21,16,20,4,61,Pass
Aryan Chopra,02-02-2005,346746,Uttar Pradesh,7,15,22,10,54,Fail
Rohan Mehta,14-04-2005,717843,Telangana,6,24,22,3,55,Fail
Paul Reddy,19-09-2005,381950,West Bengal,15,9,22,21,67,Fail
Rohan Mehta,14-07-2005,568109,West Bengal,2,12,7,13,34,Fail
Aditya Pillai,29-08-2005,990804,Rajasthan,24,23,20,21,88,Pass
Kunal Mehta,28-01-2006,491192,Bihar,15,20,19,2,56,Pass
Yash Verma,07-05-2006,763749,Puducherry,15,0,10,19,44,Pass
Krishna Verma,01-10-2005,930151,Madhya Pradesh,5,17,21,13,56,Fail
Aryan Pillai,10-02-2005,764578,Uttar Pradesh,16,18,2,14,50,Fail
Ishaan D'Souza,28-01-2005,268764,Telangana,16,20,19,16,71,Fail
Krishna D'Souza,02-05-2006,547127,Maharashtra,20,19,13,8,60,Fail
Raj Verma,13-02-2005,955751,Uttar Pradesh,14,12,3,24,53,Fail
John Sharma,27-11-2005,587454,Jharkhand,2,13,18,12,45,Pass
Rohan D'Souza,11-03-2006,655839,Rajasthan,20,20,22,8,70,Fail
Balbir Mehta,03-02-2006,713274,Uttar Pradesh,6,9,8,20,43,Fail
Krishna Reddy,28-12-2005,923586,Punjab,7,0,4,1,12,Pass
Kunal Khan,02-10-2005,909678,West Bengal,8,17,12,18,55,Fail
Aarav Pillai,24-04-2005,579154,Madhya Pradesh,15,2,0,15,32,Fail
Kunal Verma,08-11-2004,806755,Jammu & Kashmir + Ladakh,23,19,2,9,53,Pass
Aditya Singh,22-12-2005,375331,Punjab,17,8,1,1,27,Pass
Vivaan Singh,05-01-2006,658329,Uttar Pradesh,5,13,17,13,48,Fail
Aryan D'Souza,06-07-2005,606782,Haryana,20,9,24,6,59,Fail
Ishaan Verma,01-12-2004,953599,Punjab,18,19,12,10,59,Fail
Harjeet Pillai,03-04-2006,998148,Karnataka,23,21,5,14,63,Pass
Aarav Fernandes,25-03-2006,360100,Maharashtra,10,1,9,7,27,Fail
Rohan Pillai,23-11-2005,404566,Madhya Pradesh,21,3,12,24,60,Fail
Ishaan Reddy,11-10-2005,397807,Tripura,15,4,10,13,42,Fail
Rehan Singh,26-10-2005,398175,Uttar Pradesh,22,11,18,3,54,Fail
Peter Singh,18-06-2005,561474,Arunachal Pradesh,1,18,2,21,42,Fail
Raj Verma,16-08-2005,799922,Andhra Pradesh,21,2,10,10,43,Pass
Yash D'Souza,03-08-2005,508318,Uttar Pradesh,23,14,11,16,64,Fail
Vivaan Pillai,03-05-2005,297435,Bihar,4,23,0,16,43,Pass
Ishaan Sharma,16-04-2005,544951,Maharashtra,4,19,23,6,52,Fail
Ayaan Sharma,21-04-2005,908290,Uttar Pradesh,16,5,1,18,40,Fail
Vivaan Mehta,07-04-2006,513622,Arunachal Pradesh,15,9,9,24,57,Fail
Rohan Khan,29-01-2006,824213,Assam,10,5,17,4,36,Fail
Sukhwinder Sharma,09-09-2005,349197,Kerala,17,24,3,18,62,Pass
Sukhwinder Mehta,20-01-2005,125368,Gujarat,2,0,6,10,18,Fail
Rohan Verma,02-01-2005,351472,Odisha,14,5,23,19,61,Fail
Vivaan Khan,08-05-2006,908958,Uttar Pradesh,18,15,22,8,63,Fail
Vivaan Reddy,19-11-2005,219712,Jammu & Kashmir + Ladakh,11,7,0,5,23,Pass
Harjeet Mehta,30-05-2005,811556,Bihar,7,11,8,4,30,Pass
Krishna D'Souza,16-03-2006,232244,Rajasthan,9,0,5,21,35,Pass
Rohan Pillai,03-04-2005,325737,Rajasthan,17,8,8,0,33,Pass
Aditya Fernandes,08-02-2006,925038,Tamil Nadu,20,4,2,22,48,Fail
Raj Reddy,27-02-2005,109558,Haryana,14,11,24,5,54,Fail
Sukhwinder Pillai,28-04-2006,441124,Punjab,4,10,14,14,42,Pass
Sukhwinder Chopra,22-01-2005,366400,Gujarat,17,6,19,9,51,Fail
Gurpreet Chopra,30-03-2005,438089,Kerala,0,10,4,11,25,Pass
Rohan Reddy,13-03-2005,343820,Chhattisgarh,6,5,5,11,27,Fail
Raj Khan,26-07-2005,826693,Rajasthan,11,12,2,14,39,Pass
Balbir Singh,11-05-2005,787184,Maharashtra,12,4,18,5,39,Fail
Vivaan Sharma,24-07-2005,221400,Uttar Pradesh,16,14,18,0,48,Fail
David Sharma,26-12-2005,870300,Assam,23,17,3,17,60,Fail
Harjeet Verma,03-01-2006,104264,Rajasthan,11,24,2,0,37,Pass
Balbir Khan,22-03-2006,473891,Uttar Pradesh,10,19,0,13,42,Fail
Aarav Sharma,29-01-2005,404657,Maharashtra,11,16,20,22,69,Fail
Rohan Sharma,11-11-2004,219176,Karnataka,4,12,21,0,37,Pass
Aditya Mehta,28-01-2006,890090,Uttar Pradesh,15,21,10,20,66,Fail
Paul Pillai,18-03-2005,888234,Chhattisgarh,1,22,24,3,50,Fail
Gurpreet Fernandes,28-09-2005,644677,Rajasthan,0,18,18,16,52,Pass
Zaid Reddy,11-10-2005,542661,Tamil Nadu,20,16,21,0,57,Pass
Aryan Pillai,12-05-2005,669600,Punjab,5,18,18,17,58,Fail
Raj Verma,05-02-2006,506298,Gujarat,3,9,5,9,26,Fail
Aarav Fernandes,24-01-2005,160201,West Bengal,20,5,14,20,59,Fail
Rehan Khan,12-03-2005,233617,West Bengal,21,11,13,19,64,Fail
Aryan Reddy,07-09-2005,129447,Punjab,15,16,3,3,37,Pass
Yash Mehta,28-04-2006,177709,Uttarakhand,18,18,15,7,58,Fail
Sukhwinder Reddy,01-07-2005,418551,West Bengal,17,13,20,5,55,Fail
Aarav Chopra,26-10-2005,982752,Tamil Nadu,14,12,17,11,54,Fail
Manpreet D'Souza,13-10-2005,412626,Gujarat,18,19,17,24,78,Fail
Ishaan Chopra,16-12-2005,936565,Rajasthan,13,10,10,21,54,Pass
Peter Sharma,04-05-2005,788873,Gujarat,18,11,23,10,62,Fail
Aryan Fernandes,18-03-2005,489944,Bihar,0,2,16,22,40,Pass
Aryan Reddy,11-11-2005,412210,Tripura,13,13,15,24,65,Fail
Paul Chopra,04-12-2004,361673,Tamil Nadu,8,6,9,4,27,Pass
Ayaan Singh,18-06-2005,542148,Uttar Pradesh,11,6,12,18,47,Fail
Vivaan Mehta,29-01-2005,193057,Tamil Nadu,19,0,8,2,29,Pass
Krishna Chopra,04-10-2005,691959,Madhya Pradesh,9,4,22,12,47,Fail
Aryan D'Souza,09-04-2006,976702,Andhra Pradesh,19,14,8,24,65,Pass
Aditya Singh,04-07-2005,590865,Karnataka,6,15,0,3,24,Pass
Balbir Fernandes,22-02-2005,490124,Uttar Pradesh,21,17,10,22,70,Fail
Yash Mehta,30-11-2005,428809,Maharashtra,1,2,1,11,15,Fail
Aryan Reddy,27-06-2005,172766,Tamil Nadu,10,1,0,0,11,Pass
Peter Verma,20-01-2006,349608,West Bengal,15,3,6,8,32,Fail
Yash Chopra,28-04-2006,333458,Uttar Pradesh,18,8,22,3,51,Fail
Aryan D'Souza,29-06-2005,234121,Uttarakhand,16,10,8,21,55,Fail
Krishna Reddy,13-12-2005,886075,Karnataka,2,10,9,18,39,Pass
Aditya Khan,24-03-2005,991410,Chhattisgarh,9,21,17,1,48,Fail
Kunal Reddy,05-03-2006,732956,Rajasthan,12,21,16,15,64,Fail
Rehan Singh,30-01-2005,454077,Chhattisgarh,15,6,3,0,24,Fail
Sukhwinder Verma,01-07-2005,623945,Rajasthan,12,13,21,10,56,Pass
John Pillai,21-08-2005,492422,Maharashtra,15,19,24,6,64,Fail
Manpreet Chopra,02-02-2006,758509,Bihar,2,12,15,15,44,Pass
Aryan Singh,24-06-2005,478898,Bihar,23,9,14,23,69,Pass
Raj Fernandes,08-01-2005,950412,Tamil Nadu,21,6,16,7,50,Fail
Harjeet Mehta,15-02-2005,518677,Maharashtra,19,23,2,10,54,Fail
Balbir Verma,08-12-2004,774774,Rajasthan,22,24,23,8,77,Pass
Aarav Reddy,30-01-2005,687886,West Bengal,15,16,12,23,66,Fail
Aryan Mehta,12-05-2005,668442,Kerala,17,21,18,12,68,Fail
Sukhwinder Fernandes,14-03-2006,204876,Madhya Pradesh,19,13,5,8,45,Fail
John Fernandes,12-06-2005,941250,Punjab,3,24,17,8,52,Fail
Rohan Sharma,02-03-2006,586768,Kerala,19,22,23,0,64,Pass
Vivaan Chopra,10-11-2004,275182,Haryana,8,1,14,6,29,Fail
Aarav Khan,13-01-2005,688703,Assam,8,2,15,15,40,Fail
Ishaan Reddy,16-06-2005,227415,Tripura,8,24,8,5,45,Fail
Yash D'Souza,12-08-2005,362559,Madhya Pradesh,6,13,10,11,40,Fail
Farhan Sharma,11-10-2005,508367,Madhya Pradesh,22,6,16,7,51,Fail
Raj Pillai,23-04-2006,311092,Andhra Pradesh,21,3,16,24,64,Pass
Yash Reddy,18-07-2005,518437,Rajasthan,6,13,12,14,45,Pass
Paul Mehta,25-03-2006,681612,Gujarat,20,23,14,7,64,Fail
John Sharma,13-04-2006,781566,Karnataka,15,1,5,12,33,Pass
Balbir D'Souza,03-08-2005,269748,Assam,8,15,2,11,36,Fail
Zaid Mehta,22-02-2006,411236,Chhattisgarh,23,13,21,3,60,Fail
Yash Reddy,02-01-2005,775918,Bihar,3,18,19,2,42,Pass
Aarav Singh,02-02-2005,885049,Uttar Pradesh,21,7,3,14,45,Fail
Aarav Khan,26-11-2005,475658,West Bengal,24,9,11,11,55,Fail
Balbir Khan,31-07-2005,888887,Maharashtra,6,7,5,8,26,Fail
David Reddy,20-03-2006,155313,Andhra Pradesh,9,3,17,8,37,Pass
Mathew Pillai,30-06-2005,430749,Bihar,15,13,21,21,70,Pass
Aarav Pillai,03-12-2004,883195,Assam,2,15,7,12,36,Fail
Aditya Singh,15-11-2004,531664,West Bengal,15,12,15,9,51,Fail
Harjeet Pillai,22-05-2005,873035,Uttar Pradesh,16,19,5,22,62,Fail
Aryan Chopra,09-01-2005,648125,Bihar,1,9,15,19,44,Pass
Raj Sharma,18-04-2005,472169,West Bengal,12,17,3,4,36,Fail
Krishna Fernandes,29-10-2005,201755,Uttarakhand,23,6,1,20,50,Fail
Kunal Chopra,19-04-2005,104007,Assam,19,18,15,10,62,Fail
Sukhwinder Khan,04-01-2006,168436,Tamil Nadu,10,11,15,12,48,Fail
Ishaan Fernandes,02-12-2004,756664,Rajasthan,24,7,8,16,55,Pass
Kunal Verma,02-02-2005,258629,Andhra Pradesh,5,18,18,18,59,Pass
Aditya Sharma,04-05-2005,361318,Karnataka,7,22,21,13,63,Pass
Mathew Singh,13-04-2006,322342,Gujarat,21,24,18,5,68,Fail
Krishna Mehta,11-06-2005,943516,Himachal Pradesh,1,0,21,11,33,Pass
Harjeet Sharma,01-09-2005,652954,Andhra Pradesh,2,24,12,23,61,Pass
Aditya Verma,05-03-2006,120837,Madhya Pradesh,10,6,14,23,53,Fail
Gurpreet Pillai,06-06-2005,246304,Tamil Nadu,15,0,21,9,45,Fail
Krishna Khan,11-04-2005,915957,Bihar,12,1,9,21,43,Pass
John Sharma,06-08-2005,209103,Punjab,8,12,23,4,47,Fail
Manpreet Fernandes,01-12-2004,667087,Bihar,18,18,19,8,63,Pass
Raj Mehta,01-07-2005,534690,Uttar Pradesh,17,13,18,21,69,Fail
Vivaan Verma,20-06-2005,336581,Bihar,24,14,18,13,69,Pass
Aryan Reddy,12-03-2006,467838,Punjab,16,13,13,1,43,Pass
Aryan Mehta,27-06-2005,501441,Andhra Pradesh,21,20,6,1,48,Pass
Vivaan Verma,11-01-2005,399555,Bihar,9,5,11,2,27,Pass
David Khan,12-03-2006,278665,Bihar,22,12,14,4,52,Pass
Sukhwinder Mehta,01-09-2005,179172,Uttar Pradesh,19,2,10,15,46,Fail
Rehan Chopra,01-04-2005,308797,Gujarat,22,10,14,13,59,Fail
Balbir Sharma,26-11-2004,776642,Madhya Pradesh,17,15,4,17,53,Fail
Harjeet Mehta,31-12-2004,862360,Bihar,7,5,24,2,38,Pass
John Fernandes,30-12-2004,131216,Bihar,6,10,24,9,49,Pass
Aryan Reddy,27-04-2006,418178,Uttar Pradesh,15,15,19,0,49,Fail
Manpreet Chopra,25-08-2005,639947,Maharashtra,10,12,22,8,52,Fail
Ishaan Fernandes,04-02-2006,153881,Rajasthan,5,3,6,22,36,Pass
Farhan D'Souza,29-03-2006,810123,Gujarat,7,2,17,5,31,Fail
Farhan Mehta,08-12-2005,578181,Uttar Pradesh,9,19,21,4,53,Fail
Krishna Pillai,18-04-2005,357032,Uttarakhand,17,9,0,12,38,Fail
Ishaan Singh,16-04-2005,472972,Rajasthan,0,6,14,15,35,Pass
Ishaan Fernandes,13-03-2005,739270,Telangana,6,20,23,0,49,Fail
Kunal D'Souza,30-04-2005,792105,Bihar,9,1,23,2,35,Pass
Ishaan Khan,25-03-2006,867978,Uttarakhand,14,5,22,7,48,Fail
Aarav Verma,07-01-2005,252446,Kerala,1,9,18,16,44,Pass
David Mehta,26-03-2005,277039,Bihar,0,0,10,23,33,Pass
Raj Fernandes,26-04-2006,462984,Telangana,23,13,12,10,58,Fail
Farhan Mehta,17-05-2005,805923,Tamil Nadu,3,0,21,16,40,Pass
Aarav Fernandes,30-10-2005,769927,Andhra Pradesh,24,20,23,6,73,Pass
Kunal D'Souza,14-03-2005,882801,Bihar,3,7,3,20,33,Pass
Yash Singh,07-07-2005,399956,Odisha,1,14,7,12,34,Pass
Aditya Verma,02-11-2005,863765,Telangana,3,18,0,1,22,Fail
Rohan Reddy,03-01-2006,264484,Bihar,11,17,19,7,54,Pass
Vivaan Mehta,12-02-2006,836402,Jammu & Kashmir + Ladakh,8,21,12,8,49,Pass
Yash Khan,18-10-2005,181743,Punjab,23,21,7,14,65,Fail
Yash Verma,15-11-2005,593021,Uttar Pradesh,24,1,23,6,54,Fail
Aarav Sharma,22-04-2006,500916,Telangana,13,4,4,24,45,Fail
Krishna Khan,27-02-2006,232335,Uttarakhand,19,9,11,3,42,Fail
Aryan Mehta,03-10-2005,915273,Jharkhand,10,23,6,23,62,Pass
Aditya Singh,05-02-2006,561210,Telangana,9,24,5,9,47,Fail
Raj Mehta,11-11-2005,650357,Uttarakhand,7,15,14,23,59,Fail
Vivaan D'Souza,26-04-2006,878002,Tamil Nadu,15,7,19,21,62,Pass
Kunal Pillai,14-05-2005,533860,Madhya Pradesh,14,15,20,8,57,Fail
Vivaan Singh,02-03-2006,821129,Bihar,3,6,16,6,31,Pass
Kunal D'Souza,16-03-2005,164733,Kerala,13,20,24,14,71,Pass
Manpreet Fernandes,12-04-2006,375110,Karnataka,23,5,11,16,55,Pass
Rohan Sharma,10-03-2005,442632,Haryana,9,18,23,12,62,Fail
Mathew Reddy,04-03-2005,390063,Bihar,2,5,8,12,27,Pass
Raj Pillai,05-01-2005,771581,Madhya Pradesh,22,11,24,22,79,Fail
Harjeet Singh,28-05-2005,835232,Assam,20,3,15,5,43,Fail
Gurpreet Mehta,18-11-2005,500517,Jharkhand,7,12,17,17,53,Pass
Rohan Khan,10-12-2005,599704,Punjab,16,22,24,17,79,Pass
Vivaan D'Souza,06-01-2005,926632,Haryana,24,21,18,23,86,Fail
Aarav Pillai,11-07-2005,597820,Tamil Nadu,3,19,5,5,32,Pass
Aditya Pillai,16-05-2005,215831,Haryana,16,21,23,0,60,Fail
Sukhwinder Pillai,02-07-2005,618987,Rajasthan,7,9,13,7,36,Pass
Raj Mehta,16-04-2006,394102,West Bengal,22,15,22,17,76,Fail
Peter D'Souza,21-01-2005,426783,Delhi,24,8,1,20,53,Fail
Vivaan Chopra,23-05-2005,457771,Bihar,10,0,13,9,32,Pass
Manpreet Chopra,21-12-2004,941166,Rajasthan,7,16,17,23,63,Fail
Paul Chopra,30-04-2006,445054,Maharashtra,19,14,9,14,56,Fail
Aditya Singh,19-11-2005,577542,Andhra Pradesh,5,18,4,0,27,Pass
Vivaan Khan,14-06-2005,485228,Uttar Pradesh,4,5,3,8,20,Fail
Vivaan D'Souza,28-11-2004,542308,Haryana,15,2,22,4,43,Fail
Krishna Pillai,31-03-2006,481231,Jharkhand,11,16,3,16,46,Pass
Sukhwinder Khan,23-02-2006,365722,Andhra Pradesh,10,6,22,22,60,Pass
Vivaan Chopra,03-01-2005,105485,Rajasthan,5,0,24,7,36,Pass
Yash Singh,23-01-2006,997861,Karnataka,23,11,1,7,42,Pass
Rohan Chopra,05-08-2005,877782,Punjab,5,1,19,2,27,Pass
Raj D'Souza,20-04-2006,214120,Jharkhand,8,12,7,22,49,Pass
Krishna Mehta,29-04-2006,394963,Karnataka,22,4,19,8,53,Pass
John Pillai,18-07-2005,943125,Uttar Pradesh,14,17,14,12,57,Fail
Kunal Singh,11-02-2005,997628,Chhattisgarh,13,20,12,1,46,Fail
Aditya Singh,22-04-2006,254179,Karnataka,6,13,5,17,41,Pass
Ishaan Singh,15-02-2005,586397,Telangana,0,22,0,14,36,Fail
Ayaan Mehta,11-11-2005,668530,Rajasthan,4,22,20,13,59,Pass
Aryan Pillai,23-08-2005,635317,Uttar Pradesh,18,4,18,2,42,Fail
Yash Khan,27-01-2005,685200,Madhya Pradesh,10,23,23,7,63,Fail
Gurpreet Singh,05-04-2005,490961,Odisha,21,15,2,11,49,Fail
Aryan Pillai,14-02-2006,237483,Chhattisgarh,2,23,5,5,35,Fail
Krishna Verma,29-10-2005,404116,Punjab,22,19,16,16,73,Fail
Kunal Verma,07-03-2006,472497,Gujarat,21,20,11,7,59,Fail
Raj Khan,07-01-2006,816197,Haryana,9,3,14,1,27,Fail
Aarav Chopra,01-06-2005,338857,Uttarakhand,17,15,6,9,47,Fail
Rohan Sharma,06-11-2005,223661,Puducherry,9,17,0,13,39,Pass
Balbir Chopra,30-05-2005,873799,Uttar Pradesh,13,9,19,4,45,Fail
Vivaan Singh,18-12-2005,456786,Madhya Pradesh,11,13,24,24,72,Fail
Krishna Verma,09-01-2006,971676,Odisha,7,8,14,11,40,Pass
Kunal Reddy,05-08-2005,436670,Kerala,1,18,18,18,55,Pass
Manpreet Fernandes,08-10-2005,698793,Rajasthan,9,9,24,1,43,Pass
Imran Khan,30-11-2005,701785,Maharashtra,19,21,24,14,78,Fail
Krishna Verma,11-11-2004,566743,Andhra Pradesh,19,14,14,8,55,Pass
Mathew Verma,29-12-2005,157519,Bihar,8,12,16,17,53,Pass
Harjeet Pillai,09-03-2006,152508,Tamil Nadu,16,5,7,8,36,Pass
Gurpreet Singh,23-03-2005,394727,Andhra Pradesh,23,23,13,7,66,Pass
Aarav Sharma,14-04-2005,298085,Bihar,24,17,17,1,59,Pass
Peter Sharma,31-01-2005,563844,Punjab,17,15,20,17,69,Fail
Ishaan Chopra,28-06-2005,652306,Madhya Pradesh,9,20,24,17,70,Fail
Harjeet Verma,13-04-2006,150123,Rajasthan,11,18,0,24,53,Pass
Krishna Singh,07-03-2005,534192,Bihar,23,8,5,11,47,Pass
Gurpreet Chopra,22-08-2005,586813,Andhra Pradesh,0,9,19,7,35,Pass
Yash Mehta,11-04-2005,422434,Madhya Pradesh,24,10,15,4,53,Fail
Vivaan D'Souza,07-04-2005,371024,Jharkhand,2,21,4,15,42,Pass
Aryan Khan,22-03-2005,508282,Uttar Pradesh,15,6,23,2,46,Fail
Aarav Chopra,03-04-2006,748026,Madhya Pradesh,14,22,17,20,73,Fail
Yash Pillai,01-07-2005,595490,West Bengal,12,8,0,9,29,Fail
Farhan Mehta,13-04-2005,770219,Uttar Pradesh,7,22,8,1,38,Fail
Yash Chopra,05-04-2005,755673,Madhya Pradesh,8,13,21,2,44,Fail
Kunal Mehta,21-10-2005,347207,Andhra Pradesh,4,1,23,18,46,Pass
Manpreet Fernandes,15-12-2005,898461,Rajasthan,11,15,14,20,60,Fail
Krishna Reddy,11-01-2005,566496,Rajasthan,15,7,11,5,38,Pass
Aarav Reddy,10-09-2005,102154,Arunachal Pradesh,8,9,23,3,43,Fail
John Sharma,09-02-2006,946391,Odisha,7,10,12,9,38,Pass
John Pillai,24-02-2006,174573,Maharashtra,6,15,18,10,49,Fail
Ayaan Khan,21-11-2005,532840,Uttar Pradesh,16,6,22,5,49,Fail
Yash Chopra,27-01-2005,754291,Rajasthan,3,7,3,17,30,Pass
Rohan Reddy,28-11-2004,746212,Uttar Pradesh,6,4,20,16,46,Fail
Balbir Sharma,13-11-2004,612465,Gujarat,3,0,8,20,31,Fail
Aditya D'Souza,27-11-2004,295591,Rajasthan,14,7,2,0,23,Pass
Rehan D'Souza,15-03-2006,680340,Delhi,6,21,19,22,68,Fail
Krishna Sharma,25-10-2005,571554,Assam,20,18,12,23,73,Fail
Rehan Mehta,18-09-2005,716500,Uttar Pradesh,23,21,23,16,83,Fail
Aryan Pillai,10-04-2005,372595,Maharashtra,18,9,6,2,35,Fail
Imran Reddy,22-12-2005,914223,Uttar Pradesh,11,4,24,20,59,Fail
Aryan Reddy,15-11-2005,634004,Rajasthan,7,10,7,0,24,Pass
Kunal Pillai,25-01-2005,579582,Uttar Pradesh,21,8,11,11,51,Fail
Vivaan Chopra,18-11-2004,151050,Rajasthan,24,4,19,19,66,Fail
Manpreet Khan,02-04-2005,896904,Bihar,4,19,18,23,64,Pass
Manpreet Sharma,23-04-2005,378679,Karnataka,2,0,13,7,22,Pass
Aryan Chopra,06-05-2006,313505,Maharashtra,7,18,16,2,43,Fail
Aarav Sharma,23-04-2005,171595,Andhra Pradesh,17,2,12,9,40,Pass
Vivaan Pillai,06-10-2005,306158,Uttar Pradesh,12,2,1,22,37,Fail
Vivaan Mehta,06-03-2005,903532,Bihar,13,24,3,20,60,Pass
Kunal Fernandes,17-02-2005,334345,Jharkhand,23,1,20,3,47,Pass
Peter Singh,10-07-2005,883441,Madhya Pradesh,16,9,16,7,48,Fail
Aditya Chopra,25-02-2005,582956,Bihar,17,18,20,10,65,Pass
Krishna Verma,27-04-2006,913188,Madhya Pradesh,1,21,24,22,68,Fail
Raj Pillai,16-12-2005,145587,Maharashtra,0,7,24,20,51,Fail
Raj Sharma,22-02-2006,531334,Uttar Pradesh,4,23,9,11,47,Fail
Harjeet Fernandes,01-11-2005,510881,Haryana,9,18,22,20,69,Fail
Krishna Fernandes,26-08-2005,471857,Uttarakhand,5,24,23,15,67,Fail
Yash Pillai,03-04-2006,604130,Jharkhand,22,12,6,3,43,Pass
Krishna Pillai,26-03-2005,486903,Uttar Pradesh,21,15,18,11,65,Fail
Balbir Verma,30-12-2004,420080,Bihar,10,22,15,2,49,Pass
Kunal D'Souza,26-10-2005,906077,Haryana,14,20,14,4,52,Fail
Sukhwinder Khan,23-05-2005,863420,Bihar,4,17,19,6,46,Pass
Manpreet Mehta,09-01-2006,788559,Karnataka,8,16,11,5,40,Pass
Ishaan Fernandes,09-04-2006,396413,Uttar Pradesh,21,4,11,12,48,Fail
Rohan Reddy,22-11-2004,243111,Maharashtra,9,19,19,22,69,Fail
John Sharma,03-05-2006,558340,Uttar Pradesh,21,2,18,14,55,Fail
Ayaan Khan,15-02-2006,678279,Jharkhand,7,23,19,11,60,Pass
Aryan Khan,01-04-2006,655531,Jharkhand,0,9,14,7,30,Pass
Yash Verma,11-01-2006,131874,Jharkhand,21,4,12,0,37,Pass
Aditya Chopra,03-06-2005,297098,Uttar Pradesh,19,14,1,17,51,Fail
Peter D'Souza,22-03-2006,542715,West Bengal,6,10,3,0,19,Fail
Krishna Fernandes,22-02-2006,233132,Maharashtra,9,24,7,18,58,Fail
Vivaan Khan,16-09-2005,686997,Telangana,18,3,10,15,46,Fail
Aditya Verma,18-03-2005,291195,Punjab,15,1,4,1,21,Pass
Aditya Fernandes,03-08-2005,803351,Maharashtra,5,19,9,10,43,Fail
Krishna Mehta,19-01-2006,941031,Rajasthan,4,11,1,0,16,Pass
Yash Verma,22-07-2005,620875,Assam,15,21,6,1,43,Fail
Mathew Singh,06-06-2005,704516,Uttar Pradesh,1,24,6,22,53,Fail
Rohan Khan,12-07-2005,502993,Maharashtra,4,21,2,23,50,Fail
Manpreet Khan,21-11-2005,888916,Haryana,6,1,13,1,21,Fail
Gurpreet Khan,01-12-2004,789289,Haryana,8,16,0,10,34,Fail
David Chopra,09-08-2005,910501,Bihar,1,6,7,17,31,Pass
Vivaan Reddy,15-11-2005,126047,Bihar,18,12,3,15,48,Pass
Manpreet Pillai,09-04-2006,633126,Punjab,0,0,8,4,12,Pass
Vivaan Khan,04-07-2005,567172,Punjab,14,16,3,14,47,Fail
Rohan Verma,23-07-2005,897631,Punjab,22,0,0,12,34,Pass
Ishaan Pillai,13-03-2006,752873,Tamil Nadu,1,11,1,24,37,Pass
Kunal Pillai,26-12-2004,161363,Uttar Pradesh,22,19,7,9,57,Fail
Vivaan Verma,17-02-2006,100048,Maharashtra,6,19,0,11,36,Fail
Sukhwinder Mehta,06-10-2005,346388,Maharashtra,22,16,8,4,50,Fail
Raj Chopra,20-02-2006,661616,Punjab,14,4,21,23,62,Fail
Aarav Sharma,16-12-2004,480876,West Bengal,21,1,23,21,66,Fail
Yash Reddy,16-07-2005,483020,Uttar Pradesh,1,7,10,16,34,Fail
Yash Mehta,08-12-2004,483061,Uttarakhand,1,4,12,18,35,Fail
Kunal Khan,31-01-2005,748337,Uttar Pradesh,1,24,17,14,56,Fail
Aryan Sharma,04-05-2005,628097,Tripura,24,15,5,9,53,Fail
Aditya Khan,23-01-2006,498668,Tamil Nadu,23,12,12,5,52,Fail
Raj Sharma,03-10-2005,150138,Kerala,2,9,2,20,33,Pass
Raj Khan,15-07-2005,361845,Madhya Pradesh,16,14,8,2,40,Fail
Krishna Fernandes,08-05-2005,584392,Maharashtra,13,5,7,14,39,Fail
Raj Verma,04-05-2005,103704,Andhra Pradesh,5,13,19,8,45,Pass
Aarav Singh,03-12-2004,214759,Bihar,20,22,10,22,74,Pass
Krishna Verma,28-11-2005,135624,Telangana,3,19,6,12,40,Fail
Ayaan Chopra,17-03-2006,669644,Kerala,8,5,15,6,34,Pass
Kunal Reddy,04-04-2006,453532,Haryana,3,19,21,10,53,Fail
Vivaan Chopra,20-03-2005,100932,Punjab,13,17,2,21,53,Fail
Yash Verma,17-05-2005,164745,Maharashtra,3,19,5,5,32,Fail
Peter Fernandes,29-10-2005,229070,Bihar,14,22,16,3,55,Pass
Aryan Khan,09-04-2006,785897,Odisha,16,8,1,14,39,Pass
Aditya Mehta,21-12-2004,697406,Uttar Pradesh,24,14,24,17,79,Fail
John Pillai,21-07-2005,348712,Madhya Pradesh,17,18,1,4,40,Fail
Aditya Chopra,17-09-2005,161252,Haryana,21,16,17,11,65,Fail
Ishaan Singh,17-03-2006,524181,Himachal Pradesh,15,8,0,16,39,Pass
Krishna Singh,07-03-2006,495819,Maharashtra,17,17,17,19,70,Fail
Ishaan Khan,02-12-2005,283143,West Bengal,3,23,8,17,51,Fail
Ishaan Chopra,14-12-2005,345944,Uttar Pradesh,6,3,2,12,23,Fail
Vivaan Mehta,08-11-2004,574839,Madhya Pradesh,3,13,22,20,58,Fail
Rohan Khan,16-08-2005,931161,Karnataka,0,22,12,18,52,Pass
Aryan Sharma,10-10-2005,704489,Rajasthan,15,4,13,18,50,Pass
Aarav Chopra,14-01-2006,776236,Karnataka,14,18,15,7,54,Pass
Krishna Reddy,02-04-2006,429896,Bihar,16,16,16,1,49,Pass
Zaid Mehta,17-01-2006,170179,Rajasthan,21,18,10,0,49,Pass
Aarav Reddy,01-06-2005,236576,Maharashtra,22,7,11,10,50,Fail
Ayaan Reddy,14-10-2005,803829,Maharashtra,16,10,20,24,70,Fail
Ishaan Pillai,20-04-2006,540338,Odisha,12,22,21,9,64,Fail
Peter Mehta,25-02-2005,697547,Rajasthan,8,17,11,17,53,Pass
Rehan Sharma,13-06-2005,213730,Gujarat,17,9,6,6,38,Fail
Aditya Singh,01-04-2006,170244,Assam,3,7,10,11,31,Fail
Raj Chopra,05-04-2005,273398,Madhya Pradesh,5,15,21,4,45,Fail
Ishaan D'Souza,17-12-2004,826186,Madhya Pradesh,18,4,14,17,53,Fail
Yash Khan,15-11-2005,808361,Madhya Pradesh,9,13,23,12,57,Fail
Balbir Pillai,02-10-2005,908840,Uttar Pradesh,2,17,22,14,55,Fail
Kunal Chopra,16-11-2004,668793,Tamil Nadu,20,5,5,2,32,Pass
Sukhwinder Singh,06-04-2006,100177,West Bengal,15,7,20,4,46,Fail
Aarav Sharma,29-07-2005,548816,West Bengal,1,17,15,15,48,Fail
Imran Khan,10-03-2006,807957,Bihar,14,5,3,17,39,Pass
Kunal Singh,08-01-2006,180768,Assam,1,11,22,8,42,Fail
Kunal Pillai,29-03-2005,481517,Jammu & Kashmir + Ladakh,17,2,22,20,61,Pass
Rohan Reddy,08-04-2006,605179,Gujarat,2,15,22,7,46,Fail
Aarav Mehta,21-02-2006,871023,Madhya Pradesh,5,20,2,12,39,Fail
Aditya Singh,25-12-2004,631326,Tamil Nadu,4,17,3,5,29,Pass
Gurpreet D'Souza,23-04-2005,585524,Uttar Pradesh,13,14,17,9,53,Fail
Ishaan D'Souza,26-01-2005,709622,Rajasthan,13,24,2,24,63,Fail
Mathew Chopra,25-06-2005,405636,Jammu & Kashmir + Ladakh,7,8,15,21,51,Pass
Krishna Khan,16-08-2005,477097,Bihar,16,4,8,19,47,Pass
Rohan Verma,01-05-2005,625038,Delhi,5,3,16,10,34,Fail
Rohan Fernandes,27-04-2006,259786,Rajasthan,21,2,24,9,56,Pass
Mathew Khan,16-06-2005,207005,Himachal Pradesh,21,0,17,19,57,Pass
Aarav Mehta,02-09-2005,583810,Rajasthan,17,16,4,19,56,Pass
Gurpreet D'Souza,05-01-2005,991362,Haryana,5,3,15,16,39,Fail
Yash Verma,31-07-2005,432841,Jharkhand,20,18,6,13,57,Pass
Aditya Chopra,10-09-2005,451495,Meghalaya,21,18,1,13,53,Fail
Vivaan Reddy,20-04-2005,154058,Rajasthan,11,9,10,7,37,Pass
Krishna D'Souza,01-02-2005,418381,Andhra Pradesh,4,1,5,14,24,Pass
Mathew Reddy,23-02-2005,203086,Andhra Pradesh,21,21,1,2,45,Pass
Ishaan Chopra,08-11-2004,286098,Bihar,4,19,12,19,54,Pass
Aryan Pillai,13-03-2005,235110,Uttar Pradesh,19,16,5,24,64,Fail
Raj Chopra,12-01-2006,215319,Madhya Pradesh,18,0,1,4,23,Fail
Rohan Mehta,28-03-2005,438689,Maharashtra,15,8,10,2,35,Fail
Rohan D'Souza,24-11-2004,715372,Puducherry,12,16,15,6,49,Fail
Krishna Singh,14-04-2006,184793,Haryana,19,3,6,20,48,Fail
Manpreet Sharma,26-01-2006,126606,West Bengal,14,16,16,7,53,Fail
Aditya Pillai,28-10-2005,296886,Jammu & Kashmir + Ladakh,13,23,4,21,61,Pass
Harjeet Verma,11-03-2006,328428,Punjab,2,0,22,21,45,Fail
Raj Reddy,07-07-2005,249891,Uttar Pradesh,12,13,5,18,48,Fail
Ishaan Singh,01-02-2006,525811,Gujarat,18,0,10,12,40,Fail
Manpreet Reddy,15-10-2005,747357,Gujarat,10,19,2,3,34,Fail
Yash Pillai,13-11-2005,451193,Maharashtra,7,0,13,21,41,Fail
Aryan Fernandes,20-04-2005,757319,Odisha,0,0,5,1,6,Pass
Manpreet Pillai,15-11-2004,690699,Uttar Pradesh,15,24,14,10,63,Fail
Manpreet Khan,07-08-2005,787247,Bihar,21,14,3,3,41,Pass
Mathew Mehta,23-04-2006,640746,Andhra Pradesh,19,4,13,8,44,Pass
Aarav Khan,04-03-2006,603611,Chhattisgarh,18,18,19,23,78,Fail
John Reddy,24-01-2005,137885,Tamil Nadu,1,13,7,10,31,Pass
Raj Fernandes,28-12-2004,641447,Uttar Pradesh,24,3,15,9,51,Fail
Vivaan Khan,19-02-2005,806199,Haryana,18,22,12,7,59,Fail
Manpreet Khan,15-12-2005,804525,Punjab,3,15,6,6,30,Pass
Aditya D'Souza,09-11-2005,457173,Rajasthan,8,5,24,18,55,Pass
Manpreet Reddy,21-04-2005,916043,Haryana,20,23,15,16,74,Fail
Aarav D'Souza,21-12-2004,403665,Uttarakhand,24,9,23,0,56,Fail
Yash Fernandes,20-11-2005,368199,Bihar,16,7,3,11,37,Pass
Aditya Pillai,17-08-2005,400314,Maharashtra,3,12,11,8,34,Fail
Farhan Khan,24-11-2005,654683,Uttar Pradesh,15,22,8,1,46,Fail
Aryan Singh,17-11-2005,298756,Odisha,23,21,9,19,72,Fail
Vivaan Khan,26-04-2005,126151,Chhattisgarh,11,0,22,22,55,Fail
Aditya Khan,23-04-2005,768513,Odisha,17,22,7,16,62,Fail
Yash Chopra,14-09-2005,187094,Himachal Pradesh,0,0,22,23,45,Pass
Yash Verma,27-12-2005,697397,Madhya Pradesh,23,1,22,14,60,Fail
Aryan Mehta,29-06-2005,926192,Assam,18,9,24,5,56,Fail
Vivaan Reddy,16-02-2006,179688,Bihar,20,16,22,23,81,Pass
Krishna Chopra,01-11-2005,975228,Uttar Pradesh,22,7,19,9,57,Fail
Kunal D'Souza,06-12-2005,353109,Tamil Nadu,11,13,21,19,64,Fail
Aryan Khan,17-04-2005,349815,Punjab,15,23,22,18,78,Pass
Krishna Mehta,14-05-2005,180110,Maharashtra,21,7,3,1,32,Fail
Ishaan Fernandes,25-09-2005,135822,Odisha,12,8,17,8,45,Fail
Raj Singh,09-08-2005,838203,Maharashtra,2,1,4,9,16,Fail
Vivaan Reddy,09-12-2004,993193,Jammu & Kashmir + Ladakh,11,15,17,1,44,Pass
Rohan Mehta,08-12-2005,957770,Karnataka,10,2,24,6,42,Pass
Ishaan Sharma,16-07-2005,525509,Karnataka,24,13,5,11,53,Pass
Manpreet Pillai,09-04-2005,304498,Maharashtra,11,1,10,14,36,Fail
Rohan Chopra,08-05-2006,322470,Uttar Pradesh,20,21,6,20,67,Fail
Balbir Chopra,28-11-2005,854112,Uttar Pradesh,17,1,12,4,34,Fail
Aryan Fernandes,17-03-2006,145666,Jharkhand,14,14,3,1,32,Pass
Gurpreet D'Souza,10-04-2005,855058,Odisha,21,4,20,1,46,Fail
John Chopra,24-04-2006,637225,Kerala,6,5,14,6,31,Pass
Manpreet Reddy,07-12-2004,360730,Uttar Pradesh,12,21,5,2,40,Fail
Kunal Khan,12-03-2005,745270,Bihar,1,13,11,4,29,Pass
Ishaan Sharma,06-05-2006,365750,Tamil Nadu,3,3,17,10,33,Pass
Aditya Sharma,01-04-2006,826571,Chhattisgarh,2,17,14,12,45,Fail
Krishna Mehta,07-05-2006,287886,Assam,7,2,3,23,35,Fail
Vivaan Verma,22-10-2005,138863,Punjab,19,5,1,21,46,Fail
Krishna Verma,09-01-2006,735309,Kerala,17,0,24,13,54,Pass
Rohan Fernandes,02-02-2006,105252,Uttar Pradesh,16,6,10,16,48,Fail
Aditya D'Souza,13-07-2005,259969,Uttar Pradesh,13,13,6,4,36,Fail
Krishna Chopra,31-05-2005,735038,Rajasthan,12,11,9,11,43,Pass
Raj Chopra,11-03-2006,702558,Jharkhand,6,5,3,4,18,Pass
Aarav Pillai,14-12-2005,419989,Gujarat,20,6,16,16,58,Fail
Paul D'Souza,25-05-2005,881469,Bihar,14,24,1,3,42,Pass
Kunal Verma,15-04-2005,395288,Kerala,20,22,16,11,69,Fail
Ishaan Chopra,05-08-2005,642299,Rajasthan,5,18,5,18,46,Pass
Manpreet D'Souza,18-11-2005,687368,West Bengal,15,17,17,7,56,Fail
Kunal D'Souza,06-04-2006,264272,Tamil Nadu,4,21,19,18,62,Pass
Yash Reddy,30-12-2004,756359,Rajasthan,21,1,13,14,49,Pass
Rohan Pillai,18-08-2005,499098,Uttarakhand,10,24,7,2,43,Fail
Aarav D'Souza,11-01-2005,405544,Maharashtra,10,18,8,1,37,Fail
Vivaan Khan,25-04-2006,243899,Bihar,15,22,5,16,58,Pass
Raj Verma,11-06-2005,417304,Rajasthan,7,4,11,24,46,Pass
Aditya Verma,06-01-2005,146563,West Bengal,19,23,0,14,56,Fail
Balbir Chopra,01-02-2006,945733,Tamil Nadu,6,4,24,20,54,Fail
Aditya Khan,17-12-2005,936534,Rajasthan,10,21,12,6,49,Pass
Aditya Fernandes,19-01-2005,417532,Bihar,5,12,21,23,61,Pass
Kunal Khan,01-11-2005,346350,Bihar,6,10,23,8,47,Pass
David Pillai,01-05-2006,139072,Telangana,4,16,5,15,40,Fail
Krishna Mehta,10-11-2005,540570,Meghalaya,21,15,14,8,58,Fail
Yash D'Souza,01-05-2005,179011,Bihar,5,23,16,22,66,Pass
Aditya Fernandes,11-11-2004,360043,Jharkhand,1,4,22,10,37,Pass
Vivaan Chopra,15-04-2006,887041,Nagaland,19,17,22,18,76,Pass
David Chopra,27-11-2004,973042,Rajasthan,4,6,10,7,27,Pass
Aditya Singh,28-04-2005,212045,Gujarat,10,22,20,3,55,Fail
Yash Khan,21-01-2005,177902,Haryana,16,1,19,2,38,Fail
Krishna Chopra,19-02-2006,455986,Uttarakhand,15,22,17,23,77,Fail
Paul Sharma,24-11-2004,644655,Bihar,10,10,14,17,51,Pass
Manpreet Fernandes,05-03-2006,345908,Manipur,12,4,9,11,36,Fail
Raj Pillai,06-11-2005,323884,Bihar,8,6,13,16,43,Pass
Raj Singh,18-09-2005,559411,Maharashtra,6,9,2,17,34,Fail
Ayaan Pillai,16-05-2005,475082,Uttarakhand,18,20,3,3,44,Fail
Ishaan Pillai,31-03-2006,564295,Telangana,18,3,18,14,53,Fail
Zaid Verma,04-04-2005,365338,Odisha,20,10,20,20,70,Fail
Vivaan Pillai,06-02-2006,283705,Rajasthan,6,24,17,24,71,Fail
Raj Reddy,18-01-2006,392965,Rajasthan,14,4,4,10,32,Pass
Rohan Sharma,24-11-2004,181068,Rajasthan,17,20,3,8,48,Pass
Vivaan Chopra,23-11-2004,288337,Puducherry,23,1,23,9,56,Fail
Aryan Singh,14-11-2005,875416,Telangana,18,20,7,21,66,Fail
Raj Chopra,27-09-2005,109514,Maharashtra,14,20,14,24,72,Fail
Aryan D'Souza,19-02-2006,558803,Assam,23,0,21,18,62,Fail
Krishna Pillai,22-06-2005,568593,Haryana,0,20,4,13,37,Fail
Harjeet Fernandes,04-04-2006,245393,Punjab,8,14,3,1,26,Pass
John Sharma,14-02-2006,653281,Karnataka,19,5,9,8,41,Pass
Vivaan D'Souza,28-01-2005,803047,Bihar,6,21,24,12,63,Pass
Rohan D'Souza,09-11-2005,574684,Maharashtra,21,8,19,1,49,Fail
Raj Singh,29-05-2005,165579,Karnataka,21,12,20,8,61,Pass
Balbir D'Souza,02-08-2005,755973,Maharashtra,5,15,6,13,39,Fail
Krishna Verma,02-03-2005,570074,Uttarakhand,12,14,22,13,61,Fail
Vivaan Sharma,19-08-2005,221747,Andhra Pradesh,24,13,17,10,64,Pass
Ishaan D'Souza,06-03-2005,643136,Uttar Pradesh,15,9,6,5,35,Fail
Imran Pillai,21-05-2005,121708,Tamil Nadu,18,19,15,21,73,Pass
Zaid Reddy,10-04-2005,349085,Kerala,10,9,22,1,42,Pass
Raj Singh,24-04-2006,754888,Himachal Pradesh,6,7,6,9,28,Pass
Aditya Pillai,26-02-2006,975594,Tamil Nadu,8,19,14,22,63,Fail
Aditya Khan,25-07-2005,697635,Rajasthan,15,13,16,2,46,Pass
Vivaan Reddy,04-02-2005,429796,Madhya Pradesh,21,13,5,24,63,Fail
Aryan D'Souza,13-03-2005,697775,Assam,3,18,2,5,28,Fail
Aryan Chopra,03-01-2005,549169,Karnataka,2,10,1,4,17,Pass
Vivaan Sharma,24-12-2004,383383,Karnataka,5,18,2,0,25,Pass
Aditya Fernandes,08-05-2006,905445,Bihar,15,20,12,3,50,Pass
Ishaan Khan,11-04-2006,481417,Madhya Pradesh,12,2,20,2,36,Fail
Paul D'Souza,03-01-2005,711533,Chhattisgarh,2,19,23,21,65,Fail
Kunal Singh,27-08-2005,796898,West Bengal,10,2,14,7,33,Fail
Aarav Verma,11-12-2004,238361,Punjab,22,3,13,2,40,Pass
Rohan Sharma,31-01-2006,987445,Chhattisgarh,17,20,22,13,72,Fail
Kunal D'Souza,20-09-2005,500391,Bihar,21,6,0,8,35,Pass
Yash Mehta,20-04-2005,651805,Jharkhand,4,14,3,20,41,Pass
Aryan Sharma,24-06-2005,948571,Rajasthan,12,0,24,8,44,Pass
Ishaan Singh,25-01-2006,654277,Kerala,13,10,4,11,38,Pass
Ishaan Khan,07-04-2006,593107,Bihar,4,7,24,9,44,Pass
Rohan Mehta,03-06-2005,372920,Maharashtra,23,22,2,11,58,Fail
Yash D'Souza,14-02-2006,694574,Madhya Pradesh,20,3,11,11,45,Fail
Ishaan Khan,25-01-2006,838550,Bihar,13,19,18,1,51,Pass
Mathew D'Souza,24-05-2005,417694,Himachal Pradesh,16,13,18,4,51,Pass
Rohan Mehta,18-09-2005,844130,Tamil Nadu,8,6,15,13,42,Pass
Aarav Khan,02-04-2006,144534,Uttar Pradesh,3,18,10,8,39,Fail
Aryan Reddy,09-08-2005,265388,Punjab,8,7,19,13,47,Fail
Raj Fernandes,11-10-2005,233247,West Bengal,23,12,21,3,59,Fail
Balbir Khan,10-11-2004,409011,Rajasthan,14,2,19,0,35,Pass
Vivaan Mehta,04-05-2005,306940,Tamil Nadu,16,7,0,13,36,Pass
Rohan Singh,12-11-2005,205039,Tripura,18,2,10,0,30,Fail
Aditya Khan,30-12-2005,119381,Tamil Nadu,3,15,24,2,44,Pass
David D'Souza,30-08-2005,564358,Jharkhand,3,19,21,12,55,Fail
Krishna Fernandes,25-02-2006,394827,Himachal Pradesh,12,11,15,3,41,Pass
Sukhwinder Mehta,10-08-2005,778903,Madhya Pradesh,1,24,13,22,60,Fail
Aarav Sharma,28-02-2006,877464,Rajasthan,24,8,8,3,43,Pass
Raj Chopra,14-02-2006,768343,Madhya Pradesh,4,0,2,17,23,Fail
Aditya D'Souza,13-11-2004,862013,West Bengal,4,17,19,19,59,Fail
Gurpreet Reddy,18-09-2005,874820,Jammu & Kashmir + Ladakh,9,7,20,6,42,Pass
Ishaan Verma,20-03-2005,226956,Tripura,1,11,23,14,49,Fail
Krishna Singh,18-12-2005,651001,Uttar Pradesh,11,5,0,17,33,Fail
Rehan Singh,12-02-2006,312112,Uttar Pradesh,8,1,18,0,27,Fail
Aarav Reddy,02-05-2005,119230,Maharashtra,4,21,22,8,55,Fail
Aryan Mehta,15-11-2004,798362,Telangana,15,7,1,22,45,Fail
Rehan Pillai,19-10-2005,548734,Haryana,15,8,9,15,47,Fail
Rohan Khan,01-02-2005,307597,Uttar Pradesh,22,2,22,15,61,Fail
John Fernandes,10-12-2004,699674,Andhra Pradesh,20,18,7,4,49,Pass
Paul Chopra,14-11-2004,735984,Madhya Pradesh,19,18,5,11,53,Fail
Manpreet Verma,01-04-2005,765321,Madhya Pradesh,9,2,24,13,48,Fail
David Reddy,07-02-2005,642705,Punjab,24,20,9,15,68,Fail
Rohan Khan,22-06-2005,931209,Uttar Pradesh,15,9,17,14,55,Fail
Krishna Mehta,12-03-2006,294872,Bihar,6,15,19,16,56,Pass
Krishna Singh,24-09-2005,219463,Assam,23,15,10,20,68,Fail
Aryan Verma,28-04-2005,582714,Bihar,23,7,13,11,54,Pass
Harjeet Sharma,17-08-2005,220726,Karnataka,4,24,12,2,42,Pass
Paul Khan,25-04-2005,936667,Rajasthan,16,22,7,6,51,Pass
Ishaan Singh,12-01-2006,521773,Uttarakhand,19,22,17,5,63,Fail
Farhan D'Souza,02-02-2006,652497,Madhya Pradesh,21,7,17,15,60,Fail
David Verma,11-02-2005,170289,Bihar,7,17,10,0,34,Pass
Farhan Khan,07-04-2005,840124,Rajasthan,12,12,17,11,52,Pass
Kunal Mehta,16-06-2005,337721,Karnataka,20,20,22,16,78,Fail
Manpreet Mehta,03-07-2005,123436,Maharashtra,21,24,2,4,51,Fail
Paul Singh,28-08-2005,294338,Rajasthan,8,15,5,16,44,Pass
Ishaan Mehta,27-02-2005,225653,Uttar Pradesh,1,20,8,14,43,Fail
Krishna Chopra,17-12-2005,747602,Delhi,23,8,2,0,33,Fail
Aditya Mehta,25-06-2005,964890,Bihar,4,8,6,20,38,Pass
Imran Chopra,21-12-2005,336601,Assam,12,10,14,21,57,Fail
Aditya Verma,12-03-2005,833163,Maharashtra,22,8,20,2,52,Fail
Yash Khan,09-04-2005,269508,Manipur,11,6,10,2,29,Fail
Gurpreet Pillai,08-03-2006,142389,Kerala,5,3,4,14,26,Pass
Raj Chopra,18-06-2005,253486,Rajasthan,10,18,4,19,51,Pass
Aarav Khan,30-03-2005,742924,Haryana,5,19,3,0,27,Fail
Krishna Singh,11-12-2004,692665,Uttar Pradesh,1,19,22,14,56,Fail
Kunal Reddy,07-05-2005,272152,Kerala,18,0,12,21,51,Pass
Aarav Verma,07-06-2005,535904,Odisha,5,8,6,3,22,Pass
Kunal Fernandes,21-04-2005,987814,Karnataka,16,6,15,5,42,Pass
Harjeet Mehta,24-03-2005,752944,Uttar Pradesh,21,14,2,5,42,Fail
Zaid Verma,15-02-2006,964994,Gujarat,7,4,6,10,27,Fail
Ishaan Fernandes,25-01-2005,417031,Bihar,21,12,3,5,41,Pass
Ishaan Singh,09-04-2005,106401,Madhya Pradesh,20,21,16,1,58,Fail
Manpreet Khan,22-09-2005,881289,Gujarat,7,6,21,5,39,Fail
Aryan Chopra,13-04-2005,917226,Karnataka,15,3,0,17,35,Pass
Aarav Singh,10-09-2005,574616,Jharkhand,8,11,16,4,39,Pass
Aarav Chopra,27-11-2004,467707,Bihar,5,23,20,12,60,Pass
Raj Reddy,21-02-2005,296200,Jharkhand,3,2,11,15,31,Pass
Ishaan Reddy,15-01-2006,356499,Tamil Nadu,17,23,23,23,86,Pass
Raj Khan,07-02-2005,782459,Rajasthan,23,2,10,18,53,Pass
Balbir Fernandes,30-08-2005,320996,Haryana,3,5,4,24,36,Fail
Gurpreet Fernandes,24-04-2006,307330,Punjab,3,23,7,17,50,Fail
Rohan Pillai,04-06-2005,463068,Rajasthan,5,4,5,17,31,Pass
Ishaan Verma,03-01-2005,572301,Madhya Pradesh,6,1,9,11,27,Fail
Rohan Chopra,01-02-2006,895971,Uttar Pradesh,16,24,0,15,55,Fail
Balbir Sharma,02-07-2005,648511,Gujarat,17,5,8,23,53,Fail
Kunal Pillai,13-03-2005,810388,Uttar Pradesh,9,19,7,4,39,Fail
Raj Chopra,19-02-2006,196464,Uttar Pradesh,2,10,7,17,36,Fail
Aryan Sharma,25-01-2006,559034,Assam,11,2,4,17,34,Fail
Mathew Mehta,23-02-2005,211281,Rajasthan,11,7,22,20,60,Fail
Balbir Pillai,01-01-2005,319819,Karnataka,6,24,9,20,59,Pass
Harjeet D'Souza,09-06-2005,195951,Chhattisgarh,4,7,23,2,36,Fail
Aryan Fernandes,16-11-2005,835833,West Bengal,20,1,14,6,41,Fail
John Pillai,25-12-2005,741441,Telangana,5,7,5,13,30,Fail
Rohan Fernandes,03-12-2005,318506,Madhya Pradesh,22,2,3,8,35,Fail
Aarav Pillai,10-12-2005,527132,Rajasthan,6,2,3,12,23,Pass
Ishaan Mehta,19-07-2005,123513,Uttarakhand,15,17,6,13,51,Fail
John Chopra,02-10-2005,224121,Maharashtra,19,20,24,3,66,Fail
Yash Reddy,09-11-2005,807077,Andhra Pradesh,6,11,1,5,23,Pass
Kunal Reddy,15-05-2005,149548,Uttar Pradesh,23,3,10,12,48,Fail
Rohan Reddy,14-11-2005,625684,Rajasthan,1,14,13,14,42,Pass
Aditya Chopra,20-11-2005,431193,Uttar Pradesh,12,18,5,24,59,Fail
Sukhwinder Mehta,01-01-2006,948340,Gujarat,1,6,3,1,11,Fail
Raj Khan,04-10-2005,265676,Jammu & Kashmir + Ladakh,23,9,21,12,65,Pass
Rehan Verma,18-02-2006,523640,Gujarat,10,3,24,12,49,Fail
Mathew D'Souza,30-05-2005,672518,Jharkhand,3,3,21,22,49,Fail
Peter Verma,01-03-2005,449139,Tamil Nadu,23,4,4,4,35,Pass
Paul Verma,04-07-2005,900856,Rajasthan,18,11,20,10,59,Pass
Harjeet Khan,21-12-2005,209915,Andhra Pradesh,10,20,18,5,53,Pass
John Sharma,25-02-2005,962803,Tamil Nadu,11,12,4,21,48,Fail
Yash Pillai,21-01-2005,587157,Odisha,4,1,17,12,34,Pass
Peter Fernandes,11-11-2005,333840,Andhra Pradesh,13,13,18,18,62,Pass
Sukhwinder Singh,09-06-2005,806541,Andhra Pradesh,23,20,21,21,85,Pass
Kunal Mehta,29-05-2005,417629,Uttar Pradesh,17,11,23,12,63,Fail
Vivaan Reddy,18-12-2004,201113,Rajasthan,18,21,23,15,77,Pass
Aarav Chopra,20-08-2005,108058,Himachal Pradesh,6,11,19,7,43,Fail
Vivaan Chopra,19-02-2005,532888,Telangana,14,23,2,23,62,Fail
Vivaan Sharma,14-03-2006,475825,Uttar Pradesh,3,16,2,23,44,Fail
Kunal Khan,25-12-2004,888597,Sikkim,15,19,22,14,70,Fail
Balbir Singh,21-04-2005,860264,West Bengal,18,12,20,17,67,Fail
Ishaan Verma,11-11-2005,276040,Jammu & Kashmir + Ladakh,14,8,11,3,36,Pass
Peter Sharma,07-03-2005,769723,Andhra Pradesh,21,3,12,18,54,Pass
Krishna Khan,06-01-2006,302037,West Bengal,15,12,2,3,32,Fail
Paul D'Souza,12-02-2005,675201,Bihar,24,12,21,15,72,Pass
Rohan Mehta,05-11-2005,167028,Uttar Pradesh,18,20,19,18,75,Fail
Ishaan Khan,30-01-2005,401250,Bihar,5,13,15,17,50,Pass
Vivaan Pillai,22-07-2005,320540,Tamil Nadu,9,7,16,1,33,Pass
Vivaan Verma,09-09-2005,829319,Uttar Pradesh,7,8,17,11,43,Fail
Imran Fernandes,20-01-2005,333339,Delhi,11,2,16,8,37,Fail
Balbir Reddy,13-03-2005,859501,Tamil Nadu,3,24,14,16,57,Pass
Krishna Fernandes,20-01-2005,773031,Haryana,23,15,24,2,64,Fail
Yash D'Souza,20-12-2005,664907,Bihar,20,1,10,16,47,Pass
Harjeet Verma,09-10-2005,592643,Jammu & Kashmir + Ladakh,13,19,16,24,72,Fail
Aditya Sharma,12-08-2005,873975,Karnataka,16,17,23,10,66,Pass
Ishaan Khan,24-01-2006,664578,Maharashtra,17,14,15,11,57,Fail
Raj Verma,18-03-2006,504051,Uttar Pradesh,6,4,0,13,23,Fail
Aditya Mehta,02-05-2006,827826,Maharashtra,18,16,3,2,39,Fail
Manpreet Chopra,17-03-2006,932219,Madhya Pradesh,24,19,12,8,63,Fail
Ishaan Reddy,22-08-2005,525590,West Bengal,13,8,22,9,52,Fail
Ishaan Pillai,24-06-2005,577717,Bihar,8,14,17,9,48,Pass
Aditya Pillai,27-12-2005,139399,Gujarat,4,4,22,22,52,Fail
Rohan Singh,06-01-2005,680579,Haryana,2,12,20,9,43,Fail
Gurpreet Singh,03-12-2005,248779,Rajasthan,22,13,13,22,70,Fail
David Verma,20-12-2004,716359,Arunachal Pradesh,19,13,4,4,40,Fail
Vivaan D'Souza,05-01-2005,284416,Kerala,14,8,1,13,36,Pass
Kunal Khan,25-11-2005,572294,Rajasthan,6,5,9,2,22,Pass
Raj Khan,08-02-2006,924234,Punjab,14,18,4,17,53,Fail
Aditya Verma,14-05-2005,112858,Delhi,5,12,23,5,45,Fail
Kunal Verma,15-04-2006,143831,Jharkhand,4,6,1,20,31,Pass
Rohan Reddy,27-09-2005,498736,Bihar,19,6,10,5,40,Pass
Aryan Khan,02-09-2005,818616,Rajasthan,11,24,23,4,62,Fail
Krishna Khan,28-09-2005,120504,Haryana,7,11,13,24,55,Fail
Raj Singh,30-01-2005,236432,West Bengal,16,11,13,16,56,Fail
Raj Sharma,13-05-2005,997438,Punjab,9,0,4,3,16,Pass
Balbir Khan,02-04-2006,323993,Madhya Pradesh,5,23,8,18,54,Fail
Vivaan Mehta,07-01-2005,410585,Uttar Pradesh,12,14,17,12,55,Fail
Yash Khan,22-11-2004,281358,Bihar,5,6,7,7,25,Pass
Raj Khan,09-06-2005,777711,Chhattisgarh,17,20,18,8,63,Fail
Balbir Fernandes,30-04-2006,802662,West Bengal,2,13,23,11,49,Fail
Harjeet Verma,14-04-2005,238467,Maharashtra,18,5,11,8,42,Fail
Paul Sharma,12-11-2005,786318,Bihar,5,5,24,20,54,Pass
Vivaan Singh,16-11-2004,457868,Uttar Pradesh,0,22,15,5,42,Fail
Yash Khan,23-12-2005,829076,Uttar Pradesh,23,16,12,7,58,Fail
Imran Khan,16-06-2005,511570,Puducherry,24,5,21,6,56,Fail
Rohan Pillai,05-04-2005,657845,Uttar Pradesh,6,16,22,9,53,Fail
Kunal Reddy,14-04-2005,872970,Jharkhand,7,20,5,10,42,Pass
Vivaan Verma,12-04-2006,455197,Puducherry,9,17,14,11,51,Fail
Aarav D'Souza,27-11-2005,832469,Bihar,22,2,11,16,51,Pass
David Verma,07-12-2004,735229,Uttarakhand,16,19,14,23,72,Fail
Vivaan Verma,27-08-2005,523805,Tamil Nadu,2,22,3,13,40,Pass
Rehan D'Souza,02-02-2005,598055,Uttarakhand,3,22,11,17,53,Fail
Kunal Verma,12-01-2005,715298,Bihar,19,14,4,14,51,Pass
Aryan Reddy,29-06-2005,739043,West Bengal,21,8,1,8,38,Fail
Mathew Reddy,24-12-2005,377022,Maharashtra,10,2,18,6,36,Fail
Peter Mehta,02-03-2005,533969,Madhya Pradesh,8,21,9,11,49,Fail
Kunal Pillai,06-11-2005,606512,Haryana,4,11,5,19,39,Fail
Aarav Verma,02-04-2006,881702,Uttar Pradesh,23,22,2,7,54,Fail
Krishna Sharma,03-02-2005,647374,Kerala,6,24,3,4,37,Fail
Aryan Fernandes,13-12-2005,235859,Bihar,9,15,6,10,40,Pass
Yash Reddy,10-05-2005,791457,Maharashtra,4,10,23,20,57,Fail
Aarav Reddy,26-01-2005,599240,Uttarakhand,2,24,17,21,64,Fail
Raj Khan,04-02-2005,831125,Maharashtra,1,20,17,22,60,Fail
Krishna Reddy,03-12-2005,435879,Andhra Pradesh,9,12,6,18,45,Pass
Kunal D'Souza,29-08-2005,637150,Odisha,10,24,19,22,75,Fail
Rohan Khan,05-01-2006,939144,Tamil Nadu,1,3,16,17,37,Pass
Aryan Chopra,07-01-2006,540420,Punjab,2,24,2,14,42,Pass
Ishaan Singh,21-06-2005,810335,Rajasthan,3,23,7,11,44,Pass
Ishaan Khan,16-10-2005,854029,Tamil Nadu,2,2,12,20,36,Pass
Gurpreet Chopra,16-12-2005,390439,Bihar,11,15,6,11,43,Pass
Ishaan Singh,13-02-2006,411959,Bihar,8,11,10,6,35,Pass
Harjeet Fernandes,26-06-2005,739962,Jharkhand,11,4,9,1,25,Pass
Rohan Khan,20-11-2004,995293,Maharashtra,0,2,19,23,44,Fail
Krishna Fernandes,05-01-2006,646599,Rajasthan,2,6,5,14,27,Pass
Vivaan Verma,14-11-2004,822500,Odisha,5,10,17,3,35,Pass
Krishna Mehta,16-04-2005,416074,Haryana,9,21,7,0,37,Fail
Aryan Khan,28-09-2005,187792,Jharkhand,12,13,0,8,33,Pass
Aditya Khan,20-11-2005,256356,Chhattisgarh,3,9,16,0,28,Fail
Krishna Sharma,25-02-2005,969427,Madhya Pradesh,4,23,8,4,39,Fail
Yash Reddy,19-12-2004,990274,Karnataka,9,14,6,17,46,Pass
Aarav Verma,28-12-2004,825918,West Bengal,18,11,6,13,48,Fail
Kunal Pillai,09-02-2005,578255,Rajasthan,4,19,3,14,40,Pass
Aditya Khan,13-01-2005,618420,Telangana,13,21,8,24,66,Fail
Vivaan Pillai,07-03-2005,961776,Tamil Nadu,22,4,5,23,54,Fail
Aarav D'Souza,21-12-2005,109346,Bihar,14,11,23,15,63,Pass
Raj Mehta,09-11-2004,326494,Uttar Pradesh,5,23,6,4,38,Fail
Rohan Singh,11-05-2005,553126,Uttar Pradesh,16,16,15,14,61,Fail
Manpreet Reddy,09-08-2005,114662,Punjab,4,18,7,11,40,Pass
Raj Fernandes,28-08-2005,397468,Manipur,0,24,0,7,31,Fail
Ishaan Verma,25-04-2005,185195,Maharashtra,3,15,20,10,48,Fail
Harjeet Chopra,28-01-2005,208184,Madhya Pradesh,11,20,13,4,48,Fail
Vivaan Sharma,11-09-2005,611870,Rajasthan,23,9,13,6,51,Pass
Rohan Mehta,01-05-2006,570172,Haryana,19,16,22,13,70,Fail
Mathew Pillai,22-11-2005,910419,Gujarat,13,23,17,4,57,Fail
Aarav Khan,14-04-2006,141065,Odisha,4,9,11,12,36,Pass
Paul Chopra,19-08-2005,776810,Karnataka,4,7,14,15,40,Pass
Vivaan Sharma,22-05-2005,125613,Bihar,7,5,5,6,23,Pass
Aditya Fernandes,26-01-2006,506988,Uttar Pradesh,6,10,16,15,47,Fail
Kunal Singh,19-01-2005,281526,Madhya Pradesh,12,20,6,19,57,Fail
Vivaan Khan,20-01-2006,761400,Bihar,18,7,7,9,41,Pass
Vivaan Fernandes,04-03-2006,937074,Haryana,1,2,13,17,33,Fail
Yash Chopra,26-06-2005,370517,Bihar,14,3,12,15,44,Pass
Aryan D'Souza,10-02-2005,205426,Odisha,21,7,15,20,63,Fail
Aarav Reddy,18-08-2005,503137,Goa,6,22,11,5,44,Fail
Mathew Pillai,21-12-2004,624400,Punjab,19,19,14,19,71,Fail
Aarav Sharma,15-10-2005,147874,Punjab,23,4,11,18,56,Fail
Raj Verma,05-01-2005,907536,Bihar,14,14,7,3,38,Pass
Balbir Fernandes,31-12-2004,846091,Chhattisgarh,3,7,17,16,43,Fail
John Verma,07-09-2005,960059,Bihar,18,12,2,19,51,Pass
Aarav Verma,18-05-2005,412041,Maharashtra,11,22,21,12,66,Fail
Manpreet Sharma,24-04-2005,611681,Andhra Pradesh,12,17,4,5,38,Pass
Paul Mehta,18-11-2005,549542,West Bengal,12,7,14,13,46,Fail
John Khan,17-02-2005,642310,West Bengal,23,12,13,8,56,Fail
Aryan Reddy,25-12-2005,672057,Haryana,10,19,17,15,61,Fail
John Sharma,09-05-2006,432337,Chhattisgarh,12,5,24,9,50,Fail
Krishna Verma,05-06-2005,988827,Assam,12,13,13,1,39,Fail
Krishna Chopra,04-03-2006,871000,Bihar,0,7,3,21,31,Pass
Raj Verma,18-08-2005,472205,Odisha,12,13,17,1,43,Pass
Vivaan Pillai,20-04-2005,375021,Bihar,13,18,16,6,53,Pass
Aarav Chopra,01-09-2005,440523,Chhattisgarh,7,6,9,17,39,Fail
Paul Sharma,10-04-2005,288968,Maharashtra,6,23,22,14,65,Fail
Balbir Fernandes,28-02-2006,357981,Punjab,23,21,3,19,66,Fail
Kunal Khan,28-06-2005,356632,Haryana,21,2,22,18,63,Fail
Kunal Reddy,30-04-2006,612455,Bihar,0,1,24,0,25,Pass
Balbir Chopra,22-08-2005,222875,Gujarat,6,6,22,11,45,Fail
Krishna Verma,19-10-2005,382203,Assam,17,14,24,15,70,Fail
Vivaan Mehta,25-04-2006,423283,Rajasthan,0,21,23,17,61,Fail
Aditya Fernandes,29-09-2005,769593,Telangana,13,22,22,8,65,Fail
Raj Verma,19-12-2005,437756,Telangana,14,11,10,7,42,Fail
Ishaan Mehta,30-03-2006,257656,Chhattisgarh,8,13,7,10,38,Fail
Kunal Pillai,06-03-2005,566182,Jammu & Kashmir + Ladakh,10,2,11,15,38,Pass
Balbir Fernandes,17-11-2004,416828,Rajasthan,0,0,12,9,21,Pass
Krishna D'Souza,30-11-2005,985284,Tamil Nadu,12,0,6,20,38,Pass
Manpreet D'Souza,21-03-2006,590762,Tamil Nadu,13,11,10,23,57,Pass
Peter Mehta,12-06-2005,493887,Kerala,15,13,2,22,52,Fail
Krishna Reddy,06-11-2005,905566,Uttar Pradesh,3,23,7,3,36,Fail
Yash Khan,09-03-2005,860141,Haryana,12,5,24,16,57,Fail
Sukhwinder D'Souza,30-03-2005,736105,Maharashtra,13,17,14,20,64,Fail
Gurpreet Singh,20-09-2005,355645,Haryana,23,0,8,12,43,Fail
Kunal Verma,27-03-2005,947608,Haryana,1,4,24,14,43,Fail
Aditya Pillai,13-12-2005,864075,West Bengal,8,21,14,7,50,Fail
Aditya Mehta,19-11-2005,915484,Gujarat,8,12,7,16,43,Fail
Aryan Pillai,30-01-2005,441668,Bihar,16,14,2,22,54,Pass
Aditya Verma,27-04-2005,362602,Madhya Pradesh,17,21,24,3,65,Fail
Aditya Reddy,12-01-2006,308148,Rajasthan,4,16,5,17,42,Pass
Yash Verma,12-04-2006,254046,Punjab,9,0,9,23,41,Pass
Ishaan Chopra,23-01-2005,366447,Andhra Pradesh,4,10,8,2,24,Pass
Krishna Fernandes,26-09-2005,223715,Uttar Pradesh,12,7,19,2,40,Fail
Gurpreet Verma,04-12-2005,462806,West Bengal,10,14,12,22,58,Fail
Sukhwinder Verma,09-12-2005,576476,Uttar Pradesh,20,10,21,13,64,Fail
Balbir Chopra,21-05-2005,604235,Andhra Pradesh,10,16,8,3,37,Pass
Sukhwinder Reddy,28-04-2006,784885,Haryana,15,7,20,20,62,Fail
Gurpreet Singh,17-02-2005,867704,Maharashtra,19,23,5,13,60,Fail
Rohan Khan,06-06-2005,594696,Uttar Pradesh,5,1,2,18,26,Fail
Gurpreet Chopra,31-12-2005,806038,Rajasthan,12,7,4,8,31,Pass
Kunal Fernandes,29-11-2005,776325,Uttar Pradesh,8,12,6,2,28,Fail
Rohan Reddy,17-04-2005,239249,Haryana,8,5,6,15,34,Fail
Mathew Chopra,20-01-2005,146986,Tamil Nadu,20,19,10,14,63,Fail
Aarav Khan,17-07-2005,788582,Uttar Pradesh,14,21,15,13,63,Fail
John Verma,02-06-2005,813719,Rajasthan,0,2,24,12,38,Pass
Kunal Mehta,20-06-2005,225870,Uttar Pradesh,9,2,1,11,23,Fail
Mathew Mehta,01-12-2004,828933,Rajasthan,11,24,16,9,60,Fail
Ishaan Pillai,28-11-2004,892468,Rajasthan,2,4,6,18,30,Pass
Yash D'Souza,01-04-2006,208839,West Bengal,18,3,7,21,49,Fail
Sukhwinder Khan,25-10-2005,539823,Andhra Pradesh,3,6,21,8,38,Pass
Ishaan Singh,24-05-2005,885392,Bihar,0,21,22,21,64,Pass
Aryan Singh,31-01-2006,478226,Himachal Pradesh,18,6,24,10,58,Pass
David Reddy,23-04-2006,479660,Chhattisgarh,9,17,9,5,40,Fail
Yash Sharma,10-02-2005,296842,West Bengal,6,22,3,14,45,Fail
Ishaan Reddy,04-09-2005,807849,Punjab,20,10,16,14,60,Fail
Raj Singh,21-02-2006,698676,Jharkhand,1,17,8,7,33,Pass
Imran Fernandes,13-04-2005,197015,Bihar,10,0,4,16,30,Pass
Rohan Reddy,03-01-2005,215902,Maharashtra,10,23,4,22,59,Fail
Aditya D'Souza,08-07-2005,148868,Telangana,14,19,9,10,52,Fail
Raj Chopra,28-09-2005,724531,Andhra Pradesh,6,6,23,15,50,Pass
Harjeet Mehta,17-10-2005,902710,Rajasthan,18,12,24,1,55,Pass
Raj Mehta,13-12-2004,322715,Bihar,16,8,13,20,57,Pass
Raj Verma,23-03-2006,821691,Punjab,6,24,24,22,76,Pass
Vivaan Singh,17-01-2006,747108,Uttar Pradesh,7,4,3,0,14,Fail
Gurpreet Singh,22-02-2006,989582,Rajasthan,23,23,13,9,68,Fail
Rohan Sharma,23-05-2005,337932,Uttar Pradesh,10,6,15,1,32,Fail
Ishaan Khan,05-12-2004,737409,Punjab,11,19,12,3,45,Fail
Peter D'Souza,27-04-2006,176220,Telangana,24,5,21,1,51,Fail
Mathew D'Souza,28-03-2005,305306,Uttar Pradesh,18,14,10,12,54,Fail
David Fernandes,01-05-2005,436719,Bihar,16,19,8,16,59,Pass
Mathew Pillai,07-02-2006,874386,Haryana,2,12,6,11,31,Fail
Rohan Chopra,25-10-2005,287347,Manipur,16,7,18,10,51,Fail
Ishaan Pillai,25-12-2004,908117,Telangana,0,1,7,2,10,Fail
Paul Chopra,25-04-2006,696123,Rajasthan,15,12,17,20,64,Fail
Ishaan Fernandes,27-02-2005,145844,Andhra Pradesh,22,1,12,14,49,Pass
Aarav Reddy,09-11-2005,174906,Uttar Pradesh,18,12,1,23,54,Fail
Sukhwinder Reddy,08-08-2005,993173,West Bengal,15,19,22,7,63,Fail
Yash Reddy,27-11-2005,266885,Maharashtra,0,4,10,20,34,Fail
Rohan Reddy,12-07-2005,583240,West Bengal,22,24,20,7,73,Fail
Gurpreet Khan,29-05-2005,820009,Madhya Pradesh,0,13,6,22,41,Fail
Krishna Sharma,15-04-2005,957758,Bihar,22,12,24,19,77,Pass
Kunal Khan,24-02-2006,500312,Uttar Pradesh,14,13,1,0,28,Fail
Rohan D'Souza,10-04-2005,354381,Telangana,21,14,17,13,65,Fail
Aarav Pillai,21-12-2004,428897,Mizoram,20,0,23,13,56,Fail
Krishna D'Souza,08-03-2006,444287,Rajasthan,12,18,12,14,56,Pass
Krishna Verma,29-06-2005,110500,Andhra Pradesh,3,7,2,4,16,Pass
Ishaan Fernandes,21-02-2005,974610,Bihar,4,8,0,8,20,Pass
Aarav Fernandes,24-05-2005,543054,West Bengal,0,0,14,11,25,Fail
Farhan Verma,17-06-2005,120075,Bihar,17,23,15,3,58,Pass
David Singh,26-10-2005,492883,Bihar,9,7,6,10,32,Pass
Aryan Reddy,19-07-2005,466127,Karnataka,17,22,0,24,63,Pass
Yash Fernandes,04-12-2004,647074,Andhra Pradesh,7,15,13,15,50,Pass
Sukhwinder Pillai,30-05-2005,875538,Tamil Nadu,9,20,7,7,43,Fail
Aditya Khan,23-06-2005,923283,West Bengal,12,12,22,24,70,Fail
Yash Sharma,25-03-2006,185397,Tamil Nadu,20,3,6,15,44,Pass
Raj Sharma,30-01-2006,419086,Maharashtra,1,0,3,2,6,Fail
Aditya Khan,12-11-2005,872569,Punjab,19,20,13,0,52,Fail
Ayaan Singh,07-06-2005,979215,Punjab,23,17,9,4,53,Fail
Aditya Reddy,09-09-2005,139374,Andhra Pradesh,11,19,24,11,65,Pass
Manpreet Mehta,30-12-2004,922162,Himachal Pradesh,14,8,19,14,55,Pass
John Verma,06-03-2006,698915,Rajasthan,19,13,18,5,55,Pass
Gurpreet Verma,14-11-2004,771995,Rajasthan,3,15,7,3,28,Pass
Vivaan Singh,22-06-2005,369766,Bihar,21,19,4,20,64,Pass
Aditya Pillai,31-05-2005,634229,Uttar Pradesh,0,15,0,20,35,Fail
Yash Mehta,24-05-2005,224909,Uttar Pradesh,3,9,3,6,21,Fail
Imran Verma,02-09-2005,241236,Andhra Pradesh,9,20,16,3,48,Pass
Kunal D'Souza,05-06-2005,179298,Maharashtra,5,20,1,13,39,Fail
Manpreet D'Souza,09-11-2005,734545,Bihar,3,6,14,2,25,Pass
Yash Sharma,03-03-2005,984029,Chhattisgarh,17,16,21,16,70,Fail
Aarav Fernandes,29-03-2005,964700,Uttar Pradesh,24,17,14,14,69,Fail
Raj Khan,11-02-2006,815463,Chhattisgarh,2,6,12,0,20,Fail
Raj Sharma,30-09-2005,398567,Rajasthan,2,9,24,14,49,Pass
Ishaan Reddy,21-04-2005,484004,Bihar,18,2,19,14,53,Pass
Aarav Singh,10-04-2005,828885,Delhi,0,13,23,24,60,Fail
Aryan Fernandes,06-11-2005,927071,Andhra Pradesh,21,9,12,12,54,Pass
Harjeet Reddy,06-11-2005,233531,Odisha,0,19,5,3,27,Pass
Raj D'Souza,03-03-2006,685996,Rajasthan,5,2,17,24,48,Pass
Zaid D'Souza,14-02-2005,434376,Bihar,13,0,3,23,39,Pass
Manpreet Pillai,13-12-2004,483349,Madhya Pradesh,2,1,17,20,40,Fail
Rohan Pillai,23-12-2004,760567,Kerala,3,23,12,17,55,Fail
Rohan D'Souza,24-10-2005,117549,Bihar,7,7,24,12,50,Pass
Raj Fernandes,16-04-2006,244639,Punjab,10,3,5,15,33,Pass
Gurpreet Chopra,12-11-2005,599043,Andhra Pradesh,7,9,3,14,33,Pass
Harjeet Verma,06-03-2005,909925,West Bengal,23,0,19,10,52,Fail
Aryan Pillai,04-06-2005,155290,Karnataka,11,14,7,6,38,Pass
Farhan Pillai,24-11-2004,930169,Punjab,21,23,4,12,60,Fail
Balbir Fernandes,01-11-2005,539715,Kerala,10,13,9,5,37,Fail
Rohan Khan,25-04-2005,787304,Himachal Pradesh,9,1,5,22,37,Pass
Krishna Khan,24-03-2005,220599,Jharkhand,8,19,15,7,49,Pass
Aryan Singh,20-10-2005,329954,Punjab,20,18,13,23,74,Pass
Gurpreet D'Souza,17-04-2005,960423,Rajasthan,1,22,18,7,48,Pass
Raj Khan,31-05-2005,447252,Chhattisgarh,7,15,3,9,34,Fail
Kunal Reddy,24-01-2005,580417,Telangana,14,7,8,20,49,Fail
Peter Verma,09-05-2006,452635,Bihar,3,18,23,5,49,Pass
Raj Khan,28-09-2005,526046,Andhra Pradesh,7,21,18,22,68,Pass
Kunal Verma,12-05-2005,234699,West Bengal,10,18,6,16,50,Fail
Yash Reddy,07-12-2005,616221,Bihar,9,24,21,17,71,Pass
Raj Khan,30-09-2005,647279,Kerala,8,9,22,1,40,Fail
Aryan Pillai,15-11-2005,516185,Bihar,16,7,8,15,46,Pass
Aarav Khan,13-04-2006,421226,Maharashtra,4,11,15,1,31,Fail
Aryan Chopra,05-10-2005,430517,West Bengal,15,9,0,20,44,Fail
Aditya Khan,05-05-2006,416553,Maharashtra,21,23,8,7,59,Fail
Paul Chopra,10-12-2005,967113,Karnataka,23,13,22,13,71,Fail
Aditya Sharma,05-03-2006,294532,Madhya Pradesh,18,9,1,13,41,Fail
Raj Reddy,04-11-2005,425969,Haryana,24,0,15,4,43,Fail
Manpreet Sharma,16-03-2005,123546,Rajasthan,1,10,20,3,34,Pass
Rohan Khan,06-01-2006,223634,Kerala,24,14,21,3,62,Fail
Paul Fernandes,13-12-2005,206795,West Bengal,18,10,6,9,43,Fail
Ishaan Khan,23-12-2004,393244,Madhya Pradesh,24,21,8,5,58,Fail
Vivaan Pillai,10-08-2005,859493,Telangana,11,20,15,0,46,Fail
Krishna Verma,26-06-2005,179544,Tamil Nadu,24,24,12,13,73,Pass
Ishaan Khan,03-09-2005,364153,Assam,13,6,23,9,51,Fail
Aryan Fernandes,17-01-2005,334384,Odisha,15,12,12,5,44,Pass
Aarav Verma,28-02-2006,309651,Delhi,20,18,7,9,54,Fail
Vivaan Reddy,16-01-2005,336670,Jharkhand,17,21,14,2,54,Pass
Imran Khan,22-11-2004,611075,Gujarat,14,15,5,9,43,Fail
Aryan Reddy,30-08-2005,147590,Maharashtra,0,24,19,18,61,Fail
Kunal Reddy,04-01-2006,193722,Delhi,17,0,3,6,26,Fail
Rehan Verma,21-11-2005,505942,Daman & Diu / D&N Haveli,9,22,24,13,68,Fail
Raj Verma,07-10-2005,278713,Maharashtra,13,22,1,7,43,Fail
Aarav Singh,31-07-2005,677872,Tamil Nadu,15,20,20,8,63,Fail
John Fernandes,10-04-2006,710213,Andaman & Nicobar,8,24,14,10,56,Fail
Aditya Mehta,06-09-2005,274907,Uttar Pradesh,8,16,22,9,55,Fail
Mathew Sharma,03-09-2005,900200,Punjab,14,11,1,10,36,Pass
Ishaan Sharma,24-01-2005,616780,Tamil Nadu,22,7,5,16,50,Fail
Aarav Reddy,21-02-2006,917686,Punjab,6,10,7,12,35,Pass
Aarav Sharma,12-11-2004,176891,Uttar Pradesh,11,3,21,21,56,Fail
Aryan Fernandes,19-11-2005,196909,Gujarat,17,14,0,4,35,Fail
Sukhwinder Fernandes,09-01-2005,992458,Rajasthan,6,9,3,8,26,Pass
Yash Chopra,30-04-2006,746488,Tamil Nadu,18,2,17,0,37,Pass
Aryan Sharma,13-01-2006,919995,Punjab,10,1,7,5,23,Pass
Harjeet Mehta,07-01-2005,663408,Odisha,23,6,15,23,67,Fail
Balbir D'Souza,27-09-2005,256582,Bihar,10,20,11,2,43,Pass
Ayaan Fernandes,18-03-2006,229963,Andhra Pradesh,0,0,1,3,4,Pass
Raj Fernandes,21-02-2006,589878,Haryana,14,18,19,10,61,Fail
Krishna D'Souza,04-05-2005,409937,West Bengal,19,11,13,21,64,Fail
Aarav Verma,20-12-2004,414186,Tamil Nadu,10,9,17,17,53,Fail
Kunal Mehta,26-08-2005,452122,Daman & Diu / D&N Haveli,11,6,11,7,35,Fail
Balbir Sharma,13-02-2006,895281,Punjab,0,19,5,21,45,Fail
Yash Singh,19-10-2005,548552,Jharkhand,13,14,5,17,49,Pass
Raj Sharma,02-01-2005,594643,Uttar Pradesh,5,10,15,22,52,Fail
Manpreet D'Souza,10-03-2006,780964,Manipur,11,15,15,7,48,Fail
Gurpreet Pillai,26-03-2006,666043,Madhya Pradesh,16,18,9,13,56,Fail
Krishna Mehta,24-03-2006,284685,Kerala,11,7,13,19,50,Fail
Rohan Singh,27-04-2006,966713,Rajasthan,19,23,6,6,54,Pass
Peter Khan,24-12-2004,374396,Bihar,2,2,0,4,8,Pass
Aditya Pillai,11-12-2004,938630,Nagaland,10,11,5,5,31,Pass
Aarav Sharma,04-04-2005,894520,Assam,18,9,3,0,30,Fail
Aditya Sharma,02-08-2005,819611,Meghalaya,1,22,3,22,48,Fail
Vivaan Verma,31-10-2005,496249,Kerala,2,16,15,21,54,Fail
Peter Chopra,06-03-2005,580084,Gujarat,6,14,3,7,30,Fail
Aditya Chopra,06-01-2006,579275,Madhya Pradesh,13,21,0,18,52,Fail
Rehan Verma,22-12-2005,771230,Rajasthan,14,4,18,19,55,Pass
Gurpreet Singh,17-12-2004,740869,West Bengal,19,17,0,2,38,Fail
Sukhwinder Khan,09-01-2006,945291,Bihar,14,11,20,17,62,Pass
Balbir Reddy,20-12-2004,680396,West Bengal,19,21,18,9,67,Fail
Rohan Verma,10-03-2006,168948,Uttar Pradesh,4,13,22,19,58,Fail
Mathew Verma,13-04-2006,234553,Bihar,8,5,19,13,45,Pass
Aditya Chopra,24-06-2005,289195,Meghalaya,9,11,13,8,41,Pass
Kunal D'Souza,07-05-2006,553215,Bihar,3,11,13,16,43,Pass
Zaid Sharma,22-04-2006,230295,Bihar,2,16,23,15,56,Pass
Manpreet Mehta,02-02-2006,928710,Kerala,20,0,8,7,35,Fail
Mathew Sharma,24-03-2006,709508,Chhattisgarh,7,19,1,0,27,Fail
Kunal Chopra,01-05-2005,679664,Andhra Pradesh,2,0,20,16,38,Pass
Rohan Sharma,14-02-2005,687026,Uttar Pradesh,17,19,1,6,43,Fail
John Reddy,04-02-2005,195135,Uttar Pradesh,7,18,12,20,57,Fail
Vivaan Fernandes,01-02-2005,734519,Assam,13,4,2,16,35,Fail
Aryan Mehta,07-03-2005,760893,Andhra Pradesh,17,13,12,4,46,Pass
Krishna Singh,14-02-2005,834892,Bihar,22,13,11,4,50,Pass
Rohan Khan,18-04-2006,935942,Madhya Pradesh,10,7,14,15,46,Fail
Balbir Pillai,14-11-2005,932653,Assam,21,15,6,5,47,Fail
Zaid D'Souza,20-03-2006,522247,Andhra Pradesh,21,22,14,20,77,Pass
Mathew Fernandes,01-01-2005,625379,Madhya Pradesh,3,13,18,8,42,Fail
Kunal Mehta,18-11-2005,613640,Uttarakhand,19,11,16,18,64,Fail
Mathew Sharma,19-05-2005,320766,Haryana,7,10,8,9,34,Fail
Ishaan Mehta,27-04-2005,230983,West Bengal,24,4,12,10,50,Fail
Aryan Verma,23-10-2005,578089,Rajasthan,9,14,21,13,57,Pass
Sukhwinder Sharma,04-11-2005,845513,Puducherry,18,23,16,5,62,Fail
Kunal D'Souza,08-01-2006,299624,Bihar,13,15,0,7,35,Pass
Aditya Sharma,11-12-2004,815207,Uttar Pradesh,15,2,18,5,40,Fail
Yash D'Souza,28-02-2005,315588,Tamil Nadu,13,6,18,3,40,Pass
Vivaan Fernandes,21-09-2005,800606,Uttar Pradesh,12,9,17,3,41,Fail
Rohan Chopra,07-11-2005,615719,Assam,21,14,12,2,49,Fail
Raj Singh,25-02-2006,274315,Tamil Nadu,8,16,23,24,71,Pass
Yash Fernandes,28-04-2006,117194,Madhya Pradesh,8,17,18,11,54,Fail
Vivaan Fernandes,14-01-2005,381409,Jharkhand,15,20,23,3,61,Pass
Ishaan Singh,08-02-2006,722880,Himachal Pradesh,8,0,0,12,20,Pass
Aditya Singh,12-08-2005,805476,West Bengal,8,18,10,23,59,Fail
Farhan Pillai,21-12-2005,181903,Maharashtra,15,5,19,5,44,Fail
Manpreet Mehta,29-04-2005,708514,Madhya Pradesh,3,13,12,1,29,Fail
Manpreet Fernandes,02-06-2005,130050,West Bengal,3,10,10,0,23,Fail
Farhan Verma,22-04-2005,258191,Jharkhand,24,10,23,0,57,Pass
Farhan Singh,13-03-2005,569585,Rajasthan,4,1,21,24,50,Pass
Ishaan Mehta,09-04-2006,565406,Andhra Pradesh,16,24,18,11,69,Pass
Raj Verma,23-12-2004,199994,Bihar,18,14,5,9,46,Pass
Mathew Chopra,30-05-2005,604224,Karnataka,13,13,20,4,50,Pass
Vivaan Sharma,15-09-2005,931790,Haryana,1,15,1,16,33,Fail
Rehan Verma,01-04-2005,508642,Bihar,0,22,11,4,37,Pass
Kunal Singh,25-04-2006,594875,Bihar,0,3,4,18,25,Pass
Aditya Pillai,07-03-2006,104350,Uttar Pradesh,24,21,23,3,71,Fail
Aditya Verma,13-08-2005,316235,Chhattisgarh,7,11,11,24,53,Fail
Ishaan Sharma,09-02-2006,448073,Uttarakhand,15,5,21,19,60,Fail
Kunal Singh,15-09-2005,607581,Haryana,4,1,16,19,40,Fail
Krishna Chopra,28-09-2005,978163,Haryana,21,3,3,10,37,Fail
Raj Khan,19-01-2005,300713,West Bengal,1,9,4,24,38,Fail
John Khan,14-06-2005,219637,Assam,2,5,2,5,14,Fail
Gurpreet Singh,08-10-2005,201547,Rajasthan,2,0,0,11,13,Pass
John Singh,20-02-2006,538429,Uttar Pradesh,18,3,5,12,38,Fail
Aryan Reddy,23-04-2006,931580,Punjab,11,20,20,21,72,Fail
Yash Chopra,23-08-2005,775752,Uttar Pradesh,10,13,3,22,48,Fail
Balbir Verma,24-07-2005,575632,Rajasthan,24,24,17,3,68,Fail
Aryan Verma,06-04-2005,196912,Telangana,6,9,24,15,54,Fail
Rohan Chopra,28-08-2005,905585,Punjab,6,13,5,2,26,Pass
Gurpreet Khan,14-04-2005,745421,Tamil Nadu,20,4,14,16,54,Fail
Ishaan Reddy,26-01-2005,989950,Madhya Pradesh,1,22,24,19,66,Fail
Ishaan Singh,23-04-2005,287151,Maharashtra,21,16,6,5,48,Fail
Kunal Pillai,01-04-2006,700505,Maharashtra,10,14,19,12,55,Fail
David D'Souza,26-11-2004,673556,Haryana,17,8,13,3,41,Fail
Aditya Singh,07-02-2005,548030,Tripura,4,17,2,10,33,Fail
Sukhwinder Pillai,08-02-2005,412283,Punjab,2,19,5,10,36,Pass
Vivaan Sharma,19-04-2006,761297,Karnataka,18,24,20,15,77,Fail
Rohan Pillai,24-03-2005,448399,Odisha,2,0,8,7,17,Pass
Vivaan Chopra,01-12-2004,157813,Madhya Pradesh,13,24,21,12,70,Fail
Aarav Pillai,02-05-2005,403995,Himachal Pradesh,14,17,7,10,48,Pass
Kunal D'Souza,15-06-2005,994274,Chhattisgarh,11,8,21,24,64,Fail
Aarav Verma,05-10-2005,291089,Bihar,12,16,15,2,45,Pass
Yash Fernandes,16-10-2005,419543,West Bengal,0,4,10,20,34,Fail
Krishna Mehta,13-04-2005,574073,West Bengal,12,22,19,5,58,Fail
Sukhwinder Mehta,27-05-2005,204401,Telangana,16,9,15,22,62,Fail
Harjeet Verma,21-10-2005,372832,Maharashtra,10,23,23,9,65,Fail
Kunal Verma,04-05-2006,230276,Jharkhand,13,5,22,1,41,Pass
John Pillai,22-04-2005,746813,Jharkhand,20,15,22,4,61,Pass
Aditya Verma,22-01-2006,140637,Telangana,15,16,20,18,69,Fail
John Singh,29-04-2005,128662,Odisha,14,10,24,10,58,Fail
Kunal Mehta,24-10-2005,234627,Gujarat,14,11,1,11,37,Fail
Aarav Reddy,25-03-2006,886506,Tripura,4,23,12,18,57,Fail
Vivaan Singh,28-12-2004,518124,Maharashtra,0,11,3,8,22,Fail
Kunal Reddy,18-02-2006,768482,Uttar Pradesh,1,20,4,23,48,Fail
Raj Reddy,16-04-2006,232755,Madhya Pradesh,21,4,19,16,60,Fail
Gurpreet Fernandes,08-01-2005,854302,Karnataka,5,19,10,11,45,Pass
Vivaan Mehta,06-03-2006,608702,Rajasthan,22,7,22,19,70,Fail
Aditya Verma,02-01-2005,674000,West Bengal,21,7,17,8,53,Fail
Paul Reddy,30-12-2005,805402,Gujarat,16,1,20,12,49,Fail
Mathew Pillai,19-12-2005,279514,Madhya Pradesh,18,2,19,21,60,Fail
Krishna Chopra,28-11-2005,310522,Maharashtra,8,23,24,18,73,Fail
Ayaan Fernandes,03-08-2005,723783,Telangana,16,15,10,9,50,Fail
Aryan D'Souza,12-06-2005,859019,Punjab,24,4,11,23,62,Fail
Ayaan Pillai,01-07-2005,872178,Tamil Nadu,23,10,3,19,55,Fail
Kunal Singh,08-02-2006,587870,Bihar,7,1,18,10,36,Pass
Sukhwinder Pillai,02-02-2005,260855,Gujarat,0,23,9,3,35,Fail
Vivaan Fernandes,24-12-2004,865000,Punjab,14,2,16,15,47,Fail
Rohan Fernandes,28-10-2005,373756,Bihar,4,18,0,5,27,Pass
Raj Fernandes,03-02-2006,690510,Bihar,19,2,18,8,47,Pass
Harjeet D'Souza,03-03-2005,115784,West Bengal,2,9,22,17,50,Fail
Aarav D'Souza,04-08-2005,949279,Bihar,23,11,13,21,68,Pass
Raj Verma,17-06-2005,948235,Tamil Nadu,21,13,2,20,56,Pass
Aditya Fernandes,22-12-2005,393237,Chhattisgarh,12,9,23,18,62,Fail
Yash Singh,29-04-2005,382289,Rajasthan,13,13,22,6,54,Pass
Vivaan Chopra,29-04-2006,501268,Maharashtra,17,5,17,15,54,Fail
Aditya D'Souza,29-10-2005,133657,Rajasthan,20,9,20,7,56,Pass
Gurpreet Fernandes,16-01-2006,477772,Uttar Pradesh,8,4,0,16,28,Fail
Gurpreet Mehta,23-11-2004,142212,Maharashtra,13,11,19,2,45,Fail
Vivaan Pillai,03-08-2005,774459,West Bengal,14,13,1,8,36,Fail
Vivaan Fernandes,05-03-2006,700492,Rajasthan,21,3,0,17,41,Pass
Mathew Chopra,20-11-2005,464666,Bihar,11,8,5,2,26,Pass
Vivaan Fernandes,07-08-2005,719566,Maharashtra,3,4,8,12,27,Fail
Farhan Verma,10-08-2005,436251,Bihar,10,11,11,12,44,Pass
Mathew Mehta,12-11-2004,232779,Tamil Nadu,1,3,4,23,31,Pass
Krishna Verma,04-09-2005,500332,Tamil Nadu,9,9,3,4,25,Pass
Gurpreet D'Souza,16-11-2005,544973,Assam,17,15,13,10,55,Fail
Gurpreet Sharma,15-11-2004,356872,Madhya Pradesh,1,5,13,9,28,Fail
Aryan Sharma,14-03-2006,447777,Jharkhand,19,23,21,20,83,Fail
Sukhwinder Verma,03-05-2005,388681,Madhya Pradesh,24,0,0,11,35,Fail
Raj Reddy,10-02-2006,474262,Rajasthan,5,12,11,9,37,Pass
Aryan Sharma,19-03-2005,382054,Himachal Pradesh,15,1,23,10,49,Pass
Aditya D'Souza,19-11-2004,414459,Uttar Pradesh,22,2,15,7,46,Fail
Yash Sharma,13-03-2006,924000,Bihar,19,4,9,16,48,Pass
Manpreet Reddy,28-03-2006,604075,Bihar,1,5,18,10,34,Pass
Aarav Pillai,01-05-2006,647445,Uttar Pradesh,15,10,10,11,46,Fail
Balbir Khan,09-12-2004,988823,Delhi,21,17,9,5,52,Fail
Peter Mehta,28-05-2005,729381,Arunachal Pradesh,4,13,4,23,44,Fail
Aryan Pillai,15-03-2005,111408,West Bengal,4,11,5,1,21,Fail
Raj Fernandes,17-04-2005,130397,Telangana,9,2,13,6,30,Fail
Imran Singh,17-02-2005,814211,West Bengal,22,9,16,3,50,Fail
Balbir Singh,27-09-2005,395864,Maharashtra,1,14,11,14,40,Fail
Mathew Chopra,16-12-2004,634052,Uttarakhand,1,20,19,20,60,Fail
Vivaan Verma,11-08-2005,931417,Bihar,9,21,22,19,71,Pass
Ishaan Khan,26-05-2005,760795,Punjab,2,14,9,0,25,Pass
Kunal Pillai,21-07-2005,238836,Telangana,15,12,16,22,65,Fail
Krishna Verma,22-12-2004,171081,Madhya Pradesh,16,0,5,10,31,Fail
Aryan Khan,07-05-2005,787874,Haryana,8,23,14,2,47,Fail
Ishaan Mehta,12-12-2005,815273,Tamil Nadu,20,4,6,1,31,Pass
Aryan Reddy,05-10-2005,657898,Gujarat,13,17,1,22,53,Fail
Raj Mehta,02-03-2006,548791,Chhattisgarh,15,11,5,24,55,Fail
Raj Chopra,04-02-2006,693702,Punjab,11,8,19,4,42,Pass
Kunal Chopra,08-12-2004,465353,Bihar,13,21,17,13,64,Pass
Zaid Fernandes,07-01-2006,550737,Bihar,24,9,0,21,54,Pass
Vivaan Mehta,19-04-2005,986588,Chhattisgarh,0,7,1,9,17,Fail
Rohan Reddy,27-11-2004,330967,Tamil Nadu,20,22,0,11,53,Fail
Ishaan Reddy,16-05-2005,684245,Punjab,22,6,15,12,55,Fail
Raj Sharma,02-08-2005,228740,Andhra Pradesh,4,20,3,8,35,Pass
Balbir Sharma,10-07-2005,166432,Bihar,15,14,19,8,56,Pass
Krishna Fernandes,28-04-2006,564949,Rajasthan,17,8,15,7,47,Pass
Vivaan D'Souza,24-03-2006,643605,Maharashtra,1,11,7,14,33,Fail
Aryan Khan,08-10-2005,256725,Bihar,9,7,9,13,38,Pass
Aarav Chopra,30-04-2005,334509,Jharkhand,17,6,14,19,56,Pass
Yash Pillai,09-07-2005,220351,Rajasthan,19,14,18,6,57,Pass
Sukhwinder Fernandes,29-12-2004,763343,Madhya Pradesh,9,12,8,19,48,Fail
Aditya Pillai,22-09-2005,292426,Uttar Pradesh,16,5,6,5,32,Fail
Farhan Fernandes,02-04-2006,812855,Rajasthan,17,21,11,2,51,Pass
Aryan D'Souza,08-05-2006,347689,Gujarat,9,2,14,12,37,Fail
Yash Reddy,16-06-2005,673979,Andhra Pradesh,14,18,4,23,59,Pass
Ishaan D'Souza,08-12-2005,953246,Maharashtra,2,2,15,0,19,Fail
Yash Verma,29-03-2005,744013,West Bengal,0,9,8,10,27,Fail
Krishna D'Souza,31-08-2005,709924,Tamil Nadu,19,6,24,7,56,Pass
Krishna Fernandes,30-09-2005,876101,Assam,4,3,21,1,29,Fail
Krishna Singh,04-03-2006,885522,Jharkhand,11,10,1,8,30,Pass
Aarav Pillai,01-06-2005,558382,Gujarat,14,22,9,12,57,Fail
Aryan Singh,12-11-2005,263462,Jharkhand,24,3,2,19,48,Pass
Yash Chopra,31-12-2004,706031,Gujarat,24,17,0,6,47,Fail
Aditya Pillai,06-01-2005,584329,Uttar Pradesh,20,15,18,1,54,Fail
Rohan Khan,21-10-2005,592252,Maharashtra,4,20,16,21,61,Fail
Harjeet Sharma,26-02-2006,540590,Telangana,18,15,4,10,47,Fail
Balbir Chopra,17-02-2005,807511,Telangana,1,1,13,23,38,Fail
Rohan Singh,01-12-2005,634267,Gujarat,4,15,0,24,43,Fail
Vivaan Pillai,24-09-2005,506856,Rajasthan,9,16,15,0,40,Pass
Aryan Mehta,14-09-2005,860078,Punjab,24,3,23,14,64,Fail
Aarav Chopra,16-03-2006,137499,Uttar Pradesh,14,6,1,1,22,Fail
Rohan Fernandes,08-11-2005,603331,Jammu & Kashmir + Ladakh,1,1,10,11,23,Pass
Aryan Khan,20-04-2006,245738,Nagaland,5,24,17,5,51,Fail
Yash Pillai,09-12-2005,585824,Uttar Pradesh,11,3,7,2,23,Fail
Ishaan Khan,26-09-2005,911492,Telangana,17,20,11,8,56,Fail
Rohan Pillai,25-09-2005,969198,Uttar Pradesh,21,4,15,20,60,Fail
Aarav D'Souza,09-08-2005,209718,Maharashtra,7,4,14,3,28,Fail
Krishna Fernandes,06-01-2005,732032,Chhattisgarh,13,1,8,20,42,Fail
Balbir Sharma,22-10-2005,220343,Uttar Pradesh,18,19,5,21,63,Fail
Krishna Sharma,07-09-2005,759189,Bihar,13,10,22,22,67,Pass
Rohan Fernandes,17-04-2006,586046,Punjab,12,1,23,15,51,Fail
Kunal D'Souza,26-06-2005,254036,Punjab,8,0,14,4,26,Pass
Manpreet Verma,02-03-2005,888484,Madhya Pradesh,11,19,6,24,60,Fail
Kunal Chopra,02-12-2004,608476,Maharashtra,6,13,1,6,26,Fail
Kunal Reddy,03-01-2005,353377,Jharkhand,17,19,1,20,57,Pass
Kunal Khan,05-07-2005,162315,Delhi,5,18,8,6,37,Fail
Harjeet Verma,09-03-2005,287698,Bihar,9,1,7,14,31,Pass
Aditya Singh,18-01-2006,675041,Gujarat,17,10,0,22,49,Fail
Rohan Reddy,02-08-2005,389280,Bihar,11,1,20,17,49,Pass
Rohan Sharma,11-12-2005,560482,Uttar Pradesh,5,15,6,0,26,Fail
Gurpreet Mehta,27-11-2005,770879,Mizoram,6,23,2,2,33,Pass
Raj Sharma,05-12-2005,991982,Andhra Pradesh,13,2,2,9,26,Pass
Krishna Reddy,17-04-2006,858076,Uttarakhand,20,10,12,14,56,Fail
Imran Mehta,23-02-2005,811977,Bihar,4,16,11,14,45,Pass
Aryan Sharma,04-08-2005,396387,Manipur,24,3,17,21,65,Fail
Balbir Mehta,02-12-2004,518762,Rajasthan,15,21,3,18,57,Pass
Yash Pillai,27-12-2005,289400,Assam,5,18,4,8,35,Fail
Rohan Verma,14-11-2005,406108,Arunachal Pradesh,22,15,9,21,67,Fail
Rohan D'Souza,23-08-2005,991142,Rajasthan,22,18,9,5,54,Pass
Aryan Mehta,14-02-2006,420789,Haryana,14,18,17,15,64,Fail
Aryan Reddy,12-08-2005,315279,Jharkhand,1,11,15,11,38,Pass
Manpreet Sharma,22-12-2005,753445,Telangana,1,2,23,15,41,Fail
David Singh,03-05-2006,552379,Kerala,4,13,9,1,27,Fail
Sukhwinder Chopra,30-09-2005,182490,West Bengal,15,5,18,13,51,Fail
John Singh,31-03-2005,958202,Kerala,10,12,5,12,39,Fail
Aditya Khan,26-04-2005,165177,Bihar,4,3,8,12,27,Pass
Gurpreet Khan,25-08-2005,928051,Haryana,14,16,4,15,49,Fail
Ishaan Reddy,16-12-2004,383322,Rajasthan,18,18,6,17,59,Pass
Balbir D'Souza,12-11-2004,572927,Uttar Pradesh,13,8,3,2,26,Fail
Vivaan Khan,02-08-2005,254155,Manipur,3,20,8,15,46,Fail
Aryan Singh,23-06-2005,141768,Tamil Nadu,20,23,16,6,65,Pass
Ishaan Reddy,05-02-2005,161792,Telangana,21,14,18,14,67,Fail
Aditya Singh,19-03-2005,255921,Maharashtra,13,0,11,7,31,Fail
Krishna Mehta,24-02-2006,790354,Maharashtra,10,10,15,7,42,Fail
Raj Khan,07-04-2005,862506,Maharashtra,22,1,16,4,43,Fail
Yash Singh,19-05-2005,813524,Haryana,18,12,20,6,56,Fail
Ishaan Khan,08-01-2006,998041,Tamil Nadu,19,22,18,21,80,Pass
Aryan Fernandes,26-01-2006,706851,Haryana,4,11,10,24,49,Fail
Rohan Reddy,12-12-2005,825110,Madhya Pradesh,6,1,24,22,53,Fail
Kunal Sharma,01-01-2005,515542,Haryana,0,6,5,18,29,Fail
Ishaan Chopra,12-02-2006,504894,Odisha,19,8,15,7,49,Fail
Aditya Verma,29-05-2005,794665,Andhra Pradesh,9,6,20,1,36,Pass
Krishna Chopra,12-01-2005,841803,Bihar,4,23,17,4,48,Pass
Raj Pillai,08-03-2005,153176,Rajasthan,15,1,3,3,22,Pass
Zaid D'Souza,01-04-2005,190001,Assam,9,15,12,5,41,Fail
Aditya Fernandes,03-05-2005,923248,Haryana,23,16,24,10,73,Fail
Kunal Khan,17-11-2005,202117,Punjab,6,20,5,8,39,Pass
Mathew Reddy,14-11-2005,811557,Bihar,23,9,9,14,55,Pass
Krishna Mehta,22-08-2005,730519,Karnataka,21,24,17,24,86,Fail
Sukhwinder Sharma,11-12-2004,140180,Tamil Nadu,10,4,4,4,22,Pass
John Fernandes,29-04-2005,111844,Odisha,2,18,9,18,47,Fail
Harjeet Khan,27-01-2005,517391,West Bengal,16,20,23,5,64,Fail
Aditya Mehta,30-01-2006,486221,Bihar,8,9,5,17,39,Pass
Vivaan Fernandes,21-06-2005,841564,Punjab,6,1,14,2,23,Pass
Krishna Sharma,20-10-2005,724530,Andhra Pradesh,5,5,20,7,37,Pass
Harjeet Reddy,05-07-2005,452264,Madhya Pradesh,11,4,7,24,46,Fail
Vivaan D'Souza,28-12-2005,821079,Gujarat,13,23,17,11,64,Fail
Aarav D'Souza,02-08-2005,206941,Uttar Pradesh,5,5,4,3,17,Fail
Yash Khan,08-03-2006,229540,Jharkhand,20,22,18,4,64,Pass
Raj Khan,10-01-2006,499129,Haryana,5,14,17,23,59,Fail
Ishaan Mehta,17-11-2004,799915,Kerala,11,18,8,18,55,Fail
Aditya Mehta,05-01-2005,954066,Bihar,19,8,12,4,43,Pass
Aditya Sharma,22-04-2006,336837,Bihar,16,19,23,16,74,Pass
Aarav Khan,25-07-2005,119451,Telangana,9,3,18,18,48,Fail
Aditya Mehta,25-02-2005,121274,Andhra Pradesh,21,10,3,12,46,Pass
Ishaan Pillai,16-10-2005,212348,Andhra Pradesh,19,4,24,6,53,Pass
Raj Pillai,30-11-2004,655098,Uttar Pradesh,16,3,17,2,38,Fail
Raj Mehta,23-07-2005,555933,Karnataka,0,12,4,7,23,Pass
Mathew Verma,18-05-2005,571991,Madhya Pradesh,11,24,5,8,48,Fail
Mathew Pillai,14-02-2005,318160,Uttar Pradesh,14,22,22,22,80,Fail
Ishaan Verma,04-03-2006,165572,Odisha,5,19,18,16,58,Fail
Aditya Pillai,17-12-2004,265465,Odisha,9,9,16,23,57,Fail
Sukhwinder Mehta,23-01-2006,866482,Uttar Pradesh,16,9,18,5,48,Fail
Kunal Verma,01-02-2005,173478,Delhi,6,17,8,7,38,Fail
Rehan Chopra,08-12-2005,645553,Mizoram,19,2,2,18,41,Pass
Aditya Fernandes,28-02-2006,751056,Jammu & Kashmir + Ladakh,10,14,14,11,49,Pass
Ayaan Sharma,12-06-2005,678810,Delhi,23,15,13,4,55,Fail
Raj Reddy,02-03-2005,507881,Tamil Nadu,2,3,20,6,31,Pass
Krishna Chopra,14-10-2005,595013,Bihar,2,2,19,12,35,Pass
Gurpreet D'Souza,03-11-2005,525646,Maharashtra,3,0,12,8,23,Fail
Zaid Fernandes,24-11-2004,591891,Punjab,1,9,18,9,37,Pass
Aditya Reddy,21-04-2006,757043,Rajasthan,23,7,5,24,59,Pass
Yash Mehta,10-02-2005,796995,West Bengal,24,5,10,12,51,Fail
Yash Singh,19-12-2005,815666,Uttar Pradesh,10,18,21,13,62,Fail
Harjeet Reddy,16-07-2005,557892,Uttar Pradesh,15,24,0,9,48,Fail
Ishaan Pillai,12-12-2004,286160,Bihar,7,0,4,9,20,Pass
Peter Chopra,14-09-2005,789824,Jharkhand,13,24,17,5,59,Pass
Yash D'Souza,16-06-2005,695781,Uttar Pradesh,15,22,1,23,61,Fail
Zaid Pillai,29-03-2005,238860,Gujarat,12,6,13,18,49,Fail
Aarav Reddy,13-11-2004,940496,Assam,2,16,15,5,38,Fail
Vivaan Pillai,26-12-2005,481597,Delhi,17,18,7,15,57,Fail
Krishna D'Souza,29-01-2005,726656,Chhattisgarh,22,24,4,2,52,Fail
Ishaan Reddy,17-08-2005,695996,Rajasthan,12,22,4,23,61,Fail
Harjeet Sharma,07-03-2006,879944,West Bengal,2,11,24,4,41,Fail
Manpreet Sharma,07-05-2006,258840,West Bengal,9,12,16,15,52,Fail
Peter D'Souza,29-05-2005,839468,Maharashtra,4,24,6,12,46,Fail
Aarav Verma,08-02-2006,100453,Rajasthan,1,3,11,20,35,Pass
Gurpreet Singh,19-02-2005,122471,Bihar,7,6,7,15,35,Pass
Raj Mehta,25-02-2005,358945,Punjab,18,0,4,7,29,Pass
Aryan Sharma,01-03-2006,280964,Himachal Pradesh,11,17,11,23,62,Pass
Vivaan D'Souza,11-11-2005,827285,Uttar Pradesh,4,13,22,0,39,Fail
Rohan Fernandes,26-12-2005,528838,Nagaland,2,16,10,7,35,Pass
Vivaan Fernandes,25-10-2005,998657,Andhra Pradesh,0,20,18,15,53,Pass
Vivaan D'Souza,15-03-2006,450361,Rajasthan,8,10,15,16,49,Pass
Sukhwinder Fernandes,27-03-2005,427304,Delhi,22,10,9,21,62,Fail
Krishna Pillai,15-11-2004,889687,Rajasthan,24,6,13,15,58,Pass
John Sharma,08-04-2005,965136,Bihar,14,18,0,20,52,Pass
Yash Singh,13-11-2005,763815,West Bengal,21,5,12,2,40,Fail
Manpreet Pillai,12-03-2005,241731,Madhya Pradesh,8,9,7,4,28,Fail
Raj Sharma,12-12-2005,699592,Rajasthan,1,23,5,23,52,Pass
Mathew Verma,15-04-2005,487312,Bihar,5,13,16,21,55,Pass
Aarav D'Souza,19-02-2005,103852,Odisha,13,2,13,14,42,Pass
Aarav Reddy,22-01-2006,837585,Madhya Pradesh,14,0,8,10,32,Fail
Paul Singh,08-05-2006,932050,Meghalaya,15,9,4,23,51,Fail
Kunal Khan,11-07-2005,784577,Punjab,11,17,13,18,59,Fail
Vivaan Singh,06-04-2005,615049,Bihar,9,21,1,24,55,Pass
Vivaan Mehta,18-01-2006,159155,Assam,14,5,19,14,52,Fail
Kunal Reddy,16-04-2005,225918,Rajasthan,1,4,4,1,10,Pass
Sukhwinder Verma,11-04-2005,260751,West Bengal,13,13,16,2,44,Fail
Kunal Reddy,27-01-2005,528803,Maharashtra,14,13,0,19,46,Fail
Peter Chopra,12-01-2005,805122,Andhra Pradesh,21,7,9,8,45,Pass
Gurpreet Chopra,19-05-2005,152043,Madhya Pradesh,12,13,4,16,45,Fail
Vivaan Singh,15-03-2006,995104,Meghalaya,7,4,11,20,42,Pass
Gurpreet Chopra,02-02-2006,684116,Telangana,19,22,2,23,66,Fail
Aarav Reddy,02-02-2006,157873,Madhya Pradesh,3,24,8,12,47,Fail
Paul Mehta,03-06-2005,900091,Andhra Pradesh,1,3,9,2,15,Pass
Manpreet Verma,21-03-2006,634943,Bihar,18,16,9,15,58,Pass
Ishaan D'Souza,01-04-2006,312136,Jharkhand,6,13,6,20,45,Pass
Gurpreet Chopra,18-03-2005,439897,Bihar,12,2,8,6,28,Pass
Krishna Mehta,21-11-2004,376277,West Bengal,17,13,11,17,58,Fail
Aditya Khan,12-10-2005,760163,Bihar,6,14,3,8,31,Pass
Rohan D'Souza,29-06-2005,845591,Bihar,4,6,9,16,35,Pass
Krishna Fernandes,19-05-2005,181138,Tamil Nadu,20,4,10,11,45,Fail
Aarav Reddy,18-02-2006,100285,Haryana,18,18,7,22,65,Fail
Ishaan D'Souza,21-02-2005,914046,Telangana,20,0,24,13,57,Fail
Rohan Sharma,01-01-2006,960401,Bihar,16,24,13,5,58,Pass
Rohan Verma,21-10-2005,833408,Madhya Pradesh,22,5,1,24,52,Fail
Manpreet Reddy,15-08-2005,793253,Chhattisgarh,0,21,22,20,63,Fail
Aryan Reddy,26-11-2004,659998,West Bengal,4,19,13,22,58,Fail
Vivaan Verma,02-05-2006,215548,Madhya Pradesh,0,9,9,21,39,Fail
Sukhwinder Chopra,26-11-2005,555332,Rajasthan,13,9,2,20,44,Pass
Peter Verma,01-03-2005,405370,Bihar,13,4,21,9,47,Pass
Raj Singh,16-11-2005,451221,Maharashtra,3,6,17,10,36,Fail
Aarav Pillai,22-05-2005,264783,Uttar Pradesh,21,24,23,16,84,Fail
Aditya Singh,24-07-2005,577061,Uttar Pradesh,17,12,5,11,45,Fail
Kunal Chopra,25-03-2006,417375,Jharkhand,1,21,3,9,34,Pass
Aryan Reddy,25-10-2005,191672,Rajasthan,16,2,5,15,38,Pass
Farhan Singh,09-07-2005,356878,Haryana,19,6,1,7,33,Fail
Manpreet Mehta,31-01-2005,284338,Rajasthan,9,1,7,24,41,Pass
Kunal Pillai,10-01-2006,463223,Andhra Pradesh,15,11,24,18,68,Pass
Raj Pillai,14-06-2005,327701,Uttar Pradesh,2,11,15,21,49,Fail
Gurpreet Singh,19-11-2004,740397,Bihar,10,2,16,9,37,Pass
Rohan Reddy,12-01-2006,601133,Bihar,3,7,4,22,36,Pass
Aryan Fernandes,28-08-2005,118934,Puducherry,20,2,10,4,36,Pass
Ishaan D'Souza,29-04-2005,275516,Jammu & Kashmir + Ladakh,19,21,3,0,43,Pass
Aryan Sharma,11-04-2005,620090,Punjab,22,9,19,4,54,Fail
Mathew Sharma,31-07-2005,280662,Uttar Pradesh,22,22,9,0,53,Fail
Ishaan Fernandes,27-02-2006,616480,Uttar Pradesh,0,0,9,2,11,Fail
Ishaan Verma,29-09-2005,968350,Maharashtra,12,14,14,19,59,Fail
Rehan Reddy,04-02-2005,850050,Karnataka,16,5,5,9,35,Pass
Zaid Sharma,04-05-2006,726982,Odisha,4,7,15,12,38,Pass
Vivaan Fernandes,07-02-2005,620825,Mizoram,20,14,7,13,54,Fail
Vivaan Sharma,14-04-2005,270174,Kerala,24,3,10,7,44,Fail
Sukhwinder Khan,25-11-2004,509503,Sikkim,11,18,22,21,72,Fail
Rohan D'Souza,30-09-2005,256486,Telangana,6,18,7,20,51,Fail
Krishna Verma,26-06-2005,551027,Bihar,12,12,0,20,44,Pass
Farhan D'Souza,14-02-2006,966197,Rajasthan,7,17,19,1,44,Pass
Aditya Verma,02-04-2005,527871,Tamil Nadu,3,20,2,15,40,Pass
Aarav Verma,28-04-2005,402954,Madhya Pradesh,13,15,23,17,68,Fail
Vivaan Khan,18-06-2005,569801,Haryana,4,19,18,5,46,Fail
Rohan D'Souza,30-04-2005,639599,Telangana,19,17,15,0,51,Fail
Yash Sharma,23-12-2004,605695,Kerala,8,18,10,21,57,Fail
Balbir Fernandes,23-04-2006,553309,Chhattisgarh,1,3,15,21,40,Fail
Ishaan Chopra,07-11-2005,934284,Punjab,2,13,6,8,29,Pass
John Fernandes,10-10-2005,166367,Madhya Pradesh,21,20,5,13,59,Fail
Aditya Verma,12-11-2004,432698,Meghalaya,22,12,8,5,47,Fail
Krishna Reddy,19-03-2005,286193,Uttar Pradesh,23,11,0,9,43,Fail
Peter Fernandes,27-02-2005,776266,Chhattisgarh,24,18,8,16,66,Fail
Manpreet Singh,10-11-2004,585712,Chhattisgarh,5,4,15,0,24,Fail
Vivaan Reddy,06-02-2005,497284,Madhya Pradesh,19,22,1,24,66,Fail
Aditya Singh,25-12-2004,414855,Karnataka,18,18,20,5,61,Pass
Vivaan Reddy,23-11-2004,842526,Uttar Pradesh,10,10,24,1,45,Fail
Krishna D'Souza,06-03-2005,986565,Uttar Pradesh,11,2,3,4,20,Fail
Raj Chopra,31-12-2004,906116,Maharashtra,7,17,3,22,49,Fail
Gurpreet Verma,01-12-2005,891717,Tamil Nadu,3,24,18,7,52,Fail
Manpreet Pillai,21-10-2005,154249,Uttar Pradesh,20,11,7,19,57,Fail
Rehan Fernandes,30-01-2005,870892,Haryana,8,9,3,0,20,Fail
Ishaan Singh,05-05-2006,415776,Uttar Pradesh,13,12,17,4,46,Fail
Aditya D'Souza,09-11-2005,760294,Gujarat,1,6,24,15,46,Fail
Vivaan D'Souza,27-12-2005,932488,West Bengal,15,12,20,3,50,Fail
Manpreet Reddy,28-02-2005,734201,Andhra Pradesh,9,23,19,11,62,Pass
Aryan Khan,19-10-2005,917747,Haryana,22,17,3,13,55,Fail
Aryan Fernandes,28-02-2005,503200,Punjab,14,12,20,11,57,Fail
Krishna Sharma,04-05-2005,327141,West Bengal,6,7,9,4,26,Fail
Balbir D'Souza,25-02-2006,437222,Jammu & Kashmir + Ladakh,16,20,8,4,48,Pass
David Sharma,19-02-2006,921509,Tripura,3,5,17,8,33,Fail
Aditya Reddy,05-06-2005,113781,Andhra Pradesh,20,23,14,20,77,Pass
Aarav Pillai,07-03-2006,568074,Bihar,24,15,5,14,58,Pass
Vivaan Fernandes,19-01-2006,318773,Uttar Pradesh,1,13,18,20,52,Fail
Raj D'Souza,30-04-2005,434114,Madhya Pradesh,6,4,11,15,36,Fail
Vivaan Singh,03-11-2005,265275,West Bengal,4,2,6,0,12,Pass
Rohan Singh,31-10-2005,429072,Maharashtra,23,18,0,2,43,Fail
Aryan Chopra,05-09-2005,976350,Uttar Pradesh,22,13,16,19,70,Fail
Paul Pillai,10-04-2006,486345,Andhra Pradesh,0,10,16,19,45,Pass
Aarav Verma,24-01-2005,565116,Bihar,2,24,20,9,55,Pass
Zaid Fernandes,11-11-2004,130590,Madhya Pradesh,16,7,0,8,31,Fail
Aryan Singh,26-07-2005,692984,Haryana,13,6,7,3,29,Fail
Ishaan Fernandes,05-05-2006,254491,Jammu & Kashmir + Ladakh,12,20,7,14,53,Pass
Ayaan Sharma,16-01-2005,542523,Odisha,10,4,6,23,43,Pass
Yash Khan,22-07-2005,831540,Bihar,18,12,15,0,45,Pass
Krishna D'Souza,16-09-2005,592966,Telangana,24,1,24,18,67,Fail
Paul Fernandes,25-01-2006,919853,West Bengal,10,3,18,24,55,Pass
Aarav Reddy,06-10-2005,793565,Assam,6,12,6,19,43,Fail
Kunal Pillai,08-01-2005,560971,Jharkhand,17,17,23,24,81,Fail
David Reddy,15-01-2005,563982,Gujarat,4,23,22,21,70,Fail
Kunal D'Souza,26-02-2006,275900,Gujarat,5,4,0,7,16,Fail
Rehan Verma,10-01-2005,321339,Madhya Pradesh,7,12,12,9,40,Fail
Aditya Verma,18-03-2005,920803,Uttarakhand,20,9,6,9,44,Fail
Aditya Verma,25-07-2005,937181,Gujarat,23,12,12,20,67,Fail
Balbir Mehta,20-10-2005,154024,Kerala,4,6,15,6,31,Fail
Harjeet Mehta,04-08-2005,604449,Uttar Pradesh,12,2,14,7,35,Fail
Ishaan Mehta,02-04-2006,256631,Maharashtra,3,8,17,1,29,Fail
Yash Mehta,29-09-2005,106695,West Bengal,20,3,22,5,50,Pass
Aarav Mehta,26-10-2005,577511,Gujarat,11,22,10,3,46,Fail
Vivaan Sharma,25-11-2004,470330,Maharashtra,3,2,17,4,26,Fail
Zaid Reddy,22-07-2005,452232,Maharashtra,9,7,3,21,40,Fail
Yash Sharma,27-07-2005,393974,Madhya Pradesh,2,20,22,8,52,Fail
Balbir Verma,21-12-2004,985694,Uttar Pradesh,3,5,8,9,25,Fail
Peter Sharma,25-02-2006,312022,Punjab,4,7,22,17,50,Fail
Ayaan Khan,13-01-2006,659532,Maharashtra,22,22,17,0,61,Fail
Raj Mehta,23-12-2005,329170,Rajasthan,23,22,14,11,70,Fail
Kunal D'Souza,08-10-2005,637806,Mizoram,6,12,12,22,52,Fail
Rehan Fernandes,24-02-2006,735009,Karnataka,14,21,20,21,76,Fail
Paul Reddy,17-11-2004,963011,Punjab,10,1,22,19,52,Fail
Raj Fernandes,02-03-2005,252316,Andhra Pradesh,17,20,7,14,58,Pass
Ishaan Singh,03-07-2005,588883,Haryana,13,14,0,24,51,Fail
Yash Pillai,24-08-2005,851556,Rajasthan,16,4,20,14,54,Pass
Raj Reddy,10-07-2005,527684,Uttar Pradesh,20,9,10,11,50,Fail
Aarav Chopra,16-11-2005,396923,West Bengal,0,4,19,13,36,Pass
Raj Reddy,04-04-2005,855287,Rajasthan,17,18,6,24,65,Fail
Aditya D'Souza,09-03-2005,880068,Rajasthan,23,19,18,23,83,Pass
Raj Verma,03-08-2005,195618,Jharkhand,17,22,16,11,66,Pass
Rohan Chopra,11-08-2005,697565,Bihar,7,16,21,19,63,Pass
Ishaan Pillai,25-02-2006,357155,Uttar Pradesh,7,14,24,24,69,Fail
Yash Mehta,22-03-2005,108169,Bihar,6,20,14,19,59,Pass
Rohan Sharma,14-10-2005,834604,Tamil Nadu,22,1,11,11,45,Fail
Harjeet Mehta,06-10-2005,260623,Uttar Pradesh,0,11,10,11,32,Fail
David Sharma,08-07-2005,338238,Rajasthan,5,6,15,5,31,Pass
Yash Chopra,24-06-2005,185179,Assam,4,11,7,23,45,Fail
Harjeet Verma,14-01-2005,642352,Uttarakhand,11,11,7,17,46,Fail
Aryan Pillai,05-02-2005,928671,Telangana,16,13,18,4,51,Fail
Sukhwinder Pillai,08-12-2005,974521,Rajasthan,6,5,13,15,39,Pass
Raj Chopra,07-05-2005,904406,Maharashtra,23,3,5,19,50,Fail
Rehan D'Souza,31-12-2004,414785,Himachal Pradesh,7,5,12,9,33,Pass
Aryan Singh,13-11-2004,994847,Assam,23,21,17,11,72,Fail
Kunal Mehta,24-02-2006,969478,Gujarat,11,11,7,11,40,Fail
Raj Reddy,12-10-2005,404865,Uttar Pradesh,22,12,22,23,79,Fail
Aditya Fernandes,10-03-2005,281427,Rajasthan,16,21,4,13,54,Pass
Harjeet Mehta,28-03-2006,831984,Himachal Pradesh,13,7,19,15,54,Pass
Aditya Chopra,07-12-2004,515734,Bihar,8,11,11,18,48,Pass
Rohan Chopra,05-10-2005,422379,Goa,7,20,21,18,66,Fail
Sukhwinder Sharma,21-07-2005,357657,Tamil Nadu,23,2,9,11,45,Fail
Peter Pillai,17-02-2006,472629,Gujarat,3,11,11,10,35,Fail
Vivaan Pillai,10-03-2005,213306,Haryana,1,16,6,12,35,Fail
Rohan Verma,04-08-2005,905047,Madhya Pradesh,20,22,5,18,65,Fail
Ishaan Singh,23-04-2006,563937,Jharkhand,13,9,14,10,46,Pass
Raj Verma,03-01-2006,368507,Meghalaya,16,21,20,12,69,Fail
Aditya Pillai,20-05-2005,110168,Madhya Pradesh,7,17,7,0,31,Fail
Rehan Verma,08-01-2005,847614,Andhra Pradesh,5,4,23,20,52,Pass
Imran Mehta,06-11-2005,538640,Madhya Pradesh,6,15,12,18,51,Fail
Aryan Pillai,22-08-2005,291888,Bihar,19,22,9,16,66,Pass
Aditya Verma,09-05-2006,312707,Uttar Pradesh,21,20,7,21,69,Fail
Yash Sharma,19-12-2004,117761,Rajasthan,12,4,11,11,38,Pass
John D'Souza,22-01-2006,479699,Haryana,23,7,22,7,59,Fail
Sukhwinder Mehta,18-12-2004,150579,Uttar Pradesh,16,18,11,9,54,Fail
Balbir Khan,22-06-2005,717492,West Bengal,12,11,12,1,36,Pass
Vivaan Singh,13-11-2004,664782,Uttar Pradesh,14,1,2,5,22,Fail
Yash Reddy,27-12-2005,341069,Karnataka,11,20,4,8,43,Pass
Imran Khan,20-02-2006,328959,Jharkhand,12,6,24,14,56,Pass
Aditya Chopra,26-02-2006,965429,Jharkhand,4,23,21,18,66,Pass
Aryan Chopra,13-06-2005,904177,Himachal Pradesh,7,1,22,9,39,Pass
Aarav Singh,16-10-2005,441994,Andhra Pradesh,21,5,17,17,60,Pass
Rohan Verma,19-08-2005,651124,Maharashtra,20,0,22,13,55,Fail
Ishaan Singh,01-12-2005,339517,Bihar,2,22,12,11,47,Pass
Aarav Verma,22-10-2005,210717,Maharashtra,7,19,17,6,49,Fail
Raj Sharma,24-02-2006,860936,Madhya Pradesh,10,5,20,20,55,Fail
David Chopra,21-03-2006,669402,West Bengal,14,8,18,11,51,Pass
Harjeet D'Souza,15-07-2005,592273,Uttar Pradesh,18,16,15,5,54,Fail
Ishaan D'Souza,15-07-2005,360253,Tamil Nadu,17,10,16,2,45,Fail
Ishaan Mehta,26-02-2006,125735,Bihar,1,24,24,5,54,Pass
Raj Singh,20-01-2006,181732,Rajasthan,15,3,7,17,42,Pass
Paul Verma,05-11-2005,697169,Madhya Pradesh,8,12,14,22,56,Fail
Manpreet Chopra,23-05-2005,477221,Maharashtra,9,23,12,22,66,Fail
Aryan Fernandes,08-10-2005,716506,Bihar,2,20,19,9,50,Pass
Mathew Reddy,29-08-2005,207697,Rajasthan,16,15,11,21,63,Fail
Aditya Pillai,08-03-2005,884180,Kerala,9,20,9,13,51,Fail
Balbir Reddy,21-09-2005,648607,Rajasthan,12,7,23,17,59,Pass
Raj Pillai,28-11-2005,510754,Punjab,2,10,7,13,32,Pass
Farhan Reddy,11-07-2005,819610,Tamil Nadu,11,12,9,0,32,Pass
Yash Singh,31-05-2005,203317,Madhya Pradesh,3,24,10,3,40,Fail
Kunal Verma,25-01-2005,917106,Madhya Pradesh,15,2,0,18,35,Fail
Krishna Chopra,14-03-2006,553035,Kerala,20,1,16,12,49,Fail
Kunal Pillai,30-10-2005,710372,Bihar,6,23,17,2,48,Pass
Yash Khan,05-01-2006,221217,Bihar,2,12,7,19,40,Pass
Ishaan Mehta,09-02-2005,555860,Uttar Pradesh,22,5,8,7,42,Fail
Ishaan Reddy,02-08-2005,437892,Telangana,15,11,20,24,70,Fail
Ishaan Sharma,20-05-2005,169448,Maharashtra,16,19,17,9,61,Fail
Balbir Pillai,03-12-2004,606919,West Bengal,20,3,13,11,47,Pass
Rohan Fernandes,04-02-2005,303763,Uttar Pradesh,23,21,24,14,82,Fail
Paul Verma,02-01-2006,284545,Madhya Pradesh,4,24,9,16,53,Fail
Krishna Reddy,11-03-2005,216179,Uttarakhand,3,10,8,14,35,Fail
Vivaan Reddy,25-03-2006,196074,Telangana,16,23,19,23,81,Fail
Krishna D'Souza,05-01-2005,462486,Maharashtra,23,22,17,8,70,Fail
Raj Reddy,14-09-2005,937070,Chhattisgarh,9,16,12,21,58,Fail
Krishna Sharma,26-02-2005,201522,Gujarat,0,15,14,5,34,Fail
Rohan Reddy,19-12-2005,651685,Gujarat,8,18,24,16,66,Fail
Aditya Singh,21-12-2005,100557,Andhra Pradesh,1,13,1,10,25,Pass
Rohan Sharma,06-07-2005,669553,Bihar,24,8,19,12,63,Pass
Ayaan Reddy,22-02-2006,298715,Himachal Pradesh,12,6,3,5,26,Pass
Vivaan Verma,06-02-2005,479862,Bihar,17,9,10,3,39,Pass
Rohan Chopra,31-03-2005,913908,Jharkhand,4,5,15,0,24,Pass
Gurpreet Reddy,13-04-2005,334344,Madhya Pradesh,10,22,16,22,70,Fail
Vivaan D'Souza,20-02-2006,887483,Jammu & Kashmir + Ladakh,6,18,16,2,42,Pass
Rohan Pillai,01-03-2006,439859,Bihar,21,16,0,5,42,Pass
Gurpreet Fernandes,09-05-2006,299986,Maharashtra,12,9,19,16,56,Fail
Kunal Mehta,13-04-2006,734154,Madhya Pradesh,4,6,9,15,34,Fail
Manpreet D'Souza,09-04-2006,892722,Jharkhand,22,18,17,16,73,Fail
Raj Singh,02-03-2006,874564,Tamil Nadu,10,0,15,17,42,Pass
Aditya Chopra,03-10-2005,673102,Rajasthan,11,2,12,14,39,Pass
Harjeet Mehta,19-09-2005,880434,Bihar,19,15,17,18,69,Pass
Balbir Chopra,15-04-2005,176230,Karnataka,13,3,7,8,31,Pass
Yash Fernandes,25-03-2006,669280,Maharashtra,8,0,15,9,32,Fail
Krishna Fernandes,03-09-2005,714421,Maharashtra,5,2,9,21,37,Fail
Rohan Fernandes,23-04-2005,860955,Gujarat,24,11,14,12,61,Fail
Kunal Verma,20-02-2005,923714,Bihar,16,23,10,18,67,Pass
Manpreet Sharma,05-01-2005,237612,Gujarat,19,23,16,10,68,Fail
Aarav Pillai,11-11-2004,914093,Rajasthan,20,6,5,14,45,Pass
Aryan Verma,27-03-2005,364790,Bihar,11,16,8,9,44,Pass
Kunal Mehta,16-02-2005,864237,Nagaland,24,7,2,18,51,Fail
Balbir Sharma,03-05-2005,644823,Uttarakhand,4,4,20,13,41,Fail
Aarav Chopra,27-02-2006,283020,Assam,3,24,7,19,53,Fail
Ishaan Singh,23-06-2005,108845,Telangana,9,18,7,13,47,Fail
Harjeet Mehta,03-04-2006,905839,Punjab,17,20,6,9,52,Fail
Rohan Pillai,18-10-2005,521444,Odisha,3,0,12,18,33,Pass
Vivaan Pillai,27-03-2005,706553,Uttar Pradesh,0,14,1,16,31,Fail
Yash Mehta,04-11-2005,235816,Bihar,22,10,3,1,36,Pass
Rohan Verma,15-04-2005,344921,Tamil Nadu,14,15,7,2,38,Pass
Yash Sharma,27-01-2006,140211,Odisha,14,2,9,15,40,Pass
Ishaan Verma,20-04-2006,952518,Rajasthan,13,23,14,11,61,Fail
Vivaan Pillai,17-11-2005,879208,Andhra Pradesh,21,23,16,12,72,Pass
Yash Mehta,18-05-2005,390148,Bihar,0,5,7,19,31,Pass
Vivaan Khan,03-12-2005,664289,Tamil Nadu,20,6,15,7,48,Fail
Raj Chopra,25-09-2005,743187,Rajasthan,18,24,21,1,64,Fail
Yash Sharma,13-02-2005,630766,Tamil Nadu,7,14,15,3,39,Pass
Harjeet Mehta,10-07-2005,792843,Maharashtra,5,17,10,22,54,Fail
Vivaan Reddy,04-02-2005,733028,Haryana,5,8,21,20,54,Fail
Krishna Singh,01-03-2006,620067,Delhi,9,17,0,10,36,Fail
Krishna Pillai,23-12-2005,576729,Uttar Pradesh,6,9,1,12,28,Fail
Yash Fernandes,01-04-2005,391628,Tamil Nadu,13,18,12,6,49,Fail
John Chopra,15-02-2006,656471,Madhya Pradesh,15,14,7,13,49,Fail
Aditya Singh,29-04-2006,302627,Tamil Nadu,12,24,18,10,64,Fail
Farhan D'Souza,02-10-2005,385058,Uttar Pradesh,14,22,21,0,57,Fail
Manpreet Pillai,23-01-2005,355209,Telangana,19,6,13,0,38,Fail
Kunal D'Souza,07-06-2005,737540,Maharashtra,14,7,11,24,56,Fail
Manpreet Chopra,26-12-2004,201625,Chhattisgarh,16,23,5,23,67,Fail
Rehan Reddy,19-04-2006,425320,Tamil Nadu,17,15,23,21,76,Pass
Rohan Singh,13-03-2006,451745,Uttar Pradesh,17,24,12,13,66,Fail
Vivaan Sharma,02-03-2006,866789,Bihar,1,17,11,7,36,Pass
Ishaan Mehta,05-04-2006,173816,Telangana,24,2,4,1,31,Fail
Paul D'Souza,08-11-2004,197540,Andhra Pradesh,13,24,7,11,55,Pass
Kunal Reddy,07-08-2005,847625,Punjab,10,22,13,24,69,Fail
Aditya Fernandes,25-06-2005,906711,Haryana,17,19,4,3,43,Fail
Rohan Mehta,20-10-2005,321210,Chhattisgarh,10,21,24,24,79,Fail
Paul Khan,10-08-2005,902033,Rajasthan,18,8,0,11,37,Pass
John Pillai,26-03-2005,691897,Rajasthan,13,19,10,3,45,Pass
Aditya Verma,10-04-2005,951284,Maharashtra,6,24,16,2,48,Fail
Kunal Khan,18-06-2005,153799,Maharashtra,1,2,21,7,31,Fail
Harjeet D'Souza,13-03-2005,270570,Assam,8,22,23,1,54,Fail
Aditya Chopra,23-10-2005,745357,Madhya Pradesh,20,2,19,6,47,Fail
Kunal Khan,05-11-2005,244818,Jharkhand,15,13,11,16,55,Pass
Sukhwinder Verma,15-01-2005,319495,West Bengal,6,24,6,15,51,Pass
Sukhwinder Fernandes,29-04-2005,516962,Bihar,6,1,2,20,29,Pass
Aditya Verma,25-07-2005,596090,Madhya Pradesh,22,24,13,2,61,Fail
Krishna Khan,12-02-2006,180878,Assam,5,13,23,2,43,Fail
Gurpreet Mehta,19-02-2006,233771,Rajasthan,11,18,4,22,55,Pass
Gurpreet Fernandes,05-01-2005,223088,Maharashtra,11,21,1,18,51,Fail
Krishna Fernandes,15-10-2005,884096,Punjab,15,20,13,4,52,Fail
Kunal Verma,22-06-2005,854427,West Bengal,24,3,15,6,48,Pass
Aditya Chopra,15-06-2005,493735,Gujarat,24,13,3,3,43,Fail
Mathew Verma,28-10-2005,416556,Himachal Pradesh,4,15,24,10,53,Pass
Kunal Khan,01-06-2005,244306,Jharkhand,14,3,11,19,47,Pass
Rohan Reddy,08-06-2005,109696,Bihar,24,0,15,21,60,Pass
Sukhwinder Reddy,14-11-2005,767712,Arunachal Pradesh,9,6,23,24,62,Fail
Kunal D'Souza,20-12-2004,262657,Karnataka,4,14,1,1,20,Pass
Aarav Mehta,20-12-2005,563313,Kerala,3,0,23,19,45,Fail
Manpreet Fernandes,07-01-2006,991884,Tamil Nadu,12,20,1,5,38,Pass
Yash D'Souza,03-03-2006,806304,Madhya Pradesh,17,7,10,5,39,Fail
Aarav Mehta,16-04-2005,656897,Uttar Pradesh,19,12,22,11,64,Fail
Raj Sharma,25-11-2005,340873,West Bengal,15,3,7,24,49,Pass
Kunal Verma,08-04-2005,739629,Uttar Pradesh,18,13,1,13,45,Fail
Aryan Mehta,24-05-2005,121517,Tamil Nadu,10,15,16,7,48,Fail
Mathew Khan,14-08-2005,649270,Arunachal Pradesh,14,0,6,14,34,Fail
Mathew Fernandes,30-05-2005,617870,Telangana,8,24,24,0,56,Fail
Mathew Mehta,14-05-2005,873634,Rajasthan,13,7,4,22,46,Pass
Aarav Singh,29-01-2005,932481,Haryana,24,19,14,13,70,Fail
Mathew Fernandes,24-10-2005,284053,Madhya Pradesh,15,21,21,8,65,Fail
Raj Chopra,03-11-2005,356621,Punjab,21,8,24,14,67,Fail
Aryan Singh,01-11-2005,621394,Bihar,4,12,7,16,39,Pass
Yash Pillai,08-04-2005,466351,Andhra Pradesh,11,14,9,0,34,Pass
Yash Khan,19-06-2005,856180,Assam,19,20,11,7,57,Fail
Imran Fernandes,03-05-2006,409438,Haryana,4,9,10,16,39,Fail
Manpreet Mehta,02-12-2005,724250,Chhattisgarh,11,13,19,8,51,Fail
Aditya D'Souza,24-04-2006,482930,Karnataka,2,0,19,21,42,Pass
Rohan Verma,20-10-2005,643249,Kerala,1,12,19,7,39,Fail
Zaid Sharma,02-06-2005,988552,Uttarakhand,11,13,6,7,37,Fail
Balbir Reddy,30-06-2005,120529,Telangana,10,7,20,16,53,Fail
Kunal Pillai,01-02-2005,874120,Kerala,18,6,23,0,47,Fail
Rohan D'Souza,25-11-2004,515762,Rajasthan,0,11,17,20,48,Pass
Ishaan Mehta,10-09-2005,190600,Madhya Pradesh,1,20,3,23,47,Fail
Ishaan Sharma,28-03-2006,906342,Punjab,19,17,3,2,41,Pass
Gurpreet Singh,21-11-2004,785947,Madhya Pradesh,22,18,1,0,41,Fail
Aryan Sharma,30-03-2006,187847,Uttar Pradesh,20,22,17,21,80,Fail
Harjeet D'Souza,06-01-2006,118646,Bihar,23,5,21,18,67,Pass
Aryan Verma,23-02-2005,581552,West Bengal,7,2,16,6,31,Pass
Yash Fernandes,28-06-2005,959315,Maharashtra,22,2,15,8,47,Fail
Yash Verma,31-03-2006,340032,Haryana,2,18,3,5,28,Fail
Aditya Mehta,31-07-2005,177251,Bihar,21,1,10,24,56,Pass
Yash Pillai,09-01-2006,163428,Chhattisgarh,1,19,17,4,41,Fail
Aarav Verma,03-05-2005,787673,Uttar Pradesh,21,17,7,4,49,Fail
David Verma,07-10-2005,845165,Himachal Pradesh,12,20,13,12,57,Pass
Kunal Khan,31-12-2004,889701,Bihar,13,8,18,17,56,Pass
Kunal Pillai,10-11-2005,291952,Uttar Pradesh,17,14,19,13,63,Fail
Aditya Verma,11-10-2005,899683,Punjab,24,4,5,1,34,Pass
Yash Chopra,28-04-2005,476973,Karnataka,8,14,0,23,45,Pass
Ayaan Chopra,10-08-2005,375659,Tamil Nadu,6,21,19,7,53,Fail
John Pillai,13-12-2004,684915,Delhi,20,23,1,8,52,Fail
Yash Chopra,14-06-2005,667293,Rajasthan,9,8,24,16,57,Pass
Rohan Fernandes,11-08-2005,545370,West Bengal,5,1,13,11,30,Pass
Vivaan Singh,22-12-2005,627535,Telangana,21,18,22,9,70,Fail
Paul Mehta,04-08-2005,294711,Gujarat,2,12,13,0,27,Fail
Rohan Sharma,22-11-2005,194037,Odisha,5,12,3,4,24,Pass
Raj Verma,21-01-2005,847797,Uttar Pradesh,9,23,24,18,74,Fail
Aditya Mehta,27-04-2005,232309,Bihar,13,4,11,21,49,Pass
Krishna Chopra,17-03-2005,894198,Rajasthan,11,23,0,12,46,Pass
Harjeet Fernandes,24-01-2006,716626,Madhya Pradesh,9,14,5,2,30,Fail
Aditya Pillai,13-05-2005,586238,Maharashtra,22,1,18,16,57,Fail
Krishna Khan,08-10-2005,232836,Telangana,4,0,6,22,32,Fail
Mathew Pillai,22-01-2006,374162,West Bengal,15,9,1,24,49,Pass
Aryan D'Souza,28-01-2005,107616,Rajasthan,16,11,12,21,60,Fail
Raj Reddy,26-02-2006,607854,Punjab,1,3,10,7,21,Pass
John Khan,16-12-2004,977986,Madhya Pradesh,23,23,19,4,69,Fail
Vivaan Khan,10-01-2005,137693,Bihar,13,2,5,17,37,Pass
Aryan Mehta,17-10-2005,124527,Punjab,13,19,22,6,60,Fail
Aryan Fernandes,05-12-2005,975710,Madhya Pradesh,6,22,17,23,68,Fail
Harjeet Sharma,24-04-2005,736538,Haryana,19,1,17,24,61,Fail
Yash Mehta,23-02-2006,269966,Uttar Pradesh,6,7,14,5,32,Fail
Vivaan Pillai,14-01-2006,445457,Tamil Nadu,0,2,13,11,26,Pass
Ishaan Fernandes,27-11-2004,140905,Haryana,17,12,10,16,55,Fail
Krishna Khan,28-02-2006,584243,West Bengal,5,3,24,24,56,Pass
Yash Sharma,17-01-2006,934519,Uttar Pradesh,1,18,8,9,36,Fail
Manpreet Reddy,08-05-2005,338077,Jharkhand,3,1,1,16,21,Pass
Sukhwinder Khan,29-10-2005,891100,Odisha,18,17,12,20,67,Fail
Raj Singh,09-01-2005,248100,Bihar,11,4,20,6,41,Pass
Raj Mehta,09-03-2005,483460,Andhra Pradesh,9,7,22,11,49,Pass
Farhan Mehta,02-06-2005,581841,Chhattisgarh,20,2,8,10,40,Fail
Rohan Fernandes,22-06-2005,566310,Uttarakhand,19,18,17,3,57,Fail
Manpreet Khan,25-08-2005,747586,Himachal Pradesh,16,22,13,3,54,Pass
Sukhwinder Singh,18-12-2004,385573,Gujarat,17,21,20,21,79,Fail
Aryan Pillai,22-07-2005,908199,Tamil Nadu,12,18,13,20,63,Fail
Sukhwinder D'Souza,14-07-2005,702037,Madhya Pradesh,3,19,14,19,55,Fail
Manpreet Mehta,08-06-2005,117013,Jharkhand,19,11,10,9,49,Pass
Aditya D'Souza,30-11-2004,293020,Uttar Pradesh,10,16,4,10,40,Fail
Krishna D'Souza,30-03-2006,789853,Madhya Pradesh,9,12,2,8,31,Fail
Rohan Khan,28-02-2006,449866,Tamil Nadu,11,23,22,6,62,Pass
Rohan Khan,03-04-2005,250118,Tamil Nadu,11,19,19,16,65,Pass
Kunal Mehta,20-08-2005,607169,Haryana,10,6,22,8,46,Fail
John Khan,06-05-2006,808558,Maharashtra,6,24,0,2,32,Fail
Aarav Mehta,05-09-2005,680225,Gujarat,23,16,3,3,45,Fail
John Verma,27-07-2005,446080,Haryana,16,1,19,0,36,Fail
David Chopra,12-11-2004,686078,Telangana,12,4,23,5,44,Fail
Balbir Verma,01-01-2005,190959,Telangana,19,21,16,18,74,Fail
Imran Sharma,09-05-2005,589757,Karnataka,23,21,18,14,76,Fail
Gurpreet Chopra,09-11-2004,647016,Maharashtra,17,11,10,18,56,Fail
Yash Fernandes,20-09-2005,302047,Madhya Pradesh,5,22,23,21,71,Fail
Aryan Mehta,23-06-2005,509396,Tamil Nadu,11,15,2,24,52,Fail
Aryan D'Souza,22-03-2005,465356,Tamil Nadu,13,11,1,24,49,Fail
John Singh,31-01-2005,906833,Gujarat,13,13,3,18,47,Fail
Yash Khan,31-03-2006,846461,Haryana,18,16,4,18,56,Fail
Aditya Singh,16-03-2005,316461,Jharkhand,20,16,10,9,55,Pass
Mathew Pillai,26-05-2005,802136,Telangana,5,3,14,3,25,Fail
Yash D'Souza,04-01-2005,604644,Uttar Pradesh,11,13,11,13,48,Fail
Aditya D'Souza,08-05-2006,761209,Rajasthan,19,3,2,10,34,Pass
Kunal Fernandes,23-07-2005,996397,Daman & Diu / D&N Haveli,9,10,11,8,38,Fail
Vivaan Fernandes,25-04-2005,136229,Bihar,8,6,14,5,33,Pass
Kunal Verma,08-05-2005,649492,Madhya Pradesh,0,16,20,10,46,Fail
Aryan Verma,22-12-2004,321127,Bihar,20,11,12,11,54,Pass
Gurpreet Fernandes,27-02-2006,503666,Bihar,10,16,0,14,40,Pass
Sukhwinder Fernandes,09-06-2005,409862,Odisha,22,3,0,17,42,Pass
Krishna Reddy,21-05-2005,510345,Jharkhand,15,24,19,3,61,Pass
Raj D'Souza,10-01-2005,848564,Telangana,21,17,23,1,62,Fail
Farhan Pillai,04-01-2005,671035,Rajasthan,3,17,0,11,31,Pass
Aryan Verma,12-01-2005,848767,Kerala,1,7,22,5,35,Fail
Peter Chopra,26-01-2006,656719,Uttar Pradesh,15,1,14,2,32,Fail
Kunal Verma,13-12-2005,781569,Kerala,15,18,24,0,57,Fail
Rohan Mehta,18-02-2006,344930,Madhya Pradesh,9,0,3,9,21,Fail
Aryan Fernandes,01-04-2005,940521,Rajasthan,6,13,23,11,53,Pass
Vivaan Singh,18-07-2005,746884,Uttarakhand,18,21,1,12,52,Fail
Aryan Fernandes,24-01-2006,592586,West Bengal,19,3,16,21,59,Pass
Raj Chopra,12-01-2006,228173,Meghalaya,1,23,13,1,38,Pass
Vivaan D'Souza,02-12-2004,306902,Rajasthan,12,6,15,9,42,Pass
Balbir Verma,21-03-2006,344521,Bihar,16,11,5,18,50,Pass
Ishaan D'Souza,30-06-2005,735449,Tamil Nadu,8,5,11,1,25,Pass
Kunal Chopra,19-08-2005,429378,Maharashtra,9,2,24,22,57,Fail
Gurpreet Reddy,19-12-2004,330223,Madhya Pradesh,23,14,6,6,49,Fail
Rohan Sharma,23-11-2005,515768,Kerala,10,1,17,23,51,Fail
Aditya Khan,30-11-2005,158408,Tamil Nadu,24,8,3,17,52,Fail
Raj Reddy,11-02-2005,295693,Bihar,6,22,6,4,38,Pass
Rehan Sharma,27-04-2006,814446,Tamil Nadu,4,22,9,23,58,Fail
Rohan Chopra,20-03-2005,816439,Bihar,21,1,16,13,51,Pass
Krishna Khan,07-08-2005,863942,Punjab,13,22,12,24,71,Fail
Rohan Singh,18-02-2006,885357,Delhi,18,13,24,11,66,Fail
Yash Reddy,16-06-2005,400373,Punjab,16,22,10,1,49,Fail
Rohan Sharma,24-04-2006,714819,Himachal Pradesh,18,3,3,13,37,Pass
Gurpreet Khan,31-03-2005,124519,Maharashtra,22,3,21,19,65,Fail
Ishaan Chopra,09-12-2004,782929,Jammu & Kashmir + Ladakh,17,0,5,9,31,Pass
Ishaan Mehta,26-11-2005,688008,Uttar Pradesh,18,13,23,9,63,Fail
Aryan Reddy,04-01-2005,355010,Madhya Pradesh,2,5,14,5,26,Fail
Aarav Khan,08-01-2006,665950,Bihar,10,22,15,13,60,Pass
Yash Chopra,17-08-2005,527584,Uttar Pradesh,17,19,20,14,70,Fail
Aarav Mehta,21-03-2006,773932,Telangana,18,17,1,20,56,Fail
Ishaan Verma,30-11-2004,923338,Rajasthan,3,11,7,7,28,Pass
Vivaan Mehta,27-02-2006,890605,Maharashtra,15,22,23,16,76,Fail
Rohan Verma,24-11-2004,283880,Tamil Nadu,20,8,1,9,38,Pass
Rohan Chopra,27-06-2005,608226,Maharashtra,11,3,13,24,51,Fail
Sukhwinder Verma,08-03-2005,358063,Jammu & Kashmir + Ladakh,24,24,0,0,48,Pass
Aryan Pillai,21-11-2005,206429,Tamil Nadu,4,9,0,16,29,Pass
Ishaan Reddy,22-03-2006,712357,Uttar Pradesh,9,2,14,7,32,Fail
Ishaan Singh,21-06-2005,690467,Assam,11,11,2,12,36,Fail
Harjeet D'Souza,16-02-2006,315198,Bihar,7,19,21,10,57,Pass
Paul Pillai,04-12-2005,401731,Uttarakhand,8,19,3,23,53,Fail
Yash Singh,07-03-2005,104431,Maharashtra,15,8,1,6,30,Fail
Yash Reddy,20-03-2005,809462,Rajasthan,10,23,19,24,76,Pass
Rohan Mehta,02-10-2005,450133,Bihar,15,5,19,21,60,Pass
Yash Pillai,22-09-2005,226597,Tamil Nadu,11,19,14,20,64,Fail
Raj Sharma,18-12-2004,347857,Chhattisgarh,4,8,3,10,25,Fail
Paul Chopra,25-11-2005,405869,Meghalaya,22,7,24,2,55,Fail
Gurpreet Singh,22-10-2005,799834,Bihar,1,21,2,7,31,Pass
Balbir Pillai,04-02-2006,101033,Uttar Pradesh,12,20,16,8,56,Fail
Krishna Reddy,10-01-2005,175765,Madhya Pradesh,12,3,11,0,26,Fail
Yash Fernandes,30-07-2005,862080,Gujarat,16,19,19,16,70,Fail
Manpreet Singh,22-12-2004,421134,Telangana,22,16,19,2,59,Fail
Aarav Sharma,07-03-2005,595873,Uttar Pradesh,22,10,23,15,70,Fail
Paul Chopra,12-04-2006,446492,Gujarat,24,1,3,11,39,Fail
Aditya Verma,06-01-2006,600138,Punjab,10,12,24,13,59,Fail
Krishna Chopra,02-10-2005,596025,Punjab,0,3,24,14,41,Pass
Raj Chopra,24-09-2005,495191,Odisha,10,6,23,24,63,Fail
Aryan Pillai,24-07-2005,219290,Rajasthan,24,24,19,17,84,Pass
Zaid Mehta,07-02-2006,526421,Himachal Pradesh,14,21,18,7,60,Fail
Yash Khan,26-04-2005,323648,Odisha,10,3,22,20,55,Fail
Harjeet Mehta,20-01-2005,674096,Madhya Pradesh,10,23,20,2,55,Fail
Vivaan D'Souza,03-02-2006,921402,West Bengal,24,3,2,5,34,Pass
Rohan Reddy,01-11-2005,607436,Andhra Pradesh,8,18,2,21,49,Pass
Harjeet Khan,06-02-2006,921065,Maharashtra,2,16,11,0,29,Fail
Aditya D'Souza,21-01-2006,864167,Bihar,4,11,18,20,53,Pass
Rohan D'Souza,14-08-2005,149691,Assam,1,8,1,10,20,Fail
Imran Singh,20-06-2005,986984,Jharkhand,8,23,0,13,44,Pass
Sukhwinder Singh,03-07-2005,668492,Kerala,6,6,2,20,34,Fail
Harjeet Pillai,22-01-2005,166316,Uttar Pradesh,13,11,9,8,41,Fail
Kunal Fernandes,10-01-2005,352621,Rajasthan,4,17,17,5,43,Pass
Gurpreet Sharma,31-12-2004,642729,Uttar Pradesh,0,16,19,10,45,Fail
Aditya Khan,19-11-2005,564067,Uttar Pradesh,2,15,18,20,55,Fail
Yash D'Souza,08-03-2006,787518,Punjab,2,12,13,1,28,Pass
Rohan Sharma,12-08-2005,815728,Maharashtra,0,6,0,16,22,Fail
Aarav Fernandes,09-04-2005,564213,Madhya Pradesh,16,4,4,13,37,Fail
Raj Reddy,12-01-2005,822824,Rajasthan,6,12,3,4,25,Pass
David Reddy,07-11-2005,305076,Bihar,10,11,14,23,58,Pass
Vivaan Fernandes,17-11-2005,944906,Delhi,0,13,1,4,18,Fail
Balbir Reddy,20-04-2005,170084,Gujarat,7,22,15,7,51,Fail
Gurpreet Verma,26-09-2005,298058,Rajasthan,22,23,5,5,55,Pass
Kunal Singh,07-02-2006,167876,Bihar,22,1,7,0,30,Pass
Aryan Sharma,28-05-2005,900217,Meghalaya,21,19,24,9,73,Fail
Vivaan Verma,11-11-2005,716488,Bihar,13,0,6,23,42,Pass
Yash Reddy,17-02-2006,893683,Andhra Pradesh,16,8,8,9,41,Pass
Manpreet Khan,30-03-2005,229163,Punjab,18,20,16,16,70,Fail
Yash Pillai,31-03-2005,887219,Bihar,18,5,4,19,46,Pass
Yash Khan,16-10-2005,103801,West Bengal,9,4,23,1,37,Pass
Zaid Mehta,07-06-2005,821160,Andhra Pradesh,9,20,23,21,73,Pass
Aditya Mehta,24-01-2006,776516,Gujarat,2,23,22,0,47,Fail
Vivaan Sharma,03-10-2005,877880,Jharkhand,12,14,23,8,57,Pass
Harjeet Singh,18-12-2005,374234,Telangana,21,14,22,6,63,Fail
Balbir Verma,22-04-2006,552607,West Bengal,21,3,7,22,53,Pass
Raj Mehta,23-02-2005,557878,Madhya Pradesh,16,2,9,0,27,Fail
Kunal Khan,28-06-2005,449898,Telangana,3,7,15,21,46,Fail
Rohan Chopra,06-09-2005,744242,Gujarat,21,21,15,21,78,Fail
Gurpreet Reddy,04-01-2005,550598,Assam,11,16,22,24,73,Fail
Aarav Reddy,17-01-2006,206861,Kerala,13,20,1,13,47,Fail
Ishaan D'Souza,31-12-2005,255691,Assam,13,21,16,0,50,Fail
Raj Pillai,02-12-2004,621494,Daman & Diu / D&N Haveli,24,7,24,6,61,Fail
Kunal Mehta,27-02-2005,846150,Andhra Pradesh,19,10,11,20,60,Pass
Aarav Mehta,28-09-2005,708989,Madhya Pradesh,6,4,11,11,32,Fail
Rehan Chopra,25-01-2005,425197,Haryana,6,9,11,21,47,Fail
Kunal Reddy,09-02-2006,848278,Punjab,4,20,22,3,49,Fail
Vivaan Khan,25-12-2004,205163,Bihar,3,12,14,13,42,Pass
Aditya Pillai,06-01-2005,942741,Bihar,6,4,23,14,47,Pass
Mathew Pillai,02-12-2005,132096,Punjab,19,16,14,18,67,Fail
Peter Sharma,08-03-2005,975702,Bihar,14,0,5,9,28,Pass
Raj Singh,22-11-2005,617148,Gujarat,24,19,14,14,71,Fail
Krishna Sharma,05-02-2006,557842,Tamil Nadu,19,2,19,15,55,Fail
John D'Souza,21-02-2005,342599,Gujarat,20,8,10,9,47,Fail
Aditya Verma,19-01-2006,170249,Tamil Nadu,3,21,15,16,55,Fail
Aditya Reddy,10-10-2005,647458,Gujarat,19,3,7,14,43,Fail
Aditya Reddy,12-03-2005,822205,Haryana,13,13,14,2,42,Fail
Rohan Fernandes,10-02-2005,168648,Bihar,24,7,8,7,46,Pass
Harjeet Verma,18-05-2005,509807,Karnataka,12,13,18,15,58,Pass
Aarav Pillai,11-11-2004,254235,Tamil Nadu,10,6,18,12,46,Fail
Paul Khan,28-08-2005,943446,Bihar,24,15,7,13,59,Pass
Balbir Fernandes,18-02-2005,705589,Madhya Pradesh,8,22,22,19,71,Fail
Peter Verma,02-02-2006,711339,Madhya Pradesh,15,21,12,1,49,Fail
Aryan Fernandes,03-09-2005,922442,Rajasthan,24,15,13,11,63,Fail
Vivaan D'Souza,13-01-2005,578695,Andhra Pradesh,4,24,5,0,33,Pass
Aditya Fernandes,12-11-2005,560223,Punjab,8,0,4,14,26,Pass
Ishaan Sharma,25-11-2004,969588,Uttar Pradesh,15,7,15,6,43,Fail
Raj Mehta,26-04-2006,733893,Tamil Nadu,6,7,21,3,37,Pass
Rohan Reddy,16-10-2005,648963,Uttar Pradesh,16,16,6,5,43,Fail
Aryan Singh,03-03-2006,980392,Uttar Pradesh,20,18,0,15,53,Pass
Rohan Reddy,04-08-2005,804043,Bihar,20,7,16,3,46,Pass
Vivaan Sharma,14-02-2005,789015,Jharkhand,21,19,5,11,56,Pass
Vivaan Singh,29-10-2005,821985,Maharashtra,13,7,13,15,48,Fail
Sukhwinder Singh,04-02-2005,768550,Maharashtra,18,21,19,11,69,Fail
Krishna Singh,15-11-2005,796788,Maharashtra,16,5,5,23,49,Fail
Rohan Verma,31-01-2005,332196,Jharkhand,8,5,9,17,39,Pass
Ishaan Reddy,06-05-2006,232891,Uttar Pradesh,5,2,16,19,42,Pass
Peter Singh,31-05-2005,388882,Andhra Pradesh,17,13,23,21,74,Pass
Rehan Verma,12-11-2004,388941,West Bengal,2,4,22,4,32,Pass
Harjeet Verma,19-12-2004,496590,Rajasthan,8,21,3,16,48,Pass
Kunal Khan,16-01-2006,176576,Assam,2,2,18,6,28,Fail
Aryan Fernandes,10-03-2006,566336,Uttar Pradesh,16,9,9,6,40,Pass
Aditya Khan,20-09-2005,492067,Bihar,23,12,3,9,47,Pass
Raj Mehta,07-08-2005,625015,Rajasthan,6,9,4,20,39,Pass
Kunal Reddy,30-04-2005,335217,Uttar Pradesh,24,2,6,2,34,Pass
Rohan Verma,06-05-2005,162146,Madhya Pradesh,5,5,2,18,30,Fail
Aditya Mehta,04-03-2005,700772,Rajasthan,21,21,14,18,74,Pass
Aditya Chopra,04-03-2005,794336,Meghalaya,19,18,17,7,61,Fail
Gurpreet Singh,06-08-2005,871795,Karnataka,10,24,19,23,76,Fail
Ishaan Khan,11-05-2005,966014,West Bengal,11,9,4,12,36,Pass
Yash Fernandes,30-09-2005,216750,Uttar Pradesh,21,7,11,14,53,Pass
Sukhwinder Fernandes,07-03-2005,216486,Uttar Pradesh,24,6,9,4,43,Pass
Kunal Pillai,19-09-2005,702768,Punjab,14,13,14,13,54,Fail
Krishna Khan,25-07-2005,589629,Uttar Pradesh,22,8,19,3,52,Pass
Kunal Mehta,22-08-2005,768794,Andhra Pradesh,11,23,0,4,38,Pass
Aryan Reddy,19-12-2004,317819,Karnataka,22,11,9,8,50,Pass
Imran Sharma,13-02-2005,339231,Telangana,1,14,15,16,46,Fail
Yash Pillai,13-03-2006,262020,Haryana,7,14,6,7,34,Fail
Ishaan Chopra,06-10-2005,476923,Rajasthan,24,2,15,11,52,Pass
Aarav Mehta,21-07-2005,822501,Jharkhand,0,6,17,19,42,Pass
Manpreet Chopra,25-05-2005,641592,Haryana,3,11,9,24,47,Fail
Aarav Mehta,20-10-2005,322316,Rajasthan,21,19,11,13,64,Fail
Aditya D'Souza,20-12-2005,312399,Jharkhand,22,13,17,15,67,Pass
Raj Mehta,28-11-2004,753215,Karnataka,24,10,17,9,60,Pass
Aryan Sharma,13-01-2006,629930,Delhi,19,12,22,11,64,Fail
Raj Khan,31-01-2005,818339,West Bengal,8,0,8,18,34,Pass
Rohan Sharma,30-08-2005,159405,Bihar,19,16,19,18,72,Pass
Kunal Chopra,08-12-2004,159623,Maharashtra,4,17,11,18,50,Fail
Ishaan Verma,30-03-2006,333397,Andhra Pradesh,14,24,14,21,73,Pass
Krishna Sharma,06-05-2005,300714,Odisha,12,2,12,21,47,Fail
Vivaan Mehta,14-09-2005,585957,Telangana,10,24,20,1,55,Fail
Kunal Singh,22-10-2005,964844,Gujarat,19,20,6,12,57,Fail
Aditya Singh,19-02-2006,871232,Rajasthan,20,0,0,7,27,Pass
Yash Singh,14-02-2005,307825,Rajasthan,6,16,19,20,61,Fail
Imran D'Souza,02-10-2005,794668,Rajasthan,5,11,7,22,45,Pass
Aryan D'Souza,27-04-2005,440847,Madhya Pradesh,4,1,23,23,51,Fail
Raj Chopra,09-09-2005,600707,West Bengal,4,17,1,18,40,Pass
Krishna Fernandes,13-11-2004,331344,Rajasthan,13,21,11,0,45,Pass
Aarav Reddy,26-11-2004,383419,Maharashtra,6,12,11,11,40,Fail
Aryan Singh,03-09-2005,818082,Jharkhand,16,5,17,3,41,Pass
Mathew Chopra,16-12-2005,660154,Bihar,12,19,19,21,71,Pass
Aditya Sharma,28-05-2005,397568,Rajasthan,13,8,3,23,47,Pass
Rohan Pillai,24-08-2005,314335,Jammu & Kashmir + Ladakh,15,23,0,20,58,Pass
Raj Fernandes,09-12-2005,981364,Maharashtra,19,17,7,8,51,Fail
Krishna Chopra,29-01-2006,924684,Madhya Pradesh,20,22,8,1,51,Fail
Sukhwinder Khan,08-04-2006,296134,Meghalaya,7,5,20,7,39,Pass
Rohan Pillai,12-02-2006,569910,Karnataka,16,20,10,23,69,Fail
Manpreet Sharma,29-01-2005,736759,Manipur,16,3,12,4,35,Fail
Aryan Mehta,26-07-2005,113092,Tamil Nadu,7,4,8,1,20,Pass
Raj Verma,03-12-2004,766252,Rajasthan,7,6,14,8,35,Pass
Rohan Chopra,11-03-2005,344854,Meghalaya,5,20,10,2,37,Pass
Yash Pillai,25-02-2005,968589,West Bengal,5,2,13,9,29,Pass
Vivaan Verma,24-02-2006,124297,Gujarat,5,2,4,4,15,Fail
Gurpreet Fernandes,21-03-2006,999789,Uttar Pradesh,24,18,0,16,58,Pass
Kunal Reddy,12-10-2005,196159,Telangana,9,18,10,23,60,Fail
Peter Fernandes,30-01-2006,506791,Uttarakhand,21,7,3,3,34,Fail
Ishaan Khan,11-04-2006,659923,Jammu & Kashmir + Ladakh,0,4,22,8,34,Pass
Krishna Sharma,29-04-2006,835978,Uttar Pradesh,9,20,16,7,52,Pass
Ishaan Reddy,16-03-2006,281066,Bihar,22,0,9,22,53,Pass
Yash Chopra,20-01-2005,970200,Karnataka,15,15,8,1,39,Pass
Vivaan Pillai,06-02-2006,897809,Assam,4,13,20,18,55,Fail
Kunal Reddy,23-12-2005,650626,Maharashtra,7,13,22,9,51,Fail
Sukhwinder Mehta,24-10-2005,728759,Punjab,24,14,5,18,61,Fail
Balbir Fernandes,29-05-2005,552707,Daman & Diu / D&N Haveli,20,3,14,11,48,Fail
Aryan Fernandes,21-12-2004,111619,Rajasthan,11,6,21,10,48,Pass
Gurpreet Verma,25-12-2004,984632,Delhi,20,8,4,12,44,Fail
Rohan Chopra,08-07-2005,683505,Haryana,5,16,20,17,58,Fail
Manpreet Chopra,14-02-2006,487077,Bihar,9,18,10,13,50,Pass
Aditya Reddy,17-09-2005,712228,Bihar,24,2,21,17,64,Pass
Aditya Singh,14-08-2005,155063,Bihar,21,24,1,24,70,Pass
Raj Reddy,19-02-2006,815282,Punjab,9,6,13,12,40,Pass
Kunal Sharma,15-08-2005,554595,West Bengal,1,21,15,16,53,Pass
Mathew Fernandes,19-01-2006,868314,Tamil Nadu,6,15,9,9,39,Pass
Yash D'Souza,15-07-2005,637093,Bihar,1,1,8,15,25,Pass
Manpreet Fernandes,25-02-2006,437843,Uttar Pradesh,12,2,5,11,30,Pass
Yash Chopra,29-06-2005,971985,Punjab,0,0,0,4,4,Pass
Krishna Fernandes,08-02-2005,699318,Punjab,8,2,2,17,29,Pass
Harjeet Pillai,01-04-2005,790841,Tamil Nadu,17,0,18,20,55,Fail
Paul Pillai,31-01-2005,244600,Bihar,1,4,22,14,41,Pass
Manpreet Khan,25-01-2005,914949,Rajasthan,22,20,11,21,74,Pass
Krishna Chopra,26-06-2005,137437,Madhya Pradesh,12,13,2,14,41,Fail
Harjeet Reddy,20-11-2004,313715,Karnataka,24,0,20,15,59,Pass
Kunal Reddy,27-12-2004,921467,Uttar Pradesh,3,16,16,0,35,Pass
Gurpreet Sharma,20-06-2005,289767,Bihar,2,12,5,23,42,Pass
Aryan D'Souza,31-01-2006,165138,Andhra Pradesh,3,18,4,18,43,Pass
Gurpreet D'Souza,14-12-2005,344956,Karnataka,11,11,18,15,55,Pass
Krishna Sharma,05-01-2005,529705,Telangana,11,20,20,23,74,Fail
Vivaan Pillai,04-06-2005,198972,Mizoram,2,4,2,4,12,Pass
Raj Fernandes,31-03-2006,746856,Uttarakhand,5,23,17,20,65,Fail
Aarav Khan,29-01-2006,632939,Tamil Nadu,3,21,11,24,59,Pass
Ishaan Sharma,30-11-2005,474549,Jammu & Kashmir + Ladakh,18,17,0,21,56,Pass
Kunal Fernandes,17-04-2005,995721,Jharkhand,17,0,16,1,34,Pass
Paul Verma,26-03-2006,283106,Madhya Pradesh,7,3,18,4,32,Fail
Manpreet Fernandes,18-07-2005,137518,Gujarat,1,8,1,24,34,Fail
Manpreet Sharma,21-09-2005,596259,Rajasthan,7,12,0,15,34,Pass
Harjeet Pillai,18-08-2005,960538,Odisha,12,22,6,0,40,Pass
Aditya Pillai,28-12-2004,935150,Delhi,7,21,11,5,44,Fail
Gurpreet Pillai,11-02-2005,211712,Andhra Pradesh,18,16,12,22,68,Pass
Rohan Reddy,17-08-2005,624547,West Bengal,10,11,5,5,31,Pass
Kunal Pillai,11-02-2005,599426,Punjab,17,21,2,3,43,Pass
Aditya Verma,15-03-2005,906202,Rajasthan,9,18,9,1,37,Pass
Aditya D'Souza,24-02-2006,304776,Tamil Nadu,15,12,12,18,57,Pass
Kunal Chopra,21-04-2005,270049,Odisha,3,10,17,17,47,Fail
Sukhwinder Fernandes,23-05-2005,370798,Uttar Pradesh,9,1,18,23,51,Pass
Aryan Pillai,06-02-2005,998330,Uttar Pradesh,8,11,18,3,40,Pass
Rohan Pillai,09-08-2005,130985,Bihar,12,20,18,22,72,Pass
Aryan Reddy,28-12-2004,382215,Telangana,22,1,12,21,56,Fail
Mathew Verma,09-01-2005,805929,Jharkhand,20,18,24,4,66,Pass
Manpreet Pillai,01-05-2005,135921,Maharashtra,18,10,10,13,51,Fail
Gurpreet Sharma,08-05-2006,921746,Haryana,13,21,13,13,60,Fail
Krishna Fernandes,07-05-2006,690808,Bihar,19,12,23,21,75,Pass
Aarav Pillai,14-10-2005,504594,Haryana,16,15,16,3,50,Fail
Ishaan D'Souza,26-04-2006,976057,Gujarat,24,5,2,3,34,Fail
Sukhwinder Fernandes,19-04-2006,662953,Uttarakhand,4,6,21,17,48,Fail
Rohan Mehta,17-06-2005,204914,Telangana,14,19,17,3,53,Fail
Imran Reddy,11-11-2004,193027,Andhra Pradesh,3,9,13,6,31,Pass
Yash Chopra,02-11-2005,972507,Telangana,3,4,22,13,42,Fail
Vivaan Singh,31-01-2006,802191,Punjab,5,14,4,4,27,Pass
Mathew D'Souza,16-08-2005,657185,Haryana,0,2,7,20,29,Fail
Kunal D'Souza,06-07-2005,238248,Andhra Pradesh,12,20,12,10,54,Pass
Raj Khan,10-07-2005,589869,Rajasthan,20,19,14,15,68,Fail
Vivaan Singh,19-12-2004,760531,Madhya Pradesh,19,1,24,8,52,Fail
Aarav Fernandes,30-11-2005,321199,Gujarat,22,4,6,20,52,Fail
Krishna Khan,02-05-2006,110946,Delhi,10,15,12,0,37,Fail
Zaid Singh,03-11-2005,759000,Punjab,4,4,16,15,39,Pass
Kunal Chopra,17-10-2005,644456,Rajasthan,1,10,3,8,22,Pass
Balbir Fernandes,03-05-2005,400362,Bihar,13,7,23,9,52,Pass
Balbir Mehta,28-03-2005,769332,Uttar Pradesh,23,9,7,4,43,Pass
Kunal Reddy,17-11-2005,314688,Assam,5,8,22,6,41,Fail
Kunal Khan,02-12-2005,294185,Jharkhand,13,16,14,22,65,Pass
Kunal Reddy,05-11-2005,828912,Andhra Pradesh,13,1,14,4,32,Pass
Aryan Singh,07-04-2006,250670,Madhya Pradesh,22,15,3,6,46,Fail
Krishna Reddy,09-03-2005,967760,Uttar Pradesh,8,7,11,12,38,Pass
Mathew Verma,02-05-2005,566582,Mizoram,18,23,24,15,80,Pass
Sukhwinder Khan,25-11-2005,647312,Madhya Pradesh,2,17,21,7,47,Fail
Ishaan Reddy,29-10-2005,953278,Andhra Pradesh,4,12,18,19,53,Pass
Yash Singh,14-10-2005,921377,Gujarat,18,11,0,13,42,Fail
Harjeet Verma,15-12-2004,196463,Odisha,16,13,2,22,53,Fail
Gurpreet Verma,16-05-2005,725212,Gujarat,9,11,21,23,64,Fail
Aditya Reddy,04-02-2006,234377,Gujarat,9,17,22,11,59,Fail
Yash Verma,08-03-2006,129937,Madhya Pradesh,1,14,4,18,37,Fail
Aryan Fernandes,01-01-2005,805906,Gujarat,11,20,4,8,43,Fail
Vivaan Fernandes,15-11-2005,500224,West Bengal,4,0,17,9,30,Pass
Aditya Khan,12-09-2005,913717,Bihar,9,24,17,8,58,Pass
Raj Verma,07-12-2005,837036,Jammu & Kashmir + Ladakh,8,15,12,5,40,Pass
Mathew Reddy,26-12-2005,514790,West Bengal,16,4,14,11,45,Pass
Rohan D'Souza,15-09-2005,971333,Andhra Pradesh,20,20,2,2,44,Pass
John D'Souza,24-09-2005,104924,Delhi,11,16,20,19,66,Fail
Yash Verma,04-05-2005,230430,Uttar Pradesh,23,9,9,23,64,Pass
Yash Reddy,30-01-2006,129811,Rajasthan,4,14,23,24,65,Fail
Aarav Reddy,03-09-2005,819241,Karnataka,2,18,23,9,52,Pass
Paul D'Souza,16-03-2006,188745,Uttar Pradesh,20,9,9,6,44,Pass
Vivaan Mehta,20-01-2005,449959,Uttarakhand,24,5,1,19,49,Fail
Krishna Reddy,21-10-2005,557907,Jharkhand,4,18,10,6,38,Pass
John Sharma,11-12-2005,829360,Maharashtra,24,13,8,3,48,Fail
Sukhwinder Chopra,17-02-2005,783605,Andhra Pradesh,14,17,13,11,55,Pass
John Fernandes,04-04-2005,291375,Bihar,19,15,13,20,67,Pass
Rohan Chopra,24-04-2006,168583,Uttar Pradesh,22,19,10,10,61,Pass
Harjeet Chopra,08-05-2005,438885,Uttar Pradesh,16,17,11,9,53,Pass
Aryan Chopra,22-02-2006,811181,Uttar Pradesh,10,8,8,10,36,Pass
Ishaan Verma,29-05-2005,384651,Karnataka,15,23,20,8,66,Pass
Aryan Chopra,15-07-2005,828407,Uttar Pradesh,9,8,9,23,49,Pass
Aditya Khan,30-04-2005,754284,Uttar Pradesh,14,6,18,4,42,Pass
Zaid Fernandes,16-11-2005,134714,Uttar Pradesh,23,18,3,0,44,Pass
Sukhwinder Chopra,03-10-2005,835896,Telangana,18,0,19,3,40,Fail
Gurpreet Singh,07-05-2006,430815,Bihar,12,10,9,7,38,Pass
Krishna Mehta,24-03-2006,657582,Uttar Pradesh,12,18,13,10,53,Pass
Aditya Reddy,17-11-2004,591916,Haryana,6,20,17,18,61,Fail
Raj D'Souza,08-06-2005,170004,Jammu & Kashmir + Ladakh,2,0,22,17,41,Pass
Aarav Khan,02-05-2006,749981,Manipur,5,3,24,19,51,Fail
Paul Reddy,17-11-2005,796305,Odisha,4,20,12,12,48,Fail
Gurpreet Verma,13-01-2006,295266,Tamil Nadu,9,17,19,2,47,Pass
Rohan Khan,14-04-2005,788110,Andhra Pradesh,12,8,0,20,40,Pass
Yash Chopra,05-07-2005,896648,Chhattisgarh,8,14,15,4,41,Fail
Aarav D'Souza,11-10-2005,853981,Odisha,3,15,21,12,51,Fail
Vivaan Verma,16-03-2006,693333,Rajasthan,7,1,19,3,30,Pass
Raj Verma,22-06-2005,614980,Uttar Pradesh,20,3,0,9,32,Pass
Raj Mehta,08-11-2005,806637,Telangana,9,18,4,21,52,Fail
Krishna Chopra,31-10-2005,510905,Haryana,21,9,3,7,40,Fail
Imran Pillai,06-05-2006,790430,Bihar,21,20,1,2,44,Pass
David Reddy,03-09-2005,835699,Punjab,3,10,1,0,14,Pass
Krishna Pillai,07-03-2006,415713,West Bengal,16,3,18,21,58,Pass
Yash Chopra,20-03-2006,174441,West Bengal,9,16,15,14,54,Pass
Aryan Sharma,11-12-2004,302723,Madhya Pradesh,9,20,9,1,39,Fail
Paul Chopra,08-09-2005,983441,Tamil Nadu,1,0,22,18,41,Pass
Rohan Sharma,24-09-2005,834788,Telangana,19,18,9,22,68,Fail
Aarav Khan,20-02-2006,353486,Tamil Nadu,3,10,23,8,44,Pass
Ishaan Pillai,01-04-2006,151723,West Bengal,1,13,1,17,32,Pass
Aarav Singh,09-05-2006,794451,Telangana,24,20,9,19,72,Fail
Harjeet Verma,19-07-2005,838269,Kerala,6,8,10,5,29,Fail
Aditya Verma,14-03-2005,802353,Punjab,21,11,20,15,67,Fail
Raj Singh,11-03-2005,683069,Delhi,18,12,15,20,65,Fail
Aditya Singh,06-09-2005,715658,Madhya Pradesh,0,3,4,18,25,Fail
Rohan Singh,04-10-2005,731877,Karnataka,11,4,7,22,44,Pass
David Fernandes,08-06-2005,548380,Uttar Pradesh,4,11,24,5,44,Pass
Rohan D'Souza,15-02-2005,548027,Telangana,6,4,15,11,36,Fail
Harjeet Fernandes,29-10-2005,235743,Tamil Nadu,13,7,12,5,37,Pass
Aryan Chopra,29-04-2005,600121,Bihar,16,14,20,0,50,Pass
Vivaan Fernandes,18-08-2005,489634,Tamil Nadu,24,10,3,7,44,Pass
Aditya Fernandes,12-11-2004,901369,Madhya Pradesh,23,24,10,20,77,Fail
Raj Fernandes,18-10-2005,887674,West Bengal,7,22,8,11,48,Pass
Rohan Sharma,02-07-2005,129589,Jharkhand,1,7,17,15,40,Pass
Vivaan Khan,12-04-2006,952601,West Bengal,5,6,13,21,45,Pass
Yash Mehta,13-04-2005,837213,Uttar Pradesh,3,18,23,3,47,Pass
Aditya Reddy,25-05-2005,229727,Tamil Nadu,5,10,5,3,23,Pass
Rohan Fernandes,27-04-2005,307029,Jharkhand,1,4,10,2,17,Pass
Peter Pillai,02-08-2005,588783,Telangana,21,3,24,10,58,Fail
Aditya Pillai,31-01-2005,949964,Maharashtra,2,11,24,19,56,Fail
Aarav Singh,01-11-2005,739018,Odisha,11,3,6,0,20,Pass
Aditya Verma,20-09-2005,358807,Rajasthan,7,16,16,9,48,Pass
Ayaan Fernandes,28-03-2006,812768,Bihar,21,15,6,20,62,Pass
Harjeet Verma,18-02-2005,704908,Bihar,16,9,4,8,37,Pass
Rehan Fernandes,30-06-2005,948936,Haryana,18,7,21,1,47,Fail
Aarav Chopra,14-05-2005,762840,Rajasthan,15,1,17,9,42,Pass
Aryan Mehta,27-07-2005,394705,Haryana,0,5,14,3,22,Fail
Yash Verma,25-01-2006,247227,West Bengal,13,4,24,9,50,Pass
Raj Singh,27-11-2004,129203,Himachal Pradesh,24,5,3,1,33,Pass
Balbir Pillai,05-03-2005,462909,Andhra Pradesh,10,1,10,15,36,Pass
Farhan Verma,28-09-2005,102081,Delhi,4,18,21,20,63,Fail
Raj Khan,25-10-2005,600102,Telangana,11,20,1,14,46,Fail
Raj Singh,23-11-2004,454514,Bihar,5,23,24,4,56,Pass
Rohan Fernandes,05-03-2005,281712,Punjab,23,15,12,8,58,Fail
Rohan Khan,24-11-2005,188809,Delhi,0,19,16,17,52,Fail
Kunal Fernandes,14-10-2005,682381,Rajasthan,9,1,16,1,27,Pass
Aryan Mehta,19-08-2005,301392,Haryana,2,4,20,22,48,Fail
Aarav Mehta,06-11-2005,957881,Kerala,24,18,20,10,72,Fail
Aditya Chopra,13-01-2005,724905,Andhra Pradesh,2,13,13,0,28,Pass
Rohan Sharma,02-12-2004,142135,Maharashtra,0,3,23,7,33,Fail
Aarav Sharma,06-01-2006,310670,Odisha,23,6,0,12,41,Pass
Mathew Reddy,14-06-2005,825891,Karnataka,1,11,23,21,56,Pass
Gurpreet Reddy,03-03-2005,335730,Gujarat,7,12,8,12,39,Fail
Harjeet Pillai,04-04-2005,216400,Maharashtra,14,20,0,14,48,Fail
Vivaan Khan,27-03-2005,773575,Karnataka,0,15,15,18,48,Pass
Rohan Sharma,21-06-2005,314949,Andhra Pradesh,10,11,8,22,51,Pass
Kunal Pillai,31-07-2005,858385,Madhya Pradesh,24,12,24,8,68,Fail
Kunal Khan,09-11-2005,666695,Uttar Pradesh,14,5,16,14,49,Pass
Sukhwinder Khan,04-05-2005,303562,Andhra Pradesh,14,7,17,18,56,Pass
Vivaan Khan,10-07-2005,153893,Madhya Pradesh,15,11,2,4,32,Fail
Kunal Khan,09-04-2005,348010,Telangana,13,4,2,20,39,Fail
Kunal Fernandes,08-02-2005,961433,Bihar,2,2,18,1,23,Pass
Zaid Reddy,12-02-2005,354900,Maharashtra,15,21,8,16,60,Fail
Kunal Sharma,15-08-2005,520554,West Bengal,10,7,0,17,34,Pass
Peter Chopra,24-11-2005,488762,Madhya Pradesh,2,4,3,24,33,Fail
Mathew Verma,05-03-2005,334481,Uttar Pradesh,14,3,21,24,62,Pass
Sukhwinder Chopra,10-02-2006,350199,Andhra Pradesh,24,21,10,3,58,Pass
Aarav Khan,09-03-2006,924262,Madhya Pradesh,0,5,2,20,27,Fail
Paul Singh,23-09-2005,515062,Punjab,8,21,7,6,42,Pass
Kunal Khan,04-12-2004,796712,Madhya Pradesh,9,8,8,12,37,Fail
Raj Singh,18-06-2005,699115,Maharashtra,1,14,19,12,46,Fail
Gurpreet Reddy,22-07-2005,288927,Jharkhand,20,17,8,6,51,Pass
Gurpreet Chopra,13-12-2005,598425,Odisha,9,8,20,20,57,Fail
Harjeet D'Souza,12-08-2005,536102,Andhra Pradesh,2,20,13,11,46,Pass
Aarav Mehta,13-09-2005,656226,Assam,16,24,3,23,66,Fail
Vivaan Chopra,17-01-2006,243266,Maharashtra,17,13,9,24,63,Fail
Vivaan Verma,02-02-2005,881416,Bihar,18,17,2,8,45,Pass
Aditya Chopra,09-11-2004,129005,Maharashtra,17,12,9,4,42,Fail
Ishaan Fernandes,31-07-2005,274864,Assam,3,23,19,5,50,Fail
Yash Singh,04-12-2004,957018,Bihar,0,15,21,22,58,Pass
Kunal Reddy,22-11-2004,407813,Kerala,2,14,22,8,46,Fail
Vivaan Khan,09-02-2006,374098,Bihar,14,23,13,17,67,Pass
Rohan Khan,19-02-2005,747607,Maharashtra,21,13,4,18,56,Fail
Raj Fernandes,08-06-2005,819746,Uttar Pradesh,3,5,0,9,17,Pass
Balbir D'Souza,16-10-2005,980095,Gujarat,14,10,21,11,56,Fail
Ishaan Mehta,21-04-2005,485952,Rajasthan,15,6,21,3,45,Pass
Kunal Chopra,10-05-2005,339084,Madhya Pradesh,12,8,6,6,32,Fail
Aditya Verma,20-05-2005,855639,Uttar Pradesh,22,3,24,21,70,Pass
Kunal Khan,08-12-2005,449944,Himachal Pradesh,4,4,19,1,28,Pass
Aditya Chopra,06-07-2005,442815,Andhra Pradesh,20,5,10,0,35,Pass
Gurpreet Singh,04-08-2005,831902,Andhra Pradesh,15,7,24,4,50,Pass
Vivaan Mehta,30-05-2005,889481,Assam,22,2,16,1,41,Fail
Ishaan Chopra,17-10-2005,847936,Gujarat,3,14,13,22,52,Fail
Gurpreet Singh,25-04-2006,659182,Uttarakhand,18,1,23,6,48,Fail
Krishna Reddy,29-12-2005,710358,Himachal Pradesh,2,6,2,19,29,Pass
David Sharma,21-11-2004,609595,Bihar,21,1,16,0,38,Pass
Aryan Mehta,11-01-2005,478742,Haryana,20,3,0,6,29,Fail
Paul Sharma,20-11-2005,453467,Odisha,20,20,7,20,67,Fail
Kunal Pillai,04-02-2005,491427,Rajasthan,4,19,20,13,56,Pass
Krishna Fernandes,26-11-2004,736351,Chhattisgarh,21,18,9,6,54,Fail
Paul D'Souza,06-12-2004,259084,Madhya Pradesh,10,13,7,23,53,Fail
Kunal Verma,18-06-2005,353588,West Bengal,5,22,16,5,48,Pass
Ishaan Singh,08-05-2006,736095,West Bengal,14,3,24,19,60,Pass
Ishaan Pillai,05-03-2005,521558,Tamil Nadu,17,23,3,11,54,Fail
Rehan Reddy,08-02-2005,325606,Madhya Pradesh,3,9,11,3,26,Fail
Rohan Reddy,13-01-2005,960212,Punjab,11,5,1,11,28,Pass
Yash Mehta,19-01-2006,737464,Madhya Pradesh,13,3,22,2,40,Fail
Krishna Chopra,17-04-2006,476273,Telangana,3,21,14,22,60,Fail
Rohan Singh,04-11-2005,666746,Madhya Pradesh,4,11,13,22,50,Fail
Krishna D'Souza,05-10-2005,812899,Karnataka,4,13,17,5,39,Pass
Raj Verma,29-09-2005,717279,Odisha,7,3,1,8,19,Pass
Gurpreet Pillai,16-12-2004,645556,Gujarat,7,23,14,14,58,Fail
Krishna Mehta,03-12-2005,841878,Haryana,22,17,10,13,62,Fail
Mathew Khan,06-04-2005,798293,Uttar Pradesh,14,18,16,20,68,Pass
Aditya Singh,04-05-2005,174042,Punjab,11,14,4,22,51,Fail
Manpreet Fernandes,08-05-2006,114699,Maharashtra,6,4,9,7,26,Fail
Yash Sharma,25-11-2005,788332,Jammu & Kashmir + Ladakh,10,22,11,21,64,Pass
Krishna Mehta,12-03-2005,486390,Rajasthan,6,22,6,13,47,Pass
Rohan D'Souza,30-05-2005,448297,Tamil Nadu,3,2,15,21,41,Pass
Balbir Mehta,04-07-2005,610798,Rajasthan,21,23,15,9,68,Fail
Aarav Mehta,26-12-2004,715818,Rajasthan,9,22,11,7,49,Pass
Harjeet Mehta,18-01-2006,899658,Rajasthan,7,7,12,1,27,Pass
Raj Chopra,31-01-2005,391413,Gujarat,24,3,12,18,57,Fail
Kunal D'Souza,15-04-2006,392262,Bihar,7,6,5,12,30,Pass
Gurpreet Khan,03-12-2005,686946,Uttar Pradesh,2,2,7,14,25,Pass
Paul Chopra,24-02-2005,983108,Madhya Pradesh,19,6,6,9,40,Fail
Imran Mehta,10-01-2006,731343,Maharashtra,20,22,20,1,63,Fail
Sukhwinder Mehta,13-03-2005,765568,Rajasthan,3,7,13,13,36,Pass
Kunal Singh,27-08-2005,685001,Haryana,4,18,21,7,50,Fail
Kunal Pillai,29-09-2005,636924,Uttar Pradesh,9,17,11,20,57,Pass
Manpreet Reddy,13-06-2005,564574,Andhra Pradesh,16,13,20,24,73,Pass
Aditya Chopra,14-11-2004,908040,Tamil Nadu,19,4,20,2,45,Fail
Paul Sharma,18-04-2005,191490,Uttar Pradesh,17,6,13,21,57,Pass
Rohan Pillai,11-09-2005,341337,Tamil Nadu,12,3,4,11,30,Pass
Kunal Reddy,23-02-2006,433895,Jharkhand,14,1,14,6,35,Pass
Paul D'Souza,21-07-2005,472804,West Bengal,17,1,14,7,39,Pass
Aarav Pillai,26-11-2005,870533,Uttar Pradesh,15,6,0,20,41,Pass
Krishna Fernandes,09-04-2006,815192,Uttar Pradesh,17,20,10,6,53,Pass
John Verma,10-03-2005,145139,Haryana,2,16,14,2,34,Fail
Ishaan Fernandes,17-03-2005,562499,Uttar Pradesh,6,12,12,14,44,Pass
Krishna D'Souza,17-07-2005,480945,Uttarakhand,14,18,4,4,40,Fail
Aarav Mehta,28-02-2006,228742,Telangana,6,5,17,24,52,Fail
Raj D'Souza,15-06-2005,141453,Mizoram,20,11,21,6,58,Fail
Aarav Reddy,05-09-2005,246558,Madhya Pradesh,23,12,15,4,54,Fail
Krishna Khan,20-01-2006,780136,Rajasthan,23,3,14,8,48,Pass
Krishna Pillai,01-03-2005,259262,Uttar Pradesh,18,11,7,2,38,Pass
Aryan Verma,18-01-2006,317222,Madhya Pradesh,22,3,21,22,68,Fail
Ishaan Chopra,19-02-2005,367682,West Bengal,14,3,18,23,58,Pass
Ishaan Fernandes,21-03-2006,653600,Bihar,8,24,24,0,56,Pass
Krishna Sharma,25-06-2005,918722,Uttarakhand,6,16,6,21,49,Fail
Aarav Sharma,08-04-2005,402804,Jharkhand,20,16,11,24,71,Fail
Aditya Reddy,20-02-2006,195468,West Bengal,24,3,15,10,52,Pass
Ishaan Singh,16-02-2006,498141,Meghalaya,11,1,19,0,31,Pass
Aarav Khan,19-03-2006,547561,Rajasthan,8,5,7,21,41,Pass
Balbir D'Souza,11-08-2005,370891,Madhya Pradesh,11,1,11,14,37,Fail
Vivaan Reddy,10-10-2005,898000,Tamil Nadu,15,22,16,24,77,Pass
Mathew Khan,01-09-2005,184424,Karnataka,22,23,3,22,70,Fail
Aryan Singh,31-01-2005,321804,Andhra Pradesh,0,12,8,16,36,Pass
Harjeet Khan,08-02-2006,807343,West Bengal,23,3,14,23,63,Pass
Gurpreet D'Souza,18-11-2005,200321,Bihar,13,9,13,7,42,Pass
Aarav Mehta,03-01-2005,854375,Madhya Pradesh,7,1,8,0,16,Fail
Rohan Reddy,29-09-2005,974714,Telangana,15,3,7,8,33,Fail
Aryan Sharma,08-04-2006,753746,Tripura,16,21,21,18,76,Fail
Peter Sharma,06-01-2006,220252,Gujarat,16,20,24,0,60,Fail
Ishaan Fernandes,04-12-2004,282013,Andhra Pradesh,22,2,15,12,51,Pass
Krishna Khan,11-04-2005,425361,Nagaland,12,6,12,22,52,Fail
Sukhwinder Chopra,04-01-2006,433434,Madhya Pradesh,2,9,6,7,24,Fail
Raj Pillai,11-06-2005,237724,Rajasthan,16,11,0,20,47,Pass
Vivaan Singh,24-04-2006,183862,Madhya Pradesh,4,19,24,23,70,Fail
Rohan Sharma,21-04-2005,351667,Assam,4,2,1,0,7,Fail
Krishna Sharma,26-02-2005,752514,Delhi,16,5,17,24,62,Fail
Aditya Singh,17-06-2005,452466,Haryana,22,13,23,17,75,Fail
Aditya D'Souza,03-11-2005,296007,Maharashtra,15,19,8,22,64,Fail
Ishaan D'Souza,09-08-2005,662219,Haryana,1,11,13,23,48,Fail
Aditya Fernandes,14-06-2005,780472,Assam,0,8,24,23,55,Fail
Aarav Khan,01-04-2005,387092,Chhattisgarh,0,1,12,24,37,Fail
Vivaan Sharma,04-02-2006,525732,Maharashtra,3,18,7,18,46,Fail
Peter Mehta,28-02-2005,838923,Tamil Nadu,5,15,13,6,39,Pass
Rehan Reddy,27-06-2005,490791,Bihar,8,8,23,6,45,Pass
Sukhwinder D'Souza,02-10-2005,343141,Chhattisgarh,20,17,8,12,57,Fail
Paul Sharma,08-08-2005,153437,Goa,11,16,13,0,40,Fail
Vivaan Reddy,25-12-2005,891071,Himachal Pradesh,9,12,14,23,58,Pass
Krishna Pillai,19-01-2005,806258,Chhattisgarh,15,1,17,6,39,Fail
Mathew Fernandes,17-10-2005,980155,Uttar Pradesh,1,9,10,14,34,Pass
Aarav D'Souza,17-08-2005,557040,West Bengal,5,17,8,18,48,Pass
Vivaan Reddy,28-09-2005,667838,Bihar,6,21,8,0,35,Pass
Aarav Reddy,16-04-2005,221918,Assam,23,24,11,18,76,Fail
Aarav Reddy,20-12-2005,270061,Madhya Pradesh,18,14,5,7,44,Fail
Aarav Singh,19-04-2005,577101,Uttar Pradesh,18,13,5,12,48,Pass
Kunal Fernandes,06-02-2006,191702,Andhra Pradesh,17,3,9,24,53,Pass
Krishna Sharma,15-11-2005,486383,Uttar Pradesh,7,22,2,7,38,Pass
Yash D'Souza,21-08-2005,567230,Bihar,15,6,9,20,50,Pass
Raj Sharma,26-10-2005,315462,Chhattisgarh,6,22,11,8,47,Fail
Kunal Reddy,25-04-2005,572508,Uttar Pradesh,22,8,15,20,65,Pass
Raj Pillai,16-06-2005,107653,Karnataka,8,14,22,8,52,Pass
Sukhwinder D'Souza,23-03-2006,379591,Maharashtra,16,20,14,23,73,Fail
Harjeet Mehta,13-04-2006,738397,Manipur,9,4,21,12,46,Fail
Vivaan Khan,14-11-2005,718809,Odisha,22,1,4,5,32,Pass
Gurpreet Verma,28-02-2005,727397,Maharashtra,12,1,3,8,24,Fail
Kunal Singh,02-12-2004,658099,Maharashtra,14,23,11,21,69,Fail
Aditya Chopra,10-03-2006,411561,Bihar,23,4,22,12,61,Pass
Manpreet Reddy,07-05-2005,593854,Tamil Nadu,0,15,11,20,46,Fail
Imran Mehta,17-02-2006,543531,Puducherry,10,4,20,17,51,Fail
Aryan Mehta,09-07-2005,769045,Gujarat,4,12,18,3,37,Fail
Krishna Khan,01-01-2005,933954,Haryana,7,10,17,23,57,Fail
Yash Fernandes,09-02-2006,764323,Andhra Pradesh,0,15,16,22,53,Pass
Raj Fernandes,11-07-2005,386043,Rajasthan,10,4,9,21,44,Pass
Rohan Sharma,18-06-2005,796541,Karnataka,14,15,0,22,51,Pass
Sukhwinder Chopra,15-07-2005,194211,Chhattisgarh,19,18,3,14,54,Fail
Krishna Pillai,10-04-2006,857748,Telangana,15,4,19,1,39,Fail
Yash D'Souza,17-03-2005,954498,Jharkhand,10,15,2,16,43,Pass
Aditya Singh,05-10-2005,935192,Telangana,20,4,8,8,40,Fail
Kunal D'Souza,30-04-2006,769458,Maharashtra,11,15,16,0,42,Fail
Imran Verma,10-03-2006,539655,Rajasthan,22,16,24,22,84,Pass
Kunal Reddy,06-12-2005,640494,Bihar,16,8,1,1,26,Pass
Vivaan D'Souza,03-04-2006,689149,Maharashtra,4,20,9,14,47,Fail
Aarav Khan,15-11-2004,472340,Uttar Pradesh,14,3,12,9,38,Pass
Aryan Mehta,15-04-2006,496437,Rajasthan,1,9,21,19,50,Pass
Kunal Singh,19-01-2005,970775,Tamil Nadu,9,22,14,11,56,Pass
David Mehta,31-03-2006,466768,Uttar Pradesh,0,6,10,20,36,Pass
Harjeet D'Souza,10-03-2005,397507,West Bengal,21,3,1,24,49,Pass
Manpreet Pillai,09-01-2006,252718,Punjab,1,5,16,14,36,Pass
Aryan Reddy,10-08-2005,257050,West Bengal,8,21,1,20,50,Pass
Yash Reddy,14-12-2004,119113,Haryana,16,2,14,12,44,Fail
Kunal Sharma,02-11-2005,111588,Uttar Pradesh,16,19,6,12,53,Pass
Harjeet Fernandes,08-01-2005,675774,Uttar Pradesh,3,14,22,16,55,Pass
Vivaan Fernandes,18-05-2005,971209,Uttarakhand,10,21,12,16,59,Fail
Krishna Chopra,15-12-2005,630015,Punjab,7,23,8,24,62,Fail
Paul Fernandes,28-12-2005,941568,Andhra Pradesh,5,10,10,16,41,Pass
Krishna Singh,13-04-2005,110190,Gujarat,4,14,19,19,56,Fail
Rohan Reddy,12-10-2005,854556,Uttar Pradesh,14,11,5,7,37,Pass
Rohan Reddy,18-03-2006,866001,Andhra Pradesh,8,12,15,10,45,Pass
Aryan Singh,28-12-2004,485317,Jammu & Kashmir + Ladakh,10,0,6,22,38,Pass
Gurpreet Sharma,19-12-2004,923662,Tamil Nadu,24,23,24,21,92,Pass
Raj Khan,06-05-2006,218722,Karnataka,1,1,9,18,29,Pass
Kunal Singh,05-11-2005,625872,Karnataka,13,7,22,1,43,Pass
Aryan Khan,06-11-2005,480305,Bihar,20,5,23,9,57,Pass
Kunal D'Souza,18-03-2005,740741,Rajasthan,19,5,5,22,51,Pass
Krishna Mehta,18-03-2005,968200,West Bengal,19,3,20,24,66,Pass
Vivaan Fernandes,30-11-2004,939056,Gujarat,14,20,2,6,42,Fail
Aditya Reddy,01-05-2006,861240,Haryana,20,0,5,0,25,Fail
Gurpreet Reddy,17-02-2006,750617,Gujarat,15,1,13,7,36,Fail
Aditya Sharma,11-05-2005,551490,Rajasthan,14,8,9,9,40,Pass
Yash Singh,05-02-2006,572491,Andhra Pradesh,22,9,15,9,55,Pass
Harjeet Fernandes,28-11-2005,180622,Madhya Pradesh,12,14,18,23,67,Fail
Harjeet Sharma,08-05-2005,154859,Bihar,1,5,13,3,22,Pass
Rohan Singh,01-04-2005,287584,Telangana,21,12,1,22,56,Fail
Vivaan Chopra,18-04-2006,808844,Bihar,21,12,2,18,53,Pass
Zaid Reddy,26-02-2006,251351,Uttar Pradesh,9,23,7,13,52,Pass
John Mehta,26-01-2006,206591,Punjab,23,3,16,14,56,Fail
Paul Sharma,08-11-2005,642375,Punjab,6,19,0,17,42,Pass
Ishaan Khan,15-04-2006,393057,Telangana,18,22,3,10,53,Fail
Ishaan Reddy,20-04-2005,176275,Gujarat,12,17,16,6,51,Fail
Yash Reddy,21-09-2005,193391,Rajasthan,23,19,12,14,68,Fail
Vivaan Chopra,01-05-2006,845121,Uttarakhand,24,7,16,21,68,Fail
Raj Khan,24-08-2005,926683,Rajasthan,17,1,24,8,50,Pass
Ishaan Fernandes,08-02-2006,840378,Rajasthan,9,20,3,20,52,Pass
Raj Verma,14-02-2005,795517,West Bengal,20,9,12,1,42,Pass
Kunal Reddy,19-01-2005,768415,Tamil Nadu,15,9,13,17,54,Fail
Manpreet Sharma,13-12-2004,712110,Karnataka,8,21,2,3,34,Pass
Gurpreet Reddy,16-12-2004,468810,Bihar,12,15,21,11,59,Fail
Peter Chopra,26-06-2005,853838,Rajasthan,11,19,10,21,61,Fail
Rohan Fernandes,11-07-2005,248815,Madhya Pradesh,4,16,1,16,37,Fail
Raj Mehta,16-03-2005,216922,Uttar Pradesh,6,3,24,7,40,Pass
Aryan D'Souza,20-09-2005,155318,Bihar,21,2,7,12,42,Pass
Aarav Reddy,02-04-2005,217507,Uttar Pradesh,9,24,11,21,65,Pass
Aditya D'Souza,03-02-2006,163015,Andhra Pradesh,18,15,3,9,45,Pass
Aarav Khan,05-10-2005,627431,Rajasthan,17,22,16,4,59,Pass
Aryan Mehta,20-07-2005,271499,Punjab,0,16,6,6,28,Pass
Aarav Sharma,03-10-2005,770296,Uttar Pradesh,19,13,1,1,34,Pass
Ishaan Chopra,02-12-2005,586447,Rajasthan,10,17,0,2,29,Pass
Kunal Reddy,06-12-2004,681408,Telangana,22,24,6,1,53,Fail
Krishna Mehta,20-11-2004,270902,Bihar,11,0,23,4,38,Pass
Rohan Singh,14-06-2005,528995,Madhya Pradesh,15,23,21,14,73,Fail
Raj Mehta,22-10-2005,331752,Punjab,21,22,1,14,58,Fail
Kunal Sharma,11-06-2005,983148,Chhattisgarh,14,24,17,12,67,Fail
John Khan,28-07-2005,904219,Tamil Nadu,5,0,15,13,33,Pass
Vivaan Khan,07-05-2006,785247,Bihar,23,7,22,10,62,Fail
Balbir Singh,21-04-2005,308841,Himachal Pradesh,9,6,9,12,36,Pass
Aarav Fernandes,25-12-2005,806800,Uttar Pradesh,24,4,18,11,57,Pass
Farhan Fernandes,21-08-2005,435141,Maharashtra,21,7,17,20,65,Fail
Yash Reddy,05-05-2006,791706,Rajasthan,1,8,6,17,32,Pass
Vivaan D'Souza,23-08-2005,672054,Bihar,5,13,9,17,44,Fail
Aditya Chopra,15-04-2005,440061,Jammu & Kashmir + Ladakh,20,13,7,24,64,Pass
Kunal Sharma,08-02-2005,264250,Uttar Pradesh,16,9,18,0,43,Pass
Krishna Fernandes,27-07-2005,992369,Chhattisgarh,16,2,16,14,48,Fail
Gurpreet Khan,10-03-2005,247012,Andhra Pradesh,21,1,11,13,46,Pass
Aditya Verma,23-08-2005,521178,Rajasthan,21,9,13,12,55,Pass
Yash Pillai,12-01-2005,661676,West Bengal,3,4,9,20,36,Pass
Aditya Khan,16-01-2006,625776,Assam,22,19,14,19,74,Fail
Ishaan Chopra,13-08-2005,552914,Nagaland,3,15,23,21,62,Fail
Imran Chopra,08-07-2005,743823,Gujarat,18,22,20,22,82,Fail
Raj Singh,10-01-2005,295158,West Bengal,24,3,20,16,63,Pass
Balbir D'Souza,02-05-2006,450210,Rajasthan,15,7,7,13,42,Pass
Aryan Chopra,14-03-2006,951568,Jharkhand,6,18,11,24,59,Pass
Ishaan Sharma,23-06-2005,359555,Rajasthan,0,12,1,13,26,Pass
Aarav D'Souza,04-01-2005,208623,Rajasthan,4,10,11,6,31,Pass
Ishaan D'Souza,10-04-2006,393948,Maharashtra,3,9,5,21,38,Fail
Vivaan Pillai,03-01-2005,784381,Uttar Pradesh,17,18,15,0,50,Pass
Krishna Chopra,25-02-2006,192789,Kerala,21,2,18,2,43,Fail
Peter Khan,17-02-2005,656730,Andhra Pradesh,24,10,17,11,62,Pass
Aarav Sharma,23-09-2005,742261,Uttar Pradesh,23,6,16,21,66,Pass
Aryan Fernandes,01-05-2006,317021,Andhra Pradesh,3,13,14,18,48,Fail
Raj Verma,09-10-2005,422832,Uttar Pradesh,14,3,24,23,64,Pass
Aryan Pillai,05-07-2005,429937,Uttar Pradesh,6,7,10,7,30,Pass
Balbir Reddy,28-04-2005,638969,Gujarat,21,19,11,21,72,Fail
Aarav Sharma,26-04-2005,205369,Meghalaya,20,11,18,2,51,Fail
David D'Souza,30-01-2006,971479,Punjab,13,3,12,5,33,Pass
Ishaan Chopra,18-04-2005,991596,Bihar,24,1,13,12,50,Fail
John D'Souza,27-01-2006,191225,Himachal Pradesh,8,17,17,13,55,Pass
Aditya Pillai,07-04-2006,895195,Rajasthan,21,0,8,18,47,Pass
Vivaan Khan,06-06-2005,466597,Rajasthan,9,9,22,6,46,Pass
Krishna Mehta,20-02-2005,938057,Uttar Pradesh,21,12,15,5,53,Pass
Aryan Singh,15-02-2006,299383,Bihar,24,21,11,2,58,Fail
Aryan Mehta,11-05-2005,520531,Telangana,12,21,20,1,54,Fail
Zaid Sharma,03-11-2005,137196,West Bengal,17,3,21,6,47,Pass
Ishaan Mehta,20-11-2005,923709,Delhi,2,5,21,17,45,Fail
Rohan Reddy,03-03-2005,244586,Madhya Pradesh,9,0,23,21,53,Fail
Krishna Singh,04-05-2005,233100,Tamil Nadu,10,7,19,5,41,Pass
Rohan Fernandes,09-04-2005,269053,Madhya Pradesh,18,6,9,2,35,Fail
Vivaan Mehta,01-11-2005,886622,Uttar Pradesh,20,14,10,1,45,Pass
Rohan Khan,26-12-2004,133951,Haryana,1,17,6,17,41,Fail
John Chopra,10-04-2006,402688,Madhya Pradesh,13,22,2,15,52,Fail
Imran Fernandes,22-02-2005,650447,West Bengal,2,16,9,2,29,Pass
David D'Souza,01-05-2006,128234,Bihar,9,13,22,0,44,Pass
Vivaan Pillai,30-01-2006,198899,Gujarat,18,16,12,0,46,Fail
Sukhwinder Khan,08-09-2005,914138,Maharashtra,13,18,10,19,60,Fail
Raj Reddy,28-12-2004,498285,Rajasthan,4,8,24,14,50,Pass
Kunal Sharma,30-03-2006,614747,Madhya Pradesh,17,17,14,11,59,Fail
Yash Khan,25-01-2005,788684,Odisha,17,10,24,7,58,Fail
Ayaan Khan,17-11-2005,917891,West Bengal,19,3,6,22,50,Pass
Aryan Pillai,09-11-2005,753441,Maharashtra,8,1,16,6,31,Fail
David Sharma,30-12-2005,705230,Rajasthan,6,8,23,6,43,Pass
Krishna Mehta,06-03-2006,647844,Bihar,5,23,21,11,60,Fail
Ishaan Chopra,26-04-2006,578728,Bihar,13,19,1,0,33,Pass
Raj Pillai,07-01-2006,718051,Jharkhand,12,13,19,0,44,Pass
Yash Khan,07-09-2005,808304,Uttar Pradesh,1,5,15,18,39,Pass
Vivaan D'Souza,22-12-2004,230350,Maharashtra,16,10,21,3,50,Fail
Mathew Fernandes,08-02-2005,451553,Uttar Pradesh,9,17,5,9,40,Pass
Manpreet Khan,06-03-2005,788711,Rajasthan,17,9,5,24,55,Pass
Aarav Khan,11-12-2005,917049,Punjab,7,5,8,7,27,Pass
Ishaan Sharma,09-12-2004,642080,Andhra Pradesh,24,23,2,10,59,Fail
John D'Souza,23-02-2005,886865,Jammu & Kashmir + Ladakh,16,10,9,1,36,Pass
Aarav Singh,04-08-2005,896985,Bihar,13,4,3,14,34,Pass
Aarav Fernandes,26-03-2006,377481,Himachal Pradesh,0,18,12,18,48,Pass
Rohan Pillai,27-03-2006,647058,Rajasthan,19,3,21,23,66,Fail
Aryan Verma,03-01-2006,218878,Chhattisgarh,1,0,10,6,17,Fail
Rohan Reddy,02-02-2005,718045,Bihar,16,13,8,8,45,Pass
Raj Verma,24-11-2005,399697,Gujarat,5,20,4,3,32,Fail
Krishna Mehta,26-02-2005,248462,Madhya Pradesh,4,9,22,15,50,Fail
Yash Chopra,29-10-2005,451682,Punjab,16,8,20,19,63,Fail
Aditya Singh,01-09-2005,353235,Tamil Nadu,7,1,1,22,31,Pass
Aditya Chopra,26-12-2005,580083,Jharkhand,6,10,20,5,41,Pass
Ishaan Sharma,14-03-2006,175202,Chhattisgarh,2,24,12,12,50,Fail
Peter Reddy,16-08-2005,287836,Uttarakhand,4,16,23,19,62,Fail
David Reddy,23-04-2005,513877,Maharashtra,11,3,12,15,41,Fail
Aditya Fernandes,03-04-2005,123304,Tamil Nadu,16,7,9,2,34,Pass
Yash Khan,12-01-2006,485115,Punjab,10,9,7,16,42,Pass
Balbir Khan,24-02-2006,236440,Odisha,8,6,11,6,31,Pass
Ishaan Singh,08-05-2005,255414,Uttar Pradesh,15,18,9,19,61,Pass
Raj Verma,03-01-2005,109387,Bihar,6,6,22,9,43,Pass
Yash Sharma,19-06-2005,517833,Bihar,10,9,22,5,46,Fail
Aryan Khan,15-04-2005,288574,Maharashtra,8,3,16,20,47,Fail
Krishna Reddy,20-02-2006,681112,Mizoram,21,8,18,12,59,Fail
John Mehta,05-08-2005,355228,Tamil Nadu,16,12,15,12,55,Fail
Yash Mehta,30-03-2006,872845,Madhya Pradesh,9,0,6,9,24,Fail
Rohan Pillai,18-09-2005,263759,Maharashtra,17,19,6,18,60,Fail
Aryan D'Souza,09-01-2005,215768,Madhya Pradesh,8,19,19,4,50,Fail
Kunal Mehta,07-11-2005,827638,Madhya Pradesh,4,16,18,16,54,Fail
Farhan Mehta,16-02-2006,484616,Madhya Pradesh,12,0,15,15,42,Fail
Vivaan Mehta,25-12-2004,411398,Jharkhand,0,14,0,7,21,Pass
Rohan Fernandes,26-01-2006,201149,Bihar,2,23,10,4,39,Pass
Aditya Khan,08-04-2006,725494,Jharkhand,17,19,10,3,49,Pass
Paul Pillai,27-12-2004,304289,Punjab,19,19,23,8,69,Fail
Raj Pillai,15-06-2005,422096,Rajasthan,4,22,2,18,46,Pass
Zaid Verma,25-04-2006,946174,Jammu & Kashmir + Ladakh,18,9,0,3,30,Pass
Krishna Singh,07-01-2005,591430,West Bengal,7,4,3,22,36,Pass
Aryan Mehta,19-02-2006,992644,Rajasthan,16,11,22,22,71,Fail
Vivaan Singh,28-06-2005,612116,Delhi,5,14,1,19,39,Fail
Ishaan Chopra,01-08-2005,784275,Bihar,19,9,23,11,62,Fail
Sukhwinder Sharma,22-06-2005,301268,Punjab,0,19,21,4,44,Pass
Rohan Singh,09-09-2005,313888,Uttar Pradesh,5,20,7,15,47,Pass
Krishna Chopra,25-09-2005,978415,Madhya Pradesh,16,9,24,15,64,Fail
Gurpreet Verma,02-04-2005,703045,Madhya Pradesh,24,2,15,11,52,Fail
Aryan Pillai,07-06-2005,652111,Tamil Nadu,21,1,2,0,24,Pass
Raj Reddy,18-09-2005,257225,Uttarakhand,3,18,19,1,41,Fail
David Reddy,12-12-2005,261129,Tamil Nadu,5,21,2,9,37,Pass
Aarav Chopra,14-11-2005,990024,Tripura,21,10,16,24,71,Fail
Krishna D'Souza,13-09-2005,597985,Bihar,2,23,9,5,39,Fail
Yash Fernandes,08-11-2005,232513,Bihar,6,3,18,1,28,Pass
Kunal D'Souza,12-03-2006,746605,Uttar Pradesh,5,8,19,19,51,Pass
Yash Fernandes,25-07-2005,971054,Delhi,10,0,16,19,45,Fail
Gurpreet Verma,20-03-2005,951902,Jammu & Kashmir + Ladakh,16,19,14,7,56,Pass
John Mehta,12-12-2005,771737,Rajasthan,21,4,9,22,56,Pass
Aarav Fernandes,04-04-2005,726977,Delhi,21,0,1,21,43,Fail
Raj Reddy,21-04-2006,874496,West Bengal,21,3,17,8,49,Pass
Ishaan Fernandes,18-06-2005,320315,Gujarat,15,16,16,4,51,Fail
Harjeet Mehta,12-07-2005,391567,Tamil Nadu,0,2,13,0,15,Pass
Aryan Chopra,26-04-2005,671773,Bihar,0,6,10,1,17,Pass
Aryan Sharma,23-10-2005,631621,Telangana,6,12,0,13,31,Fail
Yash Reddy,30-01-2006,169052,Bihar,3,1,3,0,7,Pass
Rohan Sharma,15-11-2004,680437,Punjab,23,13,9,4,49,Fail
Sukhwinder Singh,06-01-2005,789535,Gujarat,20,3,2,4,29,Fail
Gurpreet Chopra,06-12-2004,870643,Gujarat,22,5,12,14,53,Fail
Aarav Sharma,21-06-2005,188553,Rajasthan,24,9,17,7,57,Pass
Vivaan D'Souza,31-03-2005,364266,Uttar Pradesh,17,23,3,23,66,Pass
Krishna Fernandes,10-05-2005,509411,Maharashtra,15,19,17,4,55,Fail
Balbir Reddy,19-05-2005,380801,Rajasthan,20,5,5,20,50,Pass
Raj Verma,18-03-2005,922521,Uttar Pradesh,9,11,19,2,41,Pass
Imran Pillai,07-09-2005,323341,Punjab,23,1,6,13,43,Pass
Aarav Chopra,28-01-2005,200709,Rajasthan,3,24,6,20,53,Pass
Aryan D'Souza,09-03-2006,950715,Uttar Pradesh,22,0,2,3,27,Pass
Balbir Fernandes,06-10-2005,492428,Chhattisgarh,13,13,20,1,47,Fail
Yash Mehta,08-07-2005,502803,Uttar Pradesh,22,10,18,14,64,Pass
Rohan Verma,09-04-2005,805074,Andhra Pradesh,0,18,1,9,28,Fail
Mathew Reddy,21-05-2005,671462,Bihar,15,17,11,9,52,Fail
Aarav Mehta,03-05-2006,213863,Uttar Pradesh,20,5,6,23,54,Pass
Manpreet Verma,19-08-2005,196410,Rajasthan,13,20,8,10,51,Pass
Aryan Chopra,01-01-2006,628014,Bihar,19,11,15,23,68,Fail
Balbir D'Souza,25-11-2005,995868,Gujarat,1,7,21,7,36,Fail
Gurpreet Pillai,14-02-2006,194698,Maharashtra,8,5,2,23,38,Fail
Aditya Khan,30-03-2006,247067,Madhya Pradesh,7,4,11,23,45,Fail
David Sharma,23-03-2006,693885,Rajasthan,12,22,19,19,72,Fail
Aarav D'Souza,23-01-2006,105500,Rajasthan,24,14,15,10,63,Fail
Imran Fernandes,29-11-2005,696296,Uttar Pradesh,2,17,5,11,35,Pass
Rohan D'Souza,19-08-2005,870057,Himachal Pradesh,11,23,0,14,48,Pass
Vivaan Khan,31-10-2005,515611,Himachal Pradesh,5,3,4,10,22,Pass
Vivaan Khan,30-12-2005,175426,Uttarakhand,23,19,3,16,61,Fail
Sukhwinder Pillai,15-12-2005,589064,Bihar,20,3,22,11,56,Fail
Mathew Mehta,13-11-2005,585105,Bihar,5,3,4,23,35,Pass
Rohan Sharma,26-12-2004,811967,Delhi,5,22,23,22,72,Fail
Manpreet Verma,27-02-2006,370456,Telangana,5,1,0,17,23,Fail
Aryan Verma,26-09-2005,690052,Delhi,21,17,10,1,49,Fail
Raj Mehta,10-04-2006,862192,West Bengal,6,3,23,9,41,Pass
Krishna Singh,27-12-2005,160927,Chhattisgarh,22,23,17,9,71,Fail
Raj Sharma,25-06-2005,659241,Madhya Pradesh,15,15,12,2,44,Fail
Balbir Verma,30-09-2005,573026,Haryana,19,12,5,4,40,Fail
Kunal Reddy,26-12-2004,823084,Andhra Pradesh,3,0,11,24,38,Fail
Rohan Pillai,06-05-2005,982380,Bihar,11,2,8,10,31,Pass
Harjeet Chopra,08-03-2005,527219,West Bengal,23,3,3,16,45,Pass
Yash Mehta,08-02-2006,950297,Himachal Pradesh,17,19,18,5,59,Pass
Rohan Fernandes,20-12-2005,183962,Tamil Nadu,19,15,16,1,51,Pass
Balbir Pillai,22-10-2005,641723,Odisha,18,13,16,3,50,Fail
Rehan Verma,31-05-2005,766832,Gujarat,6,11,22,23,62,Fail
Yash Khan,17-10-2005,853230,Tamil Nadu,5,18,16,11,50,Fail
Kunal Fernandes,28-03-2005,244125,Maharashtra,2,12,7,12,33,Fail
Aryan Sharma,11-12-2005,870987,Bihar,12,0,1,23,36,Pass
Yash Singh,14-12-2005,844259,Tamil Nadu,12,5,14,0,31,Pass
Raj Sharma,13-10-2005,695595,Jammu & Kashmir + Ladakh,4,12,5,21,42,Pass
Yash D'Souza,10-05-2005,533512,Punjab,20,15,23,10,68,Fail
Harjeet Singh,24-05-2005,599319,Jharkhand,4,19,16,13,52,Pass
Aryan Pillai,06-07-2005,856072,Andhra Pradesh,12,4,8,9,33,Fail
Aryan Fernandes,03-10-2005,394710,Bihar,6,5,1,22,34,Pass
Rohan Chopra,01-09-2005,901235,Rajasthan,13,1,16,24,54,Pass
Vivaan D'Souza,12-05-2005,497603,Meghalaya,6,24,20,18,68,Fail
Ishaan Fernandes,11-12-2004,326618,Rajasthan,13,22,5,20,60,Fail
Aryan Reddy,20-07-2005,664014,Uttar Pradesh,11,22,5,11,49,Pass
Balbir Fernandes,02-12-2005,357869,Jharkhand,13,22,19,18,72,Fail
David Mehta,29-11-2005,313773,Jharkhand,4,5,18,11,38,Pass
Aarav Pillai,02-03-2006,966394,Bihar,7,0,13,15,35,Pass
Balbir D'Souza,07-05-2005,112712,Maharashtra,10,24,14,21,69,Fail
Raj Verma,08-10-2005,820490,Uttar Pradesh,19,17,9,18,63,Pass
David Verma,06-03-2006,116435,Haryana,10,16,14,24,64,Fail
Manpreet Verma,07-01-2005,490501,Punjab,23,15,17,12,67,Fail
Raj Singh,16-10-2005,573800,Assam,7,4,18,8,37,Fail
Mathew Pillai,28-04-2006,240949,Kerala,8,10,6,17,41,Fail
Vivaan Verma,13-02-2006,503274,Rajasthan,1,14,1,8,24,Pass
Aditya D'Souza,19-06-2005,974788,Rajasthan,0,16,16,17,49,Pass
Manpreet D'Souza,13-04-2005,388546,Uttar Pradesh,9,13,17,7,46,Pass
Gurpreet Mehta,13-03-2005,229577,Bihar,1,0,0,4,5,Pass
Peter Khan,02-02-2005,908107,Madhya Pradesh,16,1,0,1,18,Fail
Yash Mehta,04-12-2004,157324,Manipur,19,0,13,15,47,Fail
Aarav Verma,21-12-2004,813867,Bihar,11,24,13,3,51,Fail
Raj D'Souza,01-11-2005,775951,West Bengal,21,3,6,9,39,Pass
Harjeet Reddy,01-04-2006,383437,Madhya Pradesh,22,10,15,11,58,Fail
Krishna Mehta,13-09-2005,326952,Uttar Pradesh,8,21,13,1,43,Pass
John Fernandes,21-04-2006,635315,Arunachal Pradesh,3,4,16,13,36,Fail
John Reddy,28-03-2006,631441,Tamil Nadu,1,0,13,24,38,Pass
Aditya Mehta,24-04-2005,620661,Rajasthan,18,20,10,14,62,Fail
Yash Khan,16-12-2004,891720,Andhra Pradesh,9,14,3,1,27,Fail
Balbir Mehta,18-03-2006,223335,Tamil Nadu,10,16,18,23,67,Fail
John Pillai,20-03-2005,322757,Tamil Nadu,15,19,12,12,58,Fail
Raj Chopra,07-07-2005,363186,Chhattisgarh,7,18,17,22,64,Fail
Krishna Singh,08-12-2005,402531,Punjab,0,0,18,8,26,Pass
Balbir Reddy,28-01-2006,886304,Uttar Pradesh,21,10,12,0,43,Pass
Ayaan Pillai,25-04-2006,742587,Haryana,11,13,23,4,51,Fail
Aditya D'Souza,14-08-2005,651294,Madhya Pradesh,3,17,14,4,38,Fail
Rehan Verma,20-01-2005,419476,Maharashtra,6,2,16,4,28,Fail
Gurpreet Sharma,06-11-2005,767085,Punjab,15,9,4,9,37,Pass
Ishaan Verma,13-03-2005,351507,Uttar Pradesh,17,1,1,5,24,Pass
Kunal Reddy,09-04-2006,935598,Tamil Nadu,5,11,21,12,49,Fail
Ishaan Fernandes,24-11-2004,497108,Uttar Pradesh,21,20,17,3,61,Pass
Aditya Chopra,22-02-2006,467956,Jharkhand,12,19,21,24,76,Fail
Ishaan Verma,12-12-2005,975385,Bihar,12,17,20,8,57,Fail
Sukhwinder D'Souza,29-10-2005,879147,Uttar Pradesh,13,18,6,15,52,Pass
Krishna Singh,08-12-2004,415692,Rajasthan,21,6,0,10,37,Pass
Yash Singh,15-11-2004,832644,Bihar,3,16,14,6,39,Pass
Aarav Singh,12-04-2005,956560,Maharashtra,6,12,7,18,43,Fail
Aryan Singh,26-06-2005,486859,Jharkhand,3,11,5,7,26,Pass
Kunal D'Souza,02-09-2005,568073,Uttarakhand,4,17,24,5,50,Fail
Gurpreet Fernandes,04-05-2005,889869,Rajasthan,2,5,16,9,32,Pass
Aarav Sharma,12-11-2005,207516,Haryana,8,18,9,12,47,Fail
Ishaan Pillai,11-11-2005,969492,Gujarat,15,17,0,20,52,Fail
Rohan D'Souza,27-04-2005,194693,Meghalaya,4,5,9,20,38,Pass
Gurpreet Verma,08-02-2005,800455,Uttarakhand,16,14,1,2,33,Fail
Krishna Verma,08-04-2006,597509,Assam,24,6,14,4,48,Fail
Aryan Mehta,08-06-2005,210250,Jammu & Kashmir + Ladakh,2,12,18,11,43,Pass
Vivaan Sharma,30-03-2005,503684,Odisha,19,23,8,17,67,Fail
John D'Souza,03-03-2006,201799,Maharashtra,18,10,11,10,49,Fail
Krishna Sharma,08-02-2005,494463,Andhra Pradesh,18,8,12,8,46,Fail
Manpreet Reddy,31-01-2006,811082,Telangana,3,16,8,1,28,Fail
Aditya Pillai,26-08-2005,276100,Madhya Pradesh,1,12,15,12,40,Fail
Raj Khan,22-02-2005,995462,Punjab,4,21,13,17,55,Fail
Zaid Khan,18-04-2006,820774,Rajasthan,12,3,24,6,45,Pass
Raj Singh,11-09-2005,901811,Maharashtra,12,7,21,17,57,Fail
Krishna Reddy,30-03-2006,229458,Telangana,18,8,5,17,48,Fail
Aryan Sharma,25-10-2005,662618,Uttar Pradesh,3,8,4,16,31,Pass
Manpreet Sharma,03-10-2005,285490,Madhya Pradesh,18,4,9,3,34,Fail
Rohan Mehta,13-02-2005,156694,Bihar,9,4,8,0,21,Pass
Sukhwinder Verma,02-12-2004,979834,West Bengal,23,3,18,11,55,Pass
John Fernandes,07-02-2006,502869,Bihar,7,17,0,9,33,Pass
Krishna Fernandes,25-01-2006,432394,Odisha,11,5,10,18,44,Pass
Raj Pillai,28-03-2006,834702,Uttarakhand,16,17,9,14,56,Fail
Harjeet Khan,22-12-2004,358594,Karnataka,7,8,14,7,36,Pass
Ishaan D'Souza,08-03-2006,852211,Andhra Pradesh,0,16,4,8,28,Fail
Raj Singh,24-07-2005,880375,Tamil Nadu,13,3,3,19,38,Pass
Balbir Singh,11-01-2005,941467,Delhi,12,23,15,0,50,Fail
Imran Sharma,07-05-2005,503985,Gujarat,18,21,22,19,80,Fail
Raj Chopra,09-03-2005,117478,Tamil Nadu,24,5,3,12,44,Pass
Yash Pillai,05-02-2005,438156,Maharashtra,0,18,9,14,41,Fail
Rohan Reddy,14-11-2004,542732,Andhra Pradesh,0,9,4,5,18,Fail
John Pillai,01-04-2006,677167,Uttar Pradesh,5,3,20,21,49,Pass
Yash Singh,23-10-2005,764143,Uttar Pradesh,21,10,4,15,50,Pass
Krishna Singh,22-02-2005,454949,Maharashtra,2,23,3,15,43,Fail
Ishaan Mehta,25-06-2005,964797,Madhya Pradesh,2,19,17,12,50,Fail
Gurpreet Singh,31-03-2006,673732,Maharashtra,16,15,5,5,41,Fail
Gurpreet Pillai,15-01-2005,727792,Uttar Pradesh,7,9,20,3,39,Pass
Krishna Sharma,08-04-2005,898122,Haryana,16,9,16,6,47,Fail
Kunal Pillai,04-02-2005,372934,Bihar,4,5,1,4,14,Pass
Yash Pillai,02-11-2005,917330,Karnataka,9,21,12,2,44,Pass
Raj Sharma,18-02-2005,652270,Gujarat,17,23,15,0,55,Fail
Krishna Pillai,10-12-2004,218306,Tamil Nadu,0,21,9,17,47,Pass
Aryan Mehta,04-11-2005,261282,Andhra Pradesh,12,6,9,10,37,Fail
Yash Reddy,03-02-2005,964691,Bihar,20,0,9,0,29,Pass
Imran Reddy,07-03-2005,226356,Tamil Nadu,7,19,9,24,59,Pass
Ayaan Singh,05-08-2005,711809,Uttar Pradesh,19,9,8,22,58,Pass
Gurpreet D'Souza,04-07-2005,377108,Bihar,17,5,19,20,61,Fail
Balbir Singh,01-12-2004,946159,Bihar,10,18,11,6,45,Pass
Kunal Sharma,11-06-2005,635833,Bihar,17,10,14,16,57,Fail
Krishna Sharma,04-06-2005,299287,Nagaland,16,6,8,12,42,Pass
Yash Fernandes,26-03-2005,904661,Punjab,18,21,2,22,63,Fail
Ishaan Chopra,23-04-2006,932985,Punjab,12,5,23,12,52,Fail
Aarav Singh,27-01-2005,363036,Puducherry,22,4,24,14,64,Fail
Rohan Sharma,31-10-2005,639634,Himachal Pradesh,12,9,1,17,39,Pass
Aarav Khan,07-01-2005,799631,Punjab,20,14,10,14,58,Fail
Krishna D'Souza,24-09-2005,495113,Himachal Pradesh,12,23,9,1,45,Pass
Mathew Chopra,12-05-2005,376893,Uttar Pradesh,15,3,12,17,47,Pass
Harjeet Singh,21-06-2005,496989,Uttar Pradesh,8,21,6,8,43,Pass
Sukhwinder Singh,14-10-2005,657655,Rajasthan,5,2,16,21,44,Pass
Aarav Khan,15-06-2005,383535,Bihar,19,4,9,18,50,Fail
Raj Fernandes,16-01-2006,380427,Haryana,22,22,23,15,82,Fail
Aditya D'Souza,02-05-2006,313414,Rajasthan,16,6,7,23,52,Pass
Yash Khan,04-02-2006,153358,West Bengal,17,3,1,3,24,Pass
Balbir Sharma,13-05-2005,362764,Telangana,6,9,16,2,33,Fail
Gurpreet D'Souza,16-07-2005,545351,Odisha,23,19,13,20,75,Fail
Sukhwinder Mehta,12-02-2006,846516,Bihar,14,7,6,24,51,Fail
John D'Souza,05-04-2006,530086,Himachal Pradesh,21,0,3,11,35,Pass
Balbir Sharma,14-03-2005,791530,Madhya Pradesh,9,8,22,20,59,Fail
Kunal Khan,04-08-2005,600719,Rajasthan,19,8,17,0,44,Pass
Vivaan Verma,21-02-2006,430530,Rajasthan,11,1,5,21,38,Pass
Sukhwinder Mehta,12-12-2005,202104,Odisha,15,0,9,2,26,Pass
Aarav Chopra,19-12-2005,769939,Goa,5,15,11,24,55,Fail
Rohan Mehta,16-12-2004,935524,Bihar,4,9,5,1,19,Pass
Krishna Mehta,09-11-2005,701165,Bihar,19,9,19,15,62,Fail
Aarav Fernandes,18-12-2005,253726,Haryana,12,15,3,6,36,Fail
Rohan Sharma,06-01-2005,719873,Madhya Pradesh,18,4,8,5,35,Fail
Aditya Singh,21-11-2005,745056,West Bengal,23,23,4,1,51,Pass
Rohan D'Souza,26-01-2006,200767,Tamil Nadu,14,10,22,8,54,Fail
Kunal Reddy,12-02-2006,287508,Uttar Pradesh,2,8,9,6,25,Pass
Rohan Chopra,29-04-2006,302212,Bihar,13,16,11,12,52,Fail
Raj Reddy,27-11-2005,375606,Uttarakhand,16,3,10,3,32,Fail
Aarav Pillai,04-09-2005,184919,Tripura,14,12,4,24,54,Fail
Vivaan D'Souza,17-05-2005,817428,Rajasthan,9,9,14,24,56,Pass
Yash Singh,17-02-2006,379891,Sikkim,11,10,6,22,49,Fail
Aryan Chopra,21-03-2005,409498,Haryana,19,12,20,9,60,Fail
Harjeet Mehta,22-05-2005,849608,Andhra Pradesh,21,1,20,14,56,Fail
Vivaan Pillai,04-04-2006,728594,Madhya Pradesh,24,17,24,14,79,Fail
Aarav Khan,08-10-2005,934484,Odisha,18,6,3,0,27,Pass
Krishna Reddy,04-05-2005,402647,Bihar,15,15,18,4,52,Fail
Vivaan Mehta,03-02-2005,594496,Uttar Pradesh,11,3,21,21,56,Pass
Yash Chopra,25-07-2005,290940,Kerala,18,16,5,12,51,Fail
Raj Mehta,04-04-2006,880060,West Bengal,23,3,20,16,62,Pass
Gurpreet D'Souza,25-04-2006,375227,Bihar,20,12,9,17,58,Fail
Kunal Pillai,28-10-2005,449327,Uttar Pradesh,15,7,24,14,60,Pass
Aarav Khan,03-06-2005,677232,Uttar Pradesh,8,22,1,4,35,Pass
Peter D'Souza,11-03-2006,201480,Chhattisgarh,17,9,13,2,41,Fail
Krishna Reddy,22-06-2005,213541,Tripura,4,9,9,15,37,Fail
Aarav Fernandes,01-11-2005,346447,Delhi,10,16,8,18,52,Fail
Balbir Reddy,27-01-2006,145378,Maharashtra,23,21,7,19,70,Fail
Vivaan Singh,27-07-2005,577377,Rajasthan,23,11,24,4,62,Fail
Ayaan Reddy,21-02-2006,134180,Tamil Nadu,15,19,14,9,57,Pass
Aditya Reddy,22-08-2005,551379,Daman & Diu / D&N Haveli,20,5,2,7,34,Fail
Rohan Mehta,09-12-2005,388897,Telangana,0,20,6,19,45,Fail
Peter Sharma,07-05-2005,409324,Uttar Pradesh,2,12,13,4,31,Pass
Paul Reddy,28-12-2005,294882,Andhra Pradesh,2,3,11,4,20,Fail
Krishna Reddy,14-12-2004,754633,Bihar,24,11,13,11,59,Fail
Kunal Mehta,16-01-2005,902273,Andhra Pradesh,4,17,5,2,28,Fail
Rohan Sharma,24-09-2005,145901,Madhya Pradesh,10,19,21,17,67,Fail
Ishaan Fernandes,20-02-2005,300674,Punjab,12,8,2,3,25,Pass
Vivaan Pillai,28-07-2005,905871,Jammu & Kashmir + Ladakh,5,5,16,1,27,Pass
Aryan Verma,26-02-2005,826928,Bihar,21,17,13,1,52,Fail
Krishna Sharma,18-08-2005,580374,Odisha,10,5,17,2,34,Pass
Aarav Fernandes,31-10-2005,140851,Maharashtra,10,9,24,5,48,Fail
Harjeet Khan,09-03-2006,278362,Maharashtra,15,4,6,23,48,Fail
Harjeet Singh,24-09-2005,465982,Rajasthan,20,13,5,13,51,Pass
Aryan Mehta,14-01-2006,587336,Uttar Pradesh,13,20,22,8,63,Pass
Aditya Singh,10-09-2005,526038,Haryana,1,18,1,23,43,Fail
Manpreet Sharma,28-11-2005,521946,Maharashtra,16,8,0,3,27,Fail
Ishaan Khan,20-03-2005,169129,Bihar,15,6,19,24,64,Fail
Peter Verma,25-03-2005,207883,Uttar Pradesh,22,3,22,15,62,Pass
Manpreet Reddy,05-08-2005,876503,Tripura,22,22,10,5,59,Fail
Aarav Chopra,02-01-2006,186144,Andhra Pradesh,2,3,8,5,18,Fail
Vivaan Fernandes,10-11-2005,672858,Jharkhand,20,22,13,4,59,Pass
Ishaan Khan,07-01-2005,603663,Uttarakhand,13,15,13,11,52,Fail
Aditya Chopra,13-10-2005,739349,Madhya Pradesh,19,12,4,8,43,Fail
Ayaan Khan,17-02-2005,826672,Delhi,10,4,16,23,53,Fail
Aryan Sharma,19-01-2005,885380,Himachal Pradesh,20,7,21,12,60,Pass
Rohan Sharma,18-04-2005,929796,Maharashtra,13,15,21,13,62,Fail
Gurpreet Fernandes,12-12-2005,959119,West Bengal,3,12,14,10,39,Pass
Kunal Verma,02-01-2005,225448,Andhra Pradesh,9,18,20,23,70,Fail
Aditya Singh,16-02-2005,773050,Himachal Pradesh,9,4,15,1,29,Pass
Yash Reddy,10-07-2005,164765,Gujarat,9,12,6,23,50,Fail
Rohan Chopra,22-01-2005,979823,Rajasthan,3,7,0,10,20,Pass
Harjeet D'Souza,02-12-2005,139404,Rajasthan,15,18,3,1,37,Pass
Aryan Fernandes,14-03-2005,426936,Tripura,16,12,4,1,33,Fail
Rohan Pillai,18-12-2004,926762,Tamil Nadu,3,23,4,12,42,Pass
David Chopra,24-05-2005,626847,Uttar Pradesh,13,10,9,20,52,Pass
Aditya Verma,29-04-2005,161551,Rajasthan,7,11,12,0,30,Pass
Ishaan D'Souza,03-01-2005,544035,Uttar Pradesh,10,22,0,21,53,Pass
Sukhwinder Reddy,06-01-2006,200986,Gujarat,2,1,23,19,45,Fail
Mathew Verma,21-02-2005,950611,Andhra Pradesh,21,10,6,2,39,Fail
Balbir Khan,10-12-2005,721570,Uttar Pradesh,7,22,20,15,64,Pass
Raj D'Souza,19-02-2005,614873,Maharashtra,7,7,11,14,39,Fail
Rohan Verma,06-01-2005,608211,Karnataka,14,2,11,10,37,Pass
Aarav Verma,09-02-2005,720245,Bihar,3,0,16,0,19,Pass
Yash Pillai,08-01-2005,214154,Assam,22,6,19,14,61,Fail
Aryan D'Souza,04-04-2006,473327,Rajasthan,14,1,1,18,34,Pass
Paul Pillai,09-09-2005,133244,Madhya Pradesh,22,14,7,10,53,Fail
Kunal Khan,15-04-2006,402930,Uttar Pradesh,18,8,21,22,69,Pass
Aarav Verma,02-09-2005,237703,Rajasthan,8,15,24,20,67,Fail
Kunal Chopra,12-09-2005,193731,Karnataka,14,9,18,0,41,Pass
Paul Reddy,28-11-2005,149727,Punjab,24,21,2,3,50,Fail
Raj Mehta,08-02-2005,422583,Uttarakhand,9,0,11,20,40,Fail
Mathew Mehta,31-01-2005,782660,Jharkhand,14,9,7,19,49,Pass
David Sharma,16-06-2005,948862,Rajasthan,0,22,11,20,53,Pass
Aryan Pillai,01-04-2006,250937,Rajasthan,21,9,23,14,67,Fail
Raj Khan,27-11-2004,821145,Kerala,21,5,12,9,47,Fail
Aryan Fernandes,17-08-2005,142954,Bihar,11,0,7,12,30,Pass
Gurpreet Verma,30-04-2006,147987,Jammu & Kashmir + Ladakh,19,11,12,13,55,Pass
Farhan D'Souza,08-01-2005,976140,Uttar Pradesh,7,7,18,21,53,Pass
Krishna Singh,04-04-2006,319920,Himachal Pradesh,24,17,16,0,57,Pass
Sukhwinder D'Souza,24-02-2005,894675,Haryana,17,0,18,12,47,Fail
Raj Verma,15-10-2005,477463,Gujarat,15,11,24,15,65,Fail
Aarav Verma,26-03-2005,503840,West Bengal,8,13,23,8,52,Pass
Aditya Reddy,24-05-2005,733659,Punjab,5,1,15,23,44,Pass
Kunal Chopra,13-05-2005,183280,Haryana,8,20,24,21,73,Fail
Manpreet Singh,13-03-2006,551213,Maharashtra,9,16,7,20,52,Fail
Aarav Chopra,20-03-2005,261485,Kerala,11,23,13,17,64,Fail
Vivaan Fernandes,21-11-2005,609364,Rajasthan,19,24,6,4,53,Pass
Ayaan Pillai,11-07-2005,547939,Mizoram,16,24,21,6,67,Fail
Kunal Khan,08-01-2006,402507,Haryana,23,15,0,19,57,Fail
Sukhwinder Reddy,18-01-2005,949063,Bihar,3,16,15,14,48,Fail
Aryan Pillai,28-08-2005,465993,Uttar Pradesh,15,12,6,13,46,Pass
Aryan Chopra,18-11-2004,277461,Uttar Pradesh,3,9,0,13,25,Pass
Balbir Pillai,31-01-2006,508408,Maharashtra,14,3,6,22,45,Fail
David Singh,20-11-2004,553785,Gujarat,23,14,6,11,54,Fail
Sukhwinder Verma,29-05-2005,107033,Karnataka,11,13,18,16,58,Pass
Raj Singh,26-05-2005,438917,Gujarat,16,13,23,21,73,Fail
Vivaan Verma,15-08-2005,426137,Andhra Pradesh,8,17,3,6,34,Fail
Paul Reddy,27-11-2004,143525,Rajasthan,13,9,19,22,63,Fail
Paul Reddy,18-08-2005,386470,Assam,11,0,6,2,19,Fail
Aarav D'Souza,20-04-2005,225477,Jammu & Kashmir + Ladakh,5,17,23,23,68,Fail
Raj Pillai,03-07-2005,992198,Uttar Pradesh,10,14,21,10,55,Pass
Ishaan Chopra,02-06-2005,654134,Madhya Pradesh,17,13,22,7,59,Fail
Rohan Verma,19-10-2005,367029,Maharashtra,23,10,22,22,77,Fail
Aditya D'Souza,24-03-2006,424721,Maharashtra,1,16,20,5,42,Fail
Sukhwinder Verma,30-11-2005,141480,Bihar,7,18,5,19,49,Fail
Aarav D'Souza,02-12-2005,340295,Andhra Pradesh,11,18,4,23,56,Fail
Rohan D'Souza,29-05-2005,574952,Rajasthan,18,6,14,12,50,Pass
Krishna Verma,06-02-2006,422621,West Bengal,12,1,4,9,26,Pass
Harjeet Verma,25-03-2005,361347,Telangana,22,2,22,3,49,Fail
Balbir Chopra,04-12-2004,415948,Bihar,17,6,4,4,31,Pass
Paul Mehta,06-05-2006,911222,Punjab,11,23,23,11,68,Fail
Kunal Pillai,01-11-2005,316005,Tamil Nadu,15,7,18,11,51,Pass
Vivaan Pillai,24-07-2005,684891,Uttar Pradesh,9,18,14,7,48,Pass
Aditya D'Souza,20-06-2005,852770,Uttar Pradesh,0,11,23,9,43,Pass
Raj Sharma,20-01-2006,795063,Andhra Pradesh,9,6,7,8,30,Fail
Vivaan Chopra,03-01-2006,217441,Bihar,20,0,14,22,56,Fail
Kunal Khan,27-02-2006,730286,West Bengal,12,5,4,17,38,Pass
Vivaan Fernandes,19-03-2005,968106,Punjab,8,1,1,24,34,Pass
Raj Sharma,08-05-2005,619358,Uttar Pradesh,21,21,24,6,72,Pass
Aditya Singh,12-05-2005,336997,Punjab,11,5,14,18,48,Fail
Aarav Reddy,28-02-2005,218821,Haryana,0,11,22,20,53,Fail
Aditya Reddy,03-08-2005,807568,Haryana,24,17,16,9,66,Fail
Yash Fernandes,22-11-2004,921532,Uttar Pradesh,12,9,20,3,44,Pass
Raj Chopra,02-12-2005,797643,Tamil Nadu,17,5,1,24,47,Pass
Mathew D'Souza,23-07-2005,258884,Assam,17,6,13,13,49,Fail
Raj Chopra,13-01-2005,102628,Assam,10,15,2,13,40,Fail
Aryan Khan,29-05-2005,220036,Uttar Pradesh,12,7,8,8,35,Pass
Kunal Pillai,08-02-2005,817483,Uttar Pradesh,22,21,2,2,47,Pass
Vivaan D'Souza,09-01-2005,588014,West Bengal,9,3,24,10,46,Pass
Manpreet Mehta,24-04-2006,948363,Bihar,2,16,5,17,40,Pass
Aarav Sharma,24-01-2005,799843,West Bengal,4,22,7,21,54,Pass
Mathew Reddy,01-02-2005,783192,Rajasthan,20,23,2,0,45,Pass
Ishaan Verma,02-12-2005,212099,Bihar,9,7,3,19,38,Pass
Ishaan Chopra,20-08-2005,207938,Delhi,22,12,17,10,61,Fail
Harjeet Pillai,07-02-2005,855245,Madhya Pradesh,7,20,6,13,46,Fail
Aarav Reddy,31-05-2005,182785,Gujarat,4,22,7,17,50,Fail
Rohan Verma,08-03-2006,139174,Odisha,16,24,8,20,68,Fail
Paul Mehta,08-05-2005,502280,West Bengal,22,18,9,0,49,Pass
Kunal Sharma,04-05-2005,498613,Jammu & Kashmir + Ladakh,10,20,1,20,51,Pass
Aditya Fernandes,23-11-2004,972919,Madhya Pradesh,10,23,5,22,60,Fail
Rehan Singh,05-02-2005,922062,Kerala,9,3,7,12,31,Fail
Mathew Fernandes,20-11-2005,940555,Tamil Nadu,8,15,4,6,33,Pass
Raj Mehta,13-01-2005,877802,Uttar Pradesh,1,7,8,12,28,Pass
Yash D'Souza,20-03-2005,711152,Uttar Pradesh,21,14,19,5,59,Pass
Krishna Mehta,23-12-2004,174302,Rajasthan,12,0,10,1,23,Pass
Farhan Sharma,05-05-2005,957811,Andhra Pradesh,10,17,22,12,61,Fail
Kunal Chopra,02-12-2005,101908,Uttar Pradesh,16,12,14,3,45,Pass
Vivaan Reddy,10-01-2006,222043,Uttar Pradesh,7,6,5,6,24,Pass
Aryan Reddy,02-07-2005,944861,Tamil Nadu,16,18,5,4,43,Fail
Gurpreet D'Souza,18-05-2005,183396,Tamil Nadu,16,5,11,4,36,Pass
Paul Fernandes,16-10-2005,681199,Bihar,16,2,16,17,51,Fail
Balbir Chopra,28-12-2005,598724,West Bengal,10,13,3,12,38,Pass
Krishna Chopra,24-05-2005,819785,Jharkhand,22,9,3,17,51,Pass
Paul D'Souza,15-01-2005,200250,West Bengal,19,3,20,22,64,Pass
David Mehta,20-01-2005,365998,Bihar,2,12,20,2,36,Pass
Peter Reddy,08-11-2005,519301,West Bengal,6,12,3,14,35,Pass
Manpreet Fernandes,29-10-2005,235468,Manipur,13,7,11,16,47,Fail
Aditya Reddy,11-07-2005,628660,Bihar,21,3,19,20,63,Fail
Raj Reddy,01-04-2005,896965,Meghalaya,24,14,1,16,55,Fail
Peter Reddy,15-04-2006,127873,Tamil Nadu,20,23,14,20,77,Pass
Harjeet Sharma,19-11-2004,608596,Kerala,10,23,8,4,45,Fail
Manpreet Pillai,19-01-2006,770165,Madhya Pradesh,20,23,0,15,58,Fail
Aditya Reddy,29-08-2005,518705,Bihar,21,18,21,20,80,Fail
Sukhwinder D'Souza,22-12-2004,383449,Rajasthan,1,7,17,11,36,Pass
Manpreet Sharma,11-11-2004,885954,Uttar Pradesh,2,13,20,17,52,Pass
Ishaan Khan,30-07-2005,633348,Odisha,7,23,1,1,32,Pass
Yash Khan,13-08-2005,953740,Uttar Pradesh,4,24,11,19,58,Pass
Sukhwinder Mehta,09-01-2005,242814,Chhattisgarh,13,7,24,3,47,Fail
Ishaan D'Souza,10-07-2005,256844,Maharashtra,2,14,10,7,33,Fail
Aarav Singh,06-06-2005,540006,Maharashtra,21,23,24,17,85,Fail
Vivaan Reddy,18-02-2006,775298,Odisha,14,15,22,22,73,Fail
Ishaan Pillai,03-05-2005,538041,Delhi,1,22,7,16,46,Fail
Rohan Chopra,30-08-2005,823275,West Bengal,2,18,6,9,35,Pass
Aditya Fernandes,22-05-2005,855916,Maharashtra,3,19,12,4,38,Fail
Aryan Verma,05-05-2005,975059,Maharashtra,9,5,3,3,20,Fail
Kunal Singh,05-12-2005,718434,Rajasthan,13,2,23,14,52,Pass
Rohan Fernandes,20-01-2006,758708,Punjab,19,19,10,17,65,Fail
Farhan Fernandes,17-06-2005,399841,Manipur,19,11,3,10,43,Fail
Aryan Fernandes,18-10-2005,888809,Gujarat,0,11,3,6,20,Fail
Rehan Chopra,17-05-2005,328017,Maharashtra,13,7,19,5,44,Fail
Aditya Mehta,16-06-2005,490514,Kerala,8,6,7,2,23,Fail
John Singh,25-09-2005,280466,West Bengal,11,10,15,8,44,Pass
Yash Singh,25-11-2004,360865,Uttar Pradesh,0,4,18,7,29,Pass
Ishaan Pillai,08-03-2006,263398,Andhra Pradesh,18,16,19,23,76,Fail
Krishna Mehta,15-04-2005,942793,Manipur,19,3,21,5,48,Fail
Raj Khan,22-03-2006,244681,Andhra Pradesh,20,12,13,24,69,Fail
Harjeet Pillai,21-11-2005,405998,Rajasthan,17,7,20,13,57,Pass
Kunal Mehta,09-02-2006,409620,Jharkhand,24,13,2,10,49,Pass
Ishaan D'Souza,28-04-2006,948537,Delhi,2,24,13,10,49,Fail
Rohan Reddy,28-09-2005,763950,Tamil Nadu,8,2,20,15,45,Fail
Rohan Chopra,15-09-2005,366047,Punjab,23,16,0,6,45,Fail
Aditya Khan,07-12-2005,945945,West Bengal,3,19,3,19,44,Pass
Aditya Chopra,11-05-2005,769280,Bihar,16,23,10,7,56,Fail
Ayaan Chopra,15-11-2005,530501,Jammu & Kashmir + Ladakh,23,16,12,16,67,Pass
Ishaan Fernandes,20-03-2006,242337,Assam,15,21,17,10,63,Fail
Mathew Chopra,13-12-2004,185223,Odisha,1,14,24,18,57,Fail
Rohan Pillai,03-05-2005,651654,Maharashtra,1,20,5,16,42,Fail
Rohan Reddy,31-08-2005,753537,Tamil Nadu,16,20,3,5,44,Pass
Harjeet Fernandes,28-04-2005,881927,Uttar Pradesh,17,0,11,10,38,Pass
Rohan Mehta,23-03-2006,492980,Odisha,23,18,13,9,63,Fail
Aryan Fernandes,27-02-2006,256666,Uttar Pradesh,4,11,22,8,45,Pass
Vivaan Reddy,06-01-2006,501161,Rajasthan,5,13,23,13,54,Pass
Yash Reddy,10-01-2006,924183,Uttar Pradesh,10,23,3,24,60,Pass
Ishaan Chopra,18-10-2005,132556,Jammu & Kashmir + Ladakh,8,7,19,24,58,Pass
Aarav Mehta,14-01-2005,307855,Uttar Pradesh,5,22,20,15,62,Pass
Krishna Sharma,18-03-2005,969054,West Bengal,5,1,1,13,20,Pass
Balbir Khan,30-04-2005,105934,Punjab,21,6,20,9,56,Fail
Harjeet D'Souza,24-02-2006,458829,Maharashtra,12,15,8,18,53,Fail
Aditya Reddy,15-04-2006,339954,West Bengal,11,3,16,15,45,Pass
Yash Khan,05-01-2005,217244,Bihar,0,9,13,2,24,Pass
Kunal Verma,11-12-2004,238286,Madhya Pradesh,4,2,16,3,25,Fail
Aryan Verma,20-02-2006,191042,Uttar Pradesh,23,16,2,3,44,Pass
Ishaan Verma,11-11-2004,952184,West Bengal,18,0,21,13,52,Pass
Krishna Reddy,29-12-2004,472847,Rajasthan,15,7,10,16,48,Pass
Kunal Singh,09-03-2005,472188,Madhya Pradesh,1,8,3,20,32,Fail
Rohan Pillai,25-02-2005,407352,Odisha,24,0,10,19,53,Fail
Aditya Mehta,29-01-2006,791759,Punjab,24,21,18,3,66,Fail
Krishna Sharma,06-07-2005,746264,Andhra Pradesh,12,9,6,0,27,Fail
Ayaan Chopra,25-08-2005,961158,Punjab,12,9,22,10,53,Fail
David Pillai,04-01-2005,113130,Gujarat,11,14,1,4,30,Fail
Rohan Khan,21-01-2006,469063,Madhya Pradesh,3,8,4,18,33,Fail
Aarav Verma,24-03-2005,680231,Gujarat,23,6,1,2,32,Fail
John Verma,28-01-2005,836683,Bihar,21,0,2,14,37,Pass
Rohan Verma,21-02-2005,630409,West Bengal,19,7,4,19,49,Pass
Yash Sharma,18-02-2005,548235,Maharashtra,13,2,19,21,55,Fail
Imran D'Souza,10-03-2005,436816,Madhya Pradesh,5,5,24,10,44,Fail
Aryan Mehta,30-01-2006,115055,Rajasthan,2,6,4,11,23,Pass
David Sharma,20-12-2005,806992,Karnataka,13,0,24,3,40,Pass
Gurpreet Khan,28-05-2005,476442,Assam,23,3,2,12,40,Fail
Vivaan Singh,30-01-2006,171521,Uttar Pradesh,3,21,21,8,53,Pass
Rohan Khan,24-11-2005,531512,Andhra Pradesh,12,24,10,4,50,Fail
Yash Fernandes,01-09-2005,579361,Karnataka,19,6,13,0,38,Pass
Rohan D'Souza,22-03-2005,919623,Assam,5,4,6,2,17,Fail
Aditya Sharma,29-05-2005,549226,Haryana,1,13,1,23,38,Fail
Vivaan Verma,31-01-2005,356619,Telangana,7,8,11,23,49,Fail
Yash D'Souza,06-03-2005,663656,Jammu & Kashmir + Ladakh,12,14,5,14,45,Pass
Mathew Fernandes,11-12-2004,329606,Rajasthan,12,18,22,2,54,Pass
Aarav D'Souza,01-04-2005,772217,Uttar Pradesh,14,1,18,18,51,Pass
Vivaan Khan,19-02-2005,844217,Madhya Pradesh,15,0,5,3,23,Fail
Kunal Sharma,19-11-2005,909693,Karnataka,3,8,24,9,44,Pass
Aditya Reddy,21-10-2005,425500,Jharkhand,16,10,15,24,65,Pass
Rohan D'Souza,19-01-2005,530567,Bihar,19,8,0,13,40,Pass
Yash Fernandes,03-08-2005,912831,Rajasthan,12,21,4,0,37,Pass
Aarav Mehta,19-12-2004,345893,Haryana,17,21,12,0,50,Fail
Sukhwinder Reddy,15-10-2005,184747,West Bengal,11,17,1,19,48,Pass
Aarav Verma,15-05-2005,744100,Uttar Pradesh,2,11,24,1,38,Pass
Vivaan Verma,15-11-2004,341352,Punjab,20,24,15,2,61,Fail
Mathew Mehta,05-01-2006,123865,West Bengal,21,3,12,22,58,Pass
Ishaan Mehta,24-07-2005,785443,West Bengal,22,3,17,18,60,Pass
Aditya Khan,26-11-2005,446430,Punjab,10,7,24,22,63,Fail
Aarav Reddy,15-11-2005,171900,Jharkhand,11,3,22,10,46,Pass
Gurpreet Fernandes,10-06-2005,558761,Punjab,3,10,8,20,41,Pass
Kunal Singh,27-03-2005,743525,Madhya Pradesh,14,20,21,14,69,Fail
Harjeet Verma,21-04-2006,932497,Maharashtra,23,4,19,8,54,Fail
Krishna Reddy,05-02-2005,538623,Karnataka,15,10,2,14,41,Pass
Krishna Reddy,30-03-2005,470404,Gujarat,13,21,18,6,58,Fail
Raj D'Souza,03-02-2006,745029,Maharashtra,18,14,8,16,56,Fail
Rohan D'Souza,30-03-2005,311391,Uttar Pradesh,7,3,13,12,35,Pass
Ishaan Khan,24-11-2004,226980,Kerala,18,14,5,3,40,Fail
Vivaan Mehta,23-11-2005,515740,Uttar Pradesh,8,1,0,24,33,Pass
Gurpreet Mehta,09-05-2005,719649,Telangana,13,22,2,5,42,Fail
Krishna D'Souza,19-12-2005,404860,Gujarat,11,20,18,6,55,Fail
Sukhwinder Fernandes,28-02-2005,897460,West Bengal,6,0,22,2,30,Pass
Aditya Singh,23-03-2006,530302,Bihar,5,17,18,7,47,Fail
Vivaan Mehta,05-04-2005,955808,Rajasthan,1,15,15,20,51,Pass
Krishna Khan,02-05-2005,409817,Maharashtra,16,18,2,5,41,Fail
Farhan D'Souza,15-04-2005,479121,Uttar Pradesh,12,3,9,6,30,Pass
Aarav Fernandes,28-11-2004,160195,Tamil Nadu,9,5,6,20,40,Pass
Yash Reddy,25-12-2004,165218,Punjab,17,20,24,8,69,Fail
Krishna Sharma,25-03-2006,286672,Bihar,15,18,1,6,40,Pass
Balbir D'Souza,04-09-2005,177149,Bihar,19,10,7,14,50,Fail
Aarav Fernandes,30-10-2005,256247,Bihar,3,18,24,24,69,Fail
Vivaan Chopra,09-11-2005,665910,Tamil Nadu,19,0,20,23,62,Pass
Raj Pillai,02-12-2005,635915,Punjab,5,24,16,3,48,Fail
Sukhwinder Khan,29-12-2005,332595,Haryana,10,1,12,2,25,Fail
Aarav Sharma,09-12-2005,516095,Assam,21,9,3,0,33,Fail
Vivaan Mehta,08-08-2005,866165,Madhya Pradesh,0,17,4,13,34,Fail
Harjeet Verma,27-02-2006,730390,West Bengal,6,3,18,15,42,Pass
Rohan D'Souza,09-05-2006,823827,Uttar Pradesh,0,10,10,8,28,Pass
Raj Mehta,13-05-2005,694707,Uttarakhand,8,17,9,19,53,Fail
Sukhwinder Verma,18-06-2005,796222,Haryana,15,17,4,8,44,Fail
David Pillai,04-11-2005,612928,Manipur,1,12,23,10,46,Fail
Raj D'Souza,30-06-2005,993733,Jammu & Kashmir + Ladakh,5,15,15,21,56,Pass
Harjeet Singh,13-12-2005,321338,Rajasthan,20,18,10,9,57,Pass
Vivaan Mehta,14-02-2006,987545,Delhi,22,14,16,14,66,Fail
Aryan Khan,03-06-2005,294477,Chhattisgarh,8,13,17,9,47,Fail
Ishaan Chopra,04-02-2006,945101,Madhya Pradesh,7,6,24,6,43,Fail
Ishaan D'Souza,18-01-2005,689062,Madhya Pradesh,23,13,24,10,70,Fail
Ishaan D'Souza,26-04-2005,454487,Uttar Pradesh,24,5,19,18,66,Pass
David Sharma,02-01-2006,195920,West Bengal,12,8,5,16,41,Pass
Vivaan Verma,10-04-2006,751498,Andhra Pradesh,0,19,14,13,46,Fail
Sukhwinder D'Souza,11-01-2005,670651,Haryana,4,6,14,23,47,Fail
Yash Khan,13-06-2005,194519,Telangana,18,12,19,12,61,Fail
Vivaan D'Souza,07-04-2006,935529,Rajasthan,12,20,19,15,66,Fail
Mathew Reddy,14-01-2005,540026,Bihar,0,13,0,24,37,Pass
Ishaan Sharma,06-05-2006,680093,Rajasthan,1,7,18,6,32,Pass
Aryan Pillai,29-04-2005,802987,Madhya Pradesh,24,8,9,23,64,Fail
Zaid Sharma,05-02-2005,889754,Odisha,13,0,17,10,40,Pass
Vivaan Singh,12-05-2005,923524,Tamil Nadu,3,21,15,1,40,Pass
Aryan Fernandes,05-09-2005,158243,Andhra Pradesh,22,14,18,19,73,Fail
Farhan Verma,12-02-2006,338067,Gujarat,11,2,1,0,14,Fail
Rohan Fernandes,09-03-2005,370918,Odisha,17,11,0,19,47,Fail
Aryan Verma,16-04-2006,617428,Chhattisgarh,16,15,14,10,55,Fail
Aditya Khan,28-08-2005,767118,Delhi,0,19,17,6,42,Fail
Rohan Mehta,22-11-2005,268139,Meghalaya,22,22,16,9,69,Fail
Aditya Verma,14-04-2006,630671,Andhra Pradesh,6,20,9,12,47,Fail
Vivaan Fernandes,29-05-2005,818887,Rajasthan,1,5,19,0,25,Pass
Raj Singh,02-01-2005,784581,Uttar Pradesh,20,4,23,13,60,Pass
Vivaan Mehta,24-04-2005,579757,Gujarat,17,23,22,18,80,Fail
Rohan Fernandes,12-02-2006,688653,Maharashtra,4,2,11,0,17,Fail
Krishna Reddy,28-08-2005,455526,Andhra Pradesh,1,12,13,12,38,Fail
Krishna Verma,28-04-2005,760457,Bihar,15,20,19,15,69,Fail
Rohan Pillai,13-03-2005,931603,Haryana,3,15,19,1,38,Fail
Raj Verma,03-11-2005,581282,Jharkhand,12,22,7,22,63,Pass
Harjeet Fernandes,06-07-2005,952447,Rajasthan,4,1,1,22,28,Pass
Aditya Chopra,04-03-2005,511492,Delhi,15,24,11,15,65,Fail
Kunal Reddy,27-10-2005,180968,Gujarat,9,18,2,19,48,Fail
Imran Khan,28-04-2005,362087,Madhya Pradesh,9,19,3,11,42,Fail
Vivaan Verma,22-04-2005,864268,Bihar,14,5,4,2,25,Pass
Gurpreet D'Souza,03-06-2005,187952,Gujarat,5,0,24,10,39,Fail
Krishna Sharma,15-07-2005,677861,Meghalaya,7,20,5,10,42,Pass
Paul Fernandes,06-12-2004,690873,Andhra Pradesh,0,6,15,16,37,Fail
Vivaan Reddy,11-01-2005,962673,Tamil Nadu,13,15,2,17,47,Pass
Manpreet Singh,17-04-2006,524244,Gujarat,11,16,19,13,59,Fail
Aarav Singh,25-01-2005,590413,Delhi,5,15,21,1,42,Fail
Kunal Reddy,03-02-2005,249426,Haryana,3,15,15,8,41,Fail
Aarav Fernandes,16-10-2005,660963,Bihar,4,7,2,16,29,Pass
Krishna Chopra,07-11-2005,721217,Telangana,16,13,16,17,62,Fail
John Sharma,29-09-2005,231046,Punjab,16,23,6,4,49,Fail
Yash Verma,24-02-2005,942995,Uttar Pradesh,8,23,11,1,43,Pass
Sukhwinder D'Souza,19-08-2005,376346,Telangana,6,20,21,23,70,Fail
Raj Reddy,04-05-2005,121837,Tamil Nadu,5,5,9,6,25,Pass
Krishna Khan,05-03-2005,161486,Punjab,24,17,16,11,68,Fail
Aarav Singh,09-11-2005,729271,Odisha,14,16,9,24,63,Fail
Kunal Singh,01-01-2006,225264,Nagaland,10,11,0,14,35,Pass
Peter Mehta,29-10-2005,575592,Bihar,14,24,10,2,50,Fail
Rehan Khan,11-03-2006,558317,Uttarakhand,7,16,3,17,43,Fail
Sukhwinder Fernandes,31-12-2005,509319,Bihar,9,10,4,0,23,Pass
Raj Verma,09-04-2006,680429,Tamil Nadu,4,4,23,13,44,Pass
David Reddy,05-03-2006,735671,Maharashtra,0,15,17,19,51,Fail
Ayaan Singh,15-04-2006,636408,Tamil Nadu,15,24,11,19,69,Pass
Krishna Sharma,28-11-2004,163417,Chhattisgarh,17,3,23,9,52,Fail
Aditya Chopra,16-02-2005,567716,Rajasthan,24,4,15,1,44,Pass
Vivaan Khan,20-12-2004,132473,Tamil Nadu,16,21,17,10,64,Fail
Manpreet Khan,26-04-2005,301785,Uttar Pradesh,17,6,7,6,36,Pass
Rohan Pillai,14-12-2004,758862,Uttar Pradesh,18,10,17,4,49,Pass
Aditya Singh,24-12-2004,630019,Haryana,4,19,10,8,41,Fail
Yash Pillai,13-01-2005,476883,Meghalaya,11,20,3,3,37,Pass
Rehan Chopra,09-08-2005,925301,Haryana,11,24,3,1,39,Fail
Aditya Khan,26-06-2005,793805,Assam,9,21,24,14,68,Fail
Kunal Reddy,15-10-2005,252985,Chhattisgarh,2,16,4,15,37,Fail
Vivaan Pillai,01-03-2006,820115,West Bengal,1,19,6,13,39,Pass
Krishna Reddy,26-12-2005,946215,Rajasthan,16,13,21,23,73,Fail
Zaid Sharma,01-11-2005,208668,Rajasthan,0,13,14,10,37,Pass
David D'Souza,11-09-2005,925175,Maharashtra,21,5,6,6,38,Fail
Sukhwinder D'Souza,26-08-2005,826635,Andhra Pradesh,20,14,23,15,72,Fail
Yash Khan,02-08-2005,686924,Maharashtra,6,14,8,7,35,Fail
Vivaan Pillai,06-02-2006,837792,Telangana,15,20,4,7,46,Fail
Balbir D'Souza,06-03-2005,352694,Tamil Nadu,10,3,12,12,37,Pass
Krishna Khan,07-06-2005,855830,Andhra Pradesh,19,8,10,16,53,Fail
Rohan Sharma,02-02-2006,295631,Maharashtra,16,3,9,22,50,Fail
Ishaan Khan,17-12-2005,904365,Uttar Pradesh,16,17,22,13,68,Pass
Aryan Chopra,11-08-2005,528424,Rajasthan,15,1,20,6,42,Pass
Imran Khan,24-07-2005,734136,West Bengal,23,3,23,14,63,Pass
Raj Reddy,04-06-2005,165820,Tamil Nadu,6,2,15,8,31,Pass
Yash Mehta,08-10-2005,419683,Bihar,11,10,3,15,39,Pass
Aryan Khan,22-10-2005,964503,Odisha,20,15,12,16,63,Fail
Vivaan Fernandes,10-05-2005,338451,Bihar,3,2,23,6,34,Pass
Yash Khan,25-06-2005,212940,Delhi,20,15,23,7,65,Fail
Krishna D'Souza,14-04-2005,813739,Tamil Nadu,9,6,14,7,36,Pass
Aditya Chopra,10-02-2006,546806,Gujarat,9,7,11,17,44,Fail
Aarav Verma,23-01-2006,269173,Uttarakhand,19,9,9,1,38,Fail
Vivaan Sharma,14-02-2006,917272,Kerala,6,24,13,13,56,Fail
Manpreet Chopra,19-10-2005,971587,Punjab,1,11,2,14,28,Pass
Gurpreet Pillai,31-03-2006,581166,Punjab,9,16,4,2,31,Pass
Yash Fernandes,16-01-2005,881140,Rajasthan,24,16,3,12,55,Pass
Gurpreet D'Souza,25-11-2004,851030,Assam,20,7,14,3,44,Fail
Rohan Sharma,09-09-2005,954015,Andhra Pradesh,18,0,19,18,55,Fail
Gurpreet Sharma,08-01-2005,868279,Madhya Pradesh,6,12,10,11,39,Fail
Paul Mehta,31-10-2005,322719,Karnataka,18,13,14,23,68,Fail
Vivaan Mehta,21-11-2004,810980,Rajasthan,12,22,8,24,66,Fail
Yash Chopra,23-01-2005,833385,Bihar,4,5,4,14,27,Pass
Krishna Sharma,09-11-2005,679516,Odisha,7,0,5,1,13,Pass
Aarav Sharma,09-07-2005,307882,Telangana,14,7,21,8,50,Fail
Aditya D'Souza,02-05-2006,778047,Tripura,7,3,17,1,28,Fail
Zaid Reddy,10-02-2006,730999,Nagaland,22,10,1,6,39,Pass
Vivaan Mehta,03-01-2006,502512,Bihar,11,6,10,17,44,Pass
Vivaan Khan,23-02-2005,718353,Jharkhand,15,22,17,17,71,Fail
Aryan D'Souza,26-11-2004,812236,Uttar Pradesh,0,13,6,23,42,Pass
Rohan Pillai,27-05-2005,772547,Punjab,16,23,22,10,71,Fail
Aarav Fernandes,02-02-2006,166879,Rajasthan,5,15,13,15,48,Pass
Rohan Mehta,06-01-2005,705915,Madhya Pradesh,10,19,18,3,50,Fail
Yash Mehta,09-01-2006,559189,Tamil Nadu,15,6,18,8,47,Pass
Yash D'Souza,14-02-2006,976755,Chhattisgarh,4,20,23,18,65,Fail
Yash Reddy,21-04-2005,627119,Tamil Nadu,7,23,5,6,41,Pass
Aryan Fernandes,04-07-2005,902102,Maharashtra,2,6,3,8,19,Fail
Rehan Reddy,19-03-2006,585152,Rajasthan,16,20,9,7,52,Pass
Aarav Khan,27-06-2005,889444,Punjab,15,8,1,9,33,Pass
Krishna Sharma,04-12-2004,578335,West Bengal,3,14,13,23,53,Pass
Rohan Reddy,14-06-2005,190329,Bihar,18,0,11,6,35,Pass
Manpreet Chopra,07-06-2005,631871,West Bengal,8,14,7,13,42,Pass
Mathew Khan,03-10-2005,689180,Chhattisgarh,2,11,13,4,30,Fail
Ishaan Singh,10-02-2005,143506,Rajasthan,9,17,19,6,51,Pass
Ishaan Verma,18-12-2004,573645,Bihar,13,2,10,4,29,Pass
Vivaan Chopra,24-01-2006,217827,Rajasthan,5,6,24,16,51,Pass
Imran Mehta,03-01-2006,787646,Uttar Pradesh,10,7,23,1,41,Pass
Aryan Chopra,07-12-2005,299035,Jharkhand,18,8,12,5,43,Pass
Sukhwinder Sharma,13-11-2005,211960,Madhya Pradesh,21,1,19,4,45,Fail
Harjeet Sharma,31-01-2006,571344,Bihar,11,2,9,11,33,Pass
Yash Khan,08-05-2006,654171,Haryana,5,13,15,9,42,Fail
Manpreet Sharma,07-06-2005,278098,Andhra Pradesh,15,20,2,23,60,Fail
Raj Singh,12-12-2004,954751,West Bengal,3,5,7,3,18,Pass
Kunal Sharma,21-10-2005,948890,Uttar Pradesh,22,23,14,8,67,Pass
Farhan Verma,20-12-2004,171362,Andhra Pradesh,17,1,22,17,57,Fail
Aryan D'Souza,20-02-2006,671245,Jharkhand,23,2,21,4,50,Pass
Aarav Chopra,15-04-2005,492898,Tamil Nadu,15,4,0,11,30,Pass
Raj Reddy,05-12-2005,237485,Tamil Nadu,13,8,16,21,58,Fail
Vivaan Mehta,05-02-2005,329782,Bihar,13,1,10,9,33,Pass
Sukhwinder Chopra,01-02-2005,941690,Odisha,9,4,19,7,39,Pass
Krishna Chopra,18-10-2005,828406,Gujarat,24,15,10,3,52,Fail
Aarav Singh,03-03-2005,302123,Andhra Pradesh,7,9,23,20,59,Fail
Aryan Khan,23-12-2005,565351,Bihar,21,22,14,0,57,Fail
Aditya D'Souza,21-06-2005,752464,Bihar,23,12,20,8,63,Fail
Imran Singh,11-01-2006,406199,Jharkhand,4,11,15,18,48,Pass
Yash Singh,24-11-2005,168021,Kerala,2,19,18,5,44,Fail
Ishaan Pillai,16-11-2004,181475,Rajasthan,20,19,22,8,69,Fail
Kunal Khan,07-01-2006,953460,Uttarakhand,13,11,5,6,35,Fail
Manpreet Chopra,07-03-2006,419833,Jharkhand,11,18,13,9,51,Pass
Vivaan Mehta,27-02-2005,754809,Tripura,3,19,15,8,45,Fail
Harjeet Sharma,14-04-2005,128885,Maharashtra,20,17,22,24,83,Fail
Aryan Sharma,04-03-2006,618255,Madhya Pradesh,8,3,1,3,15,Fail
Sukhwinder Mehta,07-02-2006,671676,Meghalaya,21,19,21,17,78,Pass
Rohan Chopra,07-08-2005,407531,West Bengal,19,0,1,21,41,Pass
Raj Singh,15-02-2006,251783,West Bengal,15,3,21,13,52,Pass
Kunal Singh,27-04-2005,796142,Tamil Nadu,2,21,9,21,53,Fail
Rohan Verma,06-06-2005,441851,Jharkhand,22,20,12,5,59,Pass
Raj Khan,05-05-2005,825816,Maharashtra,11,3,13,24,51,Fail
Aditya Singh,23-02-2005,622091,Andhra Pradesh,13,13,16,11,53,Fail
Ishaan Khan,23-05-2005,945324,Karnataka,24,8,15,1,48,Pass
Ishaan Reddy,17-12-2005,776928,West Bengal,4,18,5,4,31,Pass
Yash Khan,07-08-2005,307738,Uttar Pradesh,9,17,19,18,63,Pass
Kunal Reddy,04-02-2006,817100,Uttar Pradesh,0,11,22,4,37,Pass
Mathew Mehta,23-01-2005,390826,Uttar Pradesh,6,20,16,22,64,Pass
Vivaan Pillai,31-12-2005,862440,Rajasthan,12,15,18,23,68,Fail
Aarav D'Souza,11-03-2005,179077,Delhi,9,20,12,1,42,Fail
Vivaan Khan,14-03-2006,497876,Bihar,4,6,0,21,31,Pass
David Chopra,03-03-2005,801096,Uttar Pradesh,6,13,24,8,51,Pass
Ayaan Pillai,01-02-2006,328598,Kerala,14,21,15,8,58,Fail
Farhan Khan,01-01-2006,387954,Bihar,0,9,2,4,15,Pass
Aryan Mehta,29-12-2005,763655,Uttar Pradesh,5,17,5,18,45,Pass
Vivaan Sharma,26-02-2005,957187,Uttar Pradesh,10,3,24,20,57,Pass
Paul Sharma,13-06-2005,787575,West Bengal,5,8,2,16,31,Pass
Manpreet Pillai,25-12-2005,137928,Uttar Pradesh,6,12,13,7,38,Pass
Ishaan Sharma,20-01-2006,520212,Andhra Pradesh,8,24,6,6,44,Fail
Raj Reddy,12-12-2004,766301,Jharkhand,24,24,8,4,60,Pass
Yash Chopra,29-11-2004,540856,Punjab,18,22,13,12,65,Fail
Kunal Singh,21-03-2006,527527,Karnataka,1,23,10,18,52,Pass
Aditya Mehta,18-10-2005,901027,Maharashtra,13,12,6,2,33,Fail
Vivaan Mehta,27-08-2005,684588,Manipur,18,9,16,6,49,Fail
Krishna Verma,31-05-2005,466034,Maharashtra,0,16,8,1,25,Fail
Ishaan Chopra,01-04-2005,868252,Bihar,2,20,18,4,44,Pass
Rohan D'Souza,29-12-2004,409380,Odisha,15,1,21,1,38,Pass
Manpreet D'Souza,22-07-2005,431569,Andhra Pradesh,9,8,13,23,53,Fail
Krishna Pillai,12-01-2006,164751,Uttarakhand,0,12,11,21,44,Fail
Balbir Pillai,06-09-2005,526141,Madhya Pradesh,4,7,10,13,34,Fail
Zaid Khan,12-03-2005,489837,Punjab,18,19,19,16,72,Fail
Raj Reddy,24-05-2005,886429,Andhra Pradesh,19,2,21,3,45,Fail
Raj Verma,17-12-2004,517367,Kerala,16,7,8,12,43,Fail
Ishaan Chopra,29-04-2006,611764,Punjab,4,9,1,22,36,Pass
Krishna Khan,01-05-2005,204966,Punjab,19,24,8,17,68,Fail
Raj Singh,30-01-2006,812571,Bihar,7,10,13,10,40,Pass
Vivaan Mehta,10-07-2005,945702,Tamil Nadu,4,7,11,14,36,Pass
Rohan Reddy,22-01-2006,379481,Karnataka,7,0,4,10,21,Pass
Aditya Mehta,20-09-2005,139854,Andhra Pradesh,12,20,3,14,49,Fail
Yash Khan,19-01-2006,674422,Gujarat,11,8,20,4,43,Fail
Gurpreet Verma,31-01-2006,465676,Arunachal Pradesh,24,9,8,17,58,Fail
Aditya Mehta,10-10-2005,657302,Delhi,13,14,15,23,65,Fail
Vivaan Mehta,24-04-2006,899944,Andhra Pradesh,0,24,21,16,61,Fail
Paul Chopra,29-09-2005,843854,Delhi,0,4,11,8,23,Fail
Ishaan Mehta,10-01-2005,662434,Telangana,1,2,21,0,24,Fail
Sukhwinder Singh,05-03-2006,175932,Himachal Pradesh,6,15,2,16,39,Pass
David Reddy,08-04-2006,791956,Uttar Pradesh,7,22,9,13,51,Pass
Rohan Sharma,09-07-2005,452104,Chhattisgarh,22,17,21,6,66,Fail
Krishna Reddy,17-04-2005,552652,Uttar Pradesh,14,15,24,9,62,Pass
Vivaan Reddy,14-08-2005,760701,Rajasthan,11,14,11,21,57,Pass
Ishaan Singh,20-02-2005,242548,Tamil Nadu,22,23,17,16,78,Pass
Aarav Khan,02-04-2005,694829,Karnataka,7,6,3,12,28,Pass
Aditya Verma,26-03-2005,823217,Odisha,21,2,22,11,56,Fail
Yash Reddy,15-03-2006,846211,Andhra Pradesh,19,0,23,0,42,Fail
Aditya Khan,16-01-2006,243043,Maharashtra,14,2,15,8,39,Fail
Krishna Fernandes,21-02-2006,626554,Odisha,22,9,18,24,73,Fail
Raj Chopra,20-11-2005,582384,Haryana,3,23,0,8,34,Fail
Ishaan Sharma,25-12-2004,200891,Maharashtra,6,16,12,9,43,Fail
Sukhwinder D'Souza,12-07-2005,286171,Bihar,11,14,18,16,59,Fail
Aarav Fernandes,21-10-2005,314154,Andhra Pradesh,23,20,5,18,66,Fail
Ayaan Khan,28-09-2005,310895,Bihar,18,0,8,10,36,Pass
Aarav Singh,05-10-2005,623888,West Bengal,3,19,22,7,51,Pass
Yash D'Souza,04-03-2006,165755,Gujarat,6,3,0,9,18,Fail
Raj Singh,17-08-2005,343093,Karnataka,15,9,2,19,45,Pass
Krishna D'Souza,07-05-2005,273428,West Bengal,4,14,10,11,39,Pass
Krishna Khan,04-11-2005,917696,Tripura,16,14,10,4,44,Fail
Rohan Reddy,22-02-2005,783458,Madhya Pradesh,5,23,17,11,56,Fail
John Fernandes,19-10-2005,932892,Uttar Pradesh,8,11,17,17,53,Pass
Ishaan Khan,25-03-2005,449481,Sikkim,20,8,13,19,60,Fail
Mathew Sharma,04-11-2005,587117,Uttar Pradesh,14,11,12,8,45,Pass
Rohan Fernandes,16-08-2005,231819,Punjab,10,17,13,21,61,Fail
Paul Fernandes,28-03-2005,832978,West Bengal,24,9,4,1,38,Pass
Aditya Singh,07-12-2004,697625,Jharkhand,5,14,17,21,57,Pass
Gurpreet Singh,20-08-2005,593441,Rajasthan,3,4,2,16,25,Pass
Mathew Singh,02-12-2005,222204,Telangana,21,22,23,24,90,Fail
Ayaan Khan,13-11-2005,582855,Bihar,24,1,8,22,55,Fail
Kunal Mehta,01-03-2006,659045,Jharkhand,20,8,2,5,35,Pass
Paul Singh,16-01-2005,456476,Madhya Pradesh,19,21,24,0,64,Fail
Sukhwinder Sharma,15-01-2005,965639,Bihar,6,8,17,19,50,Fail
Rohan Fernandes,09-03-2006,657178,Uttar Pradesh,17,1,13,13,44,Pass
Sukhwinder Sharma,17-09-2005,840274,Uttarakhand,17,18,10,24,69,Fail
Raj Sharma,23-03-2005,403161,Bihar,21,4,1,16,42,Pass
Ishaan Verma,24-01-2006,622904,Madhya Pradesh,0,22,19,2,43,Fail
Kunal Sharma,12-06-2005,621784,Assam,11,18,18,15,62,Fail
Imran Fernandes,22-03-2005,993531,Rajasthan,20,15,13,11,59,Pass
Kunal Mehta,06-01-2006,276678,Himachal Pradesh,0,4,23,6,33,Pass
Vivaan Reddy,18-10-2005,803909,Karnataka,7,4,21,23,55,Pass
Kunal Sharma,08-04-2006,267340,Bihar,19,21,15,18,73,Fail
Krishna Singh,21-11-2005,636053,Tamil Nadu,17,7,20,20,64,Fail
Kunal Singh,04-04-2006,179297,Uttar Pradesh,12,17,7,21,57,Pass
Rohan Mehta,06-04-2005,884300,West Bengal,13,3,20,10,46,Pass
Krishna Singh,04-03-2006,958629,Bihar,7,13,23,1,44,Pass
Aditya Chopra,26-02-2006,596490,Uttar Pradesh,23,0,18,9,50,Pass
Krishna Fernandes,17-10-2005,297401,Tamil Nadu,2,12,0,10,24,Pass
Aryan Khan,25-03-2006,981264,Rajasthan,13,5,7,8,33,Pass
Mathew Sharma,19-08-2005,234136,Bihar,10,3,22,4,39,Pass
Aditya Verma,16-04-2006,709872,Haryana,23,16,21,0,60,Fail
Imran Singh,05-01-2005,945479,Andhra Pradesh,18,8,5,5,36,Fail
Yash Pillai,09-04-2006,646334,Rajasthan,24,6,15,16,61,Fail
Krishna D'Souza,13-09-2005,235394,Tamil Nadu,1,3,8,12,24,Pass
Rohan Verma,12-10-2005,509199,Bihar,24,22,11,20,77,Fail
Gurpreet Pillai,08-04-2006,262340,Maharashtra,22,10,5,1,38,Fail
Krishna Pillai,04-03-2005,428664,Tamil Nadu,23,5,2,14,44,Pass
Balbir Singh,01-01-2005,320309,Haryana,17,1,20,5,43,Fail
Aarav D'Souza,03-04-2005,827319,Haryana,8,23,9,12,52,Fail
Raj Singh,17-11-2004,582353,Rajasthan,17,12,19,4,52,Pass
David D'Souza,19-12-2004,517842,Tamil Nadu,19,19,1,20,59,Pass
Harjeet Singh,30-11-2005,949584,Uttarakhand,13,22,17,24,76,Fail
Mathew Mehta,21-01-2006,107739,Tamil Nadu,15,14,13,2,44,Pass
Raj Fernandes,29-07-2005,436436,Uttar Pradesh,6,21,14,14,55,Pass
Sukhwinder Chopra,11-01-2005,354890,Punjab,6,12,8,17,43,Pass
David Khan,26-07-2005,556942,Bihar,11,9,9,18,47,Fail
Balbir Sharma,16-05-2005,496203,Rajasthan,4,1,17,19,41,Pass
Vivaan Verma,03-12-2004,347478,Rajasthan,20,10,13,19,62,Fail
Aryan Reddy,26-07-2005,255689,Jharkhand,18,22,21,13,74,Fail
Aditya Verma,13-03-2006,126637,Odisha,5,0,16,16,37,Pass
Gurpreet Verma,03-04-2005,991883,Andhra Pradesh,2,1,17,10,30,Fail
Harjeet Sharma,12-10-2005,559688,Madhya Pradesh,15,24,12,20,71,Fail
Aditya Pillai,28-09-2005,674637,Uttarakhand,5,9,10,15,39,Fail
Aryan Fernandes,25-03-2006,514968,Maharashtra,4,21,14,13,52,Fail
Zaid Fernandes,23-01-2005,473202,Gujarat,5,7,8,13,33,Fail
Aditya Reddy,12-01-2005,805278,Rajasthan,19,22,7,5,53,Pass
Krishna Pillai,03-01-2005,100136,Chhattisgarh,11,14,12,6,43,Fail
Paul Mehta,23-10-2005,330388,Rajasthan,0,10,23,4,37,Pass
Rohan Fernandes,22-01-2005,980982,Assam,3,13,15,5,36,Fail
Vivaan Mehta,10-03-2006,318078,Andhra Pradesh,11,6,12,20,49,Fail
Peter Khan,22-04-2005,248994,Haryana,19,23,8,23,73,Fail
Kunal Verma,01-09-2005,967411,Chhattisgarh,14,3,22,8,47,Fail
Imran Mehta,15-09-2005,955324,Madhya Pradesh,11,3,6,15,35,Fail
Kunal Reddy,05-11-2005,467456,Madhya Pradesh,19,22,10,11,62,Fail
Rohan Verma,16-02-2006,596044,West Bengal,24,3,0,14,41,Pass
Vivaan Verma,04-04-2006,154822,Rajasthan,17,22,17,15,71,Fail
Balbir Reddy,17-06-2005,431336,Andhra Pradesh,13,5,7,0,25,Fail
Raj Reddy,22-02-2005,707947,Andhra Pradesh,22,9,18,10,59,Fail
Aarav Singh,04-12-2005,480696,Uttar Pradesh,23,16,11,17,67,Pass
Vivaan Mehta,03-12-2005,555195,Kerala,20,15,16,6,57,Fail
Balbir Verma,27-06-2005,589178,Chhattisgarh,20,18,13,8,59,Fail
Manpreet Singh,28-11-2004,380644,Uttar Pradesh,1,0,14,8,23,Pass
Rohan Khan,29-01-2005,680350,Uttar Pradesh,2,11,15,14,42,Pass
Krishna Sharma,15-03-2006,670544,Madhya Pradesh,1,13,18,15,47,Fail
Krishna Sharma,15-05-2005,475933,Bihar,19,14,2,16,51,Fail
Aryan Sharma,28-02-2005,876695,Bihar,4,4,17,3,28,Pass
Aditya Pillai,22-03-2006,349012,Tamil Nadu,19,19,12,21,71,Pass
Gurpreet Khan,14-02-2006,468632,Madhya Pradesh,24,17,5,10,56,Fail
Peter D'Souza,21-03-2005,980740,Odisha,22,13,21,23,79,Pass
Rohan Reddy,06-03-2005,995967,Bihar,12,0,24,0,36,Pass
Raj Singh,19-08-2005,256591,Madhya Pradesh,9,4,15,10,38,Fail
Yash Chopra,28-11-2004,289101,West Bengal,4,10,6,6,26,Pass
Harjeet D'Souza,28-01-2006,637586,Telangana,8,5,5,6,24,Fail
Manpreet Khan,16-11-2005,281503,Jharkhand,8,22,8,11,49,Pass
Aryan Chopra,11-10-2005,508033,Rajasthan,6,8,21,7,42,Pass
David Singh,19-11-2005,416956,Telangana,1,8,8,5,22,Fail
Rohan Sharma,17-10-2005,603822,Assam,16,3,3,11,33,Fail
Harjeet Fernandes,22-12-2004,283850,Goa,5,21,1,9,36,Fail
Sukhwinder Khan,11-08-2005,340875,Uttarakhand,8,23,11,1,43,Fail
Gurpreet Chopra,25-06-2005,850646,Telangana,2,7,15,1,25,Fail
Mathew Singh,08-04-2006,502080,Haryana,3,18,19,2,42,Fail
Aditya Chopra,06-04-2005,971821,Haryana,16,20,6,18,60,Fail
Farhan Pillai,31-03-2005,770278,Rajasthan,18,15,10,19,62,Fail
Raj Fernandes,15-05-2005,648107,Maharashtra,21,13,14,13,61,Fail
Balbir Singh,17-04-2005,846389,Rajasthan,7,24,20,22,73,Fail
Kunal Sharma,17-12-2005,478286,Uttar Pradesh,4,3,5,16,28,Pass
Raj Fernandes,11-10-2005,412624,Uttar Pradesh,2,23,8,12,45,Pass
Ishaan Chopra,14-04-2005,432387,Haryana,7,10,20,3,40,Fail
Harjeet Chopra,15-11-2004,668903,Uttar Pradesh,19,13,24,8,64,Pass
Raj Pillai,17-08-2005,455388,Andhra Pradesh,19,15,16,4,54,Fail
Yash Singh,04-04-2005,186518,Bihar,10,21,17,9,57,Fail
Aditya Sharma,21-02-2006,487118,Jharkhand,8,17,8,13,46,Pass
Raj Pillai,28-01-2006,987696,Bihar,5,7,2,22,36,Pass
Krishna Pillai,14-12-2004,678750,Uttar Pradesh,1,5,2,7,15,Pass
Aditya Pillai,15-11-2004,292012,Uttar Pradesh,16,6,24,20,66,Pass
Yash Chopra,24-11-2004,621753,Bihar,0,1,4,6,11,Pass
Yash Reddy,30-09-2005,702574,Maharashtra,23,24,17,13,77,Fail
Harjeet Singh,18-01-2005,563962,Uttar Pradesh,23,3,15,19,60,Pass
Yash D'Souza,13-08-2005,298270,Bihar,12,7,3,0,22,Pass
Vivaan Reddy,09-06-2005,752510,Uttar Pradesh,17,2,5,4,28,Pass
Raj Mehta,20-06-2005,999540,Maharashtra,8,0,6,1,15,Fail
Ishaan Sharma,30-10-2005,241924,Jharkhand,24,22,1,11,58,Pass
Harjeet Chopra,09-08-2005,148155,Karnataka,11,18,22,20,71,Fail
Krishna Fernandes,31-12-2004,144345,Chhattisgarh,11,15,10,22,58,Fail
Aryan Fernandes,17-02-2005,643213,Kerala,2,14,23,3,42,Fail
Ishaan Sharma,25-11-2005,991906,Rajasthan,24,19,5,4,52,Pass
Kunal Pillai,31-05-2005,277528,Haryana,0,10,9,5,24,Fail
Krishna Sharma,09-03-2005,373772,Bihar,10,10,20,3,43,Pass
Rohan Pillai,13-11-2004,438230,West Bengal,14,4,23,3,44,Pass
Mathew Fernandes,10-11-2004,479915,Bihar,7,24,11,21,63,Fail
Raj Reddy,24-07-2005,923293,Arunachal Pradesh,11,10,5,7,33,Fail
Balbir D'Souza,19-08-2005,634950,Andhra Pradesh,21,8,13,5,47,Fail
David Fernandes,03-03-2006,135726,Jammu & Kashmir + Ladakh,0,1,5,24,30,Pass
Aarav Chopra,12-04-2005,823338,Odisha,4,13,21,2,40,Pass
Vivaan Pillai,23-07-2005,397592,Tripura,23,10,9,19,61,Fail
Aditya Mehta,14-02-2005,800209,Punjab,5,13,12,7,37,Pass
Aditya Verma,09-03-2005,914667,Rajasthan,0,10,6,6,22,Pass
Aarav Verma,24-04-2005,578219,Punjab,9,21,8,0,38,Pass
Ishaan Fernandes,24-07-2005,329934,Chhattisgarh,24,9,1,24,58,Fail
Zaid Mehta,07-01-2005,594729,Sikkim,8,22,2,15,47,Fail
Sukhwinder Chopra,05-03-2006,468963,West Bengal,5,4,5,23,37,Pass
Ishaan Mehta,14-06-2005,659118,Karnataka,17,23,15,19,74,Fail
Vivaan Chopra,08-06-2005,314706,Gujarat,8,9,5,3,25,Fail
Aditya Verma,07-09-2005,226712,Assam,22,15,11,16,64,Fail
Rohan Singh,16-04-2006,967159,Uttar Pradesh,10,14,14,0,38,Pass
Raj Mehta,24-01-2006,145005,Rajasthan,11,12,5,23,51,Pass
Ishaan Mehta,23-01-2006,718968,Maharashtra,15,22,20,20,77,Fail
Sukhwinder D'Souza,09-06-2005,492142,Kerala,13,4,18,20,55,Fail
Kunal Singh,18-06-2005,912535,Telangana,11,3,11,20,45,Fail
Rohan Fernandes,14-11-2005,525633,Uttar Pradesh,20,20,20,9,69,Pass
Vivaan Fernandes,08-11-2004,941783,Kerala,1,7,19,6,33,Fail
Ishaan Sharma,16-11-2004,447639,Telangana,0,23,2,5,30,Fail
Aryan Singh,10-03-2006,323559,Punjab,0,1,20,16,37,Pass
Raj Mehta,27-05-2005,742538,Delhi,5,12,12,6,35,Fail
Kunal Mehta,21-05-2005,778473,Bihar,2,9,3,16,30,Pass
Rohan Sharma,20-04-2005,882012,West Bengal,20,3,19,18,60,Pass
Aarav Khan,23-06-2005,663532,Telangana,10,7,1,14,32,Fail
Aditya Khan,21-04-2006,859699,Manipur,9,10,12,7,38,Fail
Sukhwinder Chopra,24-12-2004,166093,Bihar,12,6,3,23,44,Pass
Aryan Verma,06-04-2006,508929,Gujarat,4,13,0,16,33,Fail
Raj Pillai,19-05-2005,220592,Gujarat,9,10,10,3,32,Fail
Mathew Chopra,26-11-2004,934990,Rajasthan,24,14,7,23,68,Fail
Aryan Sharma,16-09-2005,119340,Jharkhand,17,13,12,6,48,Pass
Sukhwinder Reddy,04-05-2006,663181,Madhya Pradesh,17,13,24,4,58,Fail
Krishna Reddy,02-06-2005,893847,Kerala,21,13,4,1,39,Fail
Raj Verma,05-05-2006,477638,Tamil Nadu,16,12,10,10,48,Fail
Manpreet Verma,14-06-2005,903431,Punjab,5,15,5,18,43,Pass
Imran Verma,19-11-2005,419563,Madhya Pradesh,16,11,8,15,50,Fail
Paul D'Souza,08-04-2005,571714,Punjab,18,0,10,17,45,Fail
Raj Sharma,15-11-2004,361331,Uttarakhand,17,21,2,3,43,Fail
Rehan Singh,20-08-2005,821973,Maharashtra,2,10,23,15,50,Fail
Harjeet D'Souza,27-04-2006,900970,Himachal Pradesh,22,8,21,2,53,Pass
Yash D'Souza,31-08-2005,357572,Tamil Nadu,5,0,7,4,16,Pass
Kunal Sharma,20-08-2005,471442,Maharashtra,21,2,2,15,40,Fail
Raj Mehta,05-09-2005,483309,West Bengal,21,0,15,6,42,Pass
Kunal Chopra,22-01-2006,614717,Manipur,0,11,23,6,40,Fail
Rohan Sharma,19-06-2005,523011,Rajasthan,2,15,0,23,40,Pass
Aarav Reddy,06-09-2005,129215,Tamil Nadu,2,22,18,10,52,Fail
Manpreet Khan,03-03-2005,945757,Tripura,19,19,24,6,68,Fail
Rohan Singh,13-11-2004,406355,West Bengal,14,9,2,15,40,Pass
Kunal Chopra,08-11-2005,495700,Uttar Pradesh,17,8,21,8,54,Pass
Yash Chopra,26-12-2004,333980,Rajasthan,17,0,15,2,34,Pass
Rohan Singh,06-10-2005,568585,Delhi,23,3,5,18,49,Fail
Aditya Singh,07-05-2005,604552,Uttar Pradesh,8,5,23,8,44,Pass
Yash Sharma,23-01-2006,879906,Uttar Pradesh,17,15,11,15,58,Pass
Ishaan Fernandes,10-07-2005,540123,Meghalaya,9,2,14,10,35,Pass
Raj Pillai,06-02-2005,731737,Tamil Nadu,4,10,3,22,39,Pass
Rohan Chopra,11-11-2004,917297,Punjab,8,6,20,8,42,Pass
Aryan Verma,26-07-2005,637683,Andhra Pradesh,18,15,6,4,43,Fail
Aryan Chopra,27-04-2005,637031,Madhya Pradesh,22,18,4,24,68,Fail
Aditya Singh,08-03-2006,928399,Jharkhand,24,2,17,11,54,Pass
Rohan Khan,03-10-2005,324273,Maharashtra,9,5,20,10,44,Fail
Vivaan Mehta,08-12-2004,457672,Rajasthan,8,10,8,10,36,Pass
Zaid Singh,17-01-2006,839558,Punjab,19,6,15,24,64,Fail
Ishaan Khan,29-01-2005,616259,Andhra Pradesh,16,24,9,8,57,Fail
Ishaan Sharma,07-05-2005,550761,Rajasthan,14,6,21,2,43,Pass
Vivaan D'Souza,17-01-2005,610825,West Bengal,1,10,1,9,21,Pass
Rohan Singh,17-03-2005,183566,Mizoram,14,23,8,24,69,Fail
Harjeet Mehta,01-11-2005,116027,Assam,20,24,1,5,50,Fail
Yash D'Souza,08-07-2005,270879,Jharkhand,17,17,22,10,66,Pass
Yash Sharma,24-12-2005,454162,Maharashtra,23,3,20,18,64,Fail
Manpreet Fernandes,05-02-2005,789771,Uttar Pradesh,17,10,6,13,46,Pass
Mathew Pillai,12-12-2004,385430,Uttar Pradesh,18,5,1,13,37,Pass
Gurpreet D'Souza,20-02-2005,415248,Tamil Nadu,16,15,3,18,52,Fail
Rohan Fernandes,21-03-2005,581831,Bihar,20,11,17,4,52,Fail
Raj Verma,06-01-2006,757466,Maharashtra,3,18,13,23,57,Fail
Ishaan Verma,08-07-2005,801238,Maharashtra,24,10,15,1,50,Fail
Raj Reddy,26-03-2005,298747,West Bengal,3,14,7,5,29,Pass
Harjeet Mehta,27-12-2004,371265,Rajasthan,13,19,5,23,60,Fail
Krishna Khan,10-06-2005,239866,Andaman & Nicobar,4,4,8,22,38,Fail
Kunal Pillai,25-08-2005,953234,Bihar,19,4,17,20,60,Fail
Kunal Fernandes,30-10-2005,784463,Tripura,13,22,13,19,67,Fail
Aarav Verma,15-03-2005,812889,Manipur,12,1,22,5,40,Fail
Krishna Mehta,12-11-2004,658901,Punjab,21,12,7,11,51,Fail
Paul Singh,19-02-2006,816819,Haryana,19,13,21,2,55,Fail
Raj Singh,01-10-2005,267029,Haryana,5,11,22,10,48,Fail
Aarav Mehta,22-03-2006,372581,Rajasthan,1,20,2,12,35,Pass
Mathew Reddy,26-08-2005,994408,Tamil Nadu,14,15,5,22,56,Pass
Aarav D'Souza,06-04-2005,853321,Madhya Pradesh,15,3,3,19,40,Fail
Rohan Mehta,26-01-2005,338519,Maharashtra,4,5,15,18,42,Fail
Aryan Reddy,08-09-2005,129034,West Bengal,16,1,13,4,34,Pass
Aditya Verma,06-04-2006,978387,Bihar,21,10,21,11,63,Fail
Aryan Singh,06-02-2006,189555,Rajasthan,7,15,21,24,67,Fail
Ishaan Mehta,21-11-2004,927592,Bihar,2,3,4,22,31,Pass
Yash Fernandes,24-07-2005,725061,Uttar Pradesh,13,1,2,16,32,Pass
Rohan Pillai,15-04-2005,322259,Uttar Pradesh,23,6,23,18,70,Pass
Ishaan Pillai,04-04-2006,702291,Bihar,4,20,19,9,52,Fail
Rohan Mehta,04-10-2005,502343,Rajasthan,8,13,3,4,28,Pass
Ayaan Reddy,30-04-2006,226333,Haryana,14,16,19,0,49,Fail
Raj Singh,21-12-2004,596344,Himachal Pradesh,22,13,16,11,62,Pass
Rohan Verma,21-03-2006,398220,Delhi,23,22,11,9,65,Fail
Kunal Chopra,18-03-2006,431090,Maharashtra,10,6,0,11,27,Fail
Krishna D'Souza,01-08-2005,293345,Bihar,3,21,12,8,44,Pass
Rohan Pillai,14-06-2005,559651,Odisha,17,6,16,21,60,Fail
Yash Pillai,05-05-2006,128986,Uttar Pradesh,12,4,10,4,30,Pass
David Reddy,29-11-2004,977536,Andhra Pradesh,3,1,16,12,32,Fail
Harjeet Chopra,25-11-2004,722383,Delhi,16,17,17,3,53,Fail
Raj Khan,25-02-2006,581058,Bihar,20,8,5,6,39,Pass
Rohan Sharma,15-10-2005,373248,Uttarakhand,17,12,8,3,40,Fail
Vivaan Fernandes,14-02-2005,727418,Maharashtra,23,11,23,14,71,Fail
Aarav Chopra,08-11-2004,995221,Jharkhand,1,22,2,16,41,Pass
David D'Souza,02-04-2005,703456,Maharashtra,13,2,14,7,36,Fail
Krishna Fernandes,07-07-2005,289311,Rajasthan,21,6,17,24,68,Fail
Krishna Pillai,31-10-2005,764833,West Bengal,8,9,24,0,41,Pass
Rohan Mehta,31-01-2006,981707,West Bengal,11,13,9,9,42,Pass
Kunal Verma,30-10-2005,200413,Tamil Nadu,22,6,6,4,38,Pass
Rohan Sharma,01-08-2005,451021,Maharashtra,16,7,13,17,53,Fail
Yash Reddy,09-06-2005,198595,Uttar Pradesh,9,10,6,1,26,Pass
Aditya Khan,07-06-2005,862735,Odisha,20,2,5,5,32,Pass
Aarav Pillai,29-01-2006,509516,West Bengal,5,7,20,12,44,Pass
Yash Sharma,04-04-2005,357324,Gujarat,14,2,7,1,24,Fail
Rohan D'Souza,29-12-2005,714287,Odisha,0,0,6,19,25,Pass
Aditya Pillai,07-04-2006,230349,Tamil Nadu,1,15,14,6,36,Pass
Aryan Pillai,20-01-2005,405726,Telangana,17,1,0,22,40,Fail
Aarav D'Souza,02-01-2005,593409,Uttar Pradesh,4,19,14,16,53,Pass
Aryan Fernandes,21-03-2005,850425,Rajasthan,14,22,21,10,67,Fail
Aryan Pillai,03-04-2006,650277,Madhya Pradesh,20,6,22,14,62,Fail
Vivaan Mehta,06-09-2005,714706,Maharashtra,18,9,7,15,49,Fail
John Singh,28-10-2005,598073,Uttar Pradesh,6,10,6,11,33,Pass
Krishna Khan,13-12-2005,852144,Haryana,20,22,12,11,65,Fail
Kunal Sharma,24-05-2005,846026,Bihar,16,0,7,9,32,Pass
Farhan Reddy,20-12-2005,856167,Odisha,2,5,21,5,33,Pass
Raj D'Souza,01-05-2005,939960,Punjab,24,7,9,18,58,Fail
Sukhwinder Verma,23-04-2006,315165,Maharashtra,18,18,11,17,64,Fail
Rohan D'Souza,31-10-2005,724082,Andhra Pradesh,0,10,23,18,51,Fail
Vivaan Fernandes,25-05-2005,278483,Karnataka,14,4,14,15,47,Pass
Vivaan Chopra,13-06-2005,792470,Tamil Nadu,24,16,14,2,56,Pass
Kunal Verma,06-01-2005,494616,Punjab,5,22,12,0,39,Pass
Paul Khan,19-02-2005,653467,Uttar Pradesh,8,3,0,2,13,Pass
Manpreet Fernandes,31-10-2005,283467,Bihar,1,3,21,9,34,Pass
Aarav Pillai,26-04-2005,964039,Bihar,6,23,23,22,74,Fail
Krishna D'Souza,26-05-2005,664359,Maharashtra,13,19,4,16,52,Fail
Paul Khan,01-10-2005,885131,Uttar Pradesh,3,19,9,7,38,Pass
Ishaan Fernandes,13-02-2006,125482,Bihar,22,7,16,7,52,Fail
Yash Mehta,12-01-2006,571385,Kerala,10,24,24,14,72,Fail
Balbir Mehta,27-05-2005,898271,Rajasthan,9,14,15,16,54,Pass
Raj Khan,20-12-2005,256274,Gujarat,16,23,24,24,87,Fail
Manpreet Singh,22-11-2005,187815,Maharashtra,3,22,2,16,43,Fail
Gurpreet Singh,16-01-2006,715041,Bihar,9,19,9,22,59,Fail
Harjeet D'Souza,01-08-2005,556120,Andhra Pradesh,12,4,11,13,40,Fail
Raj Reddy,21-09-2005,241787,Rajasthan,23,21,19,12,75,Fail
Aditya Khan,25-08-2005,853985,Rajasthan,15,24,7,6,52,Pass
Aditya Reddy,10-03-2005,721924,Maharashtra,16,4,15,11,46,Fail
Raj Mehta,31-08-2005,494897,Bihar,7,3,5,14,29,Pass
Balbir Fernandes,05-05-2006,695701,Punjab,15,18,12,21,66,Fail
Rohan Khan,04-02-2006,373952,Tamil Nadu,5,6,19,23,53,Fail
Rohan Reddy,17-02-2005,917895,Rajasthan,19,24,11,6,60,Fail
Aditya Pillai,01-06-2005,468997,Telangana,17,2,23,6,48,Fail
Krishna Khan,11-03-2005,290600,Andhra Pradesh,17,4,15,15,51,Fail
Peter Reddy,03-12-2004,602323,Arunachal Pradesh,5,6,14,11,36,Fail
John Fernandes,26-11-2004,505772,Rajasthan,17,8,18,19,62,Fail
Rehan Singh,10-01-2006,112576,West Bengal,23,3,24,8,58,Pass
Ishaan Khan,10-10-2005,835136,Andhra Pradesh,3,2,11,13,29,Fail
Aarav Reddy,09-11-2005,684882,Bihar,11,9,4,10,34,Pass
Raj Reddy,14-11-2004,319806,Meghalaya,23,21,20,8,72,Fail
Kunal D'Souza,10-02-2005,491353,Haryana,4,7,19,5,35,Fail
Aarav Sharma,19-12-2004,526436,Bihar,14,1,10,13,38,Pass
Manpreet Verma,06-01-2005,681669,Punjab,20,20,13,5,58,Fail
Raj Sharma,18-01-2006,822348,Rajasthan,21,10,13,8,52,Pass
Paul Mehta,02-09-2005,915857,Haryana,10,14,1,18,43,Fail
Yash Khan,16-07-2005,289893,Daman & Diu / D&N Haveli,7,2,19,0,28,Fail
Paul D'Souza,26-10-2005,244229,Andhra Pradesh,5,20,14,18,57,Fail
Aarav Pillai,20-02-2005,732644,Haryana,12,5,3,3,23,Fail
Rohan Fernandes,26-07-2005,291586,West Bengal,13,15,4,18,50,Pass
Ayaan D'Souza,02-01-2005,438301,Odisha,3,19,11,22,55,Fail
Paul D'Souza,22-01-2006,742673,Rajasthan,13,3,16,2,34,Pass
Krishna Sharma,28-09-2005,790218,Andhra Pradesh,5,14,4,1,24,Fail
Paul Sharma,01-02-2005,871777,Jammu & Kashmir + Ladakh,14,24,0,18,56,Pass
Mathew D'Souza,24-01-2005,669894,Odisha,0,9,19,12,40,Pass
Kunal Verma,13-12-2004,757164,West Bengal,23,3,19,24,69,Pass
Peter Pillai,26-07-2005,884740,Gujarat,22,4,20,15,61,Fail
Aarav Verma,20-08-2005,565616,Himachal Pradesh,0,3,9,21,33,Pass
Gurpreet Sharma,29-06-2005,678409,Chhattisgarh,1,13,0,6,20,Fail
Kunal Chopra,12-04-2006,157436,Manipur,18,11,2,8,39,Fail
Aarav Singh,25-06-2005,799654,Tamil Nadu,5,2,3,2,12,Pass
Manpreet Reddy,11-04-2006,609528,Odisha,8,23,18,23,72,Fail
Rehan Chopra,18-04-2005,768402,Madhya Pradesh,17,2,23,3,45,Fail
Raj Chopra,08-08-2005,741381,Madhya Pradesh,22,24,19,14,79,Fail
Mathew Reddy,12-02-2006,978564,Kerala,4,23,18,20,65,Fail
Farhan Khan,21-12-2005,160862,Chhattisgarh,17,14,17,20,68,Fail
Manpreet Khan,23-09-2005,783579,Assam,6,18,14,2,40,Fail
Krishna D'Souza,22-02-2005,955180,Uttar Pradesh,4,17,20,19,60,Pass
Krishna Singh,12-07-2005,855886,West Bengal,17,3,24,5,49,Pass
Aditya Verma,09-04-2005,901326,Uttar Pradesh,10,15,18,21,64,Pass
Raj Chopra,26-12-2005,987231,Uttarakhand,11,10,19,16,56,Fail
Ishaan Reddy,08-12-2005,848332,Bihar,22,10,8,22,62,Fail
Mathew Sharma,27-04-2006,478687,Bihar,23,11,15,11,60,Fail
Aditya Chopra,29-05-2005,450065,Rajasthan,20,4,10,23,57,Pass
Mathew Khan,31-12-2005,219959,Jharkhand,20,4,14,20,58,Pass
Mathew Khan,17-11-2004,254226,Bihar,3,13,1,4,21,Pass
David Verma,06-04-2006,537578,Maharashtra,24,18,3,19,64,Fail
Ishaan Sharma,03-01-2005,490312,Rajasthan,24,4,5,3,36,Pass
Kunal Mehta,28-04-2005,997007,Rajasthan,8,8,5,3,24,Pass
Sukhwinder Verma,15-03-2005,386984,Rajasthan,2,21,22,11,56,Pass
Krishna Pillai,24-08-2005,528175,Maharashtra,11,0,7,16,34,Fail
Kunal Pillai,13-10-2005,663293,Uttar Pradesh,12,0,5,20,37,Pass
Sukhwinder Mehta,28-12-2005,731848,Kerala,11,17,23,8,59,Fail
Raj Fernandes,19-01-2005,538391,Jammu & Kashmir + Ladakh,4,18,18,7,47,Pass
Yash Khan,14-01-2006,670769,Maharashtra,2,0,10,24,36,Fail
Vivaan Reddy,14-01-2006,967253,Madhya Pradesh,11,18,21,8,58,Fail
Aditya Verma,19-05-2005,529806,Himachal Pradesh,10,15,18,3,46,Pass
Yash Mehta,20-11-2005,177700,West Bengal,24,4,11,8,47,Pass
Ishaan Sharma,13-08-2005,696792,Uttar Pradesh,2,15,15,21,53,Pass
Krishna Sharma,04-01-2006,781682,Punjab,24,10,11,11,56,Fail
Paul Singh,03-02-2005,879918,Telangana,1,17,24,12,54,Fail
Aarav Chopra,25-05-2005,681776,Jammu & Kashmir + Ladakh,9,24,15,0,48,Pass
Aryan Sharma,08-01-2006,152644,Kerala,7,18,12,9,46,Fail
Aarav Mehta,08-02-2005,952806,Karnataka,9,0,24,3,36,Pass
Vivaan Singh,01-12-2005,324384,Bihar,7,1,23,4,35,Pass
Kunal D'Souza,04-02-2006,237012,Assam,24,13,21,17,75,Fail
Kunal Reddy,23-05-2005,232530,Manipur,16,3,22,21,62,Fail
John Singh,16-03-2005,432658,Uttar Pradesh,17,23,8,1,49,Pass
Balbir Chopra,13-03-2006,868220,Rajasthan,19,7,17,11,54,Pass
Ishaan D'Souza,25-02-2005,477184,Tamil Nadu,14,2,0,5,21,Pass
Kunal Mehta,17-11-2005,260506,Uttarakhand,21,23,9,24,77,Fail
Raj Fernandes,27-04-2006,192754,Assam,8,19,8,4,39,Fail
Aarav Pillai,08-01-2006,347028,Delhi,6,16,20,8,50,Fail
Rohan Reddy,01-08-2005,492187,Rajasthan,5,6,17,18,46,Pass
Aarav D'Souza,12-07-2005,841653,Rajasthan,8,21,18,24,71,Fail
Krishna Sharma,29-01-2006,186477,Uttarakhand,12,18,20,2,52,Fail
Ishaan Khan,05-05-2005,226699,Gujarat,17,24,19,13,73,Fail
Ishaan Verma,01-11-2005,981654,Haryana,21,12,2,10,45,Fail
Kunal Khan,03-01-2006,613984,Maharashtra,5,21,8,21,55,Fail
Vivaan Reddy,29-04-2005,339584,Gujarat,15,6,24,8,53,Fail
Krishna Pillai,25-10-2005,821004,Rajasthan,0,17,22,20,59,Pass
Vivaan Fernandes,13-07-2005,817830,Rajasthan,9,16,16,6,47,Pass
Yash Chopra,09-12-2004,273806,Rajasthan,23,20,8,14,65,Fail
John Chopra,01-08-2005,322504,Madhya Pradesh,19,2,5,14,40,Fail
Aryan Fernandes,06-05-2006,528908,Bihar,12,5,21,11,49,Fail
Kunal Chopra,09-10-2005,435081,Maharashtra,20,10,8,24,62,Fail
Raj Mehta,21-04-2006,385767,Punjab,21,11,0,10,42,Pass
Gurpreet Mehta,19-07-2005,700746,Mizoram,24,3,17,21,65,Fail
Gurpreet Fernandes,26-06-2005,714523,Madhya Pradesh,11,18,0,20,49,Fail
Peter Verma,09-06-2005,611110,Punjab,13,0,13,9,35,Pass
Raj Khan,23-11-2004,638165,Chhattisgarh,19,12,17,3,51,Fail
Kunal Pillai,28-02-2006,963382,Bihar,10,8,14,2,34,Pass
Krishna Mehta,09-01-2006,317204,Chhattisgarh,3,12,18,3,36,Fail
Rehan Singh,02-07-2005,524798,Kerala,21,8,17,13,59,Fail
Imran Reddy,02-04-2006,469105,Rajasthan,23,24,21,11,79,Pass
Aryan Chopra,20-02-2005,495106,Gujarat,22,1,15,8,46,Fail
Imran Singh,18-04-2006,278574,Tamil Nadu,11,13,15,12,51,Pass
Gurpreet Sharma,11-09-2005,636444,Tamil Nadu,4,13,15,23,55,Fail
Krishna Sharma,24-03-2005,203635,Madhya Pradesh,24,17,14,21,76,Fail
Kunal Chopra,03-10-2005,341723,Maharashtra,4,20,8,12,44,Fail
Ishaan D'Souza,07-04-2005,696262,Rajasthan,5,1,6,17,29,Pass
Balbir Sharma,23-04-2005,135014,Uttar Pradesh,10,18,21,16,65,Pass
Gurpreet Chopra,10-06-2005,265471,Madhya Pradesh,0,6,23,23,52,Fail
Vivaan Mehta,06-03-2006,161789,Bihar,11,8,1,18,38,Pass
Gurpreet Pillai,01-05-2005,379411,Jharkhand,21,23,5,2,51,Pass
David Khan,08-06-2005,166406,Jammu & Kashmir + Ladakh,13,20,0,14,47,Pass
Aryan Reddy,28-12-2004,118883,Rajasthan,8,11,23,17,59,Pass
Balbir Khan,09-01-2006,970707,Punjab,21,5,14,6,46,Fail
Peter Fernandes,25-03-2005,941226,Nagaland,17,17,9,7,50,Fail
Ishaan Sharma,26-11-2004,945580,Mizoram,17,22,3,19,61,Fail
Gurpreet Khan,24-06-2005,290064,Kerala,22,23,17,8,70,Fail
Peter Singh,19-01-2005,532936,Tamil Nadu,23,13,24,0,60,Pass
Rohan Sharma,06-10-2005,731119,West Bengal,5,3,14,1,23,Pass
Krishna Fernandes,18-03-2005,365246,Maharashtra,7,24,12,3,46,Fail
Balbir Chopra,01-07-2005,640560,Maharashtra,6,4,16,2,28,Fail
Balbir Sharma,09-01-2005,320690,Uttarakhand,22,19,6,0,47,Fail
Raj Verma,18-12-2005,935258,Andhra Pradesh,23,15,17,11,66,Fail
Aarav Singh,18-01-2005,989393,Tamil Nadu,23,13,17,11,64,Fail
Raj Sharma,15-01-2005,247553,Rajasthan,15,22,11,8,56,Pass
Balbir Singh,11-07-2005,211040,West Bengal,19,1,18,16,54,Pass
Ishaan Mehta,21-03-2005,771334,Andhra Pradesh,3,10,19,15,47,Fail
Raj D'Souza,05-05-2005,690831,Andhra Pradesh,22,11,2,22,57,Fail
Aarav Sharma,22-10-2005,978442,Bihar,3,11,8,21,43,Pass
Raj Sharma,07-03-2006,779265,Andhra Pradesh,19,12,11,6,48,Fail
Aarav Fernandes,01-01-2006,702041,Andhra Pradesh,16,14,8,7,45,Fail
Aditya Chopra,24-12-2005,972946,Chhattisgarh,12,9,17,9,47,Fail
Kunal Sharma,28-06-2005,995348,Rajasthan,14,20,20,7,61,Fail
Ishaan Sharma,05-03-2006,981637,West Bengal,18,3,22,9,52,Pass
Aditya D'Souza,16-03-2006,701386,Telangana,10,7,12,11,40,Fail
Ishaan Sharma,22-03-2005,550515,Bihar,14,22,16,21,73,Fail
Aditya Khan,03-01-2005,306352,Rajasthan,14,24,5,15,58,Pass
Rohan Khan,28-12-2005,627826,Tamil Nadu,20,1,16,19,56,Pass
Balbir Mehta,06-10-2005,742581,Rajasthan,7,13,11,13,44,Pass
Vivaan Chopra,25-11-2005,512422,West Bengal,8,3,9,18,38,Pass
Kunal D'Souza,02-01-2006,299260,Uttar Pradesh,4,12,3,20,39,Pass
Yash D'Souza,07-01-2006,381647,Andhra Pradesh,6,22,20,22,70,Fail
Aryan Reddy,12-11-2005,135931,Odisha,7,3,12,21,43,Pass
Sukhwinder Singh,04-11-2005,952329,Madhya Pradesh,18,7,5,23,53,Fail
Raj D'Souza,09-01-2006,616072,Rajasthan,14,8,13,1,36,Pass
Yash Pillai,25-03-2005,571252,Jharkhand,7,15,11,12,45,Pass
Ishaan Reddy,21-11-2005,425946,Punjab,7,0,7,19,33,Pass
Mathew Verma,20-08-2005,679113,Haryana,14,11,14,14,53,Fail
Aarav Singh,20-03-2005,683501,Gujarat,17,7,21,18,63,Fail
Rohan Verma,22-09-2005,791345,Karnataka,22,6,1,16,45,Pass
Aditya Reddy,16-02-2006,897110,Haryana,21,1,1,13,36,Fail
Ishaan Reddy,02-05-2006,688178,Punjab,5,3,13,1,22,Pass
Zaid Sharma,17-12-2005,134878,Maharashtra,10,21,2,17,50,Fail
Yash Sharma,11-04-2006,461855,Rajasthan,19,14,23,15,71,Fail
Yash Khan,02-07-2005,538592,Uttarakhand,22,16,22,22,82,Fail
Harjeet Verma,27-09-2005,724222,Jharkhand,10,18,20,23,71,Fail
Ishaan Verma,23-06-2005,865938,West Bengal,24,3,18,9,54,Pass
Yash Reddy,23-12-2004,527445,Chhattisgarh,3,14,8,5,30,Fail
Kunal Reddy,28-07-2005,329007,Tamil Nadu,8,12,14,20,54,Fail
John Mehta,14-08-2005,501360,Tamil Nadu,7,24,19,5,55,Fail
Krishna Singh,04-01-2006,449528,Madhya Pradesh,12,22,18,22,74,Fail
Raj Sharma,08-03-2006,253854,Manipur,12,22,20,4,58,Fail
Vivaan Mehta,06-06-2005,473840,Jammu & Kashmir + Ladakh,17,19,21,5,62,Pass
Yash Mehta,29-03-2006,374014,Himachal Pradesh,4,23,24,14,65,Fail
Gurpreet Singh,05-03-2006,326733,Himachal Pradesh,23,5,14,20,62,Pass
Krishna Pillai,08-11-2004,449840,West Bengal,15,4,10,7,36,Pass
Ishaan Fernandes,18-05-2005,728528,Himachal Pradesh,2,24,20,3,49,Pass
Harjeet Pillai,15-05-2005,720734,Uttar Pradesh,8,5,13,6,32,Pass
Mathew Chopra,15-02-2005,157017,Uttarakhand,19,11,9,3,42,Fail
Aarav Mehta,11-02-2006,836327,Rajasthan,16,3,15,10,44,Pass
Krishna Sharma,23-03-2005,671086,Karnataka,14,24,17,22,77,Fail
Aryan Khan,05-02-2005,528788,Rajasthan,17,24,4,23,68,Fail
Kunal Verma,03-03-2006,483468,Uttar Pradesh,4,4,21,11,40,Pass
Krishna Mehta,14-12-2004,378780,Assam,18,23,11,22,74,Fail
Aryan Mehta,14-11-2005,823733,Andhra Pradesh,1,9,24,15,49,Fail
Manpreet D'Souza,09-01-2006,222282,West Bengal,3,6,14,6,29,Pass
Aryan Fernandes,15-06-2005,609847,Haryana,15,2,4,21,42,Fail
Aarav Pillai,13-08-2005,671741,Rajasthan,15,5,16,9,45,Pass
Vivaan Khan,10-03-2006,356658,Bihar,0,6,19,8,33,Pass
Aditya Reddy,19-08-2005,156943,West Bengal,20,3,23,4,50,Pass
Ishaan Singh,01-02-2006,201070,Bihar,23,12,6,0,41,Pass
Kunal Mehta,02-11-2005,605050,Jharkhand,2,20,20,1,43,Pass
Yash Chopra,21-03-2005,153763,Madhya Pradesh,4,19,0,2,25,Fail
Rehan Fernandes,26-08-2005,704657,Tamil Nadu,21,0,9,15,45,Fail
Zaid Khan,10-12-2004,493681,Arunachal Pradesh,8,7,19,15,49,Fail
Raj Pillai,08-06-2005,222826,Telangana,17,3,4,14,38,Fail
David D'Souza,05-04-2005,924962,Tamil Nadu,22,15,6,12,55,Fail
Aditya Khan,19-03-2005,421622,Madhya Pradesh,4,20,4,10,38,Fail
Yash Khan,09-01-2005,784638,Gujarat,18,6,15,14,53,Fail
Yash D'Souza,01-12-2004,217824,Karnataka,1,24,23,18,66,Pass
Yash Sharma,24-03-2006,144036,Tamil Nadu,5,3,9,22,39,Pass
Kunal Pillai,02-11-2005,259000,Andhra Pradesh,4,4,0,15,23,Fail
Peter Sharma,23-01-2005,472538,Uttar Pradesh,10,0,4,15,29,Pass
Rohan Pillai,26-08-2005,637453,Tamil Nadu,24,9,6,19,58,Fail
Krishna Sharma,27-06-2005,943198,Bihar,16,15,5,5,41,Pass
Vivaan Reddy,25-01-2006,602628,Bihar,19,7,11,0,37,Pass
Mathew Khan,07-02-2006,248112,Madhya Pradesh,16,10,14,13,53,Fail
Raj Reddy,27-05-2005,533442,Rajasthan,17,14,5,21,57,Pass
Aditya Chopra,26-05-2005,684446,Uttar Pradesh,18,6,9,11,44,Pass
Yash D'Souza,30-08-2005,487594,Tamil Nadu,21,23,18,17,79,Fail
Krishna Pillai,17-04-2006,759730,West Bengal,14,10,6,18,48,Pass
Ishaan Sharma,21-12-2005,901609,Madhya Pradesh,10,5,16,7,38,Fail
Ishaan Verma,10-11-2005,401301,Karnataka,12,10,5,21,48,Pass
Sukhwinder Mehta,13-04-2006,381634,Telangana,17,8,16,23,64,Fail
Krishna Khan,13-02-2006,154477,Maharashtra,22,6,1,6,35,Fail
Kunal D'Souza,21-05-2005,981294,Assam,2,22,8,22,54,Fail
Yash D'Souza,04-04-2006,488084,Karnataka,17,6,16,13,52,Pass
Aryan D'Souza,12-01-2005,455092,Karnataka,24,6,22,2,54,Pass
David Singh,12-10-2005,270293,Jharkhand,18,6,7,21,52,Pass
Farhan Reddy,16-04-2005,904051,Bihar,13,2,22,12,49,Fail
Paul Fernandes,12-10-2005,402873,Bihar,4,19,11,2,36,Pass
Rohan Reddy,27-06-2005,898347,West Bengal,19,0,12,0,31,Pass
Aditya Reddy,03-02-2005,776436,Maharashtra,23,4,22,0,49,Fail
Aarav Chopra,10-12-2005,658626,Haryana,15,4,7,8,34,Fail
Aditya Khan,04-07-2005,348280,Uttar Pradesh,20,19,17,0,56,Pass
Sukhwinder Khan,18-10-2005,497864,Rajasthan,11,11,5,13,40,Pass
Yash Fernandes,01-09-2005,817191,Andhra Pradesh,2,21,6,6,35,Fail
Aditya Reddy,27-08-2005,219841,Assam,20,8,14,11,53,Fail
Vivaan Verma,23-06-2005,801544,Jammu & Kashmir + Ladakh,13,19,6,20,58,Pass
Kunal Verma,14-01-2006,937342,Telangana,3,7,2,7,19,Fail
David Khan,04-05-2006,687269,Bihar,14,2,20,16,52,Fail
Harjeet Verma,06-04-2005,448525,Tripura,24,3,13,1,41,Fail
Rohan Mehta,16-09-2005,520432,Jharkhand,16,24,21,19,80,Fail
Paul Sharma,15-04-2006,385855,Telangana,24,6,16,12,58,Fail
Kunal Singh,16-05-2005,129155,Andhra Pradesh,21,7,8,19,55,Fail
Ishaan D'Souza,20-02-2006,498246,Andhra Pradesh,2,3,14,13,32,Fail
Mathew Mehta,20-08-2005,734026,Bihar,1,2,19,24,46,Fail
Rohan Chopra,10-02-2006,594129,Tamil Nadu,23,20,15,12,70,Fail
Vivaan Fernandes,01-03-2005,304504,Rajasthan,24,3,15,14,56,Pass
Aditya Reddy,07-03-2006,562875,Odisha,14,4,21,20,59,Fail
Yash Chopra,18-04-2006,146002,Bihar,1,11,14,16,42,Pass
Raj Pillai,08-04-2005,270105,Delhi,15,7,23,2,47,Fail
Rohan Singh,06-03-2005,882533,Kerala,10,22,21,19,72,Fail
Rohan Khan,22-03-2005,200638,Uttar Pradesh,6,1,15,20,42,Pass
Krishna Khan,14-04-2005,603196,Delhi,4,19,6,7,36,Fail
Sukhwinder Singh,04-03-2005,947145,Uttar Pradesh,20,11,10,16,57,Pass
Balbir Khan,15-06-2005,291646,Uttar Pradesh,22,3,3,8,36,Pass
Aryan Verma,18-04-2006,955438,Chhattisgarh,1,4,16,21,42,Fail
Kunal Verma,30-06-2005,285408,Bihar,5,6,13,2,26,Pass
Ayaan Fernandes,26-03-2006,590664,Bihar,22,3,4,9,38,Pass
Aryan Pillai,18-04-2006,229289,Rajasthan,24,20,0,3,47,Pass
Aditya Khan,21-09-2005,489256,Jammu & Kashmir + Ladakh,4,0,21,17,42,Pass
Aryan D'Souza,21-11-2005,686455,West Bengal,15,6,4,4,29,Pass
Sukhwinder Chopra,11-06-2005,327164,Madhya Pradesh,13,7,1,9,30,Fail
Aryan D'Souza,15-11-2005,846071,Telangana,8,13,7,5,33,Fail
Ishaan Reddy,18-03-2005,335114,Madhya Pradesh,6,11,13,11,41,Fail
Vivaan Chopra,19-11-2005,924107,Telangana,1,12,20,23,56,Fail
Aditya Fernandes,16-10-2005,729020,Rajasthan,14,5,12,2,33,Pass
Peter Chopra,06-02-2006,977345,Odisha,14,4,13,11,42,Pass
Raj Mehta,06-04-2006,270944,Rajasthan,2,21,13,8,44,Pass
Ayaan Chopra,12-12-2005,379951,Tamil Nadu,13,0,5,15,33,Pass
Vivaan Pillai,23-06-2005,897667,Bihar,8,7,15,22,52,Fail
David Reddy,11-04-2006,621399,Kerala,3,2,7,19,31,Fail
Aarav Singh,28-04-2005,903119,Chhattisgarh,16,6,21,14,57,Fail
Aditya Fernandes,09-03-2006,872365,Madhya Pradesh,9,12,5,24,50,Fail
Krishna Pillai,06-03-2006,540889,West Bengal,20,12,11,0,43,Pass
David Sharma,28-01-2006,240652,Maharashtra,13,17,14,4,48,Fail
Farhan Singh,03-02-2006,556343,West Bengal,12,3,21,3,39,Pass
Aryan D'Souza,26-06-2005,602991,Bihar,12,13,8,9,42,Pass
Vivaan Mehta,11-11-2004,875909,Karnataka,24,24,21,1,70,Fail
Raj Chopra,21-01-2006,170155,Maharashtra,22,5,14,16,57,Fail
Aditya Khan,16-06-2005,256079,Bihar,18,1,20,18,57,Fail
Aarav Sharma,28-12-2004,797616,Bihar,22,2,22,8,54,Fail
Aarav Khan,26-11-2004,300847,Andhra Pradesh,0,8,15,6,29,Fail
Yash Sharma,29-01-2005,385943,Odisha,1,6,12,14,33,Pass
Aarav Khan,09-03-2005,308353,Telangana,19,18,19,10,66,Fail
Sukhwinder Fernandes,15-01-2005,377917,Rajasthan,10,20,17,19,66,Fail
John Sharma,29-05-2005,863025,Maharashtra,5,10,8,5,28,Fail
Aarav Reddy,29-12-2004,692717,Uttar Pradesh,1,24,0,13,38,Pass
Aryan Verma,30-11-2004,290605,Uttar Pradesh,17,2,13,5,37,Pass
Peter Fernandes,14-09-2005,597916,Haryana,6,7,16,20,49,Fail
Vivaan Fernandes,03-11-2005,630129,Himachal Pradesh,19,12,12,10,53,Pass
Kunal Mehta,15-04-2006,889379,Rajasthan,11,14,16,21,62,Fail
John Chopra,10-12-2004,767526,Uttar Pradesh,9,15,7,1,32,Pass
Aditya Khan,30-07-2005,451582,Kerala,14,23,6,2,45,Fail
Ishaan Sharma,08-07-2005,691125,Madhya Pradesh,15,8,2,12,37,Fail
Vivaan Chopra,08-04-2006,898176,Himachal Pradesh,18,17,12,15,62,Pass
Imran Pillai,18-05-2005,612981,Chhattisgarh,7,5,16,21,49,Fail
Yash Chopra,30-01-2006,545626,Maharashtra,13,20,19,22,74,Fail
Harjeet Reddy,17-09-2005,623703,Bihar,15,10,3,11,39,Pass
Aryan Reddy,25-11-2005,407683,Punjab,0,17,7,8,32,Pass
David Reddy,16-01-2006,896551,Bihar,13,21,7,13,54,Fail
Rohan Khan,12-03-2005,808996,Bihar,17,23,1,24,65,Fail
Peter Mehta,17-11-2005,239210,Tamil Nadu,20,11,5,20,56,Pass
Farhan Fernandes,08-03-2006,420623,West Bengal,12,7,0,15,34,Pass
Raj Chopra,23-06-2005,117818,Uttar Pradesh,19,3,1,1,24,Pass
Vivaan Khan,07-05-2006,744928,Uttarakhand,19,7,7,20,53,Fail
Farhan Singh,29-06-2005,100168,Uttar Pradesh,15,21,19,17,72,Pass
Aditya Singh,28-03-2005,221834,Uttar Pradesh,11,1,3,3,18,Pass
Aditya Mehta,27-03-2005,747919,Haryana,7,1,12,5,25,Fail
Harjeet Singh,02-02-2006,621076,Uttar Pradesh,0,21,24,9,54,Pass
Kunal Singh,22-10-2005,782348,Assam,10,4,22,14,50,Fail
Yash Chopra,21-11-2005,478516,Rajasthan,23,12,22,1,58,Pass
Kunal D'Souza,26-11-2004,423886,Andhra Pradesh,6,1,5,3,15,Fail
David Reddy,07-03-2005,433119,Bihar,0,24,11,24,59,Fail
Aditya Verma,16-03-2005,760278,Rajasthan,21,6,7,14,48,Pass
Vivaan Verma,28-11-2004,334927,Chhattisgarh,13,3,11,21,48,Fail
Balbir Chopra,11-06-2005,903355,Bihar,14,14,19,17,64,Fail
Aarav Reddy,07-01-2005,892546,Tamil Nadu,8,8,24,14,54,Fail
Rohan Pillai,11-08-2005,645761,Rajasthan,5,24,16,7,52,Pass
Aditya Singh,03-03-2006,951389,Gujarat,20,22,19,10,71,Fail
Manpreet Pillai,25-03-2005,448271,Chhattisgarh,20,6,19,23,68,Fail
Raj Sharma,13-03-2005,104317,West Bengal,7,0,10,6,23,Pass
Rehan Mehta,04-12-2005,478859,Karnataka,14,5,17,21,57,Pass
Paul Pillai,21-04-2006,948251,Uttar Pradesh,23,12,18,1,54,Pass
Aarav Mehta,20-01-2006,950432,Assam,21,22,18,5,66,Fail
Ishaan Sharma,05-09-2005,329077,West Bengal,2,14,16,1,33,Pass
Manpreet Khan,23-07-2005,311582,Bihar,0,1,15,22,38,Pass
David Reddy,13-12-2005,994498,West Bengal,17,3,4,20,44,Pass
Manpreet Sharma,01-04-2006,629566,Telangana,4,20,5,21,50,Fail
Aryan Sharma,05-03-2005,519129,Bihar,17,6,12,17,52,Fail
Sukhwinder D'Souza,25-12-2005,203216,Uttar Pradesh,21,3,23,19,66,Pass
Aarav Fernandes,11-05-2005,375037,Maharashtra,11,6,12,15,44,Fail
Aarav D'Souza,18-03-2005,962769,Maharashtra,6,0,9,3,18,Fail
Krishna D'Souza,01-03-2005,525716,Uttarakhand,14,5,22,18,59,Fail
Raj Chopra,13-09-2005,822391,Telangana,17,13,12,6,48,Fail
Sukhwinder Khan,26-12-2004,735209,Punjab,13,17,4,12,46,Fail
Harjeet Chopra,24-12-2005,363506,Himachal Pradesh,16,11,14,11,52,Pass
John Verma,20-02-2006,702554,Tamil Nadu,23,12,0,2,37,Pass
Aryan Reddy,24-05-2005,485871,Rajasthan,4,2,18,15,39,Pass
Rohan D'Souza,12-10-2005,203744,Gujarat,5,5,21,0,31,Fail
Ishaan Khan,05-12-2004,192889,Kerala,12,20,16,19,67,Fail
Aditya Mehta,04-12-2005,531743,West Bengal,6,5,21,13,45,Pass
Aditya Pillai,25-11-2004,921872,Punjab,8,21,10,8,47,Fail
Yash Mehta,13-11-2004,302188,Madhya Pradesh,19,13,15,18,65,Fail
Vivaan Khan,30-09-2005,288688,Haryana,22,4,8,6,40,Fail
Aditya Singh,11-01-2006,653035,Punjab,0,15,20,16,51,Fail
Aditya Singh,04-04-2006,497685,Maharashtra,1,17,5,0,23,Fail
Rohan Khan,31-01-2005,337347,West Bengal,21,10,7,10,48,Pass
Manpreet Reddy,13-12-2004,881602,Uttar Pradesh,7,11,5,11,34,Pass
Gurpreet Sharma,16-02-2006,482342,Assam,19,24,13,20,76,Fail
Vivaan Chopra,16-02-2006,165014,Haryana,12,22,20,23,77,Fail
Aryan Pillai,12-08-2005,399497,Haryana,5,5,10,1,21,Fail
Vivaan Chopra,18-03-2006,807247,Jharkhand,6,24,2,7,39,Pass
Ishaan Fernandes,29-09-2005,382087,Jharkhand,18,6,20,14,58,Pass
Yash Khan,10-11-2004,485706,Kerala,16,18,8,10,52,Fail
Raj Khan,21-04-2006,165786,Tamil Nadu,2,21,19,1,43,Fail
Yash Reddy,02-08-2005,697320,Uttar Pradesh,6,6,8,5,25,Pass
Balbir Reddy,05-12-2005,800884,Bihar,4,15,9,24,52,Fail
Manpreet Fernandes,03-12-2004,963651,Uttar Pradesh,20,3,12,21,56,Pass
Krishna Fernandes,09-12-2004,850505,Maharashtra,11,12,7,11,41,Fail
Balbir Mehta,13-08-2005,165373,West Bengal,16,10,13,6,45,Pass
Vivaan Reddy,12-05-2005,223389,Odisha,22,22,19,0,63,Fail
Aarav Chopra,14-04-2005,935277,Bihar,10,3,24,1,38,Pass
Aditya Fernandes,19-04-2006,470098,Maharashtra,0,21,6,6,33,Fail
Krishna Sharma,24-11-2005,264714,Madhya Pradesh,24,20,4,2,50,Fail
Krishna Sharma,01-05-2006,736277,Uttar Pradesh,0,3,2,23,28,Pass
Rohan Khan,30-10-2005,594071,Odisha,23,21,12,3,59,Fail
Aditya Fernandes,28-02-2005,139343,Andhra Pradesh,2,13,2,12,29,Fail
David Reddy,29-08-2005,761892,Rajasthan,10,24,22,21,77,Pass
Vivaan Chopra,24-03-2005,350412,Uttar Pradesh,8,18,4,20,50,Pass
Aarav Sharma,07-11-2004,800524,Haryana,20,8,3,6,37,Fail
Krishna D'Souza,08-12-2004,570094,Haryana,2,7,21,4,34,Fail
Farhan Mehta,08-02-2006,503089,Assam,4,14,20,17,55,Fail
Sukhwinder D'Souza,02-12-2005,142677,Telangana,0,6,21,23,50,Fail
Raj Verma,13-12-2005,268629,Punjab,12,2,3,0,17,Pass
Paul Sharma,27-01-2006,468396,Gujarat,7,14,16,18,55,Fail
Rohan Pillai,22-03-2005,347297,Tamil Nadu,15,8,5,4,32,Pass
Ishaan Fernandes,04-04-2005,711862,Madhya Pradesh,19,7,15,11,52,Fail
Yash Sharma,24-09-2005,882453,Telangana,19,4,17,23,63,Fail
Krishna Khan,02-03-2005,892158,Madhya Pradesh,1,19,6,23,49,Fail
Ishaan Mehta,15-07-2005,831769,Uttarakhand,8,8,12,18,46,Fail
Kunal Chopra,08-05-2005,771768,Haryana,5,10,14,11,40,Fail
Aditya Chopra,28-01-2005,308702,Uttar Pradesh,9,23,1,11,44,Pass
Sukhwinder Sharma,02-10-2005,539275,Maharashtra,14,23,16,9,62,Fail
Gurpreet Chopra,03-10-2005,862174,Delhi,5,23,13,4,45,Fail
Manpreet Fernandes,23-11-2005,137759,Karnataka,14,0,10,3,27,Pass
Krishna Mehta,21-09-2005,539430,Delhi,24,0,12,22,58,Fail
Raj Chopra,30-07-2005,979739,Uttar Pradesh,11,2,7,13,33,Pass
David Singh,01-06-2005,639899,Uttar Pradesh,16,1,21,9,47,Pass
Raj Chopra,23-11-2004,989660,Himachal Pradesh,21,22,8,5,56,Pass
Kunal Chopra,10-11-2005,482416,Bihar,9,10,5,20,44,Pass
Aryan Singh,02-04-2005,109470,Uttar Pradesh,13,24,16,2,55,Pass
Kunal Pillai,06-02-2005,177088,Maharashtra,5,6,20,9,40,Fail
Imran Singh,15-12-2004,868761,Telangana,17,1,8,16,42,Fail
Rohan Reddy,31-07-2005,312358,Uttar Pradesh,17,18,0,8,43,Pass
Sukhwinder Verma,15-03-2006,881854,Maharashtra,16,4,20,24,64,Fail
Ishaan Khan,04-08-2005,980300,Tamil Nadu,23,10,23,14,70,Fail
Aryan Khan,06-10-2005,541812,Bihar,8,18,6,12,44,Pass
Aditya Pillai,07-10-2005,879634,Rajasthan,4,1,9,3,17,Pass
Yash Chopra,30-06-2005,463485,Maharashtra,24,0,3,16,43,Fail
Paul Pillai,01-09-2005,319885,Kerala,1,7,20,10,38,Fail
Peter Reddy,22-01-2006,746306,Maharashtra,23,18,1,15,57,Fail
Aditya D'Souza,18-12-2004,793940,Jharkhand,15,7,0,14,36,Pass
Yash D'Souza,10-09-2005,673032,Punjab,22,10,7,10,49,Fail
Yash Fernandes,14-02-2006,788287,Telangana,5,22,5,8,40,Fail
Aryan Chopra,09-08-2005,282020,Madhya Pradesh,2,22,23,24,71,Fail
Rohan Khan,26-09-2005,324517,Uttar Pradesh,5,8,23,13,49,Pass
Yash Singh,08-11-2004,636708,Uttarakhand,3,6,23,23,55,Fail
Zaid Reddy,24-01-2006,263815,Rajasthan,14,7,23,2,46,Pass
Kunal Fernandes,21-08-2005,400068,Telangana,11,8,13,5,37,Fail
Raj Chopra,20-04-2005,137234,Jharkhand,4,15,9,4,32,Pass
Vivaan Pillai,20-01-2006,661755,Maharashtra,23,11,24,13,71,Fail
John Pillai,08-06-2005,986799,Bihar,9,3,10,8,30,Pass
Rohan Chopra,06-12-2005,505945,Bihar,3,4,6,22,35,Fail
Krishna Sharma,27-02-2006,634479,Punjab,12,13,11,12,48,Fail
Krishna Khan,16-01-2005,374561,Jharkhand,24,23,20,21,88,Pass
Aditya Sharma,02-03-2006,335391,Bihar,12,4,14,20,50,Fail
Manpreet Sharma,29-12-2004,471170,Himachal Pradesh,4,17,23,14,58,Pass
Rohan Fernandes,16-07-2005,518042,Maharashtra,10,11,19,11,51,Fail
Aarav Fernandes,13-11-2004,653265,Bihar,5,11,22,18,56,Fail
Aditya Singh,19-09-2005,211753,Rajasthan,1,16,17,20,54,Pass
Yash D'Souza,11-03-2006,779831,Haryana,15,11,0,14,40,Fail
Harjeet Pillai,21-02-2005,607636,Bihar,10,16,6,16,48,Fail
Harjeet Verma,23-02-2006,579607,Chhattisgarh,22,24,1,5,52,Fail
Raj Verma,02-08-2005,848331,West Bengal,1,0,7,22,30,Pass
Krishna Pillai,15-01-2006,288250,Maharashtra,9,20,10,15,54,Fail
Ishaan Mehta,20-06-2005,511603,Uttar Pradesh,11,20,7,20,58,Pass
Rehan Verma,28-04-2006,649728,Punjab,15,23,2,18,58,Fail
Vivaan Fernandes,05-06-2005,495715,Jharkhand,3,13,18,2,36,Pass
Paul Khan,22-03-2005,129758,Maharashtra,5,7,12,8,32,Fail
Gurpreet Fernandes,22-02-2006,538598,Maharashtra,9,15,18,20,62,Fail
Aarav Chopra,02-06-2005,309764,West Bengal,9,7,18,0,34,Pass
Ayaan Verma,03-05-2005,559001,Bihar,12,5,17,12,46,Fail
David Chopra,21-02-2006,953445,Tamil Nadu,0,3,16,24,43,Fail
Sukhwinder Pillai,26-04-2005,667463,Uttar Pradesh,16,12,18,17,63,Pass
Ayaan Singh,12-06-2005,947505,Delhi,16,9,18,24,67,Fail
Farhan Sharma,20-11-2005,278742,Gujarat,3,4,20,7,34,Fail
Yash Pillai,14-01-2006,341863,Bihar,11,1,22,6,40,Pass
Farhan D'Souza,17-11-2004,571053,Odisha,5,18,17,16,56,Fail
Ishaan Reddy,03-03-2006,264383,Maharashtra,13,14,1,6,34,Fail
Raj D'Souza,18-04-2006,873387,Haryana,18,13,10,19,60,Fail
Vivaan Singh,10-02-2006,451604,Haryana,21,17,1,6,45,Fail
Gurpreet Singh,11-01-2006,312289,Arunachal Pradesh,2,5,12,4,23,Pass
Kunal Sharma,12-07-2005,612009,Odisha,3,13,6,16,38,Pass
Gurpreet Pillai,29-01-2006,957668,Gujarat,4,10,14,17,45,Fail
Rohan Mehta,28-03-2006,957246,Odisha,20,11,21,22,74,Pass
John Pillai,08-06-2005,244933,Chhattisgarh,18,0,16,5,39,Fail
Krishna Singh,20-02-2006,116212,Telangana,3,18,3,13,37,Fail
Yash Sharma,05-07-2005,647415,Odisha,2,15,5,18,40,Pass
Kunal Pillai,26-03-2005,569963,Haryana,22,7,13,17,59,Fail
Paul Chopra,26-04-2006,554235,Goa,8,15,1,8,32,Fail
Krishna Fernandes,26-01-2006,647952,Rajasthan,3,18,15,2,38,Pass
Aarav Chopra,30-01-2006,150100,Rajasthan,8,17,24,20,69,Fail
Ishaan Pillai,25-08-2005,966730,Jammu & Kashmir + Ladakh,16,10,21,21,68,Fail
Vivaan Verma,06-09-2005,718956,Assam,20,19,1,17,57,Fail
Vivaan Pillai,11-02-2005,559344,Kerala,13,22,10,9,54,Fail
Gurpreet Khan,16-10-2005,717083,Manipur,10,11,18,4,43,Fail
Vivaan Pillai,12-09-2005,710288,Uttar Pradesh,4,23,4,11,42,Pass
Peter Fernandes,08-06-2005,903607,Uttar Pradesh,13,18,19,17,67,Pass
Ishaan Reddy,05-04-2006,492797,Rajasthan,19,19,22,2,62,Fail
Manpreet D'Souza,24-03-2005,320419,Punjab,5,9,9,8,31,Pass
Rohan Fernandes,21-11-2004,813273,Uttar Pradesh,13,22,13,2,50,Pass
Rohan D'Souza,07-04-2006,278075,Bihar,5,22,23,19,69,Fail
Raj Verma,16-03-2006,470589,Karnataka,15,18,14,20,67,Pass
Aryan Sharma,23-12-2004,326312,Bihar,22,12,18,13,65,Fail
Balbir Verma,18-10-2005,284040,Madhya Pradesh,10,23,13,14,60,Fail
Aarav Pillai,09-02-2006,387314,Haryana,0,15,16,4,35,Fail
Raj Fernandes,25-02-2005,617569,Rajasthan,11,23,4,18,56,Pass
Kunal Pillai,20-12-2005,647317,West Bengal,23,3,19,16,61,Pass
Vivaan Reddy,23-11-2004,313679,Punjab,6,13,5,11,35,Pass
Sukhwinder D'Souza,18-11-2004,981698,Uttarakhand,2,0,5,7,14,Fail
Krishna D'Souza,09-08-2005,367422,Jharkhand,23,5,24,14,66,Pass
Imran Fernandes,13-12-2005,843401,Haryana,12,5,20,16,53,Fail
Sukhwinder Singh,03-03-2005,868010,Himachal Pradesh,15,2,7,22,46,Pass
John Fernandes,14-01-2005,817277,Madhya Pradesh,22,19,17,23,81,Fail
Kunal Khan,30-06-2005,654370,Rajasthan,19,1,0,15,35,Pass
Gurpreet Pillai,20-09-2005,707404,Tamil Nadu,4,5,24,11,44,Pass
Rohan Verma,08-05-2005,934224,Gujarat,23,19,11,9,62,Fail
Raj D'Souza,11-06-2005,794573,Andhra Pradesh,9,12,10,19,50,Fail
Paul Reddy,07-06-2005,131118,Haryana,17,23,7,23,70,Fail
Aryan Verma,01-08-2005,488917,West Bengal,16,12,13,6,47,Pass
Rohan Mehta,24-03-2005,516886,Maharashtra,6,13,15,7,41,Fail
Krishna Fernandes,10-04-2006,972388,Andaman & Nicobar,10,12,16,17,55,Fail
Sukhwinder Mehta,31-01-2006,873393,Assam,23,1,19,0,43,Fail
Krishna Reddy,14-08-2005,278000,Punjab,5,8,3,5,21,Pass
Ishaan Pillai,25-02-2006,652039,Karnataka,4,18,19,2,43,Pass
Vivaan Verma,24-06-2005,490935,Tamil Nadu,19,16,0,4,39,Pass
Krishna Fernandes,31-12-2004,349525,Haryana,14,12,21,11,58,Fail
Krishna Fernandes,24-04-2005,891702,Puducherry,7,5,16,0,28,Pass
Peter D'Souza,26-11-2005,463240,Rajasthan,5,14,22,18,59,Pass
Peter Pillai,15-07-2005,484109,Uttar Pradesh,15,24,21,3,63,Pass
Rohan Fernandes,21-03-2006,874865,Kerala,7,7,4,19,37,Fail
Aditya Reddy,23-12-2004,403626,Andhra Pradesh,1,19,0,3,23,Fail
Mathew Fernandes,09-10-2005,353105,Maharashtra,23,7,18,23,71,Fail
Balbir Singh,14-03-2005,263791,Jammu & Kashmir + Ladakh,24,19,10,1,54,Pass
Imran Sharma,02-03-2005,875386,Maharashtra,7,9,18,17,51,Fail
Balbir Reddy,13-12-2005,628633,Uttarakhand,12,0,21,15,48,Fail
Imran Sharma,03-05-2005,544879,West Bengal,14,22,3,8,47,Pass
Manpreet Sharma,27-12-2005,431966,Bihar,15,3,21,14,53,Fail
Ishaan Pillai,29-01-2005,106172,Jharkhand,2,14,22,18,56,Pass
Rohan Verma,19-12-2005,256537,Bihar,4,12,21,0,37,Pass
Raj Singh,29-08-2005,150917,Rajasthan,15,14,20,18,67,Fail
Rohan Singh,20-02-2006,409926,Telangana,2,11,24,22,59,Fail
Aryan Khan,02-11-2005,198844,Haryana,20,11,22,3,56,Fail
Aarav Mehta,14-11-2004,906073,Gujarat,22,20,22,0,64,Fail
Raj D'Souza,10-02-2005,158355,Maharashtra,22,20,15,15,72,Fail
John Reddy,14-11-2005,961561,Delhi,8,11,18,5,42,Fail
Ishaan Sharma,01-12-2004,913195,Rajasthan,21,7,13,4,45,Pass
David Singh,21-02-2005,808461,Uttar Pradesh,8,11,4,24,47,Pass
Yash Mehta,13-10-2005,964171,Punjab,12,15,6,19,52,Fail
Rohan Singh,21-11-2004,300396,Delhi,21,13,2,5,41,Fail
Krishna Sharma,07-07-2005,584118,Goa,23,0,8,2,33,Fail
Aditya Fernandes,07-10-2005,531774,Rajasthan,20,20,13,9,62,Fail
Aditya Singh,21-06-2005,190957,Karnataka,16,24,22,15,77,Fail
Rohan Fernandes,09-01-2006,780846,Rajasthan,20,17,15,16,68,Fail
Ayaan Verma,16-09-2005,639165,Andhra Pradesh,13,10,13,23,59,Fail
Rohan Sharma,03-07-2005,325919,Bihar,3,5,21,15,44,Pass
Paul Mehta,07-03-2006,860958,Andhra Pradesh,21,11,24,4,60,Fail
Farhan Mehta,07-02-2006,847979,Jharkhand,22,19,16,11,68,Fail
Kunal Khan,26-03-2005,542033,Jharkhand,21,4,20,24,69,Fail
Aryan Reddy,20-04-2006,222436,Gujarat,24,18,19,9,70,Fail
Gurpreet Chopra,07-07-2005,174320,Jharkhand,21,9,11,9,50,Pass
Raj D'Souza,24-11-2004,773117,Bihar,13,3,20,16,52,Fail
Vivaan Mehta,07-03-2005,415545,Bihar,5,8,11,15,39,Pass
Sukhwinder Mehta,14-01-2005,247557,Kerala,24,19,14,11,68,Fail
Ishaan Singh,30-12-2005,944585,Uttar Pradesh,8,18,23,21,70,Pass
David Pillai,07-12-2005,488183,Punjab,10,18,17,9,54,Fail
Vivaan Chopra,02-10-2005,361661,Jharkhand,0,24,2,1,27,Pass
Farhan Singh,18-04-2005,357195,Gujarat,10,24,13,13,60,Fail
Gurpreet Mehta,31-05-2005,227326,Uttar Pradesh,2,12,18,7,39,Pass
Rohan Pillai,26-06-2005,446418,Andhra Pradesh,13,1,4,22,40,Fail
Aarav Singh,27-04-2005,356019,Rajasthan,4,12,10,22,48,Pass
Gurpreet Khan,21-03-2006,329577,Andhra Pradesh,18,23,5,11,57,Fail
Kunal Reddy,15-04-2006,327482,Bihar,6,21,2,6,35,Pass
Kunal Verma,16-05-2005,742022,Punjab,16,14,13,0,43,Pass
Balbir Sharma,08-09-2005,358929,Maharashtra,0,3,8,3,14,Fail
Raj Sharma,25-09-2005,225535,Tamil Nadu,12,19,14,24,69,Pass
Yash Fernandes,06-05-2006,789560,Madhya Pradesh,10,7,17,18,52,Fail
David Khan,08-02-2005,133685,Jammu & Kashmir + Ladakh,1,15,2,7,25,Pass
Manpreet D'Souza,18-10-2005,832181,Assam,13,14,11,13,51,Fail
John Mehta,21-02-2006,717719,Andhra Pradesh,5,7,1,9,22,Fail
Manpreet Fernandes,05-04-2005,334310,Bihar,17,10,23,0,50,Fail
Vivaan Fernandes,15-12-2004,122108,Uttar Pradesh,18,17,3,16,54,Pass
Aditya Pillai,20-01-2005,715682,Bihar,16,6,21,1,44,Pass
Kunal Fernandes,07-01-2006,684653,Puducherry,13,6,0,21,40,Pass
Aarav Singh,22-04-2005,750626,Maharashtra,17,8,3,12,40,Fail
Rohan Sharma,15-07-2005,357601,Punjab,0,9,18,15,42,Pass
Vivaan Singh,22-11-2005,602225,Uttar Pradesh,4,9,21,20,54,Pass
Ishaan Chopra,16-02-2006,979046,Uttar Pradesh,3,15,17,0,35,Pass
Raj D'Souza,05-07-2005,608369,West Bengal,1,12,7,13,33,Pass
Gurpreet Sharma,03-07-2005,962698,Karnataka,16,5,17,6,44,Pass
Yash Chopra,21-09-2005,639838,Delhi,11,17,21,12,61,Fail
Aarav Khan,05-11-2005,154189,Gujarat,6,24,1,0,31,Fail
Balbir Singh,08-04-2005,498352,Odisha,22,13,21,9,65,Fail
Vivaan Khan,09-01-2006,120816,Uttar Pradesh,13,16,23,8,60,Pass
Farhan Pillai,03-12-2004,277995,Haryana,13,13,6,18,50,Fail
Vivaan Verma,16-09-2005,361365,West Bengal,7,22,6,13,48,Pass
David Chopra,10-01-2006,200449,Rajasthan,18,24,15,20,77,Pass
Yash Singh,22-09-2005,561740,Gujarat,4,8,0,9,21,Fail
Ishaan Reddy,28-10-2005,643286,Andhra Pradesh,14,10,21,15,60,Fail
Peter D'Souza,12-12-2005,892151,Bihar,1,19,19,4,43,Pass
Aditya Verma,09-07-2005,990312,Maharashtra,12,4,19,17,52,Fail
Yash Singh,01-02-2005,833614,Uttarakhand,24,18,5,13,60,Fail
Ishaan Sharma,21-04-2005,924413,West Bengal,12,3,24,11,50,Pass
Vivaan Chopra,06-06-2005,300749,Odisha,17,5,8,18,48,Fail
Balbir Mehta,06-11-2005,127562,West Bengal,16,16,19,0,51,Pass
Raj Fernandes,22-04-2005,835031,Tamil Nadu,20,18,9,18,65,Pass
Krishna Verma,15-11-2004,422081,Bihar,7,14,13,13,47,Fail
Krishna Sharma,09-10-2005,350448,West Bengal,10,15,23,5,53,Pass
Rehan Pillai,29-12-2005,308427,Punjab,13,14,7,23,57,Fail
David Pillai,16-07-2005,519584,West Bengal,5,13,14,9,41,Pass
Vivaan Pillai,12-02-2006,126766,Telangana,0,23,21,2,46,Fail
Gurpreet Khan,06-02-2006,132004,Bihar,17,7,17,14,55,Fail
Aarav Singh,20-06-2005,712822,Gujarat,14,19,8,2,43,Fail
Sukhwinder Fernandes,30-01-2006,543524,Rajasthan,0,6,14,2,22,Pass
John Verma,03-12-2005,655719,Rajasthan,15,17,7,18,57,Pass
Harjeet Pillai,17-11-2004,509102,Chhattisgarh,19,21,15,17,72,Fail
Rohan Mehta,05-03-2005,102355,Maharashtra,15,10,2,11,38,Fail
Kunal Fernandes,30-06-2005,884848,Madhya Pradesh,5,16,0,22,43,Fail
Krishna Fernandes,06-07-2005,117461,Bihar,24,18,17,13,72,Fail
Vivaan D'Souza,13-02-2005,126500,Haryana,2,0,9,23,34,Fail
Rohan Singh,31-10-2005,782180,Himachal Pradesh,24,13,23,10,70,Fail
Aditya Reddy,17-11-2004,782501,Gujarat,12,21,11,13,57,Fail
Aditya Fernandes,10-02-2005,860550,Assam,22,4,13,17,56,Fail
Aryan D'Souza,01-02-2006,555988,Maharashtra,15,12,18,1,46,Fail
Yash Khan,09-11-2005,175257,Andaman & Nicobar,1,10,17,5,33,Fail
Krishna Sharma,16-01-2006,496525,Chhattisgarh,19,15,23,16,73,Fail
David Verma,11-03-2005,148865,Assam,19,18,4,0,41,Fail
Yash Verma,02-11-2005,156685,Rajasthan,6,3,24,15,48,Pass
Ishaan Khan,03-05-2006,582401,Uttar Pradesh,21,11,14,16,62,Pass
Raj Fernandes,14-01-2006,835578,Uttarakhand,0,23,8,10,41,Fail
Peter Reddy,28-08-2005,296073,Punjab,0,6,7,4,17,Pass
Manpreet Khan,09-08-2005,203410,Jharkhand,6,19,0,9,34,Pass
Rohan Sharma,09-12-2004,629784,Madhya Pradesh,1,15,23,19,58,Fail
Aryan Verma,24-05-2005,576790,Bihar,24,7,9,20,60,Fail
Balbir Sharma,06-01-2005,157779,Andhra Pradesh,13,1,16,21,51,Fail
Aditya Singh,07-01-2005,247319,Bihar,22,14,7,13,56,Fail
Aryan Verma,19-12-2005,738541,Jharkhand,12,10,21,7,50,Pass
Ishaan D'Souza,29-06-2005,581354,Haryana,9,7,0,4,20,Fail
John Mehta,17-11-2005,462358,Haryana,4,8,14,13,39,Fail
Vivaan Verma,06-05-2005,118540,Karnataka,13,1,1,11,26,Pass
Raj Verma,10-12-2004,923832,Maharashtra,20,8,1,7,36,Fail
John Singh,11-12-2004,798663,Maharashtra,2,13,14,5,34,Fail
Raj Mehta,30-06-2005,575051,Kerala,13,6,11,6,36,Fail
Ishaan Khan,23-02-2005,201589,West Bengal,2,5,5,10,22,Pass
Mathew Verma,10-02-2006,615721,Bihar,24,21,20,12,77,Fail
Ishaan Singh,13-04-2005,537100,Uttar Pradesh,15,18,10,24,67,Pass
Rohan Verma,28-02-2005,574312,Jammu & Kashmir + Ladakh,15,3,13,19,50,Pass
Sukhwinder Verma,11-05-2005,762154,Tamil Nadu,15,14,16,7,52,Fail
Vivaan Fernandes,02-05-2006,774387,Karnataka,1,1,20,18,40,Pass
Manpreet Pillai,05-11-2005,617460,Punjab,1,1,20,4,26,Pass
Balbir Mehta,25-09-2005,289418,Andhra Pradesh,6,15,18,6,45,Fail
Vivaan Verma,16-04-2006,384824,Maharashtra,13,10,21,13,57,Fail
Vivaan Verma,10-11-2005,759745,Maharashtra,7,19,23,22,71,Fail
Gurpreet Verma,20-10-2005,224267,Maharashtra,23,11,6,9,49,Fail
Ayaan Fernandes,28-08-2005,160818,Gujarat,1,10,11,11,33,Fail
Harjeet Verma,07-03-2005,728073,Mizoram,21,14,15,15,65,Fail
Yash Sharma,15-06-2005,581232,Odisha,22,0,8,4,34,Pass
Paul Sharma,02-01-2006,735646,Himachal Pradesh,16,15,16,17,64,Pass
Ishaan Sharma,08-08-2005,243923,West Bengal,8,11,5,15,39,Pass
Farhan Fernandes,19-12-2004,861887,Bihar,19,16,13,5,53,Fail
Kunal Reddy,07-01-2005,877821,Karnataka,13,6,8,19,46,Pass
Raj Pillai,29-01-2006,824017,Chhattisgarh,5,18,0,18,41,Fail
Kunal Chopra,08-01-2005,168594,Chhattisgarh,13,1,22,17,53,Fail
Rohan Chopra,08-10-2005,307725,West Bengal,13,3,16,2,34,Pass
Ishaan D'Souza,22-07-2005,614764,Maharashtra,18,2,23,0,43,Fail
Raj Singh,05-03-2005,666270,Maharashtra,11,2,21,8,42,Fail
Aryan Fernandes,17-02-2005,109568,Telangana,14,12,14,18,58,Fail
Peter Chopra,26-02-2005,475788,Andhra Pradesh,4,18,4,22,48,Fail
Kunal Mehta,19-05-2005,609936,Maharashtra,2,13,0,12,27,Fail
Ayaan Mehta,14-05-2005,353325,Haryana,13,19,3,15,50,Fail
Aditya Chopra,31-03-2005,689137,Haryana,7,15,15,11,48,Fail
Aarav Mehta,22-11-2004,360078,Telangana,5,11,22,19,57,Fail
Aryan Khan,26-01-2005,170983,Uttar Pradesh,22,3,17,16,58,Pass
Krishna Verma,16-12-2004,752309,Bihar,18,2,1,23,44,Pass
Rohan Chopra,21-07-2005,753197,Tamil Nadu,3,1,12,24,40,Pass
Balbir Fernandes,22-08-2005,197616,Rajasthan,23,6,2,9,40,Pass
Balbir Mehta,09-11-2005,254325,Punjab,5,13,21,6,45,Fail
Vivaan Reddy,29-07-2005,217693,Punjab,15,17,7,15,54,Fail
Rohan Reddy,20-03-2005,462550,Odisha,11,4,3,12,30,Pass
Aryan Pillai,18-04-2005,803525,Madhya Pradesh,19,5,2,2,28,Fail
Aryan Khan,16-12-2004,995952,Punjab,8,14,17,9,48,Fail
Kunal Verma,05-11-2005,374190,Uttarakhand,17,1,3,19,40,Fail
Kunal Sharma,22-04-2006,117156,Mizoram,4,6,10,24,44,Pass
Aryan Khan,23-04-2006,482828,Jammu & Kashmir + Ladakh,22,3,15,21,61,Pass
Aditya Chopra,06-10-2005,662807,Bihar,20,15,2,15,52,Fail
Ayaan Verma,02-03-2005,740580,West Bengal,10,17,9,7,43,Pass
Rohan Singh,03-09-2005,777822,Himachal Pradesh,12,15,4,1,32,Pass
Zaid Verma,21-07-2005,561166,Delhi,5,10,14,1,30,Fail
Zaid D'Souza,04-06-2005,945287,Andhra Pradesh,9,14,5,8,36,Fail
Aryan Singh,25-08-2005,699337,Maharashtra,15,0,9,10,34,Fail
Vivaan Fernandes,21-01-2006,147615,Karnataka,22,12,9,18,61,Pass
Manpreet Pillai,21-03-2005,206039,Andaman & Nicobar,8,14,23,19,64,Fail
Yash Khan,27-06-2005,407222,Tamil Nadu,11,8,17,24,60,Pass
Ishaan D'Souza,17-12-2005,425914,Bihar,0,6,3,8,17,Pass
Yash D'Souza,15-11-2005,762361,Odisha,5,11,17,7,40,Pass
Raj Fernandes,19-11-2005,974863,Madhya Pradesh,3,1,19,23,46,Fail
Manpreet D'Souza,29-12-2005,211147,Bihar,6,21,0,13,40,Pass
Yash Mehta,07-11-2005,975274,Maharashtra,19,6,3,10,38,Fail
Aryan Fernandes,11-09-2005,505351,Bihar,0,14,20,9,43,Pass
Aryan Pillai,07-02-2006,233347,Jammu & Kashmir + Ladakh,16,3,6,2,27,Pass
Vivaan Sharma,05-12-2005,307782,Haryana,7,16,20,2,45,Fail
Raj Reddy,11-04-2006,905608,Maharashtra,5,14,20,10,49,Fail
Ishaan Sharma,08-01-2006,320989,Rajasthan,12,20,2,5,39,Pass
Ishaan Mehta,23-04-2006,836441,Punjab,5,20,2,12,39,Pass
Balbir Verma,03-04-2006,337899,Kerala,8,17,1,6,32,Fail
Aditya Verma,17-09-2005,770191,Maharashtra,19,2,7,11,39,Fail
Harjeet Reddy,25-01-2006,951105,Andhra Pradesh,17,5,1,12,35,Fail
Aarav Sharma,06-05-2005,966413,Uttar Pradesh,4,5,19,7,35,Pass
John Singh,08-03-2006,748581,West Bengal,4,8,23,13,48,Pass
Yash Pillai,04-03-2006,965454,Bihar,1,2,13,11,27,Pass
Aarav Fernandes,19-02-2006,672720,Maharashtra,10,15,23,0,48,Fail
Raj Reddy,14-08-2005,708141,Uttar Pradesh,16,5,7,12,40,Pass
Balbir Sharma,24-12-2005,704124,Uttar Pradesh,16,23,12,4,55,Pass
Aarav Verma,28-11-2004,327531,Tamil Nadu,0,1,8,13,22,Pass
Aryan Fernandes,27-08-2005,339886,Maharashtra,11,24,3,13,51,Fail
Ishaan Verma,27-04-2005,206186,Rajasthan,1,15,7,21,44,Pass
Raj Khan,13-12-2004,484163,Telangana,12,8,10,19,49,Fail
Aditya Chopra,23-08-2005,788215,Madhya Pradesh,7,0,22,13,42,Fail
Farhan Singh,29-03-2006,575607,Madhya Pradesh,24,22,14,18,78,Fail
Kunal Khan,12-12-2004,827130,Odisha,14,24,17,10,65,Fail
David Fernandes,01-12-2004,139396,Assam,3,5,14,17,39,Fail
David Sharma,06-01-2006,844661,Tamil Nadu,5,22,9,16,52,Fail
Aryan Sharma,16-11-2005,487675,Tamil Nadu,19,7,3,12,41,Pass
Kunal Mehta,09-05-2005,386727,Tamil Nadu,10,17,3,3,33,Pass
Rohan Pillai,03-08-2005,262846,Uttar Pradesh,4,3,10,5,22,Pass
Raj Chopra,30-03-2005,637510,Assam,21,2,22,5,50,Fail
Aarav Singh,15-01-2005,433644,Rajasthan,16,18,23,17,74,Pass
Peter D'Souza,30-12-2005,433710,West Bengal,4,0,14,22,40,Pass
Yash Mehta,23-03-2005,743410,Punjab,10,16,18,11,55,Fail
Yash Singh,11-05-2005,824159,Tamil Nadu,0,12,16,24,52,Fail
Aryan Khan,27-04-2006,399463,Rajasthan,3,22,4,7,36,Pass
Kunal Singh,04-01-2005,297977,Andaman & Nicobar,1,7,23,18,49,Pass
Rohan D'Souza,03-01-2006,927455,Jharkhand,5,17,9,2,33,Pass
Ishaan Verma,28-12-2005,541002,Uttarakhand,18,13,14,20,65,Fail
Rohan Khan,14-01-2005,357775,Tripura,19,22,5,9,55,Fail
Ishaan Fernandes,04-03-2005,122432,Andhra Pradesh,24,21,13,22,80,Fail
David Sharma,26-09-2005,353291,Andhra Pradesh,24,20,7,20,71,Fail
Yash Chopra,12-04-2006,399972,Andhra Pradesh,23,18,1,20,62,Fail
Rohan D'Souza,20-02-2005,459202,Madhya Pradesh,5,20,21,23,69,Fail
Manpreet Pillai,04-07-2005,643735,Maharashtra,3,14,20,14,51,Fail
David D'Souza,19-11-2005,104946,Punjab,10,11,1,23,45,Fail
Aryan Chopra,25-04-2006,143747,Bihar,12,20,11,1,44,Pass
Aditya Singh,05-12-2005,189614,Andhra Pradesh,11,16,12,17,56,Fail
Kunal Pillai,20-12-2005,666283,Assam,1,1,7,7,16,Fail
Yash Chopra,12-01-2005,643234,Rajasthan,1,2,18,23,44,Pass
Aarav Sharma,19-08-2005,397675,Jharkhand,17,4,22,15,58,Pass
Krishna Singh,31-03-2005,446947,Delhi,3,3,2,18,26,Fail
Aditya Singh,04-04-2005,675878,Uttar Pradesh,11,0,18,8,37,Pass
Aryan Sharma,17-05-2005,682863,Telangana,6,12,17,4,39,Fail
Vivaan Fernandes,25-02-2005,507437,Andhra Pradesh,24,8,14,5,51,Fail
Aditya Fernandes,06-01-2006,282319,Madhya Pradesh,24,14,7,9,54,Fail
Ishaan Mehta,07-05-2006,168526,Tamil Nadu,23,24,14,19,80,Pass
Rohan Chopra,15-01-2006,737987,Madhya Pradesh,3,21,20,11,55,Fail
Krishna Reddy,04-01-2006,662454,Tamil Nadu,5,8,6,0,19,Pass
Aditya Khan,14-12-2005,208774,Jharkhand,22,13,2,23,60,Pass
Kunal Sharma,30-03-2006,101758,Gujarat,24,8,9,23,64,Fail
Aryan D'Souza,06-03-2006,601808,West Bengal,5,10,20,15,50,Pass
Vivaan Fernandes,17-09-2005,760919,Andhra Pradesh,21,0,9,11,41,Fail
Aarav Reddy,12-11-2004,865913,Haryana,12,18,9,15,54,Fail
Yash Fernandes,10-03-2005,720495,Andhra Pradesh,22,2,23,10,57,Fail
Rohan D'Souza,10-02-2006,200822,Uttar Pradesh,18,3,15,24,60,Pass
Vivaan Pillai,16-06-2005,180754,Madhya Pradesh,21,3,6,12,42,Fail
Rohan Fernandes,23-08-2005,509702,Bihar,13,21,0,8,42,Pass
Yash Fernandes,31-03-2006,642748,Himachal Pradesh,23,12,18,7,60,Fail
Vivaan Fernandes,22-04-2006,232757,Madhya Pradesh,8,13,15,0,36,Fail
Aarav Mehta,16-04-2005,290545,Maharashtra,24,1,20,15,60,Fail
Gurpreet Sharma,29-01-2005,903010,Punjab,23,20,22,24,89,Pass
Harjeet Reddy,20-04-2005,822759,Bihar,15,20,17,13,65,Fail
Kunal Khan,23-03-2006,461747,Jharkhand,1,11,15,18,45,Pass
Krishna D'Souza,08-10-2005,929612,Himachal Pradesh,5,16,17,16,54,Pass
Ishaan Fernandes,29-04-2006,297438,Bihar,20,14,11,2,47,Fail
Sukhwinder Sharma,04-04-2006,581853,Uttar Pradesh,21,3,16,11,51,Pass
Krishna Singh,17-09-2005,806796,Odisha,15,10,4,1,30,Pass
Imran Khan,13-09-2005,141033,Karnataka,15,2,9,6,32,Pass
Aditya Sharma,07-08-2005,574603,Tamil Nadu,2,12,6,6,26,Pass
Farhan Mehta,15-04-2005,485128,Madhya Pradesh,23,10,20,22,75,Fail
Ishaan D'Souza,02-05-2006,954144,Punjab,3,24,21,18,66,Fail
Aditya Khan,03-11-2005,337594,Punjab,5,8,11,17,41,Pass
Aditya Fernandes,17-01-2006,364936,Karnataka,1,7,19,15,42,Pass
Balbir Reddy,15-02-2006,119428,Delhi,21,0,22,18,61,Fail
Yash Khan,22-02-2006,240772,Uttar Pradesh,8,24,10,6,48,Pass
Aditya D'Souza,25-09-2005,479792,Arunachal Pradesh,0,6,11,16,33,Fail
Kunal D'Souza,07-04-2005,162396,Madhya Pradesh,8,6,10,12,36,Fail
Rohan Khan,12-08-2005,415132,Andhra Pradesh,7,0,17,8,32,Fail
Aditya Pillai,06-05-2006,507802,Andhra Pradesh,15,6,6,9,36,Fail
Balbir Fernandes,18-02-2005,454578,Rajasthan,12,22,3,8,45,Pass
Aarav Pillai,30-06-2005,544661,Bihar,18,0,17,9,44,Pass
Aditya Sharma,04-12-2004,240154,Tamil Nadu,11,3,14,16,44,Pass
Krishna Verma,11-11-2004,129551,Assam,23,12,7,14,56,Fail
Rehan Chopra,23-03-2005,870996,Bihar,23,3,11,10,47,Fail
Zaid Fernandes,13-02-2005,912235,Rajasthan,12,24,4,13,53,Pass
Aryan Sharma,13-02-2006,183946,Assam,24,19,9,23,75,Fail
Vivaan Pillai,22-02-2006,818212,Rajasthan,9,7,17,10,43,Pass
Aarav Verma,08-02-2005,887159,Uttar Pradesh,1,3,1,4,9,Pass
John Chopra,01-07-2005,482998,Andhra Pradesh,9,10,14,14,47,Fail
Yash Reddy,13-10-2005,422039,Tamil Nadu,3,22,6,15,46,Fail
Aarav Chopra,03-05-2006,371101,Haryana,5,18,5,23,51,Fail
Aarav Reddy,02-03-2005,250487,Tamil Nadu,2,23,13,21,59,Pass
Aarav Reddy,29-07-2005,354510,Uttar Pradesh,17,24,6,18,65,Pass
Vivaan Khan,07-08-2005,753401,Karnataka,22,10,14,22,68,Fail
Ishaan Khan,21-04-2005,912296,Uttar Pradesh,14,20,8,13,55,Pass
Harjeet Fernandes,06-12-2005,135832,Maharashtra,18,21,11,7,57,Fail
Aryan D'Souza,21-08-2005,788489,Odisha,12,11,10,21,54,Fail
Harjeet Singh,23-04-2006,196936,Jammu & Kashmir + Ladakh,3,5,16,15,39,Pass
Kunal Verma,06-03-2005,288952,Bihar,0,7,23,3,33,Pass
Gurpreet Sharma,01-04-2006,400268,Chhattisgarh,15,21,12,12,60,Fail
Harjeet Pillai,12-04-2006,489614,Assam,13,8,19,19,59,Fail
Vivaan Singh,22-11-2004,522916,Maharashtra,5,23,3,12,43,Fail
Aarav Pillai,11-06-2005,674141,Bihar,15,2,5,14,36,Pass
Vivaan Fernandes,20-06-2005,996857,Gujarat,4,9,6,5,24,Fail
Gurpreet Reddy,08-12-2005,721047,Uttarakhand,3,6,18,21,48,Fail
Aarav Chopra,28-12-2005,841750,Kerala,14,10,11,24,59,Fail
Ishaan Reddy,20-11-2005,595095,Uttarakhand,4,10,16,11,41,Fail
Aarav D'Souza,05-05-2006,760991,West Bengal,22,6,7,7,42,Pass
Krishna Singh,15-12-2004,215088,Madhya Pradesh,0,21,0,19,40,Fail
Mathew Singh,19-04-2005,758694,Maharashtra,17,6,20,8,51,Fail
Yash Sharma,30-08-2005,828131,Rajasthan,9,24,0,24,57,Pass
Gurpreet Fernandes,02-09-2005,373694,Uttar Pradesh,17,3,21,18,59,Pass
Rohan Mehta,21-07-2005,801306,Puducherry,14,24,14,15,67,Fail
Sukhwinder Verma,12-03-2006,936641,Haryana,17,14,15,6,52,Fail
Krishna D'Souza,26-02-2006,372512,Bihar,20,1,19,8,48,Fail
Aditya Verma,08-11-2004,591201,Uttar Pradesh,5,8,20,11,44,Pass
Manpreet Khan,21-09-2005,812432,Rajasthan,21,2,15,15,53,Pass
Aryan Mehta,02-01-2005,983935,Rajasthan,14,3,1,3,21,Pass
Harjeet Khan,24-04-2006,894656,Delhi,16,0,21,4,41,Fail
Mathew Pillai,23-04-2006,898370,Madhya Pradesh,17,1,9,14,41,Fail
Aryan Reddy,29-06-2005,857006,Telangana,1,22,15,23,61,Fail
Rohan Mehta,22-12-2004,783868,Himachal Pradesh,5,9,24,0,38,Pass
Raj Pillai,13-04-2006,558514,Odisha,22,13,9,23,67,Fail
Yash D'Souza,27-10-2005,509806,Maharashtra,6,13,7,8,34,Fail
Peter D'Souza,21-11-2004,143968,Madhya Pradesh,24,18,15,10,67,Fail
Raj Verma,09-09-2005,856954,Uttarakhand,8,21,14,8,51,Fail
Vivaan Chopra,07-08-2005,118994,Kerala,2,15,3,15,35,Fail
Krishna Sharma,29-07-2005,437487,Uttar Pradesh,5,10,19,12,46,Pass
Vivaan Verma,11-12-2005,606991,Haryana,16,14,15,9,54,Fail
Vivaan Chopra,07-01-2005,766536,Tamil Nadu,16,7,24,4,51,Pass
Ishaan Singh,04-12-2004,438372,Assam,21,22,8,13,64,Fail
Paul Verma,18-12-2005,221776,Mizoram,2,10,5,13,30,Pass
Kunal Pillai,15-11-2005,332806,Himachal Pradesh,16,5,12,7,40,Pass
Raj Fernandes,27-12-2005,249152,Karnataka,2,7,13,9,31,Pass
Balbir Verma,12-06-2005,353433,Jharkhand,15,23,20,16,74,Fail
Krishna Khan,18-07-2005,885106,Uttar Pradesh,18,3,24,8,53,Pass
Rohan Mehta,26-11-2004,208836,Bihar,2,12,5,5,24,Pass
Raj Verma,15-10-2005,283907,Karnataka,14,11,10,9,44,Pass
Vivaan D'Souza,16-03-2006,233431,Rajasthan,2,0,3,16,21,Pass
Vivaan Reddy,06-09-2005,111728,Bihar,2,9,8,13,32,Pass
Imran Singh,26-08-2005,886932,Karnataka,6,19,23,22,70,Fail
Raj Singh,16-10-2005,234541,West Bengal,10,12,4,16,42,Pass
Mathew Pillai,21-12-2005,770903,Bihar,15,13,15,20,63,Fail
Vivaan Reddy,02-12-2005,484177,Uttar Pradesh,5,3,3,9,20,Pass
Harjeet Sharma,06-05-2005,962696,Bihar,13,3,16,18,50,Fail
Vivaan Khan,07-01-2005,552840,Rajasthan,15,24,17,1,57,Pass
Krishna Pillai,29-05-2005,128907,Tamil Nadu,15,18,7,2,42,Pass
Manpreet Pillai,08-01-2005,162153,Jharkhand,5,24,10,1,40,Pass
Aryan Sharma,18-03-2006,558130,West Bengal,13,18,4,0,35,Pass
Gurpreet Chopra,31-03-2006,493079,Uttar Pradesh,4,17,19,15,55,Pass
Sukhwinder Sharma,07-09-2005,912765,Rajasthan,18,19,16,24,77,Pass
Rohan D'Souza,03-05-2006,126586,West Bengal,24,3,2,20,49,Pass
Kunal Pillai,10-04-2005,474707,Jharkhand,1,1,11,11,24,Pass
Aarav Chopra,29-10-2005,796194,Punjab,1,18,7,24,50,Fail
Manpreet Khan,09-02-2006,521348,Rajasthan,4,1,17,2,24,Pass
Raj Mehta,07-02-2006,131059,Madhya Pradesh,22,7,3,16,48,Fail
Rohan Pillai,31-01-2006,346880,Maharashtra,20,19,3,21,63,Fail
Raj Chopra,14-04-2006,390384,Gujarat,21,17,14,16,68,Fail
Yash Reddy,13-12-2005,513850,Maharashtra,21,3,18,10,52,Fail
Aarav Khan,12-04-2005,693190,Rajasthan,5,20,8,2,35,Pass
Krishna Singh,28-04-2005,341887,Rajasthan,24,10,24,10,68,Fail
Ishaan Reddy,07-10-2005,634090,Gujarat,19,1,6,18,44,Fail
Harjeet Fernandes,26-05-2005,203135,Daman & Diu / D&N Haveli,6,10,4,20,40,Fail
Vivaan Mehta,21-03-2005,732230,Odisha,5,15,3,7,30,Pass
Yash Mehta,12-11-2004,645333,Karnataka,0,10,3,14,27,Pass
Rehan Khan,31-01-2006,972874,Uttar Pradesh,8,4,11,3,26,Pass
Ishaan Chopra,03-09-2005,378860,Andhra Pradesh,20,19,14,7,60,Fail
Yash Chopra,21-03-2005,200708,Andhra Pradesh,14,19,11,21,65,Fail
Sukhwinder Pillai,10-07-2005,460417,Tripura,11,20,18,23,72,Fail
Kunal Khan,20-10-2005,990635,Telangana,16,18,15,9,58,Fail
Kunal Mehta,07-01-2006,512160,Bihar,10,24,7,1,42,Pass
Vivaan Reddy,22-03-2005,991029,Madhya Pradesh,14,2,10,5,31,Fail
Ishaan Pillai,02-04-2005,129097,West Bengal,24,3,4,20,51,Pass
Kunal Chopra,01-05-2006,119713,Rajasthan,0,10,13,5,28,Pass
Aryan Reddy,05-12-2004,402229,Rajasthan,3,1,17,8,29,Pass
Imran Mehta,31-03-2006,843428,Jammu & Kashmir + Ladakh,21,4,15,22,62,Pass
Vivaan Singh,22-06-2005,157418,Haryana,17,8,18,14,57,Fail
Manpreet Sharma,01-03-2005,699510,Kerala,15,3,24,11,53,Fail
Aryan Reddy,29-08-2005,745369,Maharashtra,13,9,12,4,38,Fail
Raj Khan,24-01-2006,220500,Kerala,13,23,16,6,58,Fail
Krishna Mehta,05-04-2005,202631,Uttar Pradesh,12,20,23,4,59,Pass
Ishaan Khan,18-11-2005,877538,Chhattisgarh,4,10,8,13,35,Fail
Raj D'Souza,26-06-2005,336925,Haryana,1,23,19,10,53,Fail
Ishaan Sharma,25-06-2005,163627,Tamil Nadu,22,10,11,9,52,Fail
Kunal D'Souza,06-04-2006,792371,Chhattisgarh,21,15,11,3,50,Fail
Yash D'Souza,22-07-2005,712407,Punjab,14,17,2,24,57,Fail
Aarav Verma,22-10-2005,784357,Maharashtra,0,9,12,2,23,Fail
Mathew Verma,08-07-2005,295953,Tripura,10,5,11,13,39,Fail
Mathew Chopra,01-03-2005,493583,Punjab,2,21,14,20,57,Fail
Krishna Singh,14-11-2004,421270,Bihar,8,22,20,9,59,Fail
Sukhwinder Pillai,15-03-2006,635112,Kerala,5,17,14,17,53,Fail
Raj Verma,02-07-2005,176706,Jharkhand,20,0,12,19,51,Pass
Yash Mehta,16-01-2006,893927,Punjab,16,11,13,4,44,Pass
Manpreet Singh,01-05-2005,832060,Jharkhand,5,2,7,15,29,Pass
John Mehta,02-10-2005,395935,Maharashtra,10,13,20,19,62,Fail
Aarav Pillai,19-05-2005,133949,Bihar,9,23,23,6,61,Fail
Yash Khan,03-02-2005,158748,Maharashtra,20,20,5,21,66,Fail
Raj D'Souza,04-11-2005,560374,Tamil Nadu,20,9,2,4,35,Pass
Aditya Pillai,09-08-2005,158465,Maharashtra,5,4,20,11,40,Fail
Ishaan D'Souza,16-11-2004,592761,Uttar Pradesh,15,13,20,21,69,Pass
Rohan Reddy,16-12-2005,826845,Madhya Pradesh,14,18,12,14,58,Fail
Aryan Fernandes,14-11-2004,716316,Uttar Pradesh,14,5,18,15,52,Pass
Manpreet Sharma,18-02-2005,236041,Rajasthan,13,7,9,18,47,Pass
Mathew Chopra,08-07-2005,561233,Bihar,19,9,19,19,66,Fail
Aditya Verma,11-05-2005,600925,Odisha,14,0,22,4,40,Pass
Kunal Singh,08-12-2005,316958,Telangana,18,4,24,23,69,Fail
Aryan Verma,01-04-2005,962050,Maharashtra,17,4,24,21,66,Fail
Ishaan Sharma,10-03-2006,125421,Tamil Nadu,11,0,18,21,50,Fail
Krishna D'Souza,24-01-2006,400735,Maharashtra,11,10,5,20,46,Fail
Harjeet Sharma,04-08-2005,472797,Bihar,23,23,5,8,59,Fail
Aarav Khan,23-04-2005,807847,Bihar,10,19,20,10,59,Fail
David Chopra,21-11-2004,600317,Bihar,16,18,17,7,58,Fail
Rohan Singh,15-03-2005,946166,Uttar Pradesh,20,6,23,20,69,Pass
Kunal D'Souza,27-06-2005,377360,Jharkhand,4,10,11,5,30,Pass
Gurpreet Khan,15-01-2006,682047,Rajasthan,8,5,8,3,24,Pass
Aarav Sharma,28-02-2005,829681,Haryana,7,4,11,24,46,Fail
Rohan Sharma,03-06-2005,301954,Punjab,10,24,13,3,50,Fail
Aditya Khan,22-12-2004,926520,Tamil Nadu,7,17,12,2,38,Pass
Ishaan Reddy,11-08-2005,859153,Himachal Pradesh,4,21,18,1,44,Pass
Peter Pillai,10-07-2005,635683,Maharashtra,2,18,0,6,26,Fail
Rohan Khan,18-06-2005,321990,Tamil Nadu,16,12,20,19,67,Fail
Manpreet Singh,05-01-2006,654825,Bihar,10,2,20,18,50,Fail
Kunal Chopra,03-08-2005,157150,Bihar,12,0,12,18,42,Pass
Manpreet Fernandes,26-07-2005,758148,Tamil Nadu,12,8,22,15,57,Pass
Aryan Verma,03-05-2006,143884,Bihar,19,11,3,2,35,Pass
Aarav Mehta,16-09-2005,878619,Madhya Pradesh,3,20,11,17,51,Fail
Aryan Sharma,05-06-2005,401193,Madhya Pradesh,2,15,11,11,39,Fail
Ishaan Fernandes,01-10-2005,650302,Maharashtra,21,17,18,3,59,Fail
Aarav Chopra,21-10-2005,534234,Uttar Pradesh,20,3,20,20,63,Pass
Vivaan Mehta,11-02-2005,721672,Madhya Pradesh,5,12,16,6,39,Fail
Rohan Singh,08-12-2005,637576,Assam,14,21,1,21,57,Fail
Rohan Reddy,29-05-2005,948608,West Bengal,21,0,11,8,40,Pass
Balbir Singh,22-02-2006,386922,Bihar,23,3,1,24,51,Fail
Rohan Pillai,19-09-2005,973141,Jammu & Kashmir + Ladakh,22,18,10,1,51,Pass
Krishna Mehta,07-03-2006,215613,Rajasthan,7,23,10,9,49,Pass
Yash Mehta,11-11-2004,810825,Gujarat,6,9,21,18,54,Fail
Kunal Pillai,14-12-2005,754487,Karnataka,24,10,9,16,59,Pass
Aarav Pillai,19-02-2006,325882,West Bengal,8,4,4,24,40,Pass
Aditya Singh,02-10-2005,925578,Bihar,13,3,20,9,45,Fail
Rohan Pillai,19-05-2005,333987,Himachal Pradesh,9,10,11,0,30,Pass
Aditya Fernandes,02-01-2006,704618,Tamil Nadu,22,16,21,23,82,Pass
Yash D'Souza,06-05-2005,980936,Kerala,7,19,22,3,51,Fail
Rehan Mehta,30-03-2006,379618,Haryana,16,8,5,8,37,Fail
Kunal Mehta,21-10-2005,263346,West Bengal,1,11,5,3,20,Pass
Krishna Reddy,07-04-2006,595430,West Bengal,16,3,19,21,59,Pass
Kunal Fernandes,18-11-2004,866740,Uttar Pradesh,14,6,20,20,60,Pass
Yash Fernandes,27-02-2005,168198,Rajasthan,20,9,11,24,64,Fail
Aryan Chopra,13-03-2006,402050,Odisha,14,23,2,12,51,Fail
Raj Fernandes,09-04-2005,956886,Rajasthan,14,0,7,14,35,Pass
Raj Reddy,19-05-2005,362905,Andhra Pradesh,4,18,1,13,36,Fail
Ishaan Sharma,10-07-2005,323316,Bihar,13,21,6,4,44,Pass
Sukhwinder Fernandes,27-03-2005,780672,Tamil Nadu,14,6,14,16,50,Fail
Aditya Verma,26-03-2006,831296,Bihar,12,24,24,22,82,Fail
Krishna Chopra,11-11-2004,567346,Jharkhand,23,13,23,8,67,Pass
John Khan,18-04-2005,692422,Bihar,3,17,18,10,48,Fail
Krishna Reddy,13-04-2005,564115,Uttar Pradesh,0,23,13,7,43,Pass
Kunal Chopra,06-10-2005,828820,Jharkhand,1,5,19,12,37,Pass
Rehan Verma,30-12-2004,403175,Madhya Pradesh,1,16,18,19,54,Fail
Aarav Reddy,03-11-2005,416205,Karnataka,1,2,24,2,29,Pass
Peter Fernandes,16-01-2005,850069,Manipur,21,4,18,4,47,Fail
Rohan Fernandes,27-03-2006,713953,Rajasthan,16,5,8,23,52,Pass
Mathew Sharma,28-05-2005,456606,Punjab,2,18,7,14,41,Pass
Aarav Chopra,24-02-2006,610189,Andhra Pradesh,24,0,22,8,54,Fail
Raj Fernandes,05-03-2006,802632,Bihar,11,6,2,19,38,Pass
Rohan Fernandes,08-02-2006,730749,Tamil Nadu,13,4,2,9,28,Pass
Aditya Verma,01-08-2005,392316,Rajasthan,9,11,15,2,37,Pass
Krishna Verma,17-10-2005,343710,Odisha,5,5,6,1,17,Pass
Rohan Verma,31-03-2006,580807,Nagaland,20,0,6,24,50,Fail
Vivaan Reddy,06-05-2005,497429,Punjab,8,13,19,12,52,Fail
Rohan Verma,21-03-2006,119202,Rajasthan,12,21,17,1,51,Pass
Sukhwinder Mehta,17-03-2005,823505,Uttar Pradesh,21,3,15,1,40,Pass
Kunal Sharma,01-11-2005,509579,Tamil Nadu,17,9,12,23,61,Pass
David Chopra,06-02-2006,395830,Uttar Pradesh,1,7,6,19,33,Pass
Rohan Fernandes,13-11-2005,565379,Tamil Nadu,24,11,22,23,80,Pass
Manpreet Pillai,09-06-2005,822376,Rajasthan,24,3,10,8,45,Pass
Ishaan Pillai,15-01-2005,880954,Bihar,6,1,6,9,22,Pass
John Mehta,04-11-2005,818243,Andhra Pradesh,12,6,15,12,45,Fail
Peter Pillai,07-03-2005,229592,Haryana,5,14,1,0,20,Fail
Ishaan Sharma,22-12-2004,767089,Gujarat,16,11,21,13,61,Fail
Yash Khan,03-04-2006,692752,Bihar,8,9,19,12,48,Fail
Farhan Mehta,14-09-2005,943803,Uttar Pradesh,20,4,0,21,45,Pass
Zaid Mehta,24-10-2005,898609,Bihar,7,13,13,2,35,Pass
Kunal Mehta,07-02-2006,537616,Maharashtra,9,4,2,22,37,Fail
Balbir Pillai,24-07-2005,753282,Nagaland,5,12,17,0,34,Pass
Kunal Sharma,13-01-2005,963697,Gujarat,21,11,22,10,64,Fail
Aarav Pillai,15-12-2004,238354,Punjab,21,13,8,0,42,Pass
Manpreet Fernandes,04-09-2005,917559,Delhi,1,24,1,24,50,Fail
Paul Pillai,02-07-2005,408436,Rajasthan,22,6,18,12,58,Pass
Yash Fernandes,20-05-2005,461117,Himachal Pradesh,14,17,15,2,48,Pass
Krishna Fernandes,16-12-2005,339519,Rajasthan,17,15,1,1,34,Pass
Aditya Khan,24-08-2005,994436,Uttar Pradesh,12,0,10,13,35,Pass
Raj Singh,26-11-2004,787080,Jharkhand,14,18,2,23,57,Pass
Rehan Reddy,24-06-2005,386862,Telangana,11,14,19,13,57,Fail
Yash Fernandes,14-12-2005,739509,Gujarat,18,22,13,4,57,Fail
Imran Chopra,11-09-2005,979434,Uttar Pradesh,4,8,23,16,51,Pass
Manpreet Reddy,16-02-2006,191906,Rajasthan,13,3,1,13,30,Pass
Aarav Pillai,22-02-2006,699480,Haryana,5,15,16,0,36,Fail
Yash D'Souza,13-12-2004,756213,Odisha,23,15,1,16,55,Fail
Sukhwinder Chopra,06-04-2005,137788,Uttar Pradesh,21,11,14,14,60,Pass
Yash Verma,02-12-2005,380794,Rajasthan,11,10,19,9,49,Pass
Aarav Fernandes,18-12-2004,668334,Uttarakhand,19,8,9,0,36,Fail
Sukhwinder Fernandes,09-04-2006,178733,Haryana,13,17,8,9,47,Fail
Paul Fernandes,01-06-2005,635308,Odisha,14,9,11,18,52,Fail
Sukhwinder Fernandes,31-10-2005,934080,Bihar,21,23,1,5,50,Fail
Yash Fernandes,05-10-2005,381043,Haryana,14,18,18,24,74,Fail
Rehan D'Souza,25-11-2004,847401,West Bengal,2,19,3,18,42,Pass
Rohan D'Souza,23-12-2005,423408,Jharkhand,8,9,20,14,51,Pass
Balbir Mehta,28-02-2006,805367,Madhya Pradesh,9,7,8,0,24,Fail
Kunal Verma,15-12-2004,197807,Uttar Pradesh,19,16,2,22,59,Pass
Rehan Khan,09-12-2004,828331,Bihar,2,17,0,16,35,Pass
Aditya Singh,18-02-2006,609788,Madhya Pradesh,21,23,3,14,61,Fail
Vivaan Verma,11-01-2005,870129,Uttar Pradesh,1,17,9,15,42,Pass
Aryan Chopra,09-01-2006,796008,Bihar,7,11,10,18,46,Fail
Krishna Sharma,12-11-2005,432452,Uttar Pradesh,0,14,6,10,30,Pass
Krishna D'Souza,10-03-2005,469547,Assam,5,0,21,23,49,Fail
Mathew Reddy,30-03-2006,445813,Andhra Pradesh,5,23,10,0,38,Fail
Raj Reddy,03-06-2005,168498,West Bengal,0,20,7,12,39,Pass
Aryan Fernandes,06-12-2004,654285,Uttar Pradesh,12,23,14,20,69,Pass
Kunal Verma,21-02-2006,902356,Punjab,24,8,9,17,58,Fail
Kunal Chopra,04-07-2005,468424,Bihar,16,4,1,14,35,Fail
Yash Fernandes,12-10-2005,544286,Madhya Pradesh,5,10,21,12,48,Fail
Yash Khan,17-12-2005,256147,Gujarat,9,23,0,1,33,Fail
Krishna Chopra,09-01-2005,367085,West Bengal,17,22,5,6,50,Pass
Sukhwinder Chopra,05-04-2006,920053,Madhya Pradesh,14,4,15,2,35,Fail
Rohan D'Souza,26-02-2005,759401,Tamil Nadu,17,6,23,18,64,Fail
Manpreet Chopra,25-03-2005,192540,Rajasthan,19,20,13,0,52,Pass
Aarav Pillai,01-05-2005,640896,Tamil Nadu,21,5,18,20,64,Fail
Vivaan D'Souza,19-11-2005,605755,Assam,10,1,15,0,26,Fail
Rehan Verma,30-11-2005,868260,Uttar Pradesh,1,24,24,18,67,Pass
Kunal Singh,07-07-2005,567392,Madhya Pradesh,3,8,20,2,33,Fail
Aarav Verma,04-08-2005,460549,West Bengal,10,1,5,8,24,Pass
Ishaan Singh,03-10-2005,115128,Uttar Pradesh,14,2,15,20,51,Pass
Yash Sharma,17-11-2004,981430,Uttar Pradesh,10,4,12,7,33,Pass
Raj Sharma,31-12-2004,732333,Telangana,1,18,9,16,44,Fail
Ishaan Verma,08-10-2005,398519,Rajasthan,12,12,0,15,39,Pass
Gurpreet Verma,04-03-2006,259033,Gujarat,11,12,13,11,47,Fail
Aryan Chopra,28-03-2005,946639,West Bengal,14,9,24,7,54,Pass
Rohan Pillai,09-11-2005,959674,Maharashtra,2,7,10,7,26,Fail
Raj Sharma,01-07-2005,283717,Bihar,4,21,23,1,49,Fail
Imran Singh,27-08-2005,658929,Madhya Pradesh,2,2,2,18,24,Fail
Raj Sharma,30-12-2004,685719,Andhra Pradesh,12,24,24,19,79,Fail
Krishna Reddy,29-01-2006,289860,Haryana,0,24,0,4,28,Fail
John Pillai,02-09-2005,988359,Tamil Nadu,3,12,7,21,43,Fail
Kunal Fernandes,22-04-2006,159904,Jammu & Kashmir + Ladakh,13,3,8,17,41,Pass
Aarav D'Souza,11-11-2005,168065,Madhya Pradesh,20,14,12,22,68,Fail
Manpreet D'Souza,21-01-2006,798459,Maharashtra,23,2,15,15,55,Fail
Rohan Verma,09-12-2005,164631,Tamil Nadu,13,20,7,12,52,Fail
Kunal Pillai,15-04-2006,427804,Bihar,2,5,3,2,12,Pass
Harjeet Verma,28-12-2004,506027,Meghalaya,6,1,8,11,26,Pass
Sukhwinder Pillai,29-01-2005,449243,Gujarat,13,17,18,18,66,Fail
John Fernandes,07-10-2005,681275,Tamil Nadu,17,17,13,23,70,Fail
Gurpreet D'Souza,14-04-2005,787807,Uttar Pradesh,11,22,10,12,55,Pass
Ishaan D'Souza,28-04-2006,969819,Arunachal Pradesh,12,5,24,13,54,Fail
Aarav Mehta,05-01-2005,890355,Madhya Pradesh,5,1,21,9,36,Fail
Paul Fernandes,18-03-2005,454391,Uttar Pradesh,15,8,17,13,53,Pass
David Mehta,18-12-2004,930081,Rajasthan,15,22,0,23,60,Fail
Gurpreet Singh,02-08-2005,102980,Odisha,8,24,10,7,49,Fail
Balbir Fernandes,05-04-2006,516723,Uttar Pradesh,1,23,18,2,44,Pass
Gurpreet Sharma,07-10-2005,387743,Uttar Pradesh,13,2,12,11,38,Pass
Rohan Mehta,02-01-2005,802920,Mizoram,1,1,13,15,30,Pass
Aryan Singh,11-11-2005,902634,Rajasthan,22,13,2,12,49,Pass
Krishna Pillai,11-04-2006,194854,Himachal Pradesh,13,3,11,1,28,Pass
Rohan Verma,16-12-2005,411134,Maharashtra,1,22,2,14,39,Fail
Manpreet Singh,25-03-2006,380965,Andaman & Nicobar,6,1,0,3,10,Pass
Ishaan Singh,04-06-2005,516396,Telangana,13,3,11,2,29,Fail
Vivaan Khan,25-02-2005,595188,Madhya Pradesh,18,3,13,19,53,Fail
Aryan Reddy,21-11-2004,735677,Karnataka,14,13,15,7,49,Pass
Vivaan Sharma,14-03-2005,254417,Madhya Pradesh,16,18,24,14,72,Fail
Ayaan Sharma,06-04-2005,702851,Telangana,13,0,12,24,49,Fail
Gurpreet Chopra,20-03-2005,916893,Punjab,7,11,5,9,32,Pass
Aditya D'Souza,25-02-2005,223548,Punjab,1,18,18,4,41,Pass
Paul D'Souza,25-02-2005,570198,Madhya Pradesh,10,17,10,0,37,Fail
Yash Mehta,31-08-2005,300275,Rajasthan,21,3,22,8,54,Pass
Aarav Chopra,05-01-2005,324221,Uttar Pradesh,10,18,23,0,51,Pass
Rehan D'Souza,08-09-2005,459491,Rajasthan,8,13,10,23,54,Pass
Kunal Verma,02-11-2005,219741,Maharashtra,12,8,0,9,29,Fail
Sukhwinder Sharma,05-02-2005,503586,Uttar Pradesh,2,19,5,1,27,Pass
Aarav Verma,23-09-2005,427255,Telangana,4,23,13,24,64,Fail
Rohan Pillai,28-12-2004,340671,Himachal Pradesh,1,7,11,7,26,Pass
Rohan Khan,30-04-2006,109312,West Bengal,16,3,20,10,49,Pass
Balbir Reddy,06-08-2005,649058,West Bengal,6,23,3,4,36,Pass
Aarav Verma,05-12-2005,986914,Bihar,0,10,18,24,52,Fail
Aditya Pillai,28-04-2005,566221,Gujarat,11,0,4,10,25,Fail
Vivaan Reddy,18-03-2005,219167,Andhra Pradesh,3,22,19,20,64,Fail
Yash Pillai,21-09-2005,234489,Bihar,6,7,4,1,18,Pass
Aryan Singh,13-05-2005,331142,West Bengal,2,13,22,0,37,Pass
Krishna Sharma,27-01-2006,235431,Haryana,1,1,10,17,29,Fail
Farhan Mehta,27-09-2005,236357,Mizoram,23,7,11,20,61,Fail
Aryan Mehta,09-02-2005,183414,Bihar,13,10,16,12,51,Fail
Rohan Reddy,18-02-2005,856781,Uttarakhand,19,0,11,10,40,Fail
Krishna Reddy,21-01-2005,131420,Telangana,3,14,5,19,41,Fail
Aditya Fernandes,09-01-2005,587855,Bihar,15,0,19,21,55,Fail
Ishaan Mehta,26-03-2006,556775,Uttar Pradesh,11,6,10,5,32,Pass
Raj D'Souza,09-02-2006,808359,Telangana,23,11,9,0,43,Fail
Gurpreet Verma,26-03-2006,609404,West Bengal,19,16,4,0,39,Pass
Aarav Pillai,24-01-2006,991356,Uttarakhand,18,4,13,23,58,Fail
Harjeet Verma,04-03-2005,886586,Rajasthan,9,20,1,1,31,Pass
Aarav Chopra,21-04-2005,145137,Assam,0,6,19,11,36,Fail
Ishaan D'Souza,10-05-2005,121953,Madhya Pradesh,10,3,12,9,34,Fail
Kunal Pillai,02-04-2006,533404,Jammu & Kashmir + Ladakh,14,20,6,20,60,Pass
Peter Chopra,20-12-2004,896937,Assam,15,19,14,18,66,Fail
Aryan Sharma,21-07-2005,917299,West Bengal,5,1,4,7,17,Pass
Ishaan Mehta,11-03-2005,145082,Jammu & Kashmir + Ladakh,3,15,6,21,45,Pass
Mathew Pillai,25-11-2005,574526,Jharkhand,10,0,16,6,32,Pass
Aditya Singh,21-02-2005,890954,Rajasthan,10,20,18,18,66,Fail
Raj Sharma,17-02-2006,124660,Haryana,2,19,8,2,31,Fail
David Fernandes,01-12-2004,336726,Kerala,12,0,8,23,43,Fail
John Pillai,17-04-2005,431100,Haryana,13,13,1,13,40,Fail
Harjeet Verma,22-12-2004,278478,Maharashtra,8,21,11,5,45,Fail
Vivaan Chopra,08-04-2006,842328,West Bengal,1,6,20,7,34,Pass
Aarav Chopra,14-03-2005,494312,Uttarakhand,21,15,19,20,75,Fail
Yash Mehta,06-05-2005,392198,Uttar Pradesh,12,3,17,22,54,Pass
Rohan Verma,28-03-2005,113619,Uttar Pradesh,18,18,10,22,68,Pass
Yash Pillai,06-09-2005,455120,Madhya Pradesh,6,7,4,8,25,Fail
Aditya Pillai,04-03-2005,812970,Kerala,19,16,1,13,49,Fail
Aryan Chopra,20-02-2006,295036,Telangana,9,4,3,10,26,Fail
Krishna Verma,20-11-2004,586214,Maharashtra,21,24,18,3,66,Fail
Rohan Pillai,24-12-2005,744288,Bihar,20,3,24,9,56,Fail
Raj Reddy,25-03-2006,609155,West Bengal,16,22,2,7,47,Pass
Krishna Fernandes,14-08-2005,769336,Uttar Pradesh,14,21,1,16,52,Pass
Paul Verma,11-03-2006,905716,Assam,14,13,20,23,70,Fail
Yash Sharma,14-12-2004,755765,Assam,19,14,13,0,46,Fail
Aryan Verma,31-12-2005,134019,Rajasthan,1,11,20,22,54,Pass
Gurpreet Reddy,03-09-2005,495202,Uttar Pradesh,15,9,11,6,41,Pass
Yash Sharma,06-02-2005,340471,Bihar,17,23,5,4,49,Fail
Vivaan D'Souza,19-01-2005,143049,Gujarat,23,17,14,2,56,Fail
Raj Mehta,06-01-2006,766331,Bihar,4,6,23,0,33,Pass
Yash Fernandes,14-05-2005,155310,Karnataka,23,10,21,0,54,Pass
Aarav Reddy,25-02-2006,667794,Rajasthan,18,15,4,22,59,Pass
Imran Sharma,13-05-2005,548902,Maharashtra,8,22,10,24,64,Fail
Manpreet Verma,21-03-2005,615283,West Bengal,15,3,20,12,50,Pass
Ishaan Reddy,03-09-2005,758412,Bihar,1,2,19,12,34,Pass
Aryan Verma,20-01-2006,197692,Bihar,12,16,15,22,65,Fail
Manpreet Verma,05-03-2005,909332,Himachal Pradesh,18,20,7,22,67,Pass
Aryan D'Souza,19-02-2005,507771,Uttar Pradesh,2,0,9,23,34,Pass
David Chopra,25-04-2006,821333,Bihar,4,21,19,13,57,Fail
Rohan Singh,18-04-2005,727543,Uttar Pradesh,6,9,7,5,27,Pass
Ishaan Reddy,03-03-2006,970684,Punjab,24,24,6,9,63,Fail
Paul Singh,20-02-2005,171476,Uttar Pradesh,17,9,5,11,42,Pass
Gurpreet Mehta,24-03-2006,697733,Maharashtra,11,2,1,17,31,Fail
Aarav Reddy,27-03-2005,371899,Kerala,17,8,24,23,72,Fail
John Singh,08-02-2005,891939,Bihar,7,5,4,21,37,Pass
Rohan Verma,05-10-2005,250597,Haryana,23,18,2,1,44,Fail
Balbir Pillai,28-01-2006,307692,Uttar Pradesh,5,16,10,3,34,Pass
Aryan Verma,02-02-2006,440982,Uttar Pradesh,19,10,23,11,63,Pass
Rohan Reddy,05-12-2004,851053,Haryana,8,0,22,21,51,Fail
Raj Singh,20-03-2006,316599,Jharkhand,14,4,8,0,26,Pass
Aditya Sharma,05-03-2005,116946,Andhra Pradesh,24,24,4,7,59,Fail
Aditya Pillai,01-07-2005,604163,Maharashtra,15,22,5,6,48,Fail
Aditya D'Souza,29-04-2005,210201,Madhya Pradesh,5,13,17,17,52,Fail
Vivaan Verma,02-12-2005,712184,Karnataka,24,12,13,23,72,Fail
Manpreet Chopra,05-03-2005,371654,Tamil Nadu,0,21,0,18,39,Pass
Aryan Chopra,21-05-2005,724124,Bihar,0,15,9,9,33,Pass
Rohan Verma,31-07-2005,579759,Rajasthan,22,8,13,11,54,Pass
Vivaan D'Souza,25-07-2005,925990,Gujarat,2,18,18,18,56,Fail
Rohan Fernandes,01-05-2005,647119,Andhra Pradesh,6,17,4,20,47,Fail
Aryan Verma,19-11-2004,978303,Chhattisgarh,21,23,22,18,84,Fail
John Pillai,27-02-2006,149960,Uttar Pradesh,19,11,21,8,59,Pass
Aditya Fernandes,07-09-2005,844376,Maharashtra,22,6,20,21,69,Fail
Raj Pillai,11-10-2005,126594,Tamil Nadu,1,10,18,11,40,Pass
Yash Reddy,08-05-2006,758685,Rajasthan,7,17,14,3,41,Pass
Aditya Khan,10-01-2006,248443,Maharashtra,24,5,14,15,58,Fail
Aarav Khan,06-09-2005,698833,Jharkhand,21,2,1,2,26,Pass
Aditya Reddy,01-05-2005,246371,Uttar Pradesh,5,23,3,1,32,Pass
Ishaan Fernandes,23-01-2006,553089,Madhya Pradesh,19,7,24,12,62,Fail
Harjeet Singh,12-06-2005,101657,Jharkhand,1,16,10,12,39,Pass
Gurpreet Mehta,04-09-2005,688179,Rajasthan,4,11,7,5,27,Pass
Aditya Chopra,21-05-2005,810836,Kerala,8,17,24,1,50,Fail
Aditya Verma,03-10-2005,438494,Bihar,16,3,6,13,38,Fail
Rohan Mehta,10-01-2006,262933,Uttar Pradesh,18,5,3,0,26,Pass
Aryan Khan,19-10-2005,494332,Madhya Pradesh,12,11,5,12,40,Fail
Rohan Mehta,30-11-2005,709718,Punjab,21,1,16,8,46,Fail
Balbir Reddy,12-12-2005,349010,Maharashtra,20,6,13,11,50,Fail
Raj Verma,10-09-2005,985467,Bihar,7,15,8,7,37,Pass
Kunal D'Souza,24-03-2006,736467,Tamil Nadu,15,12,10,19,56,Pass
Kunal Khan,04-02-2005,818105,West Bengal,20,3,3,23,49,Pass
Krishna Fernandes,17-04-2005,493522,Assam,22,6,18,2,48,Fail
Yash Pillai,06-01-2005,229981,Uttar Pradesh,14,10,18,16,58,Pass
Aarav Fernandes,09-06-2005,361970,Himachal Pradesh,1,16,15,5,37,Pass
Aditya Sharma,20-02-2005,992695,Uttar Pradesh,11,0,15,2,28,Pass
Balbir Reddy,12-06-2005,769978,Karnataka,9,22,2,13,46,Pass
Aryan Verma,17-02-2005,540655,Maharashtra,22,22,12,24,80,Fail
Mathew Singh,13-03-2005,570081,Rajasthan,8,4,1,15,28,Pass
Yash Fernandes,02-05-2005,211149,Delhi,1,12,0,6,19,Fail
Rohan Reddy,08-05-2005,116923,Punjab,12,0,19,6,37,Pass
Rohan Fernandes,04-11-2005,506427,Haryana,9,20,16,3,48,Fail
Balbir Singh,18-12-2005,303943,Maharashtra,23,14,23,2,62,Fail
Ishaan D'Souza,24-11-2004,336870,Jharkhand,13,8,13,23,57,Pass
Harjeet Pillai,25-10-2005,845806,Rajasthan,2,24,6,3,35,Pass
Ayaan Reddy,24-03-2005,257705,Madhya Pradesh,22,3,6,22,53,Fail
Harjeet Sharma,08-08-2005,614629,Delhi,14,20,3,11,48,Fail
Vivaan Verma,19-08-2005,466501,Uttar Pradesh,23,3,20,16,62,Pass
Kunal Verma,04-05-2006,304521,Uttar Pradesh,12,9,19,10,50,Pass
Aryan Pillai,26-02-2005,988205,Madhya Pradesh,8,9,4,1,22,Fail
Vivaan Reddy,08-12-2005,284815,Andhra Pradesh,8,20,15,9,52,Fail
Aarav Khan,05-06-2005,945670,Karnataka,20,15,9,12,56,Pass
Rohan Fernandes,22-05-2005,744765,Punjab,6,16,19,8,49,Fail
Aryan Sharma,14-03-2006,495630,Karnataka,18,7,12,15,52,Pass
Kunal Fernandes,16-03-2005,906952,Tamil Nadu,5,23,5,13,46,Fail
Aditya Pillai,06-11-2005,905947,Telangana,15,8,20,12,55,Fail
Peter D'Souza,24-01-2005,445257,Sikkim,5,20,14,6,45,Fail
Peter Singh,15-02-2006,780091,Uttar Pradesh,5,24,21,11,61,Pass
Farhan Khan,17-02-2006,390515,Tamil Nadu,24,15,12,22,73,Pass
Ishaan Fernandes,17-07-2005,406972,Maharashtra,21,10,8,23,62,Fail
Ishaan Pillai,22-06-2005,328463,Himachal Pradesh,0,6,19,19,44,Pass
Yash Mehta,25-06-2005,326805,Madhya Pradesh,22,2,16,12,52,Fail
Kunal Sharma,10-11-2005,867245,Uttarakhand,18,2,8,0,28,Fail
Raj Singh,27-03-2005,620705,West Bengal,14,12,9,13,48,Pass
Aditya Mehta,19-07-2005,730799,Tamil Nadu,17,3,14,0,34,Pass
Aryan Reddy,16-09-2005,553822,Karnataka,12,3,19,14,48,Pass
Aarav Sharma,08-04-2006,396621,Andhra Pradesh,14,8,0,21,43,Fail
Krishna Sharma,23-02-2005,445101,Rajasthan,24,3,17,24,68,Fail
Aditya Verma,02-12-2004,580260,Haryana,10,24,14,4,52,Fail
Aditya Pillai,21-04-2006,824351,Maharashtra,18,1,15,7,41,Fail
Rohan Chopra,27-07-2005,238977,Madhya Pradesh,17,0,20,1,38,Fail
Aditya D'Souza,12-10-2005,966456,Uttar Pradesh,20,22,6,20,68,Pass
Aditya Fernandes,06-03-2005,247239,Karnataka,7,8,14,24,53,Pass
Aditya Chopra,28-02-2006,231910,Bihar,10,16,6,10,42,Pass
David Khan,05-10-2005,103575,Assam,9,21,17,21,68,Fail
Krishna Mehta,28-12-2004,668013,Tamil Nadu,5,4,23,1,33,Pass
Raj Sharma,15-03-2005,244070,Tamil Nadu,21,8,10,5,44,Pass
Aryan Khan,31-03-2005,342257,Tamil Nadu,20,4,15,12,51,Pass
Rohan Singh,29-12-2004,954283,Delhi,10,24,11,1,46,Fail
Aryan Fernandes,03-12-2004,586742,Rajasthan,1,18,18,16,53,Pass
Peter Khan,22-11-2004,925794,Rajasthan,8,24,19,24,75,Fail
David Reddy,30-12-2005,955572,Uttar Pradesh,3,0,0,16,19,Pass
Aditya Sharma,05-12-2005,463154,Haryana,17,9,1,8,35,Fail
Aarav Sharma,05-11-2005,889375,Maharashtra,13,22,19,24,78,Fail
Ishaan Verma,19-06-2005,976265,Rajasthan,13,12,3,21,49,Pass
Krishna Mehta,06-02-2006,398879,Telangana,21,15,0,2,38,Fail
Ishaan Fernandes,02-02-2005,608804,Maharashtra,17,24,3,11,55,Fail
Yash Singh,24-02-2006,306544,Telangana,7,7,18,20,52,Fail
Aryan Mehta,03-01-2006,593956,Punjab,6,8,3,4,21,Pass
Aryan Pillai,24-12-2004,528136,Bihar,7,4,22,20,53,Fail
Ishaan Khan,09-01-2005,253239,Madhya Pradesh,24,0,0,1,25,Fail
Kunal Sharma,01-03-2005,969876,West Bengal,14,4,18,9,45,Pass
Aarav Reddy,21-12-2005,475431,Kerala,12,23,0,14,49,Fail
Raj Reddy,19-01-2006,711700,Uttar Pradesh,18,0,20,23,61,Pass
Aryan Reddy,21-02-2006,449568,Bihar,15,2,14,20,51,Fail
Yash Verma,11-10-2005,788378,Rajasthan,11,0,17,9,37,Pass
Vivaan Sharma,08-09-2005,182016,Punjab,24,19,5,24,72,Fail
Harjeet D'Souza,03-03-2005,390452,Uttar Pradesh,2,19,0,19,40,Pass
Raj D'Souza,05-01-2005,604032,Uttar Pradesh,11,4,10,24,49,Pass
Rohan Chopra,02-02-2005,602355,West Bengal,11,15,4,23,53,Pass
Mathew Verma,14-03-2006,433286,Madhya Pradesh,20,0,14,8,42,Fail
Vivaan Chopra,08-09-2005,135688,Assam,13,22,15,2,52,Fail
Peter Verma,19-10-2005,496670,Andhra Pradesh,4,16,24,13,57,Fail
Ishaan Singh,07-06-2005,266165,Bihar,2,3,9,5,19,Pass
Ishaan Khan,08-03-2005,742046,Uttar Pradesh,18,3,24,13,58,Pass
Aditya Reddy,05-03-2005,907469,Delhi,16,8,15,11,50,Fail
Vivaan Chopra,30-11-2005,350679,Uttar Pradesh,5,7,2,18,32,Pass
Peter Khan,30-10-2005,176108,Rajasthan,23,22,11,21,77,Pass
Raj Singh,23-11-2004,187553,Madhya Pradesh,18,4,17,10,49,Fail
Gurpreet Pillai,14-02-2006,113563,Haryana,9,1,14,5,29,Fail
Rohan Verma,10-04-2006,616162,Uttarakhand,14,4,1,21,40,Fail
Vivaan Fernandes,14-03-2006,111980,Bihar,7,2,3,1,13,Pass
Yash D'Souza,04-07-2005,576056,Andhra Pradesh,17,10,20,2,49,Fail
Vivaan Sharma,24-09-2005,805487,Delhi,7,24,22,20,73,Fail
Krishna Sharma,11-01-2006,146112,Uttar Pradesh,22,3,18,22,65,Pass
Krishna Verma,09-03-2005,142712,Uttar Pradesh,2,19,14,14,49,Pass
Gurpreet Reddy,19-05-2005,834561,Bihar,14,0,8,4,26,Pass
Aryan Verma,29-09-2005,813013,Odisha,13,7,17,3,40,Pass
Imran Reddy,30-12-2004,224743,Uttar Pradesh,16,6,21,8,51,Pass
David Sharma,15-11-2005,650599,Madhya Pradesh,13,24,10,17,64,Fail
Rohan Singh,23-06-2005,718533,Maharashtra,5,8,12,13,38,Fail
Aarav Verma,04-10-2005,121060,Maharashtra,1,1,8,19,29,Fail
Sukhwinder Fernandes,17-01-2005,148211,Gujarat,14,1,8,18,41,Fail
Sukhwinder Reddy,09-12-2005,385078,Haryana,10,15,12,15,52,Fail
Aditya Fernandes,20-11-2004,834948,West Bengal,17,12,23,0,52,Pass
Yash Mehta,22-02-2005,993940,Maharashtra,10,6,17,5,38,Fail
Ishaan Chopra,24-04-2006,521999,Kerala,0,13,13,15,41,Fail
Krishna Reddy,09-01-2005,350205,Madhya Pradesh,4,10,10,23,47,Fail
Krishna Pillai,24-03-2006,411721,Rajasthan,18,18,0,11,47,Pass
Vivaan D'Souza,04-07-2005,654183,Jammu & Kashmir + Ladakh,2,19,9,10,40,Pass
Peter Mehta,07-11-2005,452231,Meghalaya,14,22,19,24,79,Pass
Kunal Khan,03-02-2006,748355,Kerala,23,23,11,15,72,Fail
Vivaan Chopra,02-03-2006,769361,Andhra Pradesh,1,6,9,18,34,Fail
Manpreet Singh,20-02-2005,712143,Jharkhand,6,12,12,12,42,Pass
Aditya Singh,25-08-2005,302019,Andhra Pradesh,14,7,22,13,56,Fail
Aryan Khan,20-05-2005,100406,Madhya Pradesh,13,7,1,20,41,Fail
David Fernandes,08-12-2004,788658,Tamil Nadu,17,6,4,1,28,Pass
Kunal Fernandes,29-07-2005,512335,Meghalaya,9,14,7,6,36,Pass
Krishna Singh,04-03-2006,249824,Rajasthan,24,7,10,20,61,Fail
Aarav Singh,12-11-2004,740318,Assam,17,4,24,3,48,Fail
Aditya Mehta,26-03-2006,231573,West Bengal,10,3,21,19,53,Pass
Raj Khan,21-03-2006,940385,Tamil Nadu,10,8,16,9,43,Fail
Aditya Pillai,05-03-2006,996116,Rajasthan,13,24,22,5,64,Fail
Peter Fernandes,06-06-2005,196994,Rajasthan,19,15,11,10,55,Pass
Ishaan Verma,07-07-2005,769728,Jammu & Kashmir + Ladakh,0,7,21,17,45,Pass
Gurpreet Fernandes,02-04-2006,911928,Madhya Pradesh,16,22,14,22,74,Fail
Rohan Singh,07-03-2006,358576,Uttar Pradesh,9,19,16,10,54,Pass
Aryan Khan,08-12-2005,344857,Bihar,5,22,5,1,33,Pass
Ishaan Khan,01-07-2005,164935,Jharkhand,3,12,14,12,41,Pass
Yash Mehta,05-11-2005,891543,Mizoram,13,20,5,2,40,Pass
Krishna Reddy,03-02-2006,590549,Maharashtra,21,14,18,22,75,Fail
Peter Sharma,05-06-2005,849931,Bihar,4,16,1,6,27,Pass
Aditya Singh,14-10-2005,151776,Madhya Pradesh,10,2,17,16,45,Fail
Balbir Mehta,30-05-2005,614875,Meghalaya,4,3,22,7,36,Pass
Raj Reddy,04-02-2006,196771,Jharkhand,16,14,20,20,70,Fail
Aryan Mehta,27-06-2005,393125,Karnataka,0,0,13,3,16,Pass
Kunal Sharma,17-11-2005,971167,Bihar,23,10,7,8,48,Fail
Aarav D'Souza,08-10-2005,871250,Punjab,4,11,24,0,39,Pass
Aarav Khan,25-12-2004,336174,Uttar Pradesh,2,18,9,3,32,Pass
Aarav Reddy,03-05-2006,364516,West Bengal,0,17,22,14,53,Pass
Sukhwinder Chopra,26-03-2005,440721,Kerala,1,22,20,5,48,Fail
David Fernandes,23-08-2005,287688,Tamil Nadu,21,12,18,2,53,Fail
David Fernandes,29-11-2004,382869,Uttar Pradesh,11,18,9,9,47,Pass
Vivaan Mehta,15-03-2006,625717,West Bengal,6,5,2,16,29,Pass
Vivaan Reddy,20-10-2005,612184,Bihar,0,15,20,6,41,Pass
Farhan Fernandes,16-10-2005,376957,Uttar Pradesh,17,13,12,11,53,Pass
Raj Singh,10-07-2005,183976,Andhra Pradesh,9,10,1,24,44,Fail
Yash Singh,15-04-2006,321017,Uttar Pradesh,14,22,16,13,65,Pass
Aditya Verma,27-04-2006,106471,West Bengal,24,3,16,17,60,Pass
Vivaan Chopra,05-12-2004,919780,Assam,20,21,6,0,47,Fail
Rohan Chopra,26-06-2005,354750,Tamil Nadu,10,9,18,23,60,Pass
Yash Sharma,04-07-2005,926912,Assam,19,23,2,2,46,Fail
David Mehta,13-03-2006,795660,Andhra Pradesh,10,12,3,22,47,Fail
Yash Singh,14-04-2006,812575,Uttar Pradesh,22,8,11,7,48,Pass
Peter Chopra,04-10-2005,877131,Haryana,18,18,0,0,36,Fail
Ishaan Khan,25-11-2004,801476,Uttar Pradesh,22,16,22,0,60,Pass
Manpreet Sharma,07-09-2005,427675,Bihar,2,7,12,3,24,Pass
Balbir D'Souza,21-11-2004,900440,Maharashtra,3,23,3,14,43,Fail
Aditya Pillai,27-03-2006,668819,Uttar Pradesh,11,1,14,15,41,Pass
Krishna Verma,13-05-2005,724143,Tamil Nadu,23,10,14,17,64,Fail
Aarav Verma,10-08-2005,149160,Gujarat,21,1,3,23,48,Fail
Aarav Sharma,29-04-2005,246562,Maharashtra,11,13,19,7,50,Fail
Gurpreet Verma,24-11-2005,738011,Uttar Pradesh,18,17,13,7,55,Pass
Ishaan D'Souza,03-05-2005,304933,Punjab,4,19,11,12,46,Fail
Rohan Verma,31-03-2006,471914,Andhra Pradesh,10,5,20,22,57,Fail
Aryan D'Souza,23-03-2005,385445,Karnataka,13,21,2,8,44,Pass
Raj Mehta,24-03-2005,140412,Haryana,16,2,2,15,35,Fail
Aditya Verma,01-11-2005,557706,West Bengal,3,11,24,1,39,Pass
Ishaan Singh,07-12-2004,658240,Assam,0,20,15,21,56,Fail
Harjeet Khan,08-02-2006,189183,Haryana,16,20,21,2,59,Fail
Ishaan Reddy,02-10-2005,813306,Tamil Nadu,22,10,19,0,51,Pass
Aditya Pillai,02-09-2005,753091,Rajasthan,18,0,0,3,21,Pass
Raj Verma,03-01-2006,306230,Maharashtra,24,14,19,4,61,Fail
Raj Reddy,31-12-2004,725479,Andhra Pradesh,11,17,15,8,51,Fail
Aarav Singh,17-01-2005,322509,Chhattisgarh,20,18,17,22,77,Fail
Paul Sharma,14-12-2005,100219,Punjab,6,23,13,16,58,Fail
Rohan Verma,09-12-2004,530941,Telangana,4,15,1,3,23,Fail
Aryan Singh,03-07-2005,864956,Gujarat,17,1,9,0,27,Fail
Raj Fernandes,28-01-2006,545486,Andhra Pradesh,24,24,22,17,87,Fail
Kunal Fernandes,22-08-2005,147867,Jammu & Kashmir + Ladakh,19,16,7,7,49,Pass
Rohan Pillai,15-01-2006,816288,Punjab,15,24,24,7,70,Fail
Raj Mehta,17-01-2005,931327,Chhattisgarh,13,15,10,20,58,Fail
Yash Verma,17-09-2005,517801,Daman & Diu / D&N Haveli,14,15,22,13,64,Fail
John Chopra,30-01-2005,786178,Maharashtra,17,23,17,0,57,Fail
Vivaan Verma,27-05-2005,618479,Punjab,2,8,7,15,32,Pass
Aryan Pillai,31-03-2005,146215,Himachal Pradesh,1,2,11,23,37,Pass
Raj Pillai,26-03-2005,823916,Madhya Pradesh,9,0,2,7,18,Fail
Yash Fernandes,07-01-2006,248375,Gujarat,15,15,16,11,57,Fail
Rohan Verma,16-12-2004,271891,Bihar,15,16,5,20,56,Fail
Kunal Fernandes,06-01-2006,894645,Punjab,20,8,7,13,48,Fail
Vivaan Sharma,02-03-2005,407224,Bihar,21,7,1,2,31,Pass
Aditya Reddy,23-12-2004,472849,Gujarat,13,20,14,20,67,Fail
Gurpreet Verma,04-06-2005,752233,Andhra Pradesh,2,1,12,6,21,Fail
Peter Singh,10-03-2006,709345,Karnataka,9,21,24,10,64,Pass
Aditya Reddy,30-12-2005,604672,Gujarat,0,3,3,3,9,Fail
Imran Sharma,05-02-2005,599473,Uttar Pradesh,7,23,13,8,51,Pass
Raj Sharma,24-12-2004,625826,Tamil Nadu,13,10,10,9,42,Pass
Gurpreet Mehta,19-06-2005,206221,Bihar,7,15,3,7,32,Pass
Manpreet Reddy,23-02-2005,121538,Telangana,21,4,7,13,45,Fail
Vivaan Mehta,15-01-2005,382783,Karnataka,2,5,8,12,27,Pass
Aditya Fernandes,09-08-2005,686251,Bihar,6,9,19,23,57,Fail
Manpreet Khan,11-07-2005,485526,Punjab,22,17,4,7,50,Fail
Vivaan Singh,27-07-2005,159735,Uttar Pradesh,15,3,9,7,34,Pass
Vivaan Mehta,24-03-2006,926965,Telangana,20,20,1,7,48,Fail
Raj Sharma,28-11-2005,399795,Gujarat,14,10,10,21,55,Fail
Yash Reddy,02-09-2005,335950,Tamil Nadu,14,13,14,5,46,Fail
Gurpreet Sharma,21-02-2006,675598,Bihar,19,1,23,11,54,Fail
Raj Fernandes,10-10-2005,413662,Assam,22,10,0,5,37,Fail
Aditya Mehta,27-06-2005,688147,Rajasthan,8,19,8,18,53,Pass
Gurpreet Khan,10-02-2006,136464,Tripura,20,10,7,10,47,Fail
Aryan Reddy,15-08-2005,781746,Puducherry,10,0,6,21,37,Pass
Rohan Khan,03-02-2005,779358,Punjab,2,23,8,20,53,Fail
Aarav Khan,21-04-2006,560932,Delhi,6,9,21,6,42,Fail
Kunal Pillai,15-01-2006,348243,Punjab,11,10,22,24,67,Fail
Gurpreet Sharma,12-10-2005,841583,Punjab,18,13,6,20,57,Fail
Yash Pillai,16-10-2005,138634,Gujarat,0,21,24,14,59,Fail
Aryan Singh,28-02-2006,959243,Uttarakhand,5,7,11,4,27,Fail
Raj Verma,12-04-2005,677998,Bihar,20,12,22,0,54,Fail
Aryan D'Souza,12-09-2005,794720,Uttar Pradesh,6,8,24,1,39,Pass
John D'Souza,10-10-2005,945956,Gujarat,22,10,8,23,63,Fail
Raj Pillai,02-04-2006,373069,Punjab,20,5,7,6,38,Pass
Balbir Chopra,22-02-2005,598076,Odisha,23,8,21,6,58,Fail
Aditya Chopra,02-12-2004,142557,Andhra Pradesh,22,7,20,14,63,Fail
Ishaan Singh,29-04-2005,488704,Bihar,15,6,19,10,50,Fail
Ayaan Chopra,23-05-2005,647574,Himachal Pradesh,16,6,13,17,52,Pass
Ishaan Chopra,18-11-2004,111784,Uttar Pradesh,11,24,1,16,52,Pass
Gurpreet Verma,03-01-2005,463504,Uttar Pradesh,23,3,24,22,72,Pass
Vivaan Fernandes,01-03-2005,411578,Kerala,9,7,17,17,50,Fail
Vivaan Verma,17-09-2005,840846,Punjab,4,10,10,9,33,Pass
Peter Verma,24-01-2006,660989,Rajasthan,4,17,18,22,61,Fail
Yash Sharma,16-02-2006,878288,Madhya Pradesh,19,24,21,19,83,Fail
Aarav Verma,18-10-2005,666872,Bihar,17,22,18,3,60,Fail
David Chopra,05-11-2005,517734,Telangana,7,20,13,22,62,Fail
Aarav Khan,17-06-2005,780428,West Bengal,21,21,9,0,51,Pass
Vivaan Mehta,13-05-2005,524055,West Bengal,6,23,5,9,43,Pass
Aarav Singh,08-02-2005,595565,Maharashtra,11,13,15,18,57,Fail
Ayaan Mehta,17-11-2004,429056,Telangana,22,13,9,10,54,Fail
Aditya Mehta,03-04-2006,475441,Maharashtra,13,15,7,19,54,Fail
Peter D'Souza,02-09-2005,479583,Maharashtra,1,2,1,19,23,Fail
Aryan Khan,28-11-2005,797152,Karnataka,21,5,19,14,59,Pass
David Khan,24-11-2005,153624,Uttar Pradesh,13,22,7,19,61,Pass
Harjeet Khan,07-05-2005,557032,Madhya Pradesh,6,9,10,5,30,Fail
Mathew Sharma,06-04-2005,673332,Gujarat,22,7,15,24,68,Fail
Vivaan Verma,22-04-2006,433035,Assam,16,24,18,13,71,Fail
Kunal Mehta,30-05-2005,333757,Tamil Nadu,11,5,23,10,49,Fail
Yash Singh,30-12-2004,454792,Rajasthan,2,4,7,13,26,Pass
Krishna Mehta,03-09-2005,413837,Haryana,0,14,11,7,32,Fail
Aryan D'Souza,30-03-2005,659874,Gujarat,4,16,1,4,25,Fail
Rohan Verma,30-04-2006,430859,Uttar Pradesh,21,0,16,0,37,Pass
Sukhwinder Singh,02-03-2006,391054,Madhya Pradesh,15,9,1,1,26,Fail
Krishna Mehta,11-01-2006,631249,Uttar Pradesh,21,3,21,23,68,Pass
Rohan Reddy,04-04-2005,780488,Rajasthan,11,0,17,9,37,Pass
Ishaan Reddy,23-08-2005,256421,Rajasthan,13,24,19,23,79,Pass
Vivaan Pillai,17-03-2005,475421,Madhya Pradesh,14,22,4,3,43,Fail
Aditya D'Souza,19-11-2005,632279,Jammu & Kashmir + Ladakh,24,17,23,22,86,Fail
Raj Verma,28-04-2005,801020,Rajasthan,7,18,3,8,36,Pass
John Mehta,10-04-2006,632752,Madhya Pradesh,22,17,16,19,74,Fail
Kunal Khan,14-05-2005,868924,Andhra Pradesh,13,11,20,23,67,Fail
Sukhwinder Pillai,12-02-2006,308437,West Bengal,19,3,9,16,47,Pass
Gurpreet Chopra,22-04-2005,652281,Uttar Pradesh,4,24,12,14,54,Pass
Yash Reddy,05-04-2005,535859,Telangana,16,15,3,23,57,Fail
Rohan Singh,23-03-2006,967935,Haryana,19,24,4,16,63,Fail
Ayaan Fernandes,09-09-2005,931406,West Bengal,9,3,3,3,18,Pass
Kunal Chopra,20-02-2006,943189,Chhattisgarh,15,0,7,2,24,Fail
Yash Singh,11-03-2006,433338,Delhi,24,17,15,10,66,Fail
Raj Mehta,11-12-2005,121340,Rajasthan,13,2,17,18,50,Pass
Aditya Chopra,18-01-2006,299976,Bihar,0,18,22,23,63,Fail
Rohan Pillai,22-03-2005,603416,Karnataka,23,11,21,24,79,Fail
Yash D'Souza,10-04-2006,387471,Madhya Pradesh,4,8,3,22,37,Fail
Peter Singh,17-04-2005,705899,Gujarat,7,8,21,6,42,Fail
Harjeet D'Souza,09-07-2005,580931,Bihar,20,17,22,8,67,Fail
Ayaan Singh,02-06-2005,457209,Maharashtra,16,18,11,13,58,Fail
Kunal Pillai,20-12-2005,901932,Telangana,2,18,19,15,54,Fail
Balbir Pillai,21-11-2004,514195,Uttar Pradesh,9,3,5,17,34,Pass
Rohan Pillai,14-12-2005,734602,Maharashtra,18,9,0,5,32,Fail
Mathew Verma,06-02-2006,581387,Gujarat,16,13,7,0,36,Fail
Peter Reddy,19-11-2005,254932,Sikkim,8,6,0,5,19,Fail
Aryan Chopra,28-12-2004,157168,Jharkhand,9,17,10,21,57,Pass
Aryan Singh,23-11-2005,487389,Telangana,20,3,18,18,59,Fail
Krishna D'Souza,21-04-2006,150595,West Bengal,3,18,5,6,32,Pass
Aditya Reddy,25-12-2004,523031,Karnataka,15,9,1,3,28,Pass
Aarav Khan,07-06-2005,636718,Madhya Pradesh,3,7,0,6,16,Fail
Aditya Mehta,10-04-2006,181120,Chhattisgarh,8,3,7,4,22,Fail
Aarav Verma,01-12-2004,793684,Daman & Diu / D&N Haveli,15,16,13,13,57,Fail
Rohan Mehta,12-02-2006,330314,Tripura,24,22,8,0,54,Fail
Kunal Mehta,21-03-2006,884695,Uttar Pradesh,19,24,14,2,59,Pass
Aarav Khan,09-03-2005,114578,Madhya Pradesh,3,12,10,3,28,Fail
Raj D'Souza,23-12-2005,469072,Jharkhand,3,5,12,14,34,Pass
Rohan Khan,13-04-2005,524070,Karnataka,4,12,20,23,59,Pass
Kunal Sharma,09-05-2006,542151,Karnataka,16,16,3,8,43,Pass
Rohan Sharma,20-03-2006,994698,Haryana,2,3,1,5,11,Fail
Rohan Chopra,21-02-2006,343441,Maharashtra,1,14,24,13,52,Fail
Yash Mehta,27-09-2005,768499,Uttar Pradesh,14,8,11,21,54,Pass
Aryan Verma,13-03-2005,563991,Gujarat,23,12,4,1,40,Fail
Vivaan Pillai,06-02-2005,245628,Rajasthan,17,1,0,13,31,Pass
Vivaan Mehta,23-11-2004,184893,Odisha,5,20,4,17,46,Fail
Krishna Singh,11-10-2005,442796,Madhya Pradesh,21,4,12,10,47,Fail
Aryan Fernandes,09-06-2005,149566,Chhattisgarh,1,11,13,14,39,Fail
Ayaan D'Souza,11-07-2005,899598,Uttar Pradesh,14,10,10,13,47,Pass
Rohan Khan,29-08-2005,771207,Andhra Pradesh,15,5,16,16,52,Fail
Harjeet Chopra,24-03-2005,648513,Kerala,18,16,4,10,48,Fail
Harjeet Sharma,30-01-2005,888575,Rajasthan,1,12,12,23,48,Pass
Aditya Pillai,26-07-2005,138805,Tamil Nadu,3,22,1,24,50,Fail
Vivaan Pillai,18-12-2005,717741,Assam,24,17,16,18,75,Fail
Vivaan Verma,11-08-2005,392631,Karnataka,14,1,22,2,39,Pass
Aditya Khan,11-03-2005,830980,Rajasthan,7,4,6,18,35,Pass
Krishna Singh,06-10-2005,349185,Bihar,12,23,24,1,60,Fail
Harjeet Pillai,06-11-2005,772477,Jammu & Kashmir + Ladakh,2,23,24,17,66,Pass
Krishna Mehta,01-09-2005,636435,Gujarat,2,18,2,22,44,Fail
Gurpreet Chopra,31-01-2006,739894,Chhattisgarh,10,24,16,14,64,Fail
Kunal Pillai,12-11-2005,791340,Punjab,24,11,17,17,69,Fail
Manpreet Pillai,14-12-2004,574706,Tamil Nadu,8,5,10,2,25,Pass
Harjeet Fernandes,17-09-2005,225334,Uttarakhand,22,22,5,20,69,Fail
Vivaan Reddy,14-03-2005,944627,Uttar Pradesh,10,18,19,19,66,Pass
Vivaan Khan,17-02-2005,562772,Jharkhand,8,14,0,3,25,Pass
Krishna Sharma,02-03-2005,710561,Karnataka,16,4,16,6,42,Pass
Mathew Khan,27-02-2006,543507,Madhya Pradesh,6,5,15,9,35,Fail
Kunal Mehta,20-06-2005,837259,Odisha,2,8,21,2,33,Pass
Aditya Chopra,28-01-2006,487343,Bihar,3,19,18,0,40,Pass
Yash Fernandes,05-05-2005,525718,Rajasthan,4,24,23,17,68,Fail
Ishaan Fernandes,23-07-2005,851847,Maharashtra,18,20,1,5,44,Fail
Yash Pillai,15-11-2005,496681,Punjab,6,20,13,12,51,Fail
Ishaan D'Souza,24-01-2006,974233,Tamil Nadu,3,15,19,17,54,Fail
John Pillai,10-04-2006,432774,Haryana,8,18,24,13,63,Fail
Aarav Reddy,26-04-2005,704957,Chhattisgarh,0,12,21,0,33,Fail
Aarav Mehta,10-04-2005,264605,Madhya Pradesh,12,17,8,9,46,Fail
David Verma,27-01-2006,872201,Haryana,18,15,11,18,62,Fail
Rohan Sharma,11-09-2005,238226,Tamil Nadu,18,0,19,17,54,Fail
Yash D'Souza,08-11-2004,390746,Punjab,24,24,9,16,73,Fail
Aditya Pillai,05-05-2005,681343,Uttar Pradesh,24,3,23,15,65,Pass
Gurpreet Singh,12-02-2006,884626,West Bengal,7,10,13,7,37,Pass
Balbir Reddy,07-04-2005,423811,Madhya Pradesh,0,10,11,16,37,Fail
Manpreet Chopra,16-03-2006,778111,Rajasthan,2,1,14,1,18,Pass
Kunal Verma,23-04-2006,928551,Nagaland,13,3,20,6,42,Pass
Kunal Pillai,10-02-2005,734510,Uttar Pradesh,17,0,12,11,40,Pass
Manpreet Khan,19-06-2005,270979,Maharashtra,17,20,20,22,79,Fail
Rohan Fernandes,17-12-2005,973288,Assam,10,8,2,18,38,Fail
Ishaan Pillai,02-05-2005,976026,Bihar,3,6,1,23,33,Pass
Krishna Verma,06-04-2005,763175,Bihar,4,9,18,8,39,Pass
Aarav Fernandes,26-02-2005,165982,Haryana,23,9,13,15,60,Fail
Ishaan Chopra,05-02-2006,593016,Maharashtra,19,23,7,17,66,Fail
Krishna D'Souza,11-01-2005,323325,Madhya Pradesh,16,4,15,15,50,Fail
Mathew Chopra,03-08-2005,337011,Andhra Pradesh,9,16,13,21,59,Fail
Harjeet Mehta,09-01-2005,525374,Delhi,12,12,11,19,54,Fail
Kunal Khan,24-08-2005,522596,Andhra Pradesh,6,5,4,7,22,Fail
Kunal Khan,15-04-2006,799693,Jammu & Kashmir + Ladakh,11,22,7,16,56,Pass
Rehan D'Souza,16-06-2005,620558,Uttarakhand,0,15,3,0,18,Fail
Mathew Singh,11-11-2004,860504,Assam,7,8,24,3,42,Fail
John Mehta,13-10-2005,783003,Chhattisgarh,19,6,1,21,47,Fail
Aryan Singh,17-12-2004,964245,West Bengal,4,2,17,12,35,Pass
Kunal Reddy,12-07-2005,308124,Haryana,18,13,16,18,65,Fail
Vivaan Singh,02-05-2006,459581,Delhi,6,17,6,4,33,Fail
Peter D'Souza,16-10-2005,486911,Uttar Pradesh,10,1,17,15,43,Pass
Krishna Pillai,21-01-2006,800058,Tripura,3,16,7,17,43,Fail
Gurpreet Sharma,12-07-2005,894283,Jammu & Kashmir + Ladakh,14,12,3,6,35,Pass
Aditya Fernandes,07-03-2005,193753,Madhya Pradesh,13,9,16,18,56,Fail
Aditya Pillai,11-11-2005,172477,Bihar,23,11,6,22,62,Fail
Mathew Verma,09-10-2005,545875,Madhya Pradesh,11,2,15,17,45,Fail
Raj Singh,05-01-2005,246385,Maharashtra,7,12,21,18,58,Fail
Harjeet Fernandes,21-04-2006,931242,Maharashtra,13,22,12,2,49,Fail
Sukhwinder Pillai,26-05-2005,334713,Madhya Pradesh,21,15,9,2,47,Fail
Aditya Reddy,12-10-2005,502331,Punjab,11,4,10,19,44,Pass
Raj Singh,09-06-2005,819686,Bihar,19,14,15,13,61,Fail
Raj Reddy,17-01-2005,473229,Uttarakhand,0,7,24,16,47,Fail
Aarav Fernandes,20-02-2005,866343,Rajasthan,14,16,20,13,63,Fail
Manpreet Verma,10-01-2005,482200,Uttar Pradesh,1,3,24,18,46,Pass
Aditya Chopra,02-04-2005,505516,Tamil Nadu,21,21,6,11,59,Pass
Farhan Verma,10-02-2006,525696,Uttar Pradesh,3,2,13,2,20,Pass
Aditya Pillai,17-07-2005,608289,Madhya Pradesh,0,10,8,13,31,Fail
Aryan Reddy,10-03-2006,885007,Delhi,23,1,17,0,41,Fail
Ishaan Fernandes,11-11-2004,337435,Delhi,15,19,18,18,70,Fail
Yash Singh,11-08-2005,493046,Telangana,24,14,22,21,81,Fail
Krishna Reddy,03-04-2006,706842,Bihar,11,14,19,6,50,Fail
Raj Khan,05-02-2005,986660,Karnataka,8,6,15,9,38,Pass
Krishna D'Souza,01-04-2006,242107,Gujarat,22,21,15,22,80,Fail
Aditya Reddy,30-11-2005,490475,Madhya Pradesh,4,5,16,14,39,Fail
Aarav Singh,01-12-2005,865496,Karnataka,9,9,4,12,34,Pass
Vivaan Sharma,04-01-2006,595036,Haryana,9,22,24,19,74,Fail
Aarav Singh,12-01-2006,843009,Jammu & Kashmir + Ladakh,17,5,5,14,41,Pass
Manpreet D'Souza,09-08-2005,281753,Karnataka,11,7,8,9,35,Pass
Harjeet Fernandes,25-06-2005,894981,Tamil Nadu,15,24,7,4,50,Fail
David Sharma,06-03-2005,630943,Delhi,15,7,23,0,45,Fail
Peter Pillai,27-05-2005,929125,Rajasthan,21,22,8,7,58,Pass
John Reddy,05-04-2005,164713,Maharashtra,8,20,6,12,46,Fail
Vivaan D'Souza,28-11-2004,343834,Uttarakhand,9,3,14,21,47,Fail
Rohan Reddy,05-03-2006,204128,Maharashtra,0,4,15,14,33,Fail
Rohan Verma,09-04-2006,386078,Bihar,20,22,8,4,54,Fail
Ishaan Reddy,18-05-2005,632616,Karnataka,21,7,22,5,55,Pass
John Mehta,02-12-2004,268118,Uttar Pradesh,1,2,9,16,28,Pass
Rohan Pillai,01-06-2005,434709,Bihar,7,22,23,2,54,Fail
Raj Fernandes,18-04-2006,626941,Maharashtra,11,11,17,24,63,Fail
Ishaan Mehta,11-11-2005,640143,Delhi,14,21,11,5,51,Fail
Aditya Fernandes,09-04-2006,188588,West Bengal,13,3,10,24,50,Pass
Rohan Mehta,22-06-2005,598568,Uttar Pradesh,3,3,19,6,31,Pass
Gurpreet Reddy,19-09-2005,423818,West Bengal,12,1,11,2,26,Pass
Aditya Mehta,28-04-2005,947779,Rajasthan,19,0,2,15,36,Pass
Aditya Singh,30-08-2005,625814,Punjab,11,10,21,14,56,Fail
Yash Fernandes,11-12-2005,739280,Rajasthan,16,23,7,8,54,Pass
Aryan Pillai,16-08-2005,385593,Maharashtra,17,23,9,19,68,Fail
Peter Mehta,21-04-2005,481046,Andhra Pradesh,12,0,2,18,32,Fail
Raj Reddy,20-05-2005,201088,Bihar,12,4,5,2,23,Pass
Manpreet Reddy,06-12-2005,841686,Uttar Pradesh,23,19,12,6,60,Pass
Balbir Khan,14-03-2005,980043,Tamil Nadu,8,14,21,24,67,Fail
David Singh,25-10-2005,482539,Maharashtra,16,21,24,18,79,Fail
Vivaan Mehta,04-06-2005,408385,Rajasthan,12,19,13,17,61,Fail
Sukhwinder Mehta,21-10-2005,608015,Chhattisgarh,12,24,8,0,44,Fail
Rohan Sharma,01-01-2006,146671,Gujarat,21,3,5,2,31,Fail
Rehan Verma,05-11-2005,818330,Rajasthan,19,7,0,12,38,Pass
Rohan Fernandes,01-11-2005,988697,Maharashtra,6,3,15,6,30,Fail
Rohan Mehta,21-04-2006,808395,Gujarat,14,15,2,24,55,Fail
Yash Sharma,04-09-2005,603077,Madhya Pradesh,20,20,1,23,64,Fail
Kunal Reddy,30-04-2006,240639,Rajasthan,4,24,12,9,49,Pass
Vivaan Mehta,13-04-2006,443205,Madhya Pradesh,19,24,16,10,69,Fail
Rohan Mehta,11-01-2005,584668,Bihar,11,0,9,4,24,Pass
David Verma,06-11-2005,993947,Jharkhand,23,4,23,8,58,Pass
Yash Singh,08-02-2006,368523,Odisha,0,13,11,17,41,Pass
Kunal Mehta,03-12-2004,687049,Bihar,11,11,24,16,62,Fail
David Mehta,26-01-2006,507112,Rajasthan,20,18,20,6,64,Fail
Krishna Mehta,13-08-2005,994806,Andhra Pradesh,10,20,14,13,57,Fail
Farhan D'Souza,10-03-2006,727828,Rajasthan,14,16,24,7,61,Fail
Aarav Khan,17-05-2005,324823,Tamil Nadu,20,24,11,5,60,Pass
Raj Sharma,24-03-2005,584374,Kerala,12,21,16,14,63,Fail
Ayaan Pillai,05-03-2005,323826,Haryana,15,16,22,19,72,Fail
Kunal Singh,17-02-2006,828460,Meghalaya,9,21,13,7,50,Fail
Raj Verma,10-01-2006,598518,Maharashtra,5,14,13,14,46,Fail
Ishaan Verma,23-10-2005,680504,Tamil Nadu,5,10,9,7,31,Pass
Vivaan Mehta,15-10-2005,183853,Bihar,9,1,17,22,49,Fail
Sukhwinder D'Souza,22-12-2005,455215,Punjab,13,20,18,18,69,Fail
Ayaan Singh,30-01-2006,122106,Nagaland,8,4,7,1,20,Pass
Paul Fernandes,05-03-2005,966904,Uttar Pradesh,19,1,11,17,48,Pass
Yash Reddy,02-04-2006,905459,Madhya Pradesh,9,16,12,1,38,Fail
Ayaan Chopra,01-03-2005,835513,Jharkhand,4,9,6,16,35,Pass
Kunal Singh,01-10-2005,384301,Uttar Pradesh,8,18,0,16,42,Pass
Ayaan Singh,13-12-2005,191741,Chhattisgarh,13,5,12,13,43,Fail
Vivaan D'Souza,17-07-2005,979557,Gujarat,10,11,24,11,56,Fail
Sukhwinder Pillai,02-01-2005,725390,Uttar Pradesh,15,10,5,23,53,Pass
Balbir Khan,06-10-2005,589341,Karnataka,9,14,17,6,46,Pass
Aditya Khan,03-05-2005,241225,Assam,2,0,7,5,14,Fail
Manpreet Mehta,31-10-2005,161111,Maharashtra,1,0,11,0,12,Fail
Raj Verma,09-11-2005,876242,Jharkhand,0,6,16,23,45,Pass
Yash Verma,28-11-2004,714973,West Bengal,2,21,9,2,34,Pass
Rohan Chopra,22-12-2005,718633,Karnataka,3,6,0,21,30,Pass
Ishaan Pillai,22-05-2005,715168,Uttar Pradesh,18,15,9,5,47,Pass
Rohan D'Souza,24-03-2005,728396,Andhra Pradesh,6,22,6,21,55,Fail
Aryan Chopra,02-04-2005,852764,Gujarat,1,1,14,14,30,Fail
Raj Singh,20-05-2005,958051,Tamil Nadu,18,17,3,6,44,Pass
Yash Fernandes,07-07-2005,397076,Tamil Nadu,9,23,1,2,35,Pass
Yash Pillai,20-11-2005,539035,Uttar Pradesh,1,17,16,24,58,Pass
Aarav D'Souza,31-01-2006,275056,Madhya Pradesh,14,7,6,4,31,Fail
Manpreet Sharma,24-05-2005,511517,Gujarat,17,22,24,20,83,Fail
Vivaan Mehta,13-11-2005,176509,Delhi,3,21,14,20,58,Fail
Gurpreet Sharma,22-03-2006,571277,Arunachal Pradesh,11,6,8,4,29,Fail
Aditya Singh,19-01-2006,290257,Uttar Pradesh,15,22,14,14,65,Pass
Rohan Verma,02-05-2005,448276,Rajasthan,21,23,13,23,80,Pass
Ayaan Sharma,28-12-2005,930836,Maharashtra,5,14,17,18,54,Fail
Aarav Pillai,18-04-2005,565357,Chhattisgarh,17,3,14,2,36,Fail
David Khan,27-10-2005,790564,Bihar,15,10,5,2,32,Pass
Gurpreet Singh,22-06-2005,654263,Maharashtra,9,2,8,15,34,Fail
Balbir Pillai,14-05-2005,141678,Gujarat,5,13,0,13,31,Fail
Zaid Pillai,12-03-2006,385939,Andhra Pradesh,12,12,3,19,46,Fail
Manpreet Mehta,30-12-2005,519147,Bihar,20,11,21,11,63,Fail
Sukhwinder Verma,20-07-2005,103736,Bihar,4,14,15,17,50,Fail
Balbir Verma,07-10-2005,192155,Madhya Pradesh,21,22,10,21,74,Fail
Aryan Singh,16-04-2005,504763,Rajasthan,6,5,12,2,25,Pass
Krishna Pillai,05-02-2005,498115,Rajasthan,0,18,20,8,46,Pass
Vivaan Pillai,18-12-2005,738137,Maharashtra,20,4,6,15,45,Fail
Aarav Reddy,17-11-2005,112244,Uttarakhand,11,11,12,3,37,Fail
Krishna Sharma,23-03-2005,557087,Madhya Pradesh,10,10,4,3,27,Fail
Kunal Reddy,19-11-2005,595273,Punjab,6,11,10,7,34,Pass
Aditya Singh,16-07-2005,757740,Punjab,12,9,6,20,47,Fail
Balbir Singh,08-01-2006,403535,Bihar,15,3,9,22,49,Fail
John Mehta,06-03-2006,458351,Haryana,20,0,6,4,30,Fail
Ayaan Sharma,23-05-2005,653010,Rajasthan,9,13,9,23,54,Pass
Manpreet Mehta,12-01-2006,782775,Madhya Pradesh,14,19,22,18,73,Fail
Gurpreet Singh,26-11-2005,947562,Punjab,16,8,2,15,41,Pass
Yash Sharma,23-05-2005,296111,Gujarat,19,24,12,15,70,Fail
Aryan Reddy,29-05-2005,416797,Delhi,5,4,1,18,28,Fail
Yash Mehta,11-12-2004,623739,Uttar Pradesh,8,1,7,13,29,Pass
Harjeet Sharma,24-04-2006,502472,Assam,15,1,24,17,57,Fail
Ishaan Singh,31-12-2005,353919,Rajasthan,10,15,22,16,63,Fail
Rohan Khan,10-11-2004,738813,Puducherry,13,22,17,13,65,Fail
Yash Mehta,30-01-2005,860989,Rajasthan,11,20,18,17,66,Fail
Kunal Sharma,18-06-2005,849437,Punjab,20,13,15,10,58,Fail
Balbir D'Souza,14-04-2006,762207,West Bengal,23,4,15,0,42,Pass
Balbir Sharma,20-12-2004,554028,Haryana,12,5,23,16,56,Fail
Kunal Singh,12-01-2005,592579,Haryana,8,7,12,5,32,Fail
Kunal Chopra,21-06-2005,784877,Jharkhand,13,5,6,2,26,Pass
Ishaan Singh,16-03-2006,100596,Andhra Pradesh,21,19,5,5,50,Fail
Krishna D'Souza,14-09-2005,450334,Maharashtra,21,20,8,17,66,Fail
Imran Pillai,14-11-2004,586489,Chhattisgarh,8,6,7,5,26,Fail
Aryan D'Souza,19-04-2005,216808,West Bengal,1,12,20,1,34,Pass
Aditya Mehta,23-11-2004,658148,Jharkhand,1,20,10,24,55,Pass
Krishna Reddy,30-10-2005,791624,West Bengal,20,3,5,16,44,Pass
Aditya Fernandes,31-10-2005,914329,Jharkhand,1,23,3,20,47,Pass
Gurpreet Fernandes,09-05-2005,633920,Bihar,16,13,8,6,43,Pass
Ishaan Sharma,29-05-2005,700249,Rajasthan,3,20,23,19,65,Fail
Krishna Sharma,08-04-2006,219339,Himachal Pradesh,3,0,23,17,43,Pass
Krishna Reddy,18-04-2005,649955,Andhra Pradesh,13,13,1,23,50,Fail
David Pillai,30-06-2005,813368,Tamil Nadu,3,6,21,1,31,Pass
Krishna Sharma,02-09-2005,967307,Punjab,19,14,16,10,59,Fail
Aditya Verma,08-09-2005,569433,Gujarat,0,15,8,1,24,Fail
Aryan D'Souza,10-07-2005,159748,West Bengal,14,3,11,19,47,Pass
Kunal Pillai,23-02-2005,306962,Madhya Pradesh,24,4,8,2,38,Fail
Yash Fernandes,30-01-2005,970517,Odisha,15,20,0,20,55,Fail
Manpreet Sharma,04-12-2004,109839,Haryana,10,16,11,5,42,Fail
Krishna Sharma,22-09-2005,179141,Kerala,11,9,1,15,36,Fail
Rohan Fernandes,11-10-2005,872918,Uttar Pradesh,24,13,9,3,49,Pass
Mathew Pillai,27-02-2005,260900,Manipur,23,6,11,9,49,Fail
Balbir Sharma,24-04-2006,135972,Tamil Nadu,7,14,13,12,46,Fail
Gurpreet Reddy,30-10-2005,854967,Chhattisgarh,16,3,2,4,25,Fail
Ishaan Sharma,14-01-2005,593871,Odisha,13,0,12,10,35,Pass
Rohan Chopra,13-04-2006,839863,Madhya Pradesh,3,5,8,1,17,Fail
Peter D'Souza,16-09-2005,592899,West Bengal,14,12,4,24,54,Pass
Rohan Khan,16-12-2005,992857,West Bengal,18,3,18,20,59,Pass
Krishna Verma,05-04-2005,282384,Bihar,7,13,11,17,48,Fail
Ayaan Singh,19-03-2006,342433,West Bengal,24,3,0,24,51,Pass
Ayaan Fernandes,31-10-2005,946405,Uttar Pradesh,12,19,8,1,40,Pass
Sukhwinder Chopra,06-03-2006,399250,Madhya Pradesh,15,12,7,23,57,Fail
Kunal Reddy,02-01-2005,613064,Uttar Pradesh,16,24,19,4,63,Pass
Raj Verma,19-05-2005,904902,Telangana,10,13,4,18,45,Fail
Krishna Sharma,20-01-2005,611802,Jammu & Kashmir + Ladakh,7,15,8,20,50,Pass
Gurpreet Chopra,15-09-2005,570633,Andhra Pradesh,1,11,13,20,45,Fail
Krishna Singh,19-08-2005,519731,Maharashtra,11,7,23,15,56,Fail
Kunal D'Souza,08-01-2005,773564,Meghalaya,2,24,3,15,44,Pass
Rohan Mehta,04-02-2005,529736,West Bengal,6,0,5,0,11,Pass
Manpreet Sharma,16-12-2005,370018,Jharkhand,17,0,17,19,53,Pass
Raj D'Souza,02-04-2005,954397,Rajasthan,9,18,8,17,52,Pass
Krishna Chopra,26-10-2005,734004,Bihar,23,3,22,0,48,Fail
Raj Pillai,31-08-2005,683353,Uttarakhand,0,7,14,24,45,Fail
Kunal D'Souza,21-02-2006,227924,Punjab,8,7,10,17,42,Pass
Yash Verma,17-04-2006,425558,Uttar Pradesh,0,19,17,20,56,Pass
Aryan Fernandes,10-06-2005,180613,Punjab,21,23,22,7,73,Fail
Yash D'Souza,07-12-2004,664810,Maharashtra,22,17,17,20,76,Fail
Krishna Khan,09-11-2004,906394,Punjab,14,0,12,23,49,Fail
Aarav Fernandes,09-07-2005,403640,Maharashtra,17,19,14,18,68,Fail
Kunal Khan,17-02-2005,995949,Bihar,1,12,11,2,26,Pass
Harjeet Chopra,28-04-2005,498332,Rajasthan,5,22,16,7,50,Pass
Zaid Chopra,05-03-2006,989764,Chhattisgarh,11,0,18,18,47,Fail
Krishna Sharma,26-12-2004,752980,Tamil Nadu,3,7,17,21,48,Fail
Yash Mehta,13-12-2005,272386,Chhattisgarh,7,5,10,7,29,Fail
Aditya Reddy,22-08-2005,169712,Madhya Pradesh,16,20,12,11,59,Fail
Krishna Sharma,18-03-2005,947198,Jharkhand,1,23,18,16,58,Pass
Harjeet D'Souza,10-12-2005,899786,Manipur,1,1,0,6,8,Fail
Rohan Verma,01-09-2005,868145,Bihar,4,20,17,2,43,Pass
Raj D'Souza,24-03-2005,217165,West Bengal,23,3,15,12,53,Pass
Krishna Khan,20-01-2006,345455,Andhra Pradesh,0,2,7,4,13,Fail
Aarav Khan,24-11-2004,684144,Uttar Pradesh,1,4,6,7,18,Pass
Aryan Khan,29-12-2004,645803,Madhya Pradesh,22,22,6,7,57,Fail
Balbir Mehta,27-03-2005,885240,Haryana,21,9,19,8,57,Fail
Raj Khan,09-12-2004,253407,Chhattisgarh,14,0,21,18,53,Fail
Mathew Sharma,14-04-2006,650992,Haryana,1,19,6,5,31,Fail
Ayaan Chopra,27-05-2005,282325,Gujarat,24,17,6,12,59,Fail
Vivaan Reddy,06-01-2006,387475,Bihar,8,19,15,15,57,Fail
Gurpreet Chopra,03-07-2005,799905,Maharashtra,19,9,18,20,66,Fail
Aarav Singh,20-06-2005,865658,Madhya Pradesh,5,22,11,4,42,Fail
Sukhwinder Sharma,06-01-2005,614920,Jammu & Kashmir + Ladakh,17,21,19,14,71,Fail
Aditya Sharma,11-04-2005,428117,Haryana,3,0,19,10,32,Fail
Harjeet Singh,30-12-2004,374167,Tamil Nadu,16,14,18,20,68,Fail
Aryan Fernandes,11-08-2005,349419,Bihar,13,15,19,17,64,Fail
Rohan Singh,17-12-2005,278378,Punjab,14,0,12,24,50,Fail
Aditya Sharma,20-06-2005,713685,Tamil Nadu,9,15,12,23,59,Pass
Aditya Pillai,06-01-2006,728212,West Bengal,8,13,16,12,49,Pass
Raj Chopra,26-04-2006,520011,Rajasthan,19,11,19,7,56,Pass
Yash Khan,21-03-2006,300976,Bihar,12,18,0,6,36,Pass
Aryan Mehta,31-08-2005,571426,Uttar Pradesh,18,3,24,23,68,Pass
Harjeet Khan,05-03-2006,267782,Uttar Pradesh,11,18,4,1,34,Pass
Rohan Fernandes,13-02-2006,801392,Karnataka,5,11,21,21,58,Pass
Harjeet Pillai,09-10-2005,202407,Uttarakhand,12,24,19,20,75,Fail
Yash Khan,23-05-2005,501985,Maharashtra,0,9,17,20,46,Fail
Krishna Mehta,13-04-2005,894281,Gujarat,24,13,1,8,46,Fail
Rehan Singh,28-11-2005,125392,Bihar,17,18,24,7,66,Fail
David Mehta,31-03-2005,522928,Maharashtra,7,11,12,9,39,Fail
Kunal Mehta,16-11-2005,401033,Madhya Pradesh,23,14,14,4,55,Fail
David Chopra,13-03-2006,615681,Himachal Pradesh,19,10,20,10,59,Pass
Aryan Reddy,24-04-2005,459051,Gujarat,4,6,12,21,43,Fail
Peter Fernandes,17-01-2005,292310,Uttar Pradesh,3,23,24,13,63,Pass
Yash Chopra,04-01-2006,705035,Maharashtra,23,5,3,1,32,Fail
David Khan,21-04-2006,526782,Tamil Nadu,17,22,16,12,67,Fail
Raj D'Souza,22-08-2005,587273,Gujarat,5,19,5,24,53,Fail
Mathew Mehta,28-02-2006,641840,Maharashtra,1,19,18,9,47,Fail
Paul Khan,07-10-2005,732769,Punjab,21,15,22,4,62,Fail
Yash Chopra,01-12-2005,310853,Rajasthan,13,8,6,3,30,Pass
Balbir Khan,17-05-2005,513286,Rajasthan,11,9,22,1,43,Pass
Aryan Singh,25-11-2004,283369,Rajasthan,12,24,17,1,54,Pass
Ayaan Mehta,04-07-2005,734714,Jammu & Kashmir + Ladakh,1,16,2,21,40,Pass
Ishaan Khan,25-02-2006,315117,Karnataka,0,2,3,15,20,Pass
Paul Fernandes,29-03-2005,800031,Punjab,17,18,20,23,78,Pass
Ishaan Reddy,09-12-2005,318914,Punjab,21,16,1,6,44,Pass
Rohan Chopra,05-12-2005,438121,Bihar,18,15,10,20,63,Fail
Raj Singh,19-12-2004,935275,Uttar Pradesh,19,14,3,11,47,Pass
Ishaan Khan,03-07-2005,756764,Rajasthan,9,12,21,18,60,Fail
Yash D'Souza,28-03-2006,746265,Kerala,21,19,22,3,65,Fail
Ishaan Singh,26-03-2005,142045,Rajasthan,12,12,20,4,48,Pass
Aryan D'Souza,13-10-2005,703026,Maharashtra,4,20,8,13,45,Fail
Aarav Reddy,13-10-2005,144593,Uttar Pradesh,19,1,13,16,49,Pass
Rohan Reddy,12-10-2005,201378,Telangana,22,17,18,4,61,Fail
Raj Khan,16-01-2006,967280,Madhya Pradesh,19,23,22,6,70,Fail
Aryan Singh,26-10-2005,904514,Assam,19,22,10,15,66,Fail
Zaid Mehta,12-07-2005,329484,Tamil Nadu,13,21,12,21,67,Fail
Rohan Chopra,02-03-2006,535698,Rajasthan,3,8,24,20,55,Pass
David D'Souza,03-03-2006,308882,Madhya Pradesh,11,17,15,6,49,Fail
Ishaan Mehta,28-01-2005,617361,West Bengal,19,3,21,22,65,Pass
Vivaan Verma,15-04-2006,660700,Odisha,1,23,6,3,33,Pass
Aarav Pillai,12-02-2006,682558,Uttar Pradesh,11,23,11,16,61,Pass
Ishaan Singh,19-09-2005,471201,West Bengal,1,6,3,0,10,Pass
Rohan Verma,29-09-2005,152717,Uttar Pradesh,18,8,24,13,63,Pass
Yash Khan,08-05-2005,632073,Assam,12,4,1,10,27,Fail
Zaid Reddy,07-10-2005,220721,Rajasthan,24,23,17,12,76,Pass
Kunal Singh,23-06-2005,614146,Telangana,23,24,12,21,80,Fail
Aditya Verma,06-03-2006,363895,Odisha,13,21,17,22,73,Fail
Aarav Chopra,08-05-2005,541761,Himachal Pradesh,0,16,8,6,30,Pass
Ishaan Khan,21-02-2005,833677,Telangana,14,18,9,1,42,Fail
Kunal Chopra,06-03-2006,950714,Haryana,17,6,18,23,64,Fail
Balbir Singh,01-07-2005,866256,Jammu & Kashmir + Ladakh,16,4,4,23,47,Pass
Gurpreet Verma,20-04-2006,172485,Assam,23,3,16,5,47,Fail
Ishaan D'Souza,09-04-2005,469884,Rajasthan,4,19,8,3,34,Pass
Yash Mehta,19-02-2006,520632,Bihar,14,16,18,19,67,Fail
Peter Singh,28-03-2006,976908,Bihar,7,2,7,18,34,Pass
Aditya Reddy,20-12-2005,751087,Chhattisgarh,16,17,0,20,53,Fail
Aditya Mehta,21-03-2006,510636,Assam,12,2,19,23,56,Fail
Kunal Sharma,02-11-2005,994290,Maharashtra,6,9,22,14,51,Fail
Aarav Fernandes,17-04-2005,940042,Tamil Nadu,23,15,3,21,62,Pass
Yash Reddy,13-03-2006,786362,Punjab,18,24,2,5,49,Fail
Ishaan Reddy,07-08-2005,296692,Punjab,20,21,10,14,65,Fail
Rohan Sharma,29-12-2004,982121,Rajasthan,24,17,21,10,72,Fail
Zaid Khan,18-10-2005,845406,Punjab,23,15,5,7,50,Fail
Kunal Chopra,11-04-2006,133420,Rajasthan,18,8,17,12,55,Pass
Aditya Reddy,25-12-2004,280152,Himachal Pradesh,14,4,17,1,36,Pass
Yash Fernandes,22-09-2005,365145,Tamil Nadu,16,14,18,18,66,Pass
Rohan Pillai,17-11-2004,645260,Tamil Nadu,13,1,3,21,38,Pass
Kunal Pillai,28-03-2005,914755,Uttarakhand,12,13,3,2,30,Fail
Rehan Khan,24-03-2005,607833,Jharkhand,8,19,16,14,57,Pass
Sukhwinder Khan,03-05-2005,914722,Bihar,1,11,17,19,48,Fail
Sukhwinder Pillai,04-02-2006,100761,Jharkhand,17,5,14,15,51,Pass
Manpreet Chopra,19-11-2004,590196,Himachal Pradesh,4,16,17,17,54,Pass
Yash Mehta,07-05-2006,575570,Uttar Pradesh,15,14,4,7,40,Pass
Vivaan Pillai,05-01-2005,861523,Gujarat,2,6,5,22,35,Fail
Gurpreet D'Souza,15-12-2005,453135,Himachal Pradesh,0,4,11,3,18,Pass
Mathew Mehta,10-01-2005,441637,Delhi,1,7,20,4,32,Fail
Yash Singh,25-05-2005,194313,Bihar,8,23,11,13,55,Fail
Raj Reddy,09-10-2005,730787,Tamil Nadu,20,7,5,9,41,Pass
Yash D'Souza,10-03-2005,400778,Telangana,14,9,2,3,28,Fail
Ishaan Chopra,03-08-2005,588803,Madhya Pradesh,22,16,5,16,59,Fail
Manpreet Verma,20-02-2005,665367,Bihar,2,2,12,0,16,Pass
Kunal Verma,20-05-2005,300042,Jammu & Kashmir + Ladakh,10,5,6,15,36,Pass
Ishaan Chopra,01-12-2005,495567,Telangana,12,5,1,2,20,Fail
Aditya Pillai,01-03-2005,780389,Bihar,23,3,14,15,55,Fail
Manpreet Khan,03-12-2004,652926,Tamil Nadu,0,16,13,6,35,Pass
David D'Souza,15-11-2005,974252,Uttar Pradesh,7,15,20,13,55,Pass
Yash Mehta,06-11-2005,747916,West Bengal,12,3,17,19,51,Pass
Gurpreet Singh,19-12-2005,942312,West Bengal,22,3,19,22,66,Pass
Aditya Khan,23-01-2005,704259,Uttarakhand,0,18,1,18,37,Fail
Rohan Mehta,13-05-2005,292397,Himachal Pradesh,10,10,23,17,60,Pass
Aryan Mehta,21-12-2004,418046,Punjab,22,0,14,10,46,Fail
Krishna Pillai,22-04-2006,383865,Uttar Pradesh,13,15,4,6,38,Pass
Kunal D'Souza,06-03-2005,711050,Madhya Pradesh,23,5,9,19,56,Fail
Aarav Mehta,15-02-2005,761369,Uttar Pradesh,17,0,15,7,39,Pass
Krishna D'Souza,29-11-2005,253060,Madhya Pradesh,15,4,13,24,56,Fail
Harjeet Chopra,01-01-2005,300519,Punjab,0,7,7,21,35,Pass
Raj Sharma,03-06-2005,439670,Rajasthan,15,0,15,24,54,Pass
Raj Sharma,03-01-2005,213687,Chhattisgarh,12,24,0,12,48,Fail
Raj Sharma,09-09-2005,445933,Uttarakhand,8,10,5,6,29,Fail
Aarav Singh,04-04-2006,593202,Uttar Pradesh,8,3,15,5,31,Pass
Balbir Khan,10-08-2005,543163,Maharashtra,12,21,5,10,48,Fail
Aditya D'Souza,07-12-2004,106956,Haryana,18,22,2,5,47,Fail
Aditya Singh,04-12-2004,658629,West Bengal,11,10,6,20,47,Pass
Paul Verma,10-02-2005,522894,Uttar Pradesh,9,7,15,5,36,Pass
Kunal Singh,06-04-2005,583274,Andhra Pradesh,3,17,19,23,62,Fail
Raj Fernandes,08-03-2005,614566,Uttar Pradesh,4,1,21,18,44,Pass
Rohan Pillai,25-02-2006,657333,Uttar Pradesh,0,4,4,20,28,Pass
Harjeet Singh,24-08-2005,385677,Maharashtra,10,2,4,2,18,Fail
Krishna Pillai,16-07-2005,216079,Punjab,20,15,5,10,50,Fail
Manpreet Fernandes,21-04-2005,549919,Bihar,19,23,8,20,70,Fail
Sukhwinder Khan,16-12-2005,108403,Uttar Pradesh,12,13,24,4,53,Pass
Yash Pillai,04-09-2005,514757,Bihar,22,13,2,20,57,Fail
Ayaan Verma,23-07-2005,931753,Uttarakhand,17,2,18,19,56,Fail
Vivaan Singh,06-05-2006,632587,Tamil Nadu,11,13,20,3,47,Pass
Yash Khan,22-02-2005,999397,Gujarat,2,24,4,6,36,Fail
Yash D'Souza,29-10-2005,772663,Rajasthan,16,7,22,16,61,Fail
Manpreet Fernandes,28-04-2005,580203,Madhya Pradesh,8,2,6,6,22,Fail
Krishna Reddy,14-12-2005,913372,Rajasthan,9,17,11,4,41,Pass
Aarav Verma,17-05-2005,686752,Maharashtra,7,23,5,2,37,Fail
Aarav Reddy,31-01-2005,172258,Bihar,20,23,13,3,59,Fail
Vivaan Fernandes,26-11-2004,602837,Uttar Pradesh,20,12,9,22,63,Pass
Mathew Fernandes,29-04-2006,443114,Delhi,24,1,11,20,56,Fail
Vivaan Reddy,21-07-2005,134401,Rajasthan,24,16,14,13,67,Fail
Rohan Singh,10-02-2006,810263,Himachal Pradesh,5,5,21,5,36,Fail
Yash Mehta,05-03-2005,885865,Uttar Pradesh,2,21,7,9,39,Pass
Aarav Sharma,13-03-2006,232209,Jharkhand,16,2,24,18,60,Pass
Yash Fernandes,07-10-2005,316746,Rajasthan,22,9,3,8,42,Pass
David Singh,15-07-2005,769760,Bihar,9,3,8,20,40,Fail
Krishna Sharma,07-03-2005,645034,Rajasthan,19,8,18,4,49,Pass
Yash Reddy,12-02-2006,481947,Uttar Pradesh,23,12,5,19,59,Pass
Aarav Verma,11-06-2005,644878,Uttar Pradesh,11,0,10,10,31,Pass
Zaid Pillai,23-06-2005,306135,West Bengal,13,24,3,13,53,Pass
Ayaan Khan,30-12-2005,230712,Uttar Pradesh,13,2,11,15,41,Pass
Ishaan Fernandes,17-12-2005,974771,Maharashtra,8,15,16,11,50,Fail
Aarav Mehta,30-12-2005,763043,Chhattisgarh,5,23,12,23,63,Fail
Ishaan D'Souza,16-02-2005,707120,Punjab,11,5,22,16,54,Fail
Harjeet Verma,27-04-2005,788393,Maharashtra,21,13,8,10,52,Fail
Manpreet Khan,09-06-2005,504897,Andhra Pradesh,6,17,15,24,62,Fail
Harjeet Chopra,08-01-2005,582740,Delhi,14,6,16,22,58,Fail
Mathew Singh,14-10-2005,495304,Rajasthan,0,15,1,13,29,Pass
Yash Chopra,19-04-2006,973391,Kerala,8,20,10,6,44,Fail
Sukhwinder Reddy,17-07-2005,931459,Maharashtra,2,3,4,0,9,Fail
Vivaan Singh,25-02-2005,605064,Bihar,19,14,15,16,64,Fail
Aditya Pillai,30-04-2006,534372,Gujarat,11,16,19,14,60,Fail
Krishna Reddy,28-08-2005,281143,Bihar,5,17,14,0,36,Pass
Ishaan Pillai,18-12-2004,228530,Gujarat,3,20,14,16,53,Fail
David Verma,16-07-2005,644188,Madhya Pradesh,8,10,0,6,24,Fail
Kunal Mehta,08-12-2005,820236,Karnataka,14,20,23,22,79,Fail
Aarav D'Souza,29-07-2005,149891,Madhya Pradesh,11,15,10,6,42,Fail
Rohan Singh,08-12-2005,739299,West Bengal,5,24,10,8,47,Pass
Rohan Khan,21-04-2005,452068,Rajasthan,10,8,17,5,40,Pass
Aditya Reddy,12-03-2005,217632,Haryana,4,8,19,11,42,Fail
Raj Mehta,21-10-2005,742570,Gujarat,19,14,12,3,48,Fail
Aryan Verma,20-11-2004,870324,Tamil Nadu,11,4,0,21,36,Pass
Harjeet D'Souza,20-04-2006,734317,Rajasthan,9,4,17,14,44,Pass
Raj Chopra,24-01-2005,289047,Punjab,17,13,24,7,61,Fail
Vivaan D'Souza,29-01-2006,188489,Rajasthan,22,5,9,11,47,Pass
Aditya Singh,15-10-2005,253702,Andaman & Nicobar,23,19,6,15,63,Pass
Aarav Chopra,31-12-2005,541113,Rajasthan,22,3,1,20,46,Pass
Raj Chopra,29-06-2005,448795,Andaman & Nicobar,4,14,23,6,47,Pass
Rohan Pillai,04-08-2005,883064,Rajasthan,8,17,13,22,60,Fail
Imran Reddy,19-01-2005,631924,Rajasthan,9,5,13,1,28,Pass
Aryan Singh,12-04-2005,550418,Madhya Pradesh,11,21,8,9,49,Fail
Yash Fernandes,18-09-2005,905746,Gujarat,11,13,5,21,50,Fail
Kunal Khan,08-11-2005,668039,West Bengal,21,7,1,17,46,Pass
Zaid Khan,16-04-2005,513828,Odisha,9,24,2,3,38,Pass
Rohan Reddy,08-05-2006,328700,Gujarat,11,3,2,9,25,Fail
Krishna Khan,06-04-2006,401189,Haryana,20,5,21,3,49,Fail
Krishna Reddy,21-07-2005,260291,Manipur,20,12,24,4,60,Fail
Vivaan Mehta,26-01-2005,876727,Assam,17,23,16,24,80,Fail
Aditya Chopra,01-09-2005,499326,Jammu & Kashmir + Ladakh,18,1,13,23,55,Pass
Harjeet D'Souza,30-01-2005,265531,Tamil Nadu,20,10,16,2,48,Fail
Vivaan Pillai,06-11-2005,764544,Delhi,20,11,8,14,53,Fail
Paul Verma,23-05-2005,762726,Bihar,22,14,23,23,82,Fail
Peter Pillai,27-11-2004,606074,Bihar,15,3,14,9,41,Pass
Vivaan Sharma,18-12-2005,823901,Bihar,15,1,11,5,32,Pass
Vivaan Khan,20-03-2006,423866,Punjab,10,9,1,15,35,Pass
Yash Sharma,04-01-2006,734311,Odisha,13,2,7,11,33,Pass
Vivaan Khan,19-08-2005,750720,Uttar Pradesh,22,23,4,21,70,Pass
Kunal Singh,08-02-2006,593481,Nagaland,2,19,13,7,41,Pass
Rohan Verma,22-11-2005,802092,Tripura,18,9,2,1,30,Fail
Manpreet Singh,17-02-2006,804996,Maharashtra,9,3,12,0,24,Fail
Aditya Pillai,22-12-2004,908921,Uttar Pradesh,3,14,24,24,65,Pass
Aditya Fernandes,21-04-2005,726172,Chhattisgarh,0,4,14,9,27,Fail
Krishna Reddy,23-01-2005,861010,Tamil Nadu,14,10,24,7,55,Fail
Imran D'Souza,11-08-2005,750606,Rajasthan,13,11,18,24,66,Fail
Yash D'Souza,26-05-2005,441758,Gujarat,13,2,7,9,31,Fail
Vivaan Singh,11-12-2005,947690,Uttar Pradesh,1,17,23,20,61,Pass
Ishaan Singh,11-04-2006,815231,Madhya Pradesh,24,21,6,3,54,Fail
Harjeet Sharma,30-01-2006,377009,Rajasthan,16,6,20,9,51,Pass
Ishaan Reddy,15-11-2005,880602,Tamil Nadu,2,18,21,3,44,Pass
Aryan Reddy,10-11-2004,599075,Gujarat,3,3,6,4,16,Fail
Paul Khan,16-02-2005,889346,Uttar Pradesh,6,21,14,9,50,Pass
Raj Verma,16-01-2005,496143,Bihar,20,12,10,0,42,Pass
Krishna Khan,10-02-2005,138822,Chhattisgarh,0,1,19,13,33,Fail
Aditya Verma,17-02-2005,216423,Sikkim,0,17,19,4,40,Fail
Yash Chopra,07-02-2006,466992,Punjab,6,24,12,12,54,Fail
Raj Fernandes,29-07-2005,780370,Uttar Pradesh,18,12,21,12,63,Pass
Raj Khan,05-12-2004,384242,Madhya Pradesh,3,24,8,13,48,Fail
Peter Sharma,14-05-2005,859375,Maharashtra,21,18,16,21,76,Fail
Aditya Reddy,20-07-2005,897165,Rajasthan,9,7,23,22,61,Fail
Vivaan Chopra,04-11-2005,924106,Bihar,24,15,22,18,79,Fail
Mathew Singh,02-11-2005,368875,Uttar Pradesh,2,3,14,10,29,Pass
Vivaan Pillai,10-11-2005,290773,Manipur,16,22,20,4,62,Fail
Kunal Fernandes,17-09-2005,341826,Maharashtra,2,20,22,9,53,Fail
Aditya Chopra,06-02-2006,658545,Telangana,7,11,5,13,36,Fail
Aryan Fernandes,08-12-2004,486510,Punjab,3,6,11,19,39,Pass
Krishna Pillai,03-03-2006,648315,Madhya Pradesh,8,3,12,7,30,Fail
Vivaan Singh,10-03-2006,651367,Uttar Pradesh,6,7,8,18,39,Pass
Sukhwinder Pillai,04-11-2005,884971,Uttar Pradesh,13,6,10,16,45,Pass
Yash Pillai,15-08-2005,469168,Bihar,13,3,22,12,50,Fail
Ayaan D'Souza,03-09-2005,402403,Maharashtra,14,23,24,2,63,Fail
Aditya Sharma,07-06-2005,678857,Uttar Pradesh,11,16,19,15,61,Pass
Yash Mehta,10-05-2005,716344,Rajasthan,3,20,11,3,37,Pass
Krishna D'Souza,13-01-2006,227067,Karnataka,7,13,9,24,53,Pass
Harjeet Sharma,25-06-2005,143524,Andhra Pradesh,21,14,19,15,69,Fail
Rohan Singh,05-05-2005,177786,Bihar,23,0,0,10,33,Pass
John Chopra,08-11-2005,595279,Maharashtra,18,6,5,9,38,Fail
Krishna Fernandes,20-03-2005,712330,Rajasthan,15,4,23,20,62,Fail
Ishaan Singh,05-03-2005,819333,Madhya Pradesh,21,7,10,18,56,Fail
Aryan Fernandes,12-11-2004,231986,Uttar Pradesh,8,10,2,23,43,Pass
Yash Reddy,28-12-2004,499161,Punjab,20,12,13,14,59,Fail
Aditya Pillai,23-04-2006,935867,Gujarat,19,0,20,11,50,Fail
Ishaan Mehta,21-03-2005,463946,Bihar,13,11,8,21,53,Fail
Raj Fernandes,21-01-2005,901281,Bihar,22,10,17,2,51,Fail
Aryan Sharma,07-03-2005,259535,Bihar,10,3,5,22,40,Fail
Aarav Mehta,14-01-2005,518723,Tamil Nadu,21,22,8,23,74,Pass
Zaid Verma,23-10-2005,401497,Madhya Pradesh,1,3,0,21,25,Fail
Ayaan D'Souza,29-11-2005,412513,Madhya Pradesh,9,17,6,15,47,Fail
Ishaan Mehta,12-11-2004,110980,Uttar Pradesh,21,11,0,23,55,Pass
David Reddy,31-01-2006,438491,Chhattisgarh,14,17,24,8,63,Fail
Aryan Singh,30-12-2004,138569,Uttar Pradesh,7,22,8,20,57,Pass
Mathew Reddy,27-08-2005,723254,Uttarakhand,18,8,6,6,38,Fail
Aarav Chopra,07-09-2005,234855,Sikkim,5,11,24,11,51,Fail
Aditya Singh,21-12-2004,716876,Odisha,24,20,18,17,79,Pass
Yash Chopra,12-08-2005,116775,Andhra Pradesh,1,5,10,6,22,Fail
Sukhwinder Reddy,03-06-2005,745666,Maharashtra,24,9,24,12,69,Fail
Vivaan Chopra,16-12-2004,890034,Chhattisgarh,12,17,20,24,73,Fail
Harjeet Sharma,04-06-2005,957281,Uttar Pradesh,5,21,20,1,47,Pass
Vivaan Reddy,04-12-2004,134435,Tamil Nadu,17,0,13,5,35,Pass
Ayaan Mehta,01-12-2004,521527,Madhya Pradesh,14,18,22,17,71,Fail
Krishna Singh,03-06-2005,383355,West Bengal,1,10,21,16,48,Pass
Paul Pillai,11-01-2006,645157,Karnataka,2,5,4,19,30,Pass
Farhan Singh,29-12-2004,750152,Punjab,2,15,10,0,27,Pass
Krishna Singh,05-10-2005,397484,Maharashtra,1,19,20,13,53,Fail
Aditya Singh,12-12-2004,641716,Uttar Pradesh,3,1,13,14,31,Pass
David Chopra,10-01-2006,686286,Gujarat,14,13,8,23,58,Fail
Krishna Verma,03-04-2006,422153,Jharkhand,9,17,19,20,65,Pass
Ishaan Reddy,18-10-2005,396567,Delhi,11,22,6,7,46,Fail
Kunal Reddy,20-01-2006,705052,Madhya Pradesh,10,10,12,24,56,Fail
John Sharma,21-02-2006,864410,Madhya Pradesh,17,24,10,1,52,Fail
Yash D'Souza,01-03-2005,774382,Madhya Pradesh,1,24,5,1,31,Fail
Paul Mehta,09-12-2005,468161,Uttar Pradesh,20,22,18,7,67,Pass
Rohan Mehta,15-01-2006,315923,Rajasthan,3,5,5,2,15,Pass
Vivaan Verma,10-06-2005,357560,Maharashtra,9,12,2,18,41,Fail
Ishaan Fernandes,24-09-2005,707805,Odisha,4,6,2,18,30,Pass
Rohan Chopra,26-06-2005,298206,West Bengal,12,8,5,3,28,Pass
Aditya Singh,25-04-2005,655250,Gujarat,13,15,6,4,38,Fail
Vivaan Singh,29-10-2005,398084,Assam,8,9,18,19,54,Fail
Kunal Mehta,08-09-2005,535476,Telangana,10,2,2,19,33,Fail
Raj Mehta,16-08-2005,284215,Uttar Pradesh,11,20,1,12,44,Pass
Kunal Singh,16-09-2005,658119,Telangana,1,21,6,18,46,Fail
Ishaan Fernandes,21-11-2004,327230,Odisha,20,19,22,13,74,Pass
Aditya Khan,11-02-2006,975319,Chhattisgarh,15,22,21,23,81,Fail
Vivaan Fernandes,13-11-2004,624403,Haryana,19,16,18,12,65,Fail
Rehan Mehta,03-05-2006,395360,Uttar Pradesh,14,6,13,0,33,Pass
Aditya Chopra,11-11-2005,979335,Odisha,4,6,21,14,45,Fail
Paul Chopra,14-08-2005,612547,Goa,0,15,15,11,41,Fail
Krishna Singh,24-12-2004,526944,Chhattisgarh,4,10,6,24,44,Fail
Vivaan Khan,24-04-2005,554228,Uttar Pradesh,7,5,17,11,40,Pass
Aryan Sharma,24-04-2005,926006,Bihar,22,14,9,22,67,Fail
Aditya Singh,26-12-2005,857819,Jharkhand,18,9,5,12,44,Pass
Ishaan Khan,21-03-2005,565399,West Bengal,15,22,12,0,49,Pass
Krishna Pillai,05-03-2005,458959,Sikkim,16,14,20,24,74,Fail
Mathew Pillai,26-12-2004,275386,Kerala,4,22,15,12,53,Fail
Vivaan Verma,12-11-2005,644597,Uttar Pradesh,12,15,12,0,39,Pass
Mathew Chopra,18-01-2006,546357,Tamil Nadu,4,6,8,19,37,Pass
Aditya D'Souza,02-10-2005,493300,Uttar Pradesh,13,13,17,0,43,Pass
Sukhwinder Khan,11-02-2005,505758,Punjab,13,10,1,23,47,Fail
Krishna Singh,16-11-2005,139520,Rajasthan,22,6,23,22,73,Fail
Balbir Pillai,15-03-2005,560286,Haryana,15,12,4,8,39,Fail
David Mehta,14-02-2005,970993,Odisha,11,4,21,5,41,Pass
Ishaan Khan,10-02-2005,500809,Tamil Nadu,12,0,5,17,34,Pass
Yash Khan,24-04-2006,681616,Rajasthan,11,21,12,10,54,Pass
Raj Verma,13-01-2006,113788,Uttar Pradesh,9,23,17,4,53,Pass
Aarav Chopra,08-03-2006,595465,Bihar,1,22,1,7,31,Pass
Aditya Mehta,06-07-2005,775747,Rajasthan,18,11,0,6,35,Pass
Manpreet D'Souza,06-06-2005,563196,Bihar,6,10,4,24,44,Pass
Raj Singh,01-07-2005,517453,Telangana,10,13,13,24,60,Fail
Gurpreet D'Souza,20-12-2004,917483,Punjab,12,7,6,9,34,Pass
Aarav Khan,20-12-2005,917936,Haryana,4,11,18,5,38,Fail
Aryan Verma,25-06-2005,350522,West Bengal,18,3,18,6,45,Pass
Kunal Fernandes,16-06-2005,511314,Madhya Pradesh,6,22,14,10,52,Fail
Yash Sharma,16-11-2005,655476,Andhra Pradesh,21,15,23,9,68,Fail
Ayaan Sharma,30-12-2005,895333,Uttar Pradesh,23,22,5,12,62,Pass
Raj Chopra,04-04-2006,717229,Himachal Pradesh,14,6,6,8,34,Fail
Ishaan Verma,21-03-2006,304585,Telangana,10,10,2,9,31,Fail
Rohan Sharma,27-10-2005,933555,Madhya Pradesh,21,20,14,6,61,Fail
Kunal Chopra,05-10-2005,514709,Chhattisgarh,17,9,19,24,69,Fail
Manpreet Sharma,30-04-2006,831788,Rajasthan,2,22,8,12,44,Pass
Krishna Singh,25-06-2005,588867,Himachal Pradesh,23,12,7,7,49,Fail
Vivaan Sharma,05-03-2006,427635,Telangana,1,12,20,24,57,Fail
Rohan Mehta,15-11-2004,683451,Madhya Pradesh,21,14,5,12,52,Fail
Gurpreet Pillai,22-11-2004,879477,Uttar Pradesh,22,22,12,13,69,Pass
Rohan Singh,26-02-2006,541975,Bihar,11,5,19,15,50,Fail
Raj Reddy,04-04-2005,933736,Assam,4,12,7,21,44,Fail
Aarav Chopra,29-05-2005,986567,Himachal Pradesh,5,20,12,0,37,Pass
Aarav Fernandes,05-12-2005,965751,Rajasthan,0,9,11,16,36,Pass
Peter Fernandes,01-07-2005,514148,Haryana,6,13,19,3,41,Fail
Vivaan Sharma,19-11-2005,835807,Bihar,15,2,24,13,54,Fail
Rohan Khan,15-02-2006,935139,Haryana,4,14,18,22,58,Fail
Aarav Reddy,25-04-2006,256048,Jharkhand,22,14,2,10,48,Pass
Vivaan Khan,13-01-2005,268374,Karnataka,18,18,24,21,81,Fail
Aarav Reddy,21-07-2005,477455,Odisha,12,24,2,8,46,Fail
Rohan Khan,18-02-2006,213302,Delhi,20,21,15,19,75,Fail
Aditya Singh,27-10-2005,138309,Karnataka,21,6,9,2,38,Pass
Peter Singh,14-04-2005,651600,Punjab,23,22,7,0,52,Fail
Vivaan Verma,16-04-2006,406204,Andhra Pradesh,2,1,24,21,48,Fail
Paul Sharma,23-10-2005,752189,Uttar Pradesh,24,1,7,10,42,Pass
Ishaan Reddy,18-04-2006,229755,Assam,15,3,22,2,42,Fail
Raj Singh,04-01-2005,625513,Uttar Pradesh,21,3,5,9,38,Pass
Manpreet Reddy,06-02-2006,327951,Chhattisgarh,22,18,17,5,62,Fail
Aryan D'Souza,12-02-2006,173607,Jharkhand,24,17,16,14,71,Fail
Yash Singh,28-06-2005,564188,Jharkhand,15,14,5,12,46,Pass
Harjeet Khan,10-03-2006,655120,Gujarat,18,10,5,17,50,Fail
Mathew Chopra,19-11-2004,597112,Mizoram,5,24,5,5,39,Pass
Krishna Sharma,19-12-2004,221736,Kerala,23,20,3,2,48,Fail
Krishna Fernandes,15-05-2005,869447,Bihar,0,12,22,8,42,Pass
Harjeet Khan,07-06-2005,871653,Uttar Pradesh,1,4,23,12,40,Pass
Ishaan Fernandes,17-06-2005,852080,Punjab,20,4,22,7,53,Fail
Mathew D'Souza,20-11-2004,677743,Uttar Pradesh,4,14,23,21,62,Pass
Aarav Khan,28-01-2006,546887,Karnataka,19,13,9,18,59,Pass
Sukhwinder Singh,15-12-2005,395046,Uttar Pradesh,18,13,3,3,37,Fail
Raj Pillai,28-01-2006,530623,Tamil Nadu,9,13,24,3,49,Fail
Aarav Pillai,18-02-2006,985979,Uttar Pradesh,6,2,21,16,45,Fail
Imran Mehta,16-04-2006,341835,Uttar Pradesh,24,6,2,11,43,Fail
Vivaan Chopra,21-01-2006,586502,Tamil Nadu,24,15,0,22,61,Pass
Yash Pillai,03-12-2004,355388,Punjab,13,16,18,2,49,Fail
Manpreet Khan,21-03-2005,988406,Bihar,24,18,13,12,67,Fail
David Khan,13-01-2006,967810,Bihar,5,9,24,0,38,Pass
Ishaan D'Souza,22-10-2005,114733,Rajasthan,6,10,8,11,35,Pass
Aditya Khan,03-12-2005,416917,Rajasthan,1,20,16,8,45,Pass
Manpreet Singh,02-10-2005,994528,Assam,6,16,5,5,32,Fail
Aryan Sharma,22-02-2006,253930,West Bengal,12,3,14,24,53,Pass
Aryan Sharma,31-03-2006,120601,Bihar,18,19,22,16,75,Fail
Manpreet D'Souza,06-09-2005,327074,Maharashtra,22,7,5,4,38,Fail
Balbir Sharma,08-03-2006,423394,Himachal Pradesh,19,13,11,20,63,Pass
Krishna Chopra,01-11-2005,788398,Uttar Pradesh,1,21,18,12,52,Fail
Aarav Chopra,25-04-2005,841929,Tamil Nadu,2,18,11,5,36,Pass
Rohan D'Souza,24-02-2006,839607,Tamil Nadu,12,14,22,11,59,Pass
Balbir Singh,11-12-2004,472931,Bihar,17,21,5,14,57,Fail
Harjeet Singh,27-01-2005,309768,Maharashtra,24,20,3,5,52,Fail
Sukhwinder Khan,08-03-2005,856669,Punjab,5,19,6,24,54,Fail
Harjeet Chopra,15-09-2005,314234,Gujarat,0,7,3,17,27,Fail
Aryan Verma,01-04-2006,185842,Tamil Nadu,8,5,8,14,35,Pass
John Pillai,19-09-2005,489281,Karnataka,19,14,5,20,58,Pass
Vivaan Sharma,21-04-2005,641358,Tamil Nadu,9,9,13,7,38,Pass
Yash D'Souza,18-11-2005,376024,Uttar Pradesh,16,9,17,19,61,Fail
Raj Singh,28-12-2004,235679,Jammu & Kashmir + Ladakh,7,22,6,3,38,Pass
Raj Verma,23-10-2005,465177,Uttar Pradesh,23,2,23,12,60,Fail
Raj Pillai,19-08-2005,891052,Madhya Pradesh,13,0,20,16,49,Fail
Vivaan D'Souza,17-01-2005,171477,Uttar Pradesh,12,16,14,11,53,Fail
David Khan,16-02-2005,620601,Madhya Pradesh,2,20,15,17,54,Fail
Rohan Verma,06-06-2005,179897,West Bengal,22,3,16,15,56,Pass
Kunal Fernandes,31-01-2005,867736,Punjab,17,12,6,10,45,Fail
Krishna Chopra,24-08-2005,684565,Haryana,10,15,10,0,35,Fail
Raj Khan,15-02-2006,276508,Himachal Pradesh,9,7,7,8,31,Fail
Vivaan Singh,14-11-2005,142931,Bihar,10,0,19,7,36,Pass
Ayaan Mehta,28-06-2005,138539,Karnataka,16,3,13,21,53,Pass
Aditya Fernandes,14-03-2006,872009,Maharashtra,7,20,1,14,42,Fail
Raj Verma,23-05-2005,595520,Rajasthan,24,7,0,24,55,Pass
Yash Reddy,23-01-2006,467474,Gujarat,5,7,0,0,12,Fail
John Verma,31-12-2004,309103,Uttar Pradesh,6,4,11,1,22,Fail
Aryan Fernandes,04-01-2005,469951,Assam,9,18,15,16,58,Fail
Vivaan Singh,31-05-2005,170952,Gujarat,13,13,5,11,42,Fail
Peter Mehta,24-02-2005,852102,Maharashtra,11,7,24,14,56,Fail
Aarav Singh,31-03-2005,215467,Uttar Pradesh,10,19,6,3,38,Fail
Krishna Pillai,22-03-2006,704275,Gujarat,23,23,1,22,69,Fail
Yash D'Souza,29-01-2006,954337,Rajasthan,15,10,15,17,57,Pass
Aditya Sharma,31-03-2005,126763,Maharashtra,8,4,24,6,42,Fail
Raj Reddy,04-05-2006,582754,Bihar,19,22,8,22,71,Fail
Paul Fernandes,14-07-2005,989144,Uttar Pradesh,10,1,21,4,36,Fail
Aditya D'Souza,26-11-2004,292953,Madhya Pradesh,1,15,21,17,54,Fail
Ishaan D'Souza,07-01-2005,668837,West Bengal,3,22,11,3,39,Pass
Aarav Fernandes,08-01-2006,203979,Uttar Pradesh,20,16,15,8,59,Fail
Vivaan Sharma,14-01-2006,626690,Kerala,15,6,6,18,45,Fail
Vivaan Pillai,05-04-2005,569698,Karnataka,13,8,16,3,40,Pass
Peter Fernandes,11-09-2005,711674,Bihar,7,14,8,18,47,Fail
Balbir Mehta,08-01-2006,285048,Gujarat,24,19,15,24,82,Fail
Kunal Mehta,16-11-2004,349035,Maharashtra,16,11,5,7,39,Fail
Aarav Chopra,10-07-2005,815995,West Bengal,10,0,19,15,44,Pass
Aryan Fernandes,26-03-2005,876637,Maharashtra,20,22,5,14,61,Fail
Kunal Pillai,29-06-2005,333693,Bihar,0,12,8,23,43,Pass
Ishaan Mehta,13-01-2005,377271,Bihar,17,4,7,15,43,Pass
Vivaan Khan,16-03-2006,115466,Andhra Pradesh,21,1,10,19,51,Fail
Ishaan Fernandes,07-09-2005,283778,Rajasthan,24,11,0,17,52,Pass
Gurpreet Verma,02-03-2005,216868,Uttar Pradesh,0,5,4,5,14,Fail
Raj Fernandes,30-04-2005,780369,Jharkhand,4,8,15,2,29,Pass
Zaid Pillai,14-05-2005,398194,Rajasthan,7,6,20,15,48,Pass
Rohan Pillai,12-12-2005,252297,Uttarakhand,11,12,4,19,46,Fail
Yash Sharma,22-12-2004,370324,Andhra Pradesh,16,21,12,9,58,Fail
Aarav Chopra,13-10-2005,994350,Tamil Nadu,24,14,7,22,67,Fail
Peter Fernandes,08-08-2005,968409,Madhya Pradesh,24,6,16,23,69,Fail
Kunal Chopra,14-10-2005,704865,Maharashtra,14,9,21,15,59,Fail
Balbir D'Souza,18-01-2006,141334,Uttar Pradesh,9,6,22,16,53,Fail
Sukhwinder Singh,20-12-2005,775095,Odisha,1,10,23,2,36,Pass
Kunal Pillai,29-12-2004,875088,Jharkhand,18,9,4,1,32,Pass
Balbir Khan,07-01-2005,317492,Maharashtra,13,23,12,3,51,Fail
Raj Khan,21-11-2005,617509,Karnataka,5,7,15,22,49,Pass
Raj Verma,15-03-2006,377830,Andhra Pradesh,24,10,10,18,62,Fail
Yash Reddy,24-05-2005,225301,Delhi,10,16,2,14,42,Fail
Kunal D'Souza,09-04-2005,282010,Odisha,1,23,3,21,48,Fail
Kunal Khan,11-03-2006,584486,Madhya Pradesh,0,11,24,1,36,Fail
Aryan Reddy,07-02-2006,217508,Bihar,20,7,12,7,46,Fail
Krishna D'Souza,03-04-2006,620100,Uttar Pradesh,18,20,5,1,44,Fail
Aditya D'Souza,03-03-2005,624291,Haryana,9,0,23,4,36,Fail
Manpreet Sharma,28-01-2006,978216,Maharashtra,24,21,20,19,84,Fail
Ishaan Pillai,05-11-2005,611567,West Bengal,0,20,13,7,40,Pass
Sukhwinder D'Souza,07-11-2004,836239,West Bengal,9,16,4,6,35,Pass
Ishaan Pillai,17-04-2005,607482,Telangana,1,9,1,20,31,Fail
Harjeet Fernandes,05-02-2006,955604,Tamil Nadu,8,1,22,15,46,Fail
Raj Chopra,22-10-2005,629434,West Bengal,12,14,5,4,35,Pass
Ishaan Fernandes,18-09-2005,485215,Haryana,12,4,14,21,51,Fail
Ishaan Khan,08-10-2005,921972,Assam,7,15,22,4,48,Fail
Krishna Khan,05-03-2006,640485,Odisha,24,2,2,11,39,Pass
Aryan Sharma,31-03-2005,852826,Karnataka,11,24,4,2,41,Pass
Rohan Chopra,07-02-2006,735185,Rajasthan,15,20,0,21,56,Pass
Kunal Fernandes,15-02-2006,821649,Sikkim,7,18,10,8,43,Fail
Raj Khan,15-04-2006,303917,Madhya Pradesh,12,4,3,12,31,Fail
Raj Chopra,18-04-2005,122768,Kerala,2,17,9,6,34,Fail
Kunal Verma,23-12-2004,757711,Maharashtra,17,20,20,9,66,Fail
Yash Singh,13-10-2005,358049,Karnataka,12,7,23,18,60,Pass
Krishna Pillai,18-05-2005,193142,Haryana,20,24,21,18,83,Fail
Sukhwinder Pillai,13-11-2005,554276,Madhya Pradesh,4,20,23,14,61,Fail
Aryan Reddy,21-11-2004,842511,Punjab,7,12,8,24,51,Fail
Aarav Khan,15-11-2005,675705,Punjab,4,15,19,9,47,Fail
Aarav D'Souza,09-01-2006,332569,Punjab,7,23,9,9,48,Fail
Aryan Reddy,15-11-2004,394589,Rajasthan,5,18,11,11,45,Pass
Raj Singh,24-02-2006,953593,Rajasthan,16,6,12,12,46,Pass
Sukhwinder Pillai,09-01-2006,331358,Uttar Pradesh,14,8,18,24,64,Fail
Manpreet Khan,16-06-2005,360790,Maharashtra,11,21,3,18,53,Fail
Aarav Khan,27-12-2005,157004,Andhra Pradesh,11,22,24,23,80,Fail
John Fernandes,13-04-2005,601699,Madhya Pradesh,20,4,22,20,66,Fail
Aryan Sharma,15-06-2005,462754,Odisha,16,1,20,22,59,Fail
Sukhwinder Chopra,07-11-2005,179425,Bihar,15,1,10,17,43,Pass
Yash Verma,30-03-2005,177990,Bihar,5,9,12,11,37,Pass
Yash D'Souza,23-10-2005,324222,West Bengal,6,9,2,0,17,Pass
Kunal Sharma,27-10-2005,111425,Tamil Nadu,8,9,6,5,28,Pass
Krishna Singh,20-04-2005,860259,Karnataka,0,20,6,13,39,Pass
Aryan Pillai,07-07-2005,540440,Karnataka,6,23,10,1,40,Pass
Aditya Chopra,13-03-2005,560120,Uttar Pradesh,13,5,0,3,21,Fail
Vivaan Reddy,13-03-2006,259790,Madhya Pradesh,8,14,23,24,69,Fail
Yash Khan,01-02-2006,837903,Tamil Nadu,9,13,0,14,36,Pass
Harjeet Reddy,09-09-2005,925005,Punjab,13,2,18,24,57,Fail
Yash Singh,09-11-2004,898886,Kerala,3,0,0,22,25,Fail
Manpreet Mehta,01-08-2005,186532,Rajasthan,7,1,21,20,49,Pass
Gurpreet Pillai,15-12-2004,823304,Uttarakhand,21,4,16,20,61,Fail
Krishna Mehta,09-07-2005,631768,West Bengal,7,12,6,12,37,Pass
Sukhwinder Pillai,07-12-2004,333473,Haryana,7,11,19,12,49,Fail
Paul Verma,26-02-2005,269676,Meghalaya,9,5,13,13,40,Pass
Aarav Pillai,20-10-2005,389689,Tamil Nadu,14,5,11,5,35,Pass
Kunal D'Souza,03-12-2004,506264,Madhya Pradesh,1,20,24,3,48,Fail
Peter Mehta,21-03-2006,362734,Rajasthan,21,23,10,2,56,Pass
Mathew Singh,12-04-2006,894526,Delhi,8,14,2,9,33,Fail
Sukhwinder Singh,07-12-2004,526163,Assam,8,7,22,14,51,Fail
Yash D'Souza,05-03-2006,629846,Jharkhand,24,3,22,13,62,Pass
Raj Sharma,30-04-2005,725110,Kerala,2,4,20,8,34,Fail
Aarav D'Souza,07-05-2006,605520,Madhya Pradesh,17,2,14,18,51,Fail
Krishna Mehta,27-11-2004,734825,Uttar Pradesh,7,4,16,23,50,Fail
Imran Chopra,28-12-2005,405963,Rajasthan,23,12,21,7,63,Fail
Aarav Verma,05-04-2006,746038,Madhya Pradesh,21,4,8,4,37,Fail
Krishna Khan,30-11-2004,421044,Delhi,20,5,20,13,58,Fail
Paul Pillai,24-09-2005,593345,Tamil Nadu,19,0,23,20,62,Pass
Rohan Mehta,16-03-2005,842017,Jammu & Kashmir + Ladakh,9,2,20,22,53,Pass
Rohan Mehta,28-04-2006,236205,Rajasthan,20,24,18,7,69,Fail
Kunal Khan,09-07-2005,176121,Odisha,13,19,8,20,60,Fail
Krishna Khan,16-11-2004,653822,Maharashtra,9,3,16,9,37,Fail
Yash Singh,14-10-2005,377072,Delhi,12,13,23,0,48,Fail
Aryan D'Souza,03-07-2005,496758,West Bengal,13,3,20,5,41,Pass
Yash Reddy,02-06-2005,415499,Manipur,12,16,12,6,46,Fail
Harjeet Mehta,26-03-2005,267729,Himachal Pradesh,11,16,14,12,53,Pass
Manpreet Mehta,24-10-2005,220922,Bihar,18,5,24,17,64,Fail
Rohan Chopra,12-11-2005,296160,Uttar Pradesh,24,18,14,16,72,Fail
Yash Khan,27-11-2005,332647,Odisha,24,1,10,7,42,Pass
Gurpreet Khan,06-12-2004,129799,Telangana,6,7,2,6,21,Fail
Imran Mehta,01-12-2005,340902,Bihar,21,7,13,1,42,Pass
Mathew Reddy,31-03-2006,508734,Puducherry,7,5,4,22,38,Pass
Vivaan Mehta,24-11-2005,288390,Uttar Pradesh,14,20,19,16,69,Fail
Raj Fernandes,12-01-2006,827097,Madhya Pradesh,3,1,13,24,41,Fail
Yash Pillai,15-11-2004,301113,Tamil Nadu,22,20,18,20,80,Pass
Raj Fernandes,11-06-2005,298277,Assam,18,14,22,2,56,Fail
Vivaan Singh,25-01-2006,536908,Jharkhand,15,9,5,13,42,Pass
Raj Sharma,20-11-2005,399526,Madhya Pradesh,16,7,18,8,49,Fail
Aditya Pillai,04-02-2006,941649,Madhya Pradesh,11,23,22,5,61,Fail
Aarav Fernandes,06-11-2005,153373,Bihar,9,9,20,21,59,Fail
Rohan Pillai,18-03-2005,966542,Kerala,9,17,22,4,52,Fail
Manpreet Singh,05-11-2005,351854,Karnataka,9,14,21,11,55,Pass
Farhan D'Souza,02-12-2004,175190,Delhi,19,24,19,5,67,Fail
Manpreet Pillai,27-08-2005,712538,Gujarat,21,11,24,0,56,Fail
Ishaan Mehta,26-09-2005,590450,Maharashtra,22,17,5,1,45,Fail
Yash D'Souza,19-03-2005,434356,Haryana,20,2,13,8,43,Fail
Sukhwinder D'Souza,05-05-2006,951956,Rajasthan,23,7,0,19,49,Pass
Aarav Singh,27-02-2005,881080,Maharashtra,2,3,24,8,37,Fail
Aarav Singh,19-07-2005,983282,Rajasthan,22,5,21,18,66,Fail
Gurpreet Reddy,24-06-2005,157948,Tamil Nadu,23,24,11,15,73,Pass
Harjeet Reddy,02-03-2005,621865,Karnataka,0,0,2,22,24,Pass
Harjeet D'Souza,22-08-2005,328339,Madhya Pradesh,11,24,24,1,60,Fail
Rohan Reddy,19-02-2006,514293,Manipur,15,14,23,4,56,Fail
Rehan D'Souza,08-01-2006,991175,Tamil Nadu,2,3,23,21,49,Fail
Mathew Chopra,23-12-2004,613459,Uttar Pradesh,7,11,14,3,35,Fail
Raj Pillai,26-11-2004,910804,Andhra Pradesh,18,18,13,10,59,Fail
Aditya Verma,28-11-2005,282545,Bihar,3,0,3,8,14,Pass
Mathew Fernandes,29-05-2005,495491,West Bengal,19,2,9,1,31,Pass
Raj Reddy,18-01-2006,866705,Rajasthan,12,20,19,10,61,Fail
Balbir Verma,27-07-2005,144120,Andhra Pradesh,13,17,9,6,45,Fail
Balbir Reddy,18-01-2006,470085,Madhya Pradesh,12,23,14,14,63,Fail
Aditya Reddy,17-05-2005,136545,Odisha,14,13,20,19,66,Fail
Vivaan D'Souza,19-09-2005,200890,Rajasthan,8,22,4,21,55,Pass
Ishaan D'Souza,26-11-2005,378532,Punjab,22,24,17,23,86,Pass
Harjeet Fernandes,13-02-2005,305269,Maharashtra,0,2,5,12,19,Fail
Yash Reddy,17-01-2005,326649,Uttar Pradesh,6,18,23,21,68,Fail
Vivaan D'Souza,12-04-2005,844293,Bihar,16,15,15,21,67,Fail
Yash Khan,12-08-2005,857491,Odisha,9,21,2,8,40,Pass
Aryan Sharma,25-08-2005,651087,Jammu & Kashmir + Ladakh,8,10,10,4,32,Pass
Balbir Sharma,02-07-2005,439523,Odisha,23,13,7,21,64,Fail
Vivaan Chopra,18-07-2005,326317,Kerala,17,23,19,21,80,Fail
Sukhwinder D'Souza,09-01-2005,295416,West Bengal,14,3,24,13,54,Pass
Gurpreet Reddy,15-08-2005,288016,Haryana,19,7,11,15,52,Fail
Mathew Fernandes,26-10-2005,788226,West Bengal,5,3,17,24,49,Pass
Aarav Mehta,12-12-2004,230171,Kerala,19,13,21,24,77,Fail
Aditya D'Souza,26-12-2004,233723,Sikkim,6,0,22,1,29,Fail
Aarav D'Souza,10-12-2005,350918,Andhra Pradesh,1,6,16,24,47,Fail
Imran Verma,27-07-2005,162405,Bihar,18,22,24,12,76,Fail
Harjeet Khan,20-03-2005,737033,Haryana,7,18,4,4,33,Fail
Aryan Chopra,16-11-2005,257456,Rajasthan,2,6,19,9,36,Pass
Zaid Chopra,30-05-2005,819744,Bihar,2,1,6,21,30,Pass
Raj D'Souza,19-05-2005,780988,Odisha,22,13,4,14,53,Fail
Vivaan D'Souza,08-09-2005,267540,West Bengal,16,12,3,4,35,Pass
Raj Sharma,18-04-2006,946476,Uttar Pradesh,12,11,22,20,65,Fail
Sukhwinder Chopra,22-10-2005,842330,Himachal Pradesh,4,5,23,14,46,Pass
Rohan Singh,08-02-2006,937131,Chhattisgarh,5,11,16,23,55,Fail
Peter Singh,26-03-2006,165325,Tamil Nadu,7,18,2,22,49,Fail
Paul Verma,19-03-2005,706462,Uttarakhand,2,10,13,3,28,Fail
Zaid Sharma,13-04-2005,842911,Haryana,18,5,7,22,52,Fail
Raj Reddy,04-02-2006,986171,Uttar Pradesh,16,2,3,18,39,Fail
Raj Pillai,07-02-2006,864879,Maharashtra,24,18,11,16,69,Fail
Rohan Pillai,11-01-2006,649178,Haryana,17,16,11,10,54,Fail
Rehan Fernandes,22-03-2005,687043,Bihar,23,14,8,17,62,Fail
Yash Mehta,26-03-2005,570038,West Bengal,20,3,19,5,47,Pass
Krishna Mehta,03-03-2006,541359,Rajasthan,23,6,7,12,48,Pass
Rehan Reddy,18-10-2005,382112,Punjab,19,8,22,11,60,Fail
Raj Fernandes,18-08-2005,953600,Odisha,11,10,10,12,43,Pass
Aarav Sharma,13-01-2005,653763,Madhya Pradesh,20,6,22,16,64,Fail
Manpreet Khan,30-01-2005,119600,Madhya Pradesh,3,22,13,18,56,Fail
Raj Mehta,14-02-2005,821126,Odisha,12,2,10,21,45,Fail
Yash D'Souza,22-02-2006,693898,Uttarakhand,12,1,7,7,27,Fail
David Fernandes,03-12-2005,852250,Maharashtra,22,16,5,14,57,Fail
Raj Mehta,29-12-2005,743152,Rajasthan,4,16,9,8,37,Pass
Yash Reddy,31-07-2005,619063,Chhattisgarh,17,1,2,24,44,Fail
Aditya Singh,12-11-2004,184050,West Bengal,24,3,5,22,54,Pass
Sukhwinder Reddy,24-02-2006,186379,Tamil Nadu,20,4,18,3,45,Fail
Krishna D'Souza,15-09-2005,421232,Jammu & Kashmir + Ladakh,19,22,9,9,59,Pass
Aryan Fernandes,02-07-2005,871302,Madhya Pradesh,18,20,0,11,49,Fail
Raj Verma,03-10-2005,472524,Uttarakhand,20,20,16,1,57,Fail
Aditya Reddy,23-11-2004,187102,Himachal Pradesh,19,16,2,4,41,Pass
Ishaan Sharma,10-10-2005,225916,Madhya Pradesh,13,12,0,4,29,Fail
Aditya Chopra,01-12-2005,722147,Jharkhand,19,6,10,19,54,Pass
Aarav Fernandes,15-10-2005,652794,Maharashtra,7,19,14,10,50,Fail
Aryan Verma,03-05-2005,457784,Madhya Pradesh,3,10,9,13,35,Fail
Yash Pillai,14-10-2005,252538,Chhattisgarh,10,4,4,15,33,Fail
Paul Singh,23-07-2005,931668,Rajasthan,7,19,13,4,43,Pass
Vivaan Verma,26-05-2005,142993,Bihar,19,22,15,24,80,Fail
Mathew Fernandes,08-12-2004,997608,Rajasthan,24,23,13,7,67,Fail
Aditya Pillai,14-11-2005,266468,Uttar Pradesh,23,10,20,22,75,Fail
Krishna Reddy,07-08-2005,952231,Tamil Nadu,20,8,4,17,49,Fail
Mathew Sharma,19-11-2005,719506,Karnataka,7,23,10,15,55,Pass
Gurpreet Reddy,14-08-2005,338215,Bihar,20,15,19,9,63,Fail
Yash Khan,12-11-2005,509068,Uttar Pradesh,18,13,19,16,66,Fail
Kunal Khan,13-06-2005,387123,Himachal Pradesh,6,10,0,22,38,Pass
Vivaan Pillai,03-04-2006,816879,Uttar Pradesh,17,11,16,22,66,Fail
John D'Souza,27-11-2005,306615,West Bengal,8,4,6,11,29,Pass
Aditya Mehta,19-07-2005,775524,Bihar,23,3,11,18,55,Fail
Ishaan Mehta,03-11-2005,547876,Himachal Pradesh,7,7,5,21,40,Pass
Aryan D'Souza,05-05-2005,152715,West Bengal,18,2,20,14,54,Pass
Peter Singh,05-03-2005,567653,Punjab,10,4,4,11,29,Pass
Ishaan Chopra,26-01-2006,740540,Gujarat,18,9,8,22,57,Fail
Yash Pillai,27-04-2006,359037,Haryana,13,17,6,12,48,Fail
Aditya Reddy,08-07-2005,405793,Andhra Pradesh,19,12,2,16,49,Fail
Rohan D'Souza,11-12-2005,978137,Karnataka,12,11,6,7,36,Pass
Ishaan Khan,12-02-2005,115832,Uttar Pradesh,6,11,17,12,46,Fail
Balbir Verma,25-11-2005,245407,Haryana,13,18,0,6,37,Fail
Vivaan Pillai,05-10-2005,532440,Jammu & Kashmir + Ladakh,17,4,15,4,40,Pass
Aryan Pillai,12-04-2005,978383,Tamil Nadu,3,2,21,23,49,Fail
Paul Khan,14-03-2006,879419,Gujarat,14,1,7,8,30,Fail
Yash Khan,17-03-2006,829021,Haryana,17,13,14,7,51,Fail
Kunal Pillai,30-11-2005,523282,Madhya Pradesh,23,19,2,9,53,Fail
Gurpreet Sharma,22-11-2005,905410,Haryana,8,9,12,10,39,Fail
Vivaan Chopra,15-01-2006,157331,Kerala,20,6,24,12,62,Fail
Ishaan Reddy,29-04-2006,797380,Madhya Pradesh,18,6,22,18,64,Fail
Rohan Mehta,04-02-2005,716404,Telangana,20,16,6,23,65,Fail
Ishaan Fernandes,14-11-2004,558312,Delhi,14,13,17,13,57,Fail
Sukhwinder Verma,20-08-2005,670266,Karnataka,12,20,21,0,53,Pass
Krishna Khan,25-08-2005,903208,West Bengal,9,11,3,10,33,Pass
Imran Sharma,31-07-2005,166322,Jharkhand,11,2,7,3,23,Pass
Rohan Sharma,19-01-2006,629749,Uttarakhand,24,16,2,14,56,Fail
Imran Fernandes,26-02-2005,149896,Andhra Pradesh,9,24,8,7,48,Fail
Raj Khan,29-03-2006,140815,Rajasthan,17,1,14,22,54,Pass
Rohan D'Souza,17-09-2005,501850,Telangana,14,19,3,24,60,Fail
John Sharma,23-02-2005,402958,West Bengal,5,7,11,13,36,Pass
Vivaan Pillai,01-07-2005,416391,Jharkhand,22,3,3,8,36,Pass
Ishaan D'Souza,21-01-2005,363668,Madhya Pradesh,20,16,14,7,57,Fail
Rohan Fernandes,17-03-2005,451676,West Bengal,3,3,14,23,43,Pass
Raj Pillai,06-07-2005,735558,Madhya Pradesh,24,7,15,1,47,Fail
Mathew D'Souza,17-01-2005,695199,Chhattisgarh,11,20,21,17,69,Fail
John Singh,15-09-2005,651297,Uttar Pradesh,4,23,1,23,51,Fail
Krishna D'Souza,20-02-2006,267813,Tamil Nadu,21,0,13,21,55,Fail
Peter Sharma,23-01-2006,830227,Gujarat,22,10,12,20,64,Fail
Harjeet Chopra,16-08-2005,808770,Tamil Nadu,23,1,14,18,56,Pass
Farhan Chopra,28-10-2005,720472,Punjab,7,11,22,22,62,Fail
David Singh,08-02-2006,727954,West Bengal,14,3,9,22,48,Pass
Gurpreet Pillai,18-08-2005,757359,Rajasthan,17,17,16,12,62,Fail
Gurpreet Khan,23-01-2006,117600,Punjab,14,15,18,24,71,Fail
Raj Sharma,27-02-2005,821390,Gujarat,3,4,15,22,44,Fail
Ishaan Reddy,20-03-2006,145797,Andhra Pradesh,10,19,16,8,53,Fail
Rohan Chopra,10-05-2005,556854,Madhya Pradesh,18,11,15,3,47,Fail
Raj Mehta,21-02-2005,183805,Uttar Pradesh,0,15,7,5,27,Fail
Kunal Chopra,08-11-2005,718500,Uttar Pradesh,2,23,7,16,48,Fail
Ishaan Reddy,18-11-2004,667648,Rajasthan,12,19,16,11,58,Pass
Raj Pillai,25-12-2005,604624,Haryana,0,18,23,15,56,Fail
Aditya D'Souza,18-01-2005,947085,Rajasthan,22,11,13,3,49,Pass
Raj Sharma,26-03-2005,377966,Rajasthan,15,14,21,0,50,Pass
Rehan Reddy,22-04-2006,245983,Uttar Pradesh,8,15,5,15,43,Fail
Ishaan Singh,01-02-2006,467688,Telangana,19,19,19,19,76,Fail
Ayaan Reddy,04-09-2005,421894,Andhra Pradesh,8,11,1,5,25,Fail
Manpreet Pillai,05-04-2006,680872,Madhya Pradesh,3,23,9,9,44,Fail
Yash Sharma,17-11-2005,882231,Kerala,9,17,0,15,41,Fail
Rohan Reddy,09-07-2005,662375,Madhya Pradesh,13,13,8,17,51,Fail
John Reddy,25-04-2006,445286,Assam,17,20,18,7,62,Fail
Aditya Mehta,04-03-2006,227492,Telangana,10,23,18,13,64,Fail
Aarav Mehta,12-02-2006,622368,Telangana,23,11,4,16,54,Fail
Vivaan Chopra,19-09-2005,264119,Uttar Pradesh,21,9,12,15,57,Fail
Zaid Verma,14-09-2005,405912,Haryana,17,2,24,5,48,Fail
Farhan Verma,24-04-2005,976934,Rajasthan,20,19,20,20,79,Pass
Krishna Fernandes,19-11-2004,730446,Chhattisgarh,21,23,18,20,82,Fail
Krishna D'Souza,26-12-2005,535571,Bihar,16,10,11,23,60,Fail
Vivaan Pillai,10-03-2006,123221,Madhya Pradesh,16,10,7,4,37,Fail
Vivaan Sharma,11-07-2005,608617,Daman & Diu / D&N Haveli,20,20,12,11,63,Fail
Aarav Chopra,22-01-2006,887511,West Bengal,15,3,19,19,56,Pass
Krishna Fernandes,20-03-2006,913747,Jharkhand,8,3,5,18,34,Pass
Vivaan Pillai,01-12-2004,619350,Chhattisgarh,20,24,17,14,75,Fail
Aarav Sharma,13-12-2005,471255,Maharashtra,21,12,11,11,55,Fail
Aryan Chopra,21-02-2005,716589,Madhya Pradesh,11,5,22,14,52,Fail
Kunal Singh,13-04-2006,364685,Haryana,2,10,9,14,35,Fail
Yash Reddy,08-04-2005,611336,Uttar Pradesh,15,2,12,6,35,Fail
Rohan Pillai,05-10-2005,619184,Haryana,24,15,18,5,62,Fail
Krishna Pillai,15-04-2006,764341,Madhya Pradesh,11,8,9,21,49,Fail
Raj Fernandes,02-07-2005,954442,Uttar Pradesh,15,22,8,12,57,Fail
Raj Chopra,28-05-2005,824265,Bihar,6,17,12,1,36,Pass
Kunal Chopra,17-08-2005,333683,Rajasthan,19,0,13,21,53,Pass
Aarav D'Souza,28-03-2005,733353,Telangana,20,2,11,2,35,Fail
Manpreet D'Souza,11-04-2005,540633,Bihar,7,18,3,4,32,Pass
Kunal Verma,19-09-2005,774947,Tamil Nadu,5,6,18,12,41,Pass
Yash Singh,12-02-2005,397475,West Bengal,22,3,16,2,43,Pass
Sukhwinder Mehta,09-02-2005,424471,Jammu & Kashmir + Ladakh,9,9,17,18,53,Pass
Aditya Reddy,12-11-2004,207606,Uttar Pradesh,14,20,1,18,53,Fail
Gurpreet Reddy,14-09-2005,459603,Chhattisgarh,18,4,5,1,28,Fail
Rohan Mehta,04-04-2006,107235,Gujarat,11,5,1,22,39,Fail
Aditya Reddy,05-12-2004,401953,Bihar,6,4,16,23,49,Fail
Krishna Pillai,17-01-2006,204505,Maharashtra,15,12,17,20,64,Fail
Vivaan Verma,18-01-2005,404003,Nagaland,6,7,4,9,26,Pass
Kunal Sharma,22-05-2005,412671,Madhya Pradesh,23,6,3,18,50,Fail
Ishaan Khan,11-11-2004,411427,Kerala,11,18,0,21,50,Fail
Aditya D'Souza,03-05-2005,334625,Rajasthan,20,13,8,8,49,Pass
Krishna Singh,18-10-2005,471781,Punjab,13,15,17,13,58,Fail
Aarav Singh,12-06-2005,684560,Rajasthan,11,5,17,5,38,Pass
Vivaan Pillai,18-05-2005,573840,Delhi,2,11,17,13,43,Fail
Krishna Reddy,05-05-2006,181493,Bihar,2,1,1,3,7,Pass
Ishaan Fernandes,29-04-2005,419562,Kerala,18,4,22,10,54,Fail
Aarav Sharma,14-01-2005,777796,Uttar Pradesh,7,11,20,4,42,Fail
Rohan Fernandes,18-03-2005,852213,Jharkhand,17,17,13,12,59,Pass
Peter D'Souza,03-09-2005,868539,Odisha,6,14,18,18,56,Fail
Gurpreet Verma,29-04-2005,348786,Telangana,5,5,18,9,37,Fail
Ishaan Fernandes,18-02-2005,487127,Maharashtra,22,2,5,5,34,Fail
Kunal Verma,15-02-2005,108536,West Bengal,12,22,7,6,47,Pass
Vivaan Reddy,14-12-2005,827655,Uttar Pradesh,22,23,9,19,73,Fail
Ishaan Mehta,22-01-2005,780067,Uttar Pradesh,17,22,0,5,44,Fail
Aryan Khan,22-03-2005,594949,Uttar Pradesh,16,24,5,14,59,Fail
Yash D'Souza,08-04-2006,506130,Punjab,8,2,0,19,29,Pass
Manpreet Verma,03-04-2005,941946,Delhi,22,20,12,15,69,Fail
Raj Sharma,29-03-2006,818322,Madhya Pradesh,14,16,3,10,43,Fail
Yash D'Souza,25-09-2005,161377,Karnataka,17,12,22,5,56,Pass
Aryan Chopra,07-02-2006,574870,Uttar Pradesh,2,7,8,6,23,Fail
Raj Chopra,30-01-2006,883233,Punjab,22,15,5,3,45,Fail
Yash Fernandes,02-05-2005,126507,Haryana,8,16,3,13,40,Fail
John Reddy,16-08-2005,923331,Tamil Nadu,22,23,2,20,67,Fail
Harjeet Singh,12-10-2005,374731,Tamil Nadu,15,6,13,9,43,Fail
Manpreet D'Souza,15-01-2006,990440,Tamil Nadu,20,0,3,9,32,Pass
Yash Verma,12-01-2006,226485,Madhya Pradesh,3,3,3,9,18,Fail
Ayaan Pillai,20-12-2005,427356,Bihar,20,14,9,23,66,Fail
Sukhwinder Verma,15-12-2005,628544,Maharashtra,20,4,14,5,43,Fail
Aryan D'Souza,05-05-2005,863519,Rajasthan,3,10,19,15,47,Pass
Krishna Sharma,18-11-2004,721182,Punjab,0,1,19,10,30,Pass
Gurpreet Sharma,03-01-2006,343118,Uttar Pradesh,1,23,19,12,55,Fail
Balbir Verma,20-08-2005,118639,Andhra Pradesh,7,2,11,9,29,Fail
John Singh,05-02-2005,416275,Rajasthan,12,14,24,13,63,Fail
Gurpreet Mehta,01-03-2005,315696,Madhya Pradesh,15,10,23,3,51,Fail
Ishaan Verma,24-04-2005,886337,Bihar,19,13,24,23,79,Fail
Vivaan D'Souza,11-11-2005,997368,Andhra Pradesh,10,20,12,24,66,Fail
Harjeet Verma,07-05-2006,469363,Haryana,13,14,1,11,39,Fail
Aarav Pillai,31-10-2005,946428,West Bengal,3,3,15,22,43,Pass
Sukhwinder Reddy,11-12-2004,613974,Tamil Nadu,12,12,11,17,52,Fail
Ishaan Mehta,29-07-2005,935655,Rajasthan,1,13,18,4,36,Pass
Harjeet Sharma,29-04-2006,742935,Madhya Pradesh,2,8,20,12,42,Fail
David Fernandes,20-01-2005,128811,Tamil Nadu,15,16,4,8,43,Fail
Rohan D'Souza,06-08-2005,307446,Rajasthan,5,4,6,6,21,Pass
Aryan Mehta,30-09-2005,829635,Himachal Pradesh,11,22,8,15,56,Pass
Farhan Reddy,23-09-2005,676727,Haryana,0,5,19,20,44,Fail
Aarav Mehta,20-08-2005,452477,West Bengal,17,3,21,20,61,Pass
Krishna Fernandes,14-12-2004,930517,Madhya Pradesh,0,11,2,24,37,Fail
Aarav Mehta,26-11-2004,869964,Rajasthan,6,24,17,13,60,Fail
Aryan Sharma,20-07-2005,301289,Andhra Pradesh,19,14,10,11,54,Fail
Ayaan Chopra,24-04-2005,496544,Rajasthan,9,2,1,18,30,Pass
Raj Mehta,25-09-2005,221345,Uttar Pradesh,3,12,17,20,52,Fail
Kunal Fernandes,20-12-2004,822965,Madhya Pradesh,17,7,20,5,49,Fail
Yash D'Souza,06-03-2006,768908,Jharkhand,13,9,0,7,29,Pass
Ishaan Chopra,23-01-2005,240146,Tamil Nadu,22,24,3,8,57,Pass
Ishaan Chopra,15-04-2006,117598,Haryana,21,0,19,15,55,Fail
Aarav Khan,13-04-2006,524988,Rajasthan,20,23,0,18,61,Fail
Paul Sharma,27-03-2006,266168,West Bengal,13,3,11,20,47,Pass
Krishna D'Souza,01-12-2004,129863,Rajasthan,24,19,17,1,61,Fail
Yash Pillai,30-07-2005,802795,Bihar,5,9,23,1,38,Pass
David Fernandes,08-07-2005,457496,Madhya Pradesh,1,14,19,16,50,Fail
Kunal D'Souza,25-05-2005,297526,Bihar,18,23,8,16,65,Fail
Imran Pillai,09-03-2005,545146,Madhya Pradesh,4,19,20,2,45,Fail
Yash Verma,19-02-2006,133170,Tamil Nadu,8,18,22,19,67,Fail
Aryan Mehta,02-02-2005,265458,Madhya Pradesh,13,15,23,21,72,Fail
Raj Pillai,27-12-2005,881427,Tamil Nadu,9,10,24,7,50,Fail
Raj Sharma,22-09-2005,218640,Kerala,3,3,3,8,17,Fail
John Verma,06-04-2006,193134,Haryana,11,12,18,3,44,Fail
Raj Sharma,10-02-2005,872330,Jharkhand,2,1,9,17,29,Pass
Aarav Fernandes,20-09-2005,269687,Bihar,18,14,3,6,41,Pass
Vivaan Khan,24-05-2005,997769,Rajasthan,20,6,4,1,31,Pass
Aryan Chopra,14-01-2006,437968,West Bengal,11,4,0,7,22,Pass
Rohan Singh,28-11-2004,243919,Maharashtra,12,20,21,8,61,Fail
Raj Singh,10-11-2005,924566,Daman & Diu / D&N Haveli,8,22,9,22,61,Fail
Yash Chopra,16-05-2005,847588,Jammu & Kashmir + Ladakh,17,18,21,14,70,Fail
Sukhwinder Verma,14-02-2006,110262,Bihar,14,17,5,5,41,Pass
Krishna D'Souza,16-11-2004,683979,Jammu & Kashmir + Ladakh,11,20,20,19,70,Fail
Aarav Fernandes,25-06-2005,805615,Karnataka,15,8,22,4,49,Pass
Krishna Singh,09-04-2006,641320,Uttar Pradesh,7,14,1,7,29,Fail
Yash Reddy,30-08-2005,903823,Maharashtra,6,22,4,0,32,Fail
Aarav Fernandes,25-06-2005,584476,Uttar Pradesh,12,10,8,13,43,Fail
Yash Singh,16-04-2005,265973,Uttar Pradesh,17,5,3,8,33,Fail
Ayaan Khan,21-04-2005,429508,Uttar Pradesh,16,9,3,15,43,Fail
Aarav Khan,24-03-2005,672468,Andhra Pradesh,24,3,20,20,67,Fail
Aarav Reddy,07-02-2006,479639,Bihar,16,10,4,20,50,Fail
Vivaan Khan,02-01-2005,792333,Tamil Nadu,4,20,16,15,55,Fail
Aryan Verma,14-01-2005,555713,Tamil Nadu,16,20,20,21,77,Pass
Aarav Singh,01-01-2005,629639,Tripura,10,8,9,20,47,Fail
David D'Souza,02-02-2005,278174,Madhya Pradesh,20,19,22,14,75,Fail
Vivaan Fernandes,13-11-2005,771128,Rajasthan,18,11,21,11,61,Fail
Raj Reddy,22-03-2005,937659,Haryana,6,24,19,20,69,Fail
Aarav Chopra,03-04-2006,556514,Rajasthan,21,12,12,8,53,Pass
Raj Pillai,05-05-2005,570321,West Bengal,7,17,16,0,40,Pass
Ishaan Sharma,08-02-2006,404575,Haryana,17,22,1,14,54,Fail
Manpreet Sharma,20-11-2005,653867,Kerala,9,8,8,24,49,Fail
Krishna Singh,04-01-2006,602521,Tamil Nadu,6,21,14,3,44,Pass
Balbir Verma,07-12-2004,113555,Madhya Pradesh,0,20,8,4,32,Fail
Manpreet Chopra,02-05-2006,195285,Bihar,16,24,21,22,83,Pass
Kunal Mehta,06-03-2005,617494,Maharashtra,20,1,9,22,52,Fail
Rohan Fernandes,17-04-2005,743029,Tamil Nadu,11,22,16,11,60,Pass
Aryan Verma,06-10-2005,214509,Maharashtra,5,21,19,14,59,Fail
Yash Pillai,04-01-2005,584133,Bihar,15,19,21,23,78,Fail
Krishna Fernandes,16-12-2005,964723,Maharashtra,16,5,23,16,60,Fail
Raj Singh,21-12-2005,348986,Telangana,3,11,0,1,15,Fail
David D'Souza,13-02-2006,393987,Bihar,20,14,23,12,69,Fail
Rohan Mehta,25-01-2005,435309,Uttarakhand,12,5,6,4,27,Fail
Ishaan Singh,09-04-2006,392174,Gujarat,10,8,10,6,34,Fail
Paul Khan,28-01-2006,271516,Gujarat,18,12,14,0,44,Fail
Aarav Chopra,23-07-2005,134427,Jharkhand,1,21,11,7,40,Pass
David Chopra,29-12-2005,514774,Andhra Pradesh,0,4,11,24,39,Fail
Ishaan Sharma,26-11-2004,916722,Delhi,6,6,2,9,23,Fail
Gurpreet Khan,24-01-2006,961350,Maharashtra,19,0,13,23,55,Fail
Ishaan Fernandes,23-02-2006,384614,Nagaland,2,22,19,14,57,Fail
Manpreet Pillai,15-04-2006,506453,Himachal Pradesh,3,15,21,12,51,Pass
Zaid D'Souza,26-01-2006,113002,Uttar Pradesh,4,10,4,19,37,Fail
David Fernandes,16-01-2006,306708,Uttar Pradesh,5,17,24,16,62,Fail
Balbir D'Souza,18-11-2004,827928,Maharashtra,23,4,19,7,53,Fail
Raj Chopra,01-05-2006,692588,Tamil Nadu,3,2,0,6,11,Pass
Imran Singh,22-04-2005,146212,Bihar,2,7,11,10,30,Pass
Aditya Chopra,11-02-2006,119868,Haryana,8,6,10,8,32,Fail
Aditya Fernandes,01-02-2005,437282,Chhattisgarh,15,6,1,18,40,Fail
Aditya Pillai,16-01-2005,718847,Uttar Pradesh,24,0,16,15,55,Fail
Vivaan Singh,10-04-2006,852351,Gujarat,17,21,24,4,66,Fail
David Sharma,09-11-2004,148409,Jammu & Kashmir + Ladakh,9,17,8,16,50,Pass
Aditya D'Souza,14-02-2006,690645,Bihar,9,7,15,6,37,Pass
Imran Mehta,14-12-2004,229966,Jharkhand,7,0,19,15,41,Pass
Rohan Verma,05-01-2006,136051,West Bengal,24,3,16,22,65,Pass
Ishaan Singh,01-02-2005,522829,Madhya Pradesh,20,4,11,12,47,Fail
Rohan Khan,02-01-2006,342341,Jharkhand,15,3,1,12,31,Pass
Ishaan Verma,10-01-2006,614431,Punjab,18,20,0,5,43,Pass
Manpreet Sharma,19-11-2004,349990,West Bengal,8,5,17,22,52,Pass
Ishaan Chopra,29-01-2006,840952,Tamil Nadu,15,2,21,7,45,Fail
Sukhwinder Fernandes,28-11-2004,337024,Madhya Pradesh,11,3,5,12,31,Fail
Sukhwinder Chopra,16-11-2005,943482,West Bengal,14,23,10,6,53,Pass
Imran Reddy,05-12-2005,250263,Uttar Pradesh,1,3,15,16,35,Fail
Krishna Singh,21-11-2004,578718,Karnataka,12,0,19,18,49,Pass
Harjeet D'Souza,14-03-2005,229407,Madhya Pradesh,15,15,0,12,42,Fail
Rohan Mehta,22-11-2004,616104,West Bengal,21,6,9,15,51,Pass
Sukhwinder Fernandes,11-09-2005,337517,Sikkim,23,19,16,9,67,Fail
Rohan Chopra,21-12-2005,510742,Uttar Pradesh,22,18,13,23,76,Fail
Krishna Chopra,27-01-2006,793046,Mizoram,16,20,5,17,58,Fail
Aditya Verma,29-04-2005,855644,Tamil Nadu,14,12,23,5,54,Fail
Rehan Singh,25-02-2006,508523,Uttar Pradesh,0,8,1,16,25,Fail
Vivaan Verma,14-06-2005,595187,Uttar Pradesh,22,10,15,6,53,Fail
Yash Chopra,07-01-2005,720329,Bihar,3,2,8,15,28,Pass
Aryan Khan,18-01-2006,342332,Kerala,21,17,18,2,58,Fail
Krishna Sharma,18-06-2005,703643,Madhya Pradesh,11,4,19,14,48,Fail
Manpreet Mehta,26-01-2006,700475,Maharashtra,19,7,15,17,58,Fail
Ishaan Pillai,13-03-2006,145149,Maharashtra,13,15,2,3,33,Fail
Ayaan Khan,05-01-2006,892889,Uttar Pradesh,17,4,7,4,32,Fail
Aryan Sharma,13-11-2004,260589,Bihar,2,11,11,0,24,Pass
Harjeet Chopra,19-04-2006,446451,Rajasthan,16,4,4,13,37,Pass
Manpreet Chopra,26-02-2006,181545,Jharkhand,5,10,10,12,37,Pass
Ishaan Fernandes,20-06-2005,585050,Odisha,16,6,17,21,60,Fail
Kunal D'Souza,21-05-2005,101661,Andhra Pradesh,18,23,23,23,87,Fail
Harjeet Singh,25-05-2005,152537,Bihar,19,3,15,17,54,Fail
Aditya Mehta,13-04-2005,227328,Andhra Pradesh,11,2,1,20,34,Fail
Krishna Khan,18-08-2005,113412,Madhya Pradesh,21,8,17,20,66,Fail
Aryan Khan,15-02-2005,135371,Maharashtra,12,20,24,20,76,Fail
Krishna Singh,10-03-2006,933013,Gujarat,23,18,10,3,54,Fail
Balbir Sharma,16-03-2005,976058,Bihar,24,6,4,6,40,Pass
Sukhwinder Chopra,14-03-2006,716760,Maharashtra,5,9,14,13,41,Fail
Vivaan Mehta,07-04-2005,747365,Andhra Pradesh,17,3,21,11,52,Fail
Aditya Reddy,07-12-2005,693437,Odisha,7,8,4,24,43,Pass
Ishaan Sharma,24-01-2006,247669,Bihar,3,24,23,8,58,Fail
Gurpreet D'Souza,31-03-2005,772113,Uttar Pradesh,7,24,2,13,46,Fail
Manpreet Reddy,25-03-2005,665363,Uttar Pradesh,2,0,9,15,26,Fail
Sukhwinder Mehta,27-03-2006,634733,Bihar,24,22,8,19,73,Fail
Aryan Khan,23-02-2005,460248,Uttar Pradesh,6,0,10,3,19,Fail
Aditya Mehta,25-08-2005,878907,Madhya Pradesh,17,12,1,5,35,Fail
Vivaan Mehta,01-02-2006,834471,West Bengal,3,24,10,5,42,Pass
Aarav Khan,21-03-2005,527878,Uttarakhand,13,14,8,11,46,Fail
Aarav Chopra,17-07-2005,185461,Jharkhand,20,14,2,1,37,Pass
Aarav Singh,15-08-2005,771860,Bihar,11,13,5,23,52,Fail
Aditya Verma,05-10-2005,259153,Rajasthan,7,0,8,2,17,Pass
Aditya Mehta,19-02-2006,782128,Andhra Pradesh,24,20,2,12,58,Fail
Aditya Singh,02-02-2006,284674,Uttar Pradesh,9,5,17,18,49,Fail
Rohan Chopra,19-10-2005,919832,Delhi,21,23,3,11,58,Fail
Aryan Sharma,04-01-2005,316473,Karnataka,24,20,10,17,71,Fail
Harjeet Sharma,10-02-2006,192542,Andhra Pradesh,7,9,5,1,22,Fail
Gurpreet Pillai,19-08-2005,278888,West Bengal,23,0,10,18,51,Pass
Peter Verma,21-11-2004,936893,Madhya Pradesh,24,13,24,4,65,Fail
Krishna Sharma,26-05-2005,428446,Delhi,7,19,15,4,45,Fail
Rohan D'Souza,13-02-2006,593493,Rajasthan,4,11,0,2,17,Pass
Vivaan Verma,25-03-2006,184100,Chhattisgarh,1,10,17,11,39,Fail
Vivaan Sharma,28-06-2005,974943,Gujarat,24,22,3,6,55,Fail
Mathew Mehta,11-11-2005,245784,Rajasthan,14,22,5,2,43,Pass
Kunal Mehta,29-01-2006,127483,Telangana,11,13,2,15,41,Fail
Gurpreet Sharma,26-02-2006,116784,Bihar,22,15,15,5,57,Fail
Manpreet Chopra,15-02-2006,850377,Tamil Nadu,14,12,22,8,56,Pass
Kunal Singh,25-01-2006,547590,Karnataka,2,4,18,5,29,Pass
Rohan Khan,05-02-2005,330523,Rajasthan,18,7,21,2,48,Pass
Kunal Reddy,16-02-2005,919239,Uttar Pradesh,23,8,21,16,68,Fail
Rohan Pillai,16-11-2005,911279,Bihar,12,16,9,16,53,Fail
Mathew Pillai,24-12-2005,740014,Karnataka,0,0,7,0,7,Pass
Yash Fernandes,06-07-2005,156177,Kerala,12,18,0,17,47,Fail
Krishna Singh,23-04-2006,496432,Chhattisgarh,14,1,19,1,35,Fail
Vivaan Pillai,18-11-2005,190636,Uttar Pradesh,22,2,11,13,48,Fail
Aditya Reddy,07-01-2006,693327,Jammu & Kashmir + Ladakh,23,0,8,6,37,Pass
Gurpreet Chopra,01-06-2005,370148,Uttar Pradesh,16,0,14,4,34,Fail
Vivaan D'Souza,27-06-2005,350969,Andhra Pradesh,15,15,7,14,51,Fail
Krishna Sharma,24-01-2005,463846,Gujarat,3,20,17,18,58,Fail
Aarav Khan,24-03-2006,721987,Tamil Nadu,22,7,24,4,57,Pass
Vivaan Verma,20-04-2005,516535,Jharkhand,23,5,16,18,62,Pass
Vivaan Sharma,17-05-2005,775469,Madhya Pradesh,24,24,17,3,68,Fail
Aryan Verma,08-07-2005,976175,Haryana,18,2,18,8,46,Fail
David Fernandes,13-05-2005,356691,Uttar Pradesh,13,17,22,19,71,Fail
Aditya Khan,09-08-2005,349112,Jammu & Kashmir + Ladakh,11,18,10,1,40,Pass
Raj Chopra,25-04-2006,767973,Nagaland,13,16,16,1,46,Fail
Paul Mehta,22-02-2005,526809,Bihar,23,24,10,3,60,Fail
John Pillai,07-12-2004,595593,Tamil Nadu,6,1,15,18,40,Pass
Vivaan Singh,11-11-2004,461908,Rajasthan,7,3,17,22,49,Pass
Mathew D'Souza,11-04-2005,960607,Maharashtra,18,16,19,17,70,Fail
Krishna Chopra,03-07-2005,564983,Uttar Pradesh,6,23,15,12,56,Fail
Rohan Verma,17-08-2005,488652,Assam,13,13,3,15,44,Fail
Ishaan Chopra,07-12-2005,862815,Gujarat,13,11,8,13,45,Fail
Rohan D'Souza,10-08-2005,680699,Andhra Pradesh,23,5,19,5,52,Fail
Rohan Sharma,23-03-2006,167946,Tamil Nadu,1,14,2,0,17,Pass
Rohan Sharma,07-08-2005,953745,Tamil Nadu,11,23,8,1,43,Fail
Kunal Verma,11-09-2005,497259,Tamil Nadu,16,6,15,10,47,Pass
Krishna Fernandes,02-10-2005,235486,Telangana,17,2,8,20,47,Fail
Rohan D'Souza,30-05-2005,611885,Haryana,21,8,20,6,55,Fail
Sukhwinder Pillai,11-09-2005,136649,Jammu & Kashmir + Ladakh,7,14,4,23,48,Pass
Krishna Khan,17-09-2005,671308,Uttarakhand,20,4,20,10,54,Fail
Krishna Singh,14-04-2006,353901,Uttar Pradesh,14,19,1,0,34,Fail
Aarav Singh,12-05-2005,303467,Karnataka,10,5,7,23,45,Pass
Aarav Reddy,03-01-2005,948393,Karnataka,1,15,1,17,34,Pass
Ishaan Khan,07-05-2005,531762,Rajasthan,10,9,15,19,53,Pass
Kunal Chopra,23-08-2005,413939,Gujarat,20,19,3,22,64,Fail
Peter Fernandes,05-02-2006,800439,Maharashtra,20,23,10,11,64,Fail
Kunal Pillai,29-04-2005,302584,Punjab,3,11,20,17,51,Fail
Raj Verma,08-06-2005,189982,Assam,24,13,23,11,71,Fail
Aryan Chopra,27-04-2006,646606,Assam,11,3,0,8,22,Fail
Kunal Fernandes,02-04-2005,975677,Delhi,3,8,15,15,41,Fail
David Pillai,09-12-2005,757508,Jharkhand,1,14,6,23,44,Pass
Kunal Sharma,18-07-2005,130419,Himachal Pradesh,2,16,20,3,41,Pass
Aryan Verma,13-01-2005,298486,Odisha,1,5,13,16,35,Pass
Raj Chopra,18-12-2005,119250,Uttar Pradesh,9,10,14,12,45,Fail
Sukhwinder Singh,16-06-2005,814673,Bihar,12,9,7,22,50,Fail
Aryan Verma,09-01-2006,938617,Madhya Pradesh,13,18,22,12,65,Fail
Yash Fernandes,16-12-2005,333357,Tamil Nadu,4,2,1,23,30,Pass
Ishaan Verma,29-11-2005,911291,Uttar Pradesh,16,17,11,8,52,Fail
Rohan Verma,09-04-2006,226939,Bihar,6,21,23,1,51,Fail
Gurpreet Chopra,14-08-2005,158495,West Bengal,16,4,3,3,26,Pass
Raj D'Souza,04-10-2005,209721,Telangana,19,5,14,5,43,Fail
Ishaan Sharma,22-12-2005,735094,Delhi,1,2,17,24,44,Fail
Yash Mehta,12-07-2005,641151,Madhya Pradesh,4,9,5,11,29,Fail
Aryan Singh,22-01-2005,877771,West Bengal,9,5,21,19,54,Pass
Kunal Mehta,08-08-2005,890907,Madhya Pradesh,6,14,20,19,59,Fail
Sukhwinder D'Souza,23-04-2006,920955,Haryana,1,11,9,15,36,Fail
Rohan Chopra,20-01-2005,842793,West Bengal,4,18,12,18,52,Pass
Krishna Singh,03-11-2005,664408,Andhra Pradesh,11,15,0,8,34,Fail
Gurpreet Fernandes,02-07-2005,964851,Maharashtra,8,3,19,10,40,Fail
Manpreet Mehta,26-10-2005,245395,Jharkhand,15,17,10,16,58,Pass
Raj Sharma,16-02-2006,526556,Karnataka,8,15,8,2,33,Pass
Rehan Chopra,28-06-2005,785444,Bihar,20,9,22,1,52,Fail
Aryan Fernandes,12-12-2005,296141,Uttar Pradesh,20,10,20,10,60,Fail
Vivaan Sharma,01-02-2005,528193,Andhra Pradesh,14,12,21,4,51,Fail
Sukhwinder Reddy,26-03-2005,135409,Uttarakhand,3,9,23,23,58,Fail
Peter Khan,10-03-2006,547111,Odisha,0,3,18,11,32,Pass
Aditya Reddy,05-05-2005,785991,Delhi,17,0,8,24,49,Fail
Aarav Mehta,14-10-2005,530010,Maharashtra,3,22,24,2,51,Fail
Kunal Verma,21-01-2006,527455,Punjab,0,15,12,17,44,Pass
Sukhwinder Chopra,18-01-2006,412315,Assam,5,15,3,22,45,Fail
Vivaan Sharma,10-02-2006,528800,Karnataka,19,20,21,12,72,Fail
Raj Fernandes,07-08-2005,826113,Punjab,4,3,5,8,20,Pass
Krishna Singh,19-12-2005,716514,Bihar,0,7,11,13,31,Pass
Kunal Verma,28-07-2005,228830,Uttar Pradesh,11,24,8,18,61,Fail
Manpreet Verma,29-01-2006,339019,Uttarakhand,11,19,7,13,50,Fail
Vivaan Chopra,04-07-2005,416617,Uttarakhand,6,3,24,5,38,Fail
Aryan Singh,19-04-2006,526298,Telangana,7,11,20,24,62,Fail
Farhan Mehta,12-11-2004,495306,Rajasthan,7,15,0,21,43,Pass
Ishaan Fernandes,27-01-2006,640821,Bihar,17,24,6,24,71,Fail
Peter Chopra,21-06-2005,435362,Andhra Pradesh,2,4,4,8,18,Fail
Balbir Mehta,18-03-2005,492364,Bihar,18,13,0,9,40,Pass
Aryan Chopra,02-05-2005,233994,Rajasthan,8,14,13,5,40,Pass
Kunal Khan,28-04-2006,387266,Kerala,1,13,8,24,46,Fail
Manpreet Verma,25-02-2006,401450,Telangana,3,14,1,10,28,Fail
Ishaan D'Souza,30-09-2005,704977,Uttar Pradesh,15,15,12,13,55,Fail
Krishna Reddy,13-07-2005,200289,Telangana,10,22,17,2,51,Fail
Kunal Singh,18-01-2006,579633,Bihar,18,21,24,6,69,Fail
Gurpreet Fernandes,18-04-2005,305938,Maharashtra,3,24,8,6,41,Fail
Vivaan Reddy,08-12-2005,441899,Bihar,13,1,7,13,34,Pass
Balbir D'Souza,09-06-2005,506167,West Bengal,11,22,2,20,55,Pass
Mathew Verma,15-02-2005,883582,Kerala,7,8,23,18,56,Fail
Kunal Singh,28-03-2005,453808,Uttar Pradesh,2,9,1,22,34,Fail
Paul Singh,14-01-2005,239868,Bihar,6,4,14,2,26,Pass
Raj Pillai,30-01-2005,132584,Punjab,5,19,6,13,43,Pass
Aditya Verma,26-02-2006,984746,Haryana,2,6,4,7,19,Fail
Raj Khan,09-01-2005,459151,Punjab,11,20,18,7,56,Fail
Aryan D'Souza,19-07-2005,959304,Karnataka,13,20,18,2,53,Pass
Gurpreet Fernandes,02-03-2005,961206,Telangana,18,13,0,14,45,Fail
Aditya Reddy,26-06-2005,693506,Telangana,7,2,17,13,39,Fail
Krishna Chopra,05-10-2005,574128,Punjab,9,15,15,23,62,Fail
Kunal Sharma,02-05-2005,437078,Odisha,11,22,0,3,36,Pass
John Pillai,17-04-2006,427608,Uttarakhand,10,13,6,2,31,Fail
Harjeet Mehta,28-12-2005,659450,Haryana,0,0,1,6,7,Fail
Raj Khan,16-01-2006,198706,Haryana,21,16,15,6,58,Fail
Peter Mehta,12-12-2004,548926,Punjab,11,9,12,20,52,Fail
Aditya Khan,26-03-2006,613100,Andhra Pradesh,8,0,20,24,52,Fail
John Fernandes,01-04-2005,670681,Tamil Nadu,4,7,16,2,29,Pass
Raj Mehta,06-11-2005,235451,Uttar Pradesh,15,2,10,21,48,Fail
Kunal Reddy,19-11-2005,745989,Telangana,18,16,3,9,46,Fail
Gurpreet Fernandes,02-04-2005,827982,Rajasthan,8,7,5,23,43,Pass
Paul D'Souza,26-09-2005,810349,Andhra Pradesh,7,1,10,0,18,Fail
Yash Singh,19-02-2005,147335,West Bengal,2,5,16,19,42,Pass
Kunal Mehta,23-08-2005,225063,Maharashtra,19,13,15,24,71,Fail
Rohan Reddy,22-12-2004,978086,Kerala,3,24,12,8,47,Fail
Rehan Reddy,13-03-2006,362495,Rajasthan,9,2,13,13,37,Pass
Raj Pillai,31-07-2005,511454,Uttar Pradesh,22,19,11,22,74,Fail
Kunal Reddy,19-12-2004,322272,Haryana,3,23,10,10,46,Fail
Manpreet Sharma,09-11-2005,638184,Uttar Pradesh,2,12,18,23,55,Fail
Paul Singh,05-02-2005,543417,Rajasthan,0,12,14,18,44,Pass
Aarav Reddy,17-10-2005,356352,Telangana,13,13,14,0,40,Fail
Raj Khan,13-04-2005,460529,Madhya Pradesh,20,6,23,16,65,Fail
David Singh,26-06-2005,919740,Maharashtra,7,13,2,4,26,Fail
Kunal D'Souza,20-02-2006,986861,Rajasthan,4,1,13,22,40,Pass
David Singh,09-04-2005,499751,Arunachal Pradesh,6,3,14,3,26,Fail
Sukhwinder Singh,18-09-2005,165586,West Bengal,2,4,24,21,51,Pass
Mathew Mehta,18-11-2005,850089,Jammu & Kashmir + Ladakh,12,4,1,13,30,Pass
Aditya Chopra,01-01-2006,662923,Bihar,13,3,7,1,24,Pass
Raj D'Souza,12-06-2005,744356,Haryana,18,9,14,20,61,Fail
Paul D'Souza,15-12-2005,342925,Haryana,9,4,16,2,31,Fail
Aditya Mehta,23-11-2005,178785,Chhattisgarh,6,22,14,16,58,Fail
Aarav Sharma,02-03-2006,657139,Andhra Pradesh,18,10,6,20,54,Fail
Rohan Verma,08-03-2006,477207,Jharkhand,19,5,16,3,43,Pass
Rehan Reddy,06-08-2005,348942,Karnataka,21,23,20,21,85,Fail
Gurpreet Reddy,08-10-2005,274212,Madhya Pradesh,13,3,3,10,29,Fail
Rohan Sharma,15-08-2005,719848,Madhya Pradesh,12,6,7,4,29,Fail
Kunal Sharma,04-10-2005,841101,Delhi,12,24,22,23,81,Fail
Raj Singh,09-08-2005,779061,Punjab,0,14,13,9,36,Pass
Yash Pillai,10-03-2005,978953,Jammu & Kashmir + Ladakh,17,21,4,11,53,Pass
Manpreet Reddy,13-03-2006,192317,Telangana,2,23,2,23,50,Fail
Vivaan Mehta,20-01-2005,779676,Rajasthan,14,6,4,12,36,Pass
Harjeet Pillai,31-03-2006,126336,Bihar,19,1,24,18,62,Fail
Aryan Fernandes,16-03-2005,270008,Rajasthan,23,2,10,16,51,Pass
Aditya Reddy,08-01-2005,901237,Maharashtra,14,16,13,22,65,Fail
Ishaan Verma,25-12-2004,820023,Maharashtra,6,5,7,18,36,Fail
Sukhwinder Mehta,31-08-2005,858931,West Bengal,19,19,2,24,64,Pass
Aditya Khan,21-12-2005,429762,Gujarat,21,20,11,23,75,Fail
Rohan Fernandes,18-10-2005,857247,Tamil Nadu,9,13,3,0,25,Pass
Kunal Khan,02-04-2005,552606,Tamil Nadu,15,2,13,8,38,Pass
Rohan Sharma,27-08-2005,430415,Punjab,4,11,9,2,26,Pass
Aarav Pillai,14-07-2005,385555,Uttar Pradesh,17,8,2,0,27,Fail
Yash D'Souza,23-02-2005,451536,Maharashtra,23,23,24,7,77,Fail
Sukhwinder Reddy,09-01-2006,576026,Andhra Pradesh,9,15,14,5,43,Fail
Paul Reddy,06-02-2006,453150,Uttar Pradesh,13,1,4,8,26,Fail
Aditya Chopra,20-12-2004,742810,Rajasthan,10,24,9,11,54,Pass
Vivaan Chopra,21-01-2006,833709,Punjab,11,17,22,12,62,Fail
Mathew Mehta,24-02-2005,360213,Gujarat,11,11,5,20,47,Fail
Yash Sharma,08-08-2005,821928,Maharashtra,16,21,11,24,72,Fail
Aarav Fernandes,05-12-2004,716630,Kerala,8,17,21,2,48,Fail
Aarav Mehta,23-12-2005,120157,Punjab,1,18,8,22,49,Fail
Yash Singh,04-08-2005,916420,Rajasthan,1,6,7,16,30,Pass
Raj Mehta,30-03-2005,119337,Punjab,9,19,14,10,52,Fail
Rohan Singh,05-03-2005,362848,Bihar,22,24,15,5,66,Fail
Aryan Pillai,11-06-2005,456367,Bihar,0,7,7,14,28,Pass
Aditya Chopra,17-12-2004,970120,Jharkhand,4,15,3,13,35,Pass
Aarav Pillai,07-03-2006,611140,Tamil Nadu,12,22,21,19,74,Pass
Ishaan Sharma,05-05-2006,174093,Punjab,19,10,24,13,66,Fail
Raj Fernandes,14-02-2005,666957,Uttar Pradesh,18,15,15,5,53,Fail
Harjeet Mehta,08-04-2005,625823,Uttar Pradesh,14,0,13,21,48,Fail
Yash Fernandes,20-02-2005,553193,Kerala,4,5,14,18,41,Fail
Yash Chopra,22-01-2005,702451,Maharashtra,21,18,17,21,77,Fail
Balbir Chopra,02-12-2004,350406,Punjab,15,15,14,2,46,Fail
Yash Pillai,29-11-2005,761504,Kerala,23,4,23,22,72,Fail
Sukhwinder Pillai,12-02-2005,526372,Maharashtra,12,8,19,6,45,Fail
Rohan Khan,30-10-2005,619814,Chhattisgarh,23,7,7,22,59,Fail
Krishna Verma,31-01-2006,327749,Maharashtra,3,10,7,22,42,Fail
Peter Khan,18-02-2006,404387,Punjab,7,7,21,6,41,Pass
Ishaan D'Souza,24-02-2005,331905,Madhya Pradesh,10,10,18,15,53,Fail
Aarav Fernandes,23-12-2004,791593,Bihar,13,8,16,23,60,Fail
Farhan Pillai,01-05-2006,495905,Bihar,9,21,12,13,55,Fail
Rohan Reddy,30-05-2005,737577,Andhra Pradesh,14,5,17,3,39,Fail
Krishna D'Souza,27-12-2005,128252,Uttarakhand,10,19,6,0,35,Fail
Vivaan Sharma,01-11-2005,106317,Jammu & Kashmir + Ladakh,15,19,0,13,47,Pass
Aditya Verma,25-12-2005,125649,Rajasthan,24,17,5,20,66,Fail
Vivaan Singh,08-09-2005,999243,Madhya Pradesh,8,8,22,22,60,Fail
Raj Mehta,23-03-2006,198133,Haryana,21,3,16,24,64,Fail
Gurpreet Pillai,29-12-2004,652218,Uttar Pradesh,10,7,13,8,38,Fail
Raj Sharma,24-07-2005,995074,Bihar,0,20,11,20,51,Fail
Aarav Fernandes,23-09-2005,841351,Assam,4,11,16,7,38,Fail
Aarav Singh,26-08-2005,224484,Maharashtra,17,20,0,18,55,Fail
Aarav Khan,21-01-2006,996125,Jharkhand,20,24,8,16,68,Fail
Aditya D'Souza,19-05-2005,675121,Rajasthan,2,13,12,21,48,Pass
Aarav Mehta,22-12-2005,182075,Tamil Nadu,19,10,14,3,46,Fail
Balbir D'Souza,12-12-2004,285127,Andhra Pradesh,4,10,17,16,47,Fail
Ishaan D'Souza,28-02-2005,286129,Andhra Pradesh,18,5,13,16,52,Fail
Mathew Sharma,03-02-2005,715843,Madhya Pradesh,17,9,20,19,65,Fail
Krishna D'Souza,11-11-2005,644208,Bihar,6,0,23,14,43,Pass
Rehan Mehta,08-08-2005,964731,Assam,1,4,0,17,22,Fail
Raj Reddy,20-01-2006,550487,Madhya Pradesh,12,7,0,21,40,Fail
Krishna Mehta,09-03-2005,487716,Andhra Pradesh,10,13,1,13,37,Fail
Balbir Chopra,09-10-2005,766582,Odisha,4,23,7,17,51,Fail
Rehan Pillai,31-12-2005,363273,Uttar Pradesh,22,14,2,13,51,Fail
Aditya D'Souza,11-08-2005,903848,Madhya Pradesh,20,18,17,22,77,Fail
Farhan Chopra,13-08-2005,468958,Madhya Pradesh,15,2,6,3,26,Fail
Aditya Chopra,31-03-2005,253094,Uttar Pradesh,6,0,24,1,31,Fail
Krishna Mehta,22-12-2005,245859,Assam,13,5,20,7,45,Fail
Vivaan Pillai,27-11-2005,712067,Maharashtra,18,10,1,8,37,Fail
Yash Sharma,03-03-2006,356234,West Bengal,23,10,2,24,59,Pass
Aarav Verma,08-06-2005,966158,Chhattisgarh,21,4,18,10,53,Fail
Aditya Reddy,16-02-2005,490850,Uttar Pradesh,9,17,23,8,57,Fail
Aryan D'Souza,18-07-2005,682761,Jharkhand,21,21,4,13,59,Pass
Aryan Khan,21-07-2005,460766,Uttarakhand,14,22,21,0,57,Fail
Aarav Khan,06-07-2005,445705,Uttarakhand,1,7,23,2,33,Fail
Mathew Singh,20-08-2005,803037,Madhya Pradesh,3,7,19,14,43,Fail
Raj Singh,19-11-2004,701838,Maharashtra,17,12,18,11,58,Fail
John Singh,22-01-2005,254527,Telangana,12,15,19,14,60,Fail
Rohan Mehta,11-11-2004,768214,Uttar Pradesh,4,18,18,19,59,Fail
Balbir Chopra,24-03-2006,803414,Uttarakhand,20,0,15,8,43,Fail
Krishna Sharma,31-03-2006,110157,Kerala,9,19,22,23,73,Fail
Yash Pillai,31-07-2005,869455,West Bengal,15,13,5,19,52,Pass
Aryan Sharma,06-05-2005,745742,Jharkhand,16,16,17,15,64,Pass
Aarav Singh,15-07-2005,235098,Kerala,6,14,22,5,47,Fail
Raj Khan,21-06-2005,484466,Uttar Pradesh,24,15,16,16,71,Fail
Ayaan Reddy,18-12-2005,189643,Uttar Pradesh,7,13,4,8,32,Fail
Aryan Singh,03-11-2005,552314,Maharashtra,1,8,19,5,33,Fail
Yash Reddy,15-04-2005,200316,Karnataka,8,16,17,3,44,Pass
Aditya Pillai,31-12-2004,667034,Uttar Pradesh,11,3,4,10,28,Fail
Sukhwinder Pillai,13-03-2006,808384,Kerala,13,10,12,20,55,Fail
Vivaan Singh,19-11-2005,854028,Uttar Pradesh,7,4,20,21,52,Fail
Ishaan Chopra,19-12-2005,578359,Andhra Pradesh,4,18,10,4,36,Fail
Rohan Verma,20-10-2005,736732,Rajasthan,15,22,12,7,56,Pass
Aarav Fernandes,09-07-2005,237867,Karnataka,13,18,13,18,62,Pass
Aarav Mehta,14-11-2004,547354,Meghalaya,0,21,20,3,44,Pass
Aditya Sharma,03-03-2006,858456,Assam,1,24,20,0,45,Fail
Yash Singh,24-07-2005,426907,Maharashtra,15,6,21,20,62,Fail
Aarav Fernandes,09-06-2005,160060,Telangana,18,20,12,22,72,Fail
Rohan Sharma,09-03-2005,393784,Tamil Nadu,10,1,24,12,47,Pass
Aarav Sharma,17-04-2006,600727,Rajasthan,12,6,18,19,55,Pass
John Reddy,17-04-2005,458952,Tamil Nadu,10,10,19,0,39,Pass
Krishna Singh,24-12-2004,314129,Tamil Nadu,23,21,19,10,73,Pass
Krishna Verma,26-05-2005,909328,Puducherry,16,8,2,17,43,Pass
Aarav Fernandes,10-04-2006,325744,Gujarat,10,2,11,15,38,Fail
Aarav Chopra,10-12-2004,112905,Bihar,19,19,12,13,63,Fail
Aarav Mehta,09-07-2005,691793,Rajasthan,12,8,5,22,47,Pass
John Pillai,14-12-2004,697134,Jammu & Kashmir + Ladakh,19,8,23,18,68,Fail
Yash Singh,25-01-2005,718528,Chhattisgarh,0,10,6,20,36,Fail
Rehan Pillai,12-01-2006,162649,Uttar Pradesh,6,13,13,9,41,Fail
Aryan Pillai,18-08-2005,925932,Uttar Pradesh,12,19,24,17,72,Fail
David Fernandes,07-04-2006,534064,West Bengal,2,1,9,0,12,Pass
Rohan Pillai,19-03-2005,917983,Tamil Nadu,9,11,12,14,46,Fail
Paul Khan,30-11-2005,101694,Rajasthan,10,6,18,7,41,Pass
Raj D'Souza,21-01-2006,417076,Kerala,24,15,8,17,64,Fail
Rohan Pillai,18-02-2006,925458,Rajasthan,18,6,15,18,57,Pass
Krishna Mehta,28-11-2005,225242,Tamil Nadu,7,3,24,4,38,Pass
Aarav Singh,14-04-2005,405651,Maharashtra,10,20,17,0,47,Fail
Ishaan Verma,07-03-2005,622498,Odisha,1,21,19,6,47,Fail
Sukhwinder Verma,28-11-2005,894034,Assam,9,23,17,21,70,Fail
Raj Khan,29-04-2006,600071,Punjab,21,22,16,14,73,Fail
Manpreet Verma,24-07-2005,749609,Maharashtra,20,5,13,24,62,Fail
Raj Reddy,24-03-2005,968514,Punjab,16,20,24,20,80,Pass
Ishaan Chopra,26-05-2005,805387,Assam,1,9,8,13,31,Fail
Aarav D'Souza,18-10-2005,371463,Maharashtra,11,24,18,13,66,Fail
Vivaan Fernandes,22-01-2006,420091,Bihar,13,13,15,4,45,Pass
Kunal Sharma,22-08-2005,955635,Andhra Pradesh,22,14,18,17,71,Fail
Rohan Singh,10-10-2005,446075,Telangana,2,12,19,15,48,Fail
Ishaan Verma,03-03-2005,290611,Telangana,8,5,16,3,32,Fail
Rehan Fernandes,24-01-2006,120731,Maharashtra,16,3,9,5,33,Fail
Sukhwinder Sharma,23-09-2005,758204,Meghalaya,5,0,21,20,46,Fail
Aditya Chopra,19-03-2005,796665,Jharkhand,21,14,0,9,44,Pass
Aryan Singh,30-12-2004,713805,Bihar,15,15,2,4,36,Pass
Aryan Sharma,19-09-2005,702773,Assam,13,6,11,7,37,Fail
Balbir Mehta,16-11-2004,854940,Punjab,13,5,24,17,59,Fail
Ayaan Chopra,07-04-2006,405666,West Bengal,22,0,14,10,46,Pass
Vivaan Reddy,15-02-2006,375789,Tamil Nadu,5,20,1,8,34,Pass
Aditya Fernandes,24-12-2005,264341,Uttar Pradesh,14,2,23,24,63,Fail
Kunal D'Souza,11-05-2005,447231,Delhi,6,10,11,3,30,Fail
Aditya Fernandes,11-01-2005,380700,Jharkhand,21,14,7,21,63,Pass
Yash Chopra,11-04-2005,165439,Delhi,1,20,24,9,54,Fail
Yash Khan,17-04-2005,128111,West Bengal,11,6,14,19,50,Pass
Gurpreet Reddy,04-07-2005,707887,Haryana,5,18,19,2,44,Fail
Manpreet Sharma,03-12-2004,790202,Tamil Nadu,21,20,19,11,71,Pass
Raj Fernandes,13-11-2005,591080,Karnataka,23,5,24,11,63,Pass
Raj Sharma,20-01-2005,497260,Assam,4,11,11,22,48,Fail
Kunal Chopra,06-05-2006,836427,Uttar Pradesh,8,23,24,24,79,Fail
Aarav Reddy,15-06-2005,512298,Gujarat,9,15,4,17,45,Fail
Vivaan Chopra,10-06-2005,709085,Maharashtra,23,23,12,12,70,Fail
Ishaan Mehta,24-11-2005,671777,Bihar,21,20,18,9,68,Fail
Aryan Pillai,21-03-2006,327109,Andhra Pradesh,8,0,3,7,18,Fail
Aarav Singh,20-12-2004,155717,Bihar,19,5,7,11,42,Pass
Kunal D'Souza,18-12-2004,166056,Madhya Pradesh,22,24,12,18,76,Fail
Rohan Pillai,05-01-2006,584550,Madhya Pradesh,9,15,22,17,63,Fail
Mathew Mehta,17-08-2005,490505,Chhattisgarh,12,15,9,3,39,Fail
Yash Reddy,05-01-2006,891308,Odisha,16,9,15,22,62,Fail
Aditya Chopra,06-02-2006,632512,Uttar Pradesh,9,22,20,21,72,Fail
Krishna Verma,15-04-2006,124903,Haryana,0,15,10,3,28,Fail
Aditya D'Souza,18-12-2005,325690,Maharashtra,17,1,21,19,58,Fail
Vivaan Pillai,08-08-2005,326229,Odisha,13,10,4,15,42,Pass
Paul Reddy,02-03-2005,406193,Bihar,3,9,6,23,41,Pass
Raj Reddy,12-02-2006,859687,Jharkhand,9,10,22,6,47,Pass
Kunal Reddy,28-06-2005,152437,Gujarat,20,11,5,11,47,Fail
Rohan Khan,14-07-2005,615863,Nagaland,14,0,24,15,53,Fail
Aarav Verma,26-01-2006,568147,Uttar Pradesh,0,18,22,1,41,Fail
Krishna Singh,12-02-2006,930040,Tamil Nadu,10,10,24,18,62,Pass
Gurpreet Singh,08-05-2006,126732,Karnataka,5,17,3,13,38,Pass
Raj Sharma,11-06-2005,718946,Gujarat,13,22,19,5,59,Fail
Aditya Khan,23-12-2005,320594,Jharkhand,9,13,15,14,51,Pass
Manpreet Pillai,07-11-2004,758186,Tamil Nadu,12,2,18,12,44,Pass
Raj Chopra,16-07-2005,974944,Tamil Nadu,3,0,10,5,18,Pass
Krishna Mehta,17-01-2006,565422,Telangana,11,14,23,1,49,Fail
Rohan Verma,15-03-2005,182910,Karnataka,11,22,19,7,59,Pass
Kunal Verma,30-12-2005,345257,West Bengal,1,21,12,19,53,Pass
Ishaan D'Souza,10-01-2006,264748,Odisha,20,5,4,17,46,Fail
Aarav Sharma,14-06-2005,399352,Meghalaya,5,22,24,6,57,Fail
Ishaan Pillai,08-09-2005,423393,Bihar,20,22,19,14,75,Fail
Sukhwinder Sharma,26-08-2005,826195,Bihar,11,14,24,7,56,Fail
Paul Mehta,24-02-2005,459696,Bihar,2,8,16,18,44,Pass
Aryan Mehta,01-05-2006,538310,Bihar,22,16,4,15,57,Fail
Mathew D'Souza,25-01-2006,550882,Maharashtra,22,0,12,14,48,Fail
Ishaan Sharma,11-05-2005,930361,Uttar Pradesh,1,18,1,9,29,Fail
Yash Reddy,08-12-2004,603630,Chhattisgarh,4,19,3,5,31,Fail
Krishna Khan,23-02-2006,656414,Himachal Pradesh,11,0,4,4,19,Pass
Vivaan Khan,21-04-2005,321327,Odisha,14,15,19,20,68,Fail
Raj Verma,18-01-2005,882527,Uttarakhand,11,12,3,17,43,Fail
Krishna Reddy,19-04-2005,306816,Kerala,4,22,24,9,59,Fail
Imran Verma,09-11-2004,376350,West Bengal,10,4,1,3,18,Pass
Harjeet Sharma,14-12-2005,722811,Rajasthan,2,17,17,8,44,Pass
Krishna D'Souza,24-07-2005,480520,Uttarakhand,20,21,24,21,86,Fail
Balbir Mehta,31-01-2006,229797,Assam,7,1,13,9,30,Fail
Gurpreet Verma,03-03-2006,196684,West Bengal,17,17,2,18,54,Pass
Ishaan Fernandes,10-08-2005,468216,Uttar Pradesh,15,3,2,7,27,Fail
Aditya Chopra,18-11-2005,917386,Chhattisgarh,21,17,21,0,59,Fail
Harjeet D'Souza,13-08-2005,917319,Goa,24,2,15,13,54,Fail
Ishaan Pillai,05-04-2005,172405,Kerala,8,12,2,12,34,Fail
Yash Chopra,07-08-2005,864372,Bihar,6,0,24,18,48,Fail
Mathew Khan,01-01-2006,709029,Rajasthan,13,4,3,14,34,Pass
Aarav Pillai,30-05-2005,243119,Punjab,18,23,10,7,58,Fail
Rohan Khan,13-10-2005,739636,Punjab,6,7,3,1,17,Pass
Aditya Verma,12-02-2006,873471,Tamil Nadu,9,17,20,9,55,Fail
Manpreet Reddy,11-12-2005,248288,Uttarakhand,24,24,10,2,60,Fail
Mathew Mehta,19-08-2005,337833,Madhya Pradesh,8,1,14,2,25,Fail
Ishaan Khan,25-06-2005,575638,Haryana,14,8,5,22,49,Fail
Balbir Sharma,06-03-2006,202808,Assam,21,14,5,3,43,Fail
Ishaan Khan,17-07-2005,689276,Haryana,10,11,16,22,59,Fail
Aditya Fernandes,08-04-2005,566364,Maharashtra,17,14,23,23,77,Fail
Peter Mehta,16-04-2006,917869,Rajasthan,2,22,9,19,52,Pass
Vivaan Fernandes,18-04-2006,263332,Uttar Pradesh,11,0,13,22,46,Fail
Yash Chopra,11-01-2005,520448,Rajasthan,11,0,4,16,31,Pass
Raj Pillai,15-04-2005,256894,Bihar,3,3,0,3,9,Pass
Aditya Fernandes,15-02-2006,876381,Karnataka,22,24,11,1,58,Pass
Kunal Singh,13-03-2005,251039,Rajasthan,0,23,18,15,56,Pass
Aarav Verma,03-07-2005,864802,Maharashtra,8,13,6,13,40,Fail
Aarav Chopra,22-11-2004,865363,Rajasthan,6,9,7,23,45,Pass
Krishna Mehta,05-01-2006,776524,Tamil Nadu,13,1,18,7,39,Pass
Krishna Verma,26-01-2005,526161,Tamil Nadu,17,15,19,8,59,Pass
Gurpreet Pillai,29-10-2005,175925,West Bengal,15,11,2,24,52,Pass
Vivaan Pillai,24-06-2005,563609,Uttarakhand,16,4,8,16,44,Fail
Rohan Reddy,30-03-2006,121319,Rajasthan,18,5,8,16,47,Pass
Mathew Sharma,10-02-2005,761038,Madhya Pradesh,4,18,15,7,44,Fail
Sukhwinder D'Souza,08-02-2006,202790,Rajasthan,11,14,14,16,55,Pass
Vivaan Pillai,20-10-2005,234831,Jharkhand,9,5,0,21,35,Pass
Raj Fernandes,02-02-2005,726806,West Bengal,20,19,2,5,46,Pass
Krishna Sharma,03-01-2005,559125,Karnataka,24,18,3,17,62,Pass
Harjeet D'Souza,25-04-2006,378882,Andhra Pradesh,13,8,23,4,48,Fail
Vivaan Sharma,17-03-2006,108093,Jharkhand,16,19,5,4,44,Pass
Gurpreet Khan,07-04-2005,204601,Telangana,23,2,22,17,64,Fail
David Verma,01-10-2005,118765,West Bengal,10,3,9,13,35,Pass
Paul Singh,30-04-2005,486629,West Bengal,8,20,2,17,47,Pass
Aarav Verma,04-01-2005,463733,Uttar Pradesh,14,18,4,22,58,Fail
Paul D'Souza,02-10-2005,627936,Bihar,22,9,13,0,44,Pass
Aarav Reddy,20-06-2005,413085,Gujarat,14,2,23,14,53,Fail
Gurpreet Mehta,03-12-2004,355243,Uttar Pradesh,6,5,16,1,28,Fail
Balbir Pillai,11-11-2004,916194,Telangana,22,14,5,19,60,Fail
Yash Singh,19-03-2006,713016,Madhya Pradesh,7,11,21,20,59,Fail
David Singh,16-12-2005,651458,Uttarakhand,7,11,13,4,35,Fail
Aryan Singh,30-11-2004,670939,Rajasthan,10,14,16,22,62,Fail
Ishaan Verma,24-03-2005,992364,Jharkhand,17,23,9,6,55,Pass
Rohan Mehta,21-01-2006,589480,Haryana,10,6,22,2,40,Fail
Kunal Sharma,02-03-2006,498963,Karnataka,6,5,4,17,32,Pass
Krishna Singh,13-09-2005,832347,Himachal Pradesh,18,2,20,2,42,Pass
Kunal Singh,17-12-2004,874821,Tamil Nadu,4,20,23,1,48,Fail
Rohan Khan,21-11-2005,754549,Delhi,22,0,3,4,29,Fail
Yash Mehta,19-09-2005,450680,Jharkhand,16,17,21,3,57,Pass
Rohan Fernandes,13-02-2006,614024,Telangana,5,16,11,24,56,Fail
Ishaan Sharma,15-06-2005,879505,Rajasthan,24,15,5,7,51,Pass
Rohan Chopra,28-12-2004,552714,Assam,9,24,19,21,73,Fail
Aryan Khan,02-09-2005,678942,West Bengal,4,23,15,7,49,Pass
Krishna Singh,11-01-2006,627881,Maharashtra,5,22,13,2,42,Fail
Vivaan Chopra,05-03-2006,142468,West Bengal,15,3,14,3,35,Pass
Yash D'Souza,06-02-2006,557244,Punjab,14,18,9,3,44,Pass
Vivaan Singh,24-08-2005,882675,Tamil Nadu,20,12,5,9,46,Fail
Vivaan D'Souza,17-08-2005,747095,Madhya Pradesh,13,21,11,11,56,Fail
Ishaan Singh,30-01-2006,622875,Bihar,6,20,0,15,41,Pass
Aditya Chopra,30-01-2005,104089,Tamil Nadu,1,16,13,20,50,Fail
Raj Reddy,21-07-2005,575386,Bihar,6,6,10,20,42,Pass
Aarav Singh,04-03-2005,883957,Chhattisgarh,4,16,21,14,55,Fail
Aryan Fernandes,19-08-2005,909581,Maharashtra,10,24,10,17,61,Fail
Krishna Singh,10-11-2005,950164,Bihar,4,4,22,2,32,Pass
Krishna Khan,09-09-2005,820475,Maharashtra,19,10,6,16,51,Fail
Harjeet Reddy,10-11-2004,534614,Punjab,16,15,22,4,57,Fail
Krishna Sharma,15-03-2005,610812,Punjab,8,23,9,13,53,Fail
Peter Verma,26-05-2005,860428,West Bengal,24,20,2,8,54,Pass
Aditya Chopra,15-12-2005,131954,Rajasthan,24,2,17,24,67,Fail
Vivaan Reddy,19-11-2005,598541,West Bengal,8,8,21,3,40,Pass
Harjeet Chopra,17-11-2004,556875,Tripura,0,22,24,24,70,Fail
Yash Fernandes,24-11-2004,354095,Madhya Pradesh,20,11,21,5,57,Fail
Paul Chopra,29-04-2006,787151,Manipur,5,21,13,8,47,Fail
Aarav Reddy,28-11-2004,821208,Bihar,23,5,0,19,47,Fail
Paul Chopra,20-04-2006,993398,Odisha,5,23,12,22,62,Fail
Paul D'Souza,16-10-2005,689591,Odisha,6,5,11,2,24,Pass
Aryan Singh,26-03-2005,930360,Uttar Pradesh,3,18,23,13,57,Fail
Ishaan Reddy,07-02-2005,930556,Odisha,10,18,0,6,34,Pass
Aditya Verma,01-10-2005,336063,Uttar Pradesh,5,9,17,21,52,Fail
Mathew Pillai,16-04-2006,990392,Assam,20,19,24,18,81,Fail
Aarav Singh,19-10-2005,340168,Bihar,4,21,2,1,28,Pass
Manpreet Chopra,15-12-2004,659720,Tamil Nadu,13,22,6,14,55,Fail
Ishaan Fernandes,11-01-2005,754674,Tamil Nadu,24,20,23,7,74,Pass
Krishna Singh,29-11-2004,834954,Karnataka,4,11,19,21,55,Pass
Aditya Reddy,01-09-2005,575337,West Bengal,9,12,5,18,44,Pass
John Fernandes,13-12-2004,976176,Bihar,15,0,7,17,39,Pass
Kunal Khan,21-03-2005,855290,Nagaland,12,11,0,23,46,Fail
Ishaan Pillai,14-04-2006,642206,Uttar Pradesh,18,1,10,6,35,Fail
Ishaan Singh,10-08-2005,483812,Uttar Pradesh,20,8,10,24,62,Fail
Ayaan D'Souza,22-01-2006,897672,Kerala,2,9,11,3,25,Fail
Aryan Singh,15-09-2005,548901,Gujarat,13,1,12,21,47,Fail
Aditya Khan,13-06-2005,372142,Maharashtra,13,17,5,24,59,Fail
Ayaan Pillai,07-11-2004,747246,Bihar,19,4,23,12,58,Fail
Krishna Sharma,02-02-2006,218810,Uttar Pradesh,0,20,7,1,28,Fail
Aarav Singh,21-07-2005,608004,West Bengal,15,24,2,13,54,Pass
Yash Verma,22-12-2004,847771,Meghalaya,5,12,4,14,35,Pass
Sukhwinder Singh,01-12-2004,476257,Bihar,4,21,6,15,46,Fail
Harjeet Fernandes,19-04-2005,900743,Punjab,9,19,21,10,59,Fail
Manpreet Chopra,27-07-2005,346924,Rajasthan,15,1,1,2,19,Pass
Yash Fernandes,23-06-2005,837478,Delhi,14,21,22,18,75,Fail
Manpreet Reddy,08-02-2006,397616,Gujarat,16,11,15,0,42,Fail
Aryan Chopra,24-02-2005,370276,Madhya Pradesh,5,22,19,23,69,Fail
Aryan Khan,10-04-2006,117000,Rajasthan,11,4,3,23,41,Pass
Vivaan Sharma,04-07-2005,674023,Bihar,11,7,22,17,57,Fail
Raj Verma,07-10-2005,389643,Rajasthan,0,6,17,1,24,Pass
Ishaan Singh,05-02-2006,837700,Madhya Pradesh,8,3,7,19,37,Fail
Peter Sharma,14-06-2005,379599,Assam,12,12,11,13,48,Fail
Manpreet Reddy,15-01-2005,490867,Maharashtra,9,12,8,23,52,Fail
Ishaan Chopra,31-08-2005,651424,Bihar,17,23,0,24,64,Fail
David Pillai,02-02-2006,210195,Madhya Pradesh,20,22,1,8,51,Fail
Kunal D'Souza,22-06-2005,691781,Jammu & Kashmir + Ladakh,7,19,14,3,43,Pass
Rohan Verma,17-01-2006,763722,Chhattisgarh,3,18,8,0,29,Fail
Aditya Verma,21-12-2004,699825,Uttar Pradesh,22,11,0,13,46,Fail
Aryan Singh,06-03-2006,549396,Jammu & Kashmir + Ladakh,6,7,17,2,32,Pass
Yash Verma,01-09-2005,508272,Delhi,20,9,12,21,62,Fail
Yash Verma,14-04-2006,808233,Rajasthan,6,21,19,0,46,Pass
Peter D'Souza,06-03-2006,356122,Delhi,11,12,3,13,39,Fail
Kunal Verma,09-08-2005,375109,Tripura,16,11,10,13,50,Fail
Harjeet Fernandes,17-02-2006,902303,Karnataka,13,23,19,8,63,Pass
Aditya Reddy,16-11-2004,742802,Odisha,12,14,22,9,57,Fail
Aditya Khan,09-04-2006,770826,Jharkhand,7,16,12,13,48,Pass
Imran Singh,23-02-2005,222748,Madhya Pradesh,24,23,5,5,57,Fail
Balbir D'Souza,19-11-2004,634580,West Bengal,22,1,16,7,46,Pass
Krishna Sharma,22-02-2006,773530,Mizoram,1,15,9,21,46,Fail
Sukhwinder Reddy,05-01-2005,299831,Madhya Pradesh,8,5,10,15,38,Fail
Ishaan Singh,22-02-2005,302377,Gujarat,22,13,10,14,59,Fail
Aarav Chopra,12-05-2005,449532,Maharashtra,6,20,23,21,70,Fail
John D'Souza,04-07-2005,167211,Jammu & Kashmir + Ladakh,3,10,19,9,41,Pass
Paul Pillai,08-12-2004,407387,Uttar Pradesh,14,17,4,13,48,Fail
Aryan Reddy,27-04-2005,548648,Bihar,13,6,14,6,39,Pass
Aryan Khan,08-01-2006,570140,Tamil Nadu,16,2,7,4,29,Pass
Krishna Singh,09-01-2005,656260,Tamil Nadu,10,12,11,24,57,Pass
Aryan Mehta,15-07-2005,821588,Madhya Pradesh,24,20,9,6,59,Fail
Yash Pillai,30-06-2005,115261,West Bengal,18,12,22,2,54,Pass
Aarav Sharma,30-05-2005,900138,Rajasthan,18,18,9,8,53,Pass
Kunal D'Souza,29-11-2004,819766,Uttarakhand,11,8,0,7,26,Fail
Krishna Khan,24-12-2005,700421,Bihar,10,16,9,3,38,Pass
Aarav Fernandes,02-10-2005,663685,West Bengal,21,17,4,0,42,Pass
Kunal Singh,23-12-2005,143939,Bihar,7,14,2,1,24,Pass
Kunal Verma,08-05-2005,783464,Karnataka,9,10,8,15,42,Pass
Balbir Khan,18-08-2005,628720,Bihar,15,12,12,0,39,Pass
Kunal Khan,01-07-2005,605259,Rajasthan,12,5,20,14,51,Pass
Paul Khan,01-02-2006,471037,Bihar,19,22,21,17,79,Fail
John Chopra,28-11-2005,252020,Uttar Pradesh,18,5,22,20,65,Fail
Mathew Khan,09-11-2005,605436,Tamil Nadu,9,12,7,10,38,Pass
Rehan Mehta,19-06-2005,337277,Nagaland,8,15,14,19,56,Fail
Yash Verma,13-03-2005,618379,Gujarat,10,13,22,20,65,Fail
Harjeet Reddy,17-06-2005,896924,Andhra Pradesh,6,23,1,21,51,Fail
Mathew Singh,28-03-2005,648265,Punjab,23,17,19,16,75,Fail
Ishaan Pillai,28-01-2005,785523,Arunachal Pradesh,9,11,24,24,68,Fail
Aarav Pillai,12-11-2004,605493,Kerala,4,18,17,0,39,Fail
Vivaan D'Souza,11-09-2005,902103,Punjab,9,22,13,18,62,Fail
Balbir Fernandes,13-05-2005,584942,Maharashtra,7,22,12,11,52,Fail
Aarav Chopra,14-01-2006,219878,Rajasthan,0,16,15,15,46,Pass
Kunal Singh,06-01-2006,182761,Rajasthan,11,23,20,3,57,Pass
Manpreet D'Souza,15-02-2005,438244,Tamil Nadu,14,12,14,19,59,Pass
Aarav Reddy,30-05-2005,699522,Madhya Pradesh,14,7,0,18,39,Fail
Rohan Mehta,05-03-2005,294667,Telangana,10,11,1,21,43,Fail
Ishaan Singh,15-03-2005,651840,Uttar Pradesh,6,4,9,6,25,Fail
Krishna Khan,10-04-2006,580947,Andhra Pradesh,2,8,10,7,27,Fail
Aarav Pillai,24-02-2005,838773,West Bengal,6,1,21,18,46,Pass
Ishaan Pillai,18-04-2006,327478,Telangana,4,20,0,18,42,Fail
Vivaan Sharma,07-11-2005,584241,Haryana,3,3,18,20,44,Fail
Vivaan D'Souza,03-03-2006,362477,Haryana,15,5,9,18,47,Fail
Yash Khan,18-02-2006,491029,Bihar,6,17,21,14,58,Fail
Imran Pillai,05-02-2006,133772,Punjab,15,11,2,6,34,Pass
Rohan Mehta,14-10-2005,958489,Tamil Nadu,4,16,16,23,59,Pass
Harjeet Sharma,11-10-2005,288232,Rajasthan,8,5,4,6,23,Pass
Aarav Pillai,25-01-2005,221413,Bihar,7,3,9,11,30,Pass
Aarav Sharma,04-10-2005,694837,Tamil Nadu,20,13,19,11,63,Fail
Aditya Sharma,18-08-2005,829388,Kerala,7,23,1,5,36,Fail
Rohan Fernandes,08-01-2006,870280,Uttarakhand,22,5,0,1,28,Fail
Aryan Reddy,18-12-2004,775322,Uttar Pradesh,24,21,16,16,77,Fail
Rehan Khan,13-11-2005,870926,Maharashtra,4,14,18,4,40,Fail
Ishaan Fernandes,25-11-2004,333489,Tripura,8,17,22,13,60,Fail
Harjeet Singh,02-04-2005,859835,Maharashtra,22,13,0,5,40,Fail
Ishaan Singh,02-06-2005,855994,Karnataka,22,17,9,20,68,Fail
Yash Khan,10-02-2005,451019,Bihar,20,9,2,18,49,Fail
David Fernandes,28-01-2005,711851,Telangana,4,12,9,0,25,Fail
Raj Reddy,17-12-2005,787370,Chhattisgarh,8,12,6,7,33,Fail
Aryan Mehta,27-12-2004,374515,Uttar Pradesh,1,3,20,4,28,Fail
Gurpreet Reddy,08-08-2005,491067,Uttar Pradesh,1,3,12,23,39,Fail
Vivaan Singh,26-10-2005,141760,Maharashtra,0,14,2,12,28,Fail
Yash Chopra,10-08-2005,979829,Bihar,12,13,15,15,55,Fail
Aarav Singh,02-04-2005,539315,Delhi,3,18,19,13,53,Fail
Aarav Khan,18-04-2006,981831,Bihar,23,8,14,4,49,Fail
Ishaan Singh,04-02-2005,268198,Uttar Pradesh,13,19,21,2,55,Fail
Sukhwinder D'Souza,03-05-2006,696925,Delhi,0,18,4,20,42,Fail
Vivaan Fernandes,12-07-2005,616983,Maharashtra,8,18,10,8,44,Fail
Ayaan Singh,06-06-2005,869798,Telangana,0,7,12,16,35,Fail
Aditya Singh,06-12-2005,775631,Uttar Pradesh,8,24,24,23,79,Fail
Kunal Sharma,06-02-2006,892928,Kerala,21,13,9,18,61,Fail
Manpreet Singh,18-12-2004,333405,Jammu & Kashmir + Ladakh,19,7,19,11,56,Pass
Imran Chopra,04-12-2004,884222,Madhya Pradesh,23,24,4,18,69,Fail
Raj Singh,21-05-2005,809763,West Bengal,4,22,2,11,39,Pass
Harjeet Singh,15-04-2006,702049,Bihar,9,4,17,7,37,Pass
Yash Sharma,21-01-2006,243413,Andhra Pradesh,6,10,3,23,42,Fail
Zaid Sharma,20-05-2005,267556,Rajasthan,21,7,15,11,54,Pass
Farhan Sharma,11-03-2006,838740,Gujarat,18,1,7,2,28,Fail
Mathew Pillai,19-03-2005,533201,Bihar,16,17,0,22,55,Fail
Zaid Fernandes,15-12-2004,149001,Andhra Pradesh,2,12,15,9,38,Fail
Raj Mehta,29-03-2005,809550,Uttar Pradesh,19,3,24,20,66,Fail
Gurpreet Fernandes,16-05-2005,121686,Maharashtra,21,8,7,5,41,Fail
Aryan Singh,19-10-2005,712947,Uttar Pradesh,8,7,20,7,42,Fail
Farhan Pillai,27-06-2005,727464,Maharashtra,24,3,24,20,71,Fail
Raj Sharma,18-11-2004,274030,Andhra Pradesh,17,20,0,17,54,Fail
Gurpreet Khan,14-03-2006,491341,Himachal Pradesh,12,3,15,4,34,Pass
Ishaan Khan,11-02-2005,932099,Maharashtra,24,16,8,1,49,Fail
Manpreet Fernandes,14-11-2005,624489,Rajasthan,20,3,16,3,42,Pass
Raj Pillai,12-03-2006,587849,Chhattisgarh,11,17,2,12,42,Fail
Yash Verma,01-03-2006,333905,Bihar,18,8,12,24,62,Fail
Manpreet D'Souza,02-05-2005,951895,Kerala,21,8,18,0,47,Fail
Rohan Reddy,05-05-2005,840494,Karnataka,22,15,24,4,65,Pass
Raj D'Souza,07-01-2006,370392,Gujarat,9,7,7,23,46,Fail
Imran D'Souza,05-08-2005,762662,West Bengal,12,15,2,22,51,Pass
Aarav Fernandes,28-11-2005,701917,Haryana,18,15,2,3,38,Fail
Aryan Reddy,07-01-2005,390634,Maharashtra,22,6,8,0,36,Fail
Rohan Pillai,09-02-2006,344512,West Bengal,12,14,9,12,47,Pass
Aditya D'Souza,12-12-2004,332910,Rajasthan,4,4,0,8,16,Pass
Aryan Pillai,24-01-2005,148984,Bihar,5,12,15,11,43,Pass
Aditya Singh,15-10-2005,120188,Uttar Pradesh,1,12,14,19,46,Fail
Krishna Sharma,02-03-2005,662601,Telangana,7,11,18,15,51,Fail
Krishna Verma,06-07-2005,445468,Jammu & Kashmir + Ladakh,7,14,11,18,50,Pass
Aditya Fernandes,26-02-2006,631792,Meghalaya,0,18,20,15,53,Fail
Aditya Pillai,11-03-2006,196888,Telangana,22,22,19,2,65,Fail
Yash D'Souza,02-10-2005,930107,Gujarat,2,16,24,23,65,Fail
Raj Sharma,16-04-2006,589103,Andhra Pradesh,12,11,6,14,43,Fail
Manpreet Pillai,10-01-2006,261010,Bihar,17,23,15,18,73,Fail
Rohan Khan,07-08-2005,234244,Uttarakhand,16,1,24,19,60,Fail
Kunal Singh,12-11-2005,853831,Jammu & Kashmir + Ladakh,13,2,18,23,56,Pass
Aditya Singh,04-05-2006,396655,Rajasthan,7,21,3,12,43,Pass
Ishaan Chopra,13-02-2006,304681,Karnataka,6,4,23,4,37,Pass
Kunal D'Souza,13-11-2004,256991,Kerala,19,21,13,16,69,Fail
Aditya Reddy,06-12-2004,684718,Tamil Nadu,7,13,5,2,27,Pass
Kunal Chopra,01-02-2006,184068,Madhya Pradesh,14,18,3,3,38,Fail
Aryan Singh,19-01-2005,882198,West Bengal,14,14,4,12,44,Pass
Manpreet Pillai,02-10-2005,675419,Manipur,4,16,20,8,48,Fail
Yash Khan,03-11-2005,591852,West Bengal,14,20,4,14,52,Pass
Raj Mehta,15-02-2006,999147,Madhya Pradesh,12,4,0,11,27,Fail
Rehan Khan,05-12-2004,510151,West Bengal,19,2,9,24,54,Pass
David Verma,28-10-2005,341432,Madhya Pradesh,11,3,22,16,52,Fail
Rohan Mehta,01-05-2005,146896,Gujarat,7,3,14,18,42,Fail
Manpreet Sharma,11-03-2006,626772,Tamil Nadu,18,23,0,19,60,Pass
Raj Singh,19-07-2005,500906,Haryana,21,0,22,9,52,Fail
Peter D'Souza,29-01-2005,468759,Gujarat,5,11,2,9,27,Fail
Kunal Sharma,05-09-2005,636206,West Bengal,13,7,17,7,44,Pass
John D'Souza,11-03-2005,698721,Punjab,10,15,23,5,53,Fail
Krishna Sharma,19-12-2005,118664,Uttarakhand,18,24,2,22,66,Fail
Vivaan Fernandes,13-07-2005,825642,West Bengal,11,6,2,21,40,Pass
Aarav Khan,19-06-2005,880510,Jharkhand,11,23,24,18,76,Fail
Ishaan Khan,22-06-2005,285929,Telangana,5,13,13,20,51,Fail
Aditya Reddy,18-12-2004,122915,Uttar Pradesh,5,7,17,8,37,Fail
Gurpreet Khan,25-07-2005,140890,Rajasthan,24,13,4,23,64,Fail
Aditya Mehta,24-04-2005,556590,Punjab,24,7,10,9,50,Fail
Ishaan Khan,01-05-2006,491545,Andhra Pradesh,4,2,19,13,38,Fail
Manpreet Reddy,11-02-2005,557935,Puducherry,4,6,23,24,57,Fail
Mathew Sharma,06-08-2005,915044,Sikkim,5,10,15,6,36,Fail
Sukhwinder Sharma,02-03-2005,760824,Odisha,9,14,12,11,46,Fail
Rehan Chopra,03-01-2005,785069,Rajasthan,11,3,8,22,44,Pass
Aryan Fernandes,04-09-2005,604082,Gujarat,18,6,19,1,44,Fail
John Singh,26-12-2005,745717,Uttar Pradesh,6,13,22,21,62,Fail
Rohan Mehta,14-03-2006,776306,Uttar Pradesh,15,10,22,20,67,Fail
Aryan Fernandes,20-02-2005,475608,Maharashtra,0,3,18,0,21,Fail
Manpreet D'Souza,04-07-2005,784799,West Bengal,15,13,2,16,46,Pass
Peter Singh,21-01-2005,825810,Telangana,7,9,4,3,23,Fail
Krishna D'Souza,02-06-2005,961017,Assam,5,2,23,7,37,Fail
Kunal Singh,08-09-2005,198000,Madhya Pradesh,16,11,5,10,42,Fail
Aditya Singh,18-11-2004,473139,Maharashtra,10,20,10,17,57,Fail
Sukhwinder Sharma,10-05-2005,165372,Telangana,15,6,16,12,49,Fail
Aarav D'Souza,14-03-2006,583591,Tamil Nadu,2,1,4,4,11,Pass
Ishaan Reddy,05-12-2005,287577,Uttar Pradesh,2,13,0,11,26,Fail
Gurpreet Fernandes,25-02-2005,324305,Madhya Pradesh,13,13,3,1,30,Fail
Rohan Singh,10-08-2005,988942,Madhya Pradesh,14,19,15,12,60,Fail
Mathew Verma,22-06-2005,520761,Gujarat,12,0,0,4,16,Fail
Aarav Khan,13-01-2005,319010,Uttarakhand,24,7,7,17,55,Fail
Aryan Chopra,13-01-2006,988388,Uttar Pradesh,11,3,1,15,30,Fail
Manpreet Khan,16-09-2005,566508,Tamil Nadu,15,8,16,9,48,Fail
Aarav Reddy,23-12-2004,172937,Bihar,1,15,23,2,41,Pass
Yash Fernandes,24-01-2005,863031,Uttar Pradesh,17,4,18,11,50,Fail
Harjeet Fernandes,14-04-2005,530764,Assam,18,16,1,18,53,Fail
Balbir Pillai,04-01-2006,106342,Rajasthan,5,5,4,4,18,Pass
Yash Chopra,23-02-2006,733117,Odisha,6,22,15,21,64,Fail
Kunal Pillai,27-11-2005,766947,Rajasthan,24,9,15,2,50,Pass
Raj Verma,30-04-2005,338629,Karnataka,4,14,5,9,32,Pass
Krishna Verma,28-12-2005,241435,Karnataka,15,22,16,5,58,Pass
Rohan Chopra,05-09-2005,782738,Tamil Nadu,19,24,19,3,65,Pass
Aditya Mehta,17-04-2005,591452,Kerala,24,20,18,11,73,Fail
Aarav Khan,06-03-2005,363881,Madhya Pradesh,19,3,13,22,57,Fail
Peter Mehta,08-03-2006,565149,Andhra Pradesh,9,11,24,17,61,Fail
Aryan Singh,19-01-2006,912614,Andhra Pradesh,12,12,9,0,33,Fail
Ishaan Singh,10-01-2006,810236,Maharashtra,1,17,8,22,48,Fail
Rohan Verma,06-10-2005,675796,Punjab,13,4,20,14,51,Fail
Harjeet Chopra,02-01-2006,876215,Maharashtra,23,8,6,6,43,Fail
Balbir Pillai,27-04-2005,816140,Maharashtra,8,8,8,5,29,Fail
Farhan Sharma,17-10-2005,686696,West Bengal,8,4,16,12,40,Pass
Aarav Khan,18-03-2006,283559,Punjab,9,17,15,21,62,Fail
Harjeet Chopra,14-02-2006,695083,Rajasthan,20,22,24,1,67,Fail
Farhan Verma,24-01-2005,832777,Karnataka,7,19,20,2,48,Pass
Yash Verma,18-05-2005,754334,Madhya Pradesh,14,8,7,12,41,Fail
Ishaan Chopra,18-11-2005,293298,Tamil Nadu,5,7,1,7,20,Pass
Manpreet Reddy,31-12-2004,696514,Assam,11,22,0,24,57,Fail
Ishaan Singh,28-01-2006,454879,Uttar Pradesh,6,4,10,0,20,Fail
Krishna Reddy,04-01-2005,999264,Nagaland,4,15,9,8,36,Pass
Aditya D'Souza,12-05-2005,827346,Bihar,0,19,15,11,45,Pass
Raj Chopra,12-05-2005,473770,Rajasthan,15,13,21,11,60,Fail
Kunal Chopra,19-09-2005,628136,Haryana,16,15,23,21,75,Fail
Vivaan Pillai,01-12-2004,564988,Tamil Nadu,17,18,11,0,46,Fail
Yash Reddy,18-03-2006,152311,Bihar,11,6,24,8,49,Fail
Yash Singh,23-04-2006,961347,Manipur,1,18,14,15,48,Fail
Vivaan Reddy,03-08-2005,677778,Uttar Pradesh,13,17,5,3,38,Fail
Imran Chopra,11-12-2004,254473,Chhattisgarh,16,19,14,11,60,Fail
Rohan Chopra,24-01-2006,381730,Uttar Pradesh,23,7,12,10,52,Fail
Rehan Fernandes,20-12-2004,348110,Odisha,7,15,21,19,62,Fail
Manpreet D'Souza,01-03-2005,586817,Uttar Pradesh,13,17,6,6,42,Fail
Yash Reddy,22-05-2005,951012,Uttar Pradesh,21,4,18,4,47,Fail
Krishna D'Souza,07-05-2006,148072,Punjab,22,14,14,22,72,Fail
Aditya Pillai,20-04-2006,974303,Uttar Pradesh,8,4,24,13,49,Fail
Gurpreet Singh,26-10-2005,267001,Karnataka,5,13,19,2,39,Pass
Ishaan Reddy,03-04-2005,617888,Uttar Pradesh,20,18,19,20,77,Fail
Aarav Singh,29-11-2004,762974,Delhi,1,5,22,8,36,Fail
Vivaan D'Souza,15-02-2006,709557,Uttar Pradesh,5,4,22,21,52,Fail
Peter Sharma,21-01-2005,537276,Rajasthan,15,14,22,2,53,Pass
Vivaan Mehta,15-12-2004,433274,Arunachal Pradesh,19,9,13,17,58,Fail
Vivaan Khan,22-01-2005,643645,Kerala,22,23,4,1,50,Fail
Ishaan Pillai,19-04-2006,521617,Rajasthan,21,10,7,12,50,Pass
Krishna Singh,03-02-2006,934270,Maharashtra,15,18,8,3,44,Fail
Balbir Verma,17-01-2005,435117,Haryana,5,13,2,18,38,Fail
Yash Singh,28-12-2004,185184,Bihar,18,10,18,21,67,Fail
Aryan Pillai,01-12-2004,118512,Bihar,20,21,21,1,63,Fail
Manpreet Mehta,02-06-2005,238966,Maharashtra,6,14,11,7,38,Fail
Sukhwinder Verma,10-02-2006,661247,Jharkhand,19,23,23,9,74,Fail
Aryan Mehta,07-12-2005,337393,Bihar,4,16,22,10,52,Fail
Rohan Singh,22-02-2005,710683,Uttarakhand,14,24,17,1,56,Fail
Aryan Pillai,27-02-2006,950999,Punjab,22,6,0,2,30,Pass
Rohan Khan,04-10-2005,761354,Nagaland,17,21,23,1,62,Fail
Vivaan Sharma,02-11-2005,206771,Madhya Pradesh,14,19,8,1,42,Fail
Imran Khan,04-01-2005,593022,Haryana,7,13,24,9,53,Fail
Raj Reddy,23-03-2005,608522,Bihar,22,7,22,18,69,Fail
Harjeet Mehta,26-04-2006,596138,Rajasthan,0,3,7,22,32,Pass
Ishaan Pillai,06-03-2005,985170,Haryana,2,11,6,4,23,Fail
Rohan Mehta,11-12-2004,216272,Sikkim,15,18,0,6,39,Fail
Ishaan Mehta,29-07-2005,467079,Maharashtra,2,4,22,14,42,Fail
Kunal Verma,10-04-2006,550546,Kerala,24,21,11,2,58,Fail
Manpreet Fernandes,15-01-2006,244477,Maharashtra,20,11,1,2,34,Fail
Peter Pillai,27-09-2005,804000,Madhya Pradesh,15,2,9,6,32,Fail
Aarav Reddy,25-04-2005,852462,Himachal Pradesh,24,5,13,21,63,Pass
Aditya Sharma,01-12-2005,444554,Andhra Pradesh,10,19,0,7,36,Fail
Krishna Chopra,09-01-2006,319715,Andaman & Nicobar,20,9,0,23,52,Pass
Aditya Sharma,19-11-2004,561961,Chhattisgarh,1,11,24,2,38,Fail
Vivaan Khan,01-06-2005,623146,Tamil Nadu,16,24,24,11,75,Pass
Kunal Verma,26-08-2005,768279,Rajasthan,3,0,18,11,32,Pass
Manpreet Mehta,29-06-2005,417057,West Bengal,6,16,0,14,36,Pass
Aryan Pillai,12-10-2005,233903,Bihar,9,18,13,2,42,Pass
Raj Reddy,21-02-2006,650094,Madhya Pradesh,16,7,20,0,43,Fail
David Singh,02-05-2006,257283,Kerala,17,2,8,17,44,Fail
Vivaan D'Souza,25-11-2005,857654,Rajasthan,14,4,17,9,44,Pass
Krishna Khan,17-06-2005,415896,Uttar Pradesh,20,9,24,20,73,Fail
Aarav D'Souza,26-04-2006,302331,Andhra Pradesh,6,15,3,21,45,Fail
Vivaan Verma,24-04-2006,481132,Telangana,16,14,20,1,51,Fail
Krishna Fernandes,17-01-2005,408390,Madhya Pradesh,22,13,8,3,46,Fail
Kunal Singh,05-02-2006,448537,Delhi,17,1,10,5,33,Fail
Aditya Singh,13-03-2006,786678,Rajasthan,24,0,2,7,33,Pass
Kunal Mehta,08-09-2005,642534,Punjab,1,8,14,22,45,Fail
Aditya Chopra,22-01-2005,192674,Haryana,24,9,20,11,64,Fail
Harjeet Pillai,20-03-2006,319212,Chhattisgarh,2,2,23,23,50,Fail
Balbir Mehta,13-08-2005,356905,Jharkhand,5,22,21,10,58,Pass
Balbir Khan,11-02-2006,497202,Himachal Pradesh,20,21,0,7,48,Pass
Aryan Singh,21-07-2005,601593,Madhya Pradesh,14,22,11,7,54,Fail
Kunal Mehta,18-01-2005,662417,Bihar,7,0,12,8,27,Pass
Aarav Mehta,07-11-2005,189280,Haryana,3,16,2,12,33,Fail
Mathew Mehta,13-01-2005,272894,Madhya Pradesh,19,21,20,6,66,Fail
Yash Mehta,22-03-2005,374690,Bihar,21,20,24,15,80,Fail
Rohan Reddy,12-03-2006,552264,Assam,8,24,22,6,60,Fail
Aarav Khan,22-09-2005,621846,Maharashtra,24,20,13,3,60,Fail
Imran Khan,21-01-2006,582302,Punjab,1,7,5,3,16,Pass
Aryan Reddy,07-08-2005,464562,Uttar Pradesh,9,21,22,20,72,Fail
Aryan Sharma,03-05-2006,117481,Tamil Nadu,7,5,19,13,44,Pass
Vivaan D'Souza,27-01-2005,831254,West Bengal,1,19,11,15,46,Pass
Raj Singh,26-03-2006,509602,Rajasthan,1,17,5,17,40,Pass
Kunal Mehta,04-10-2005,140597,Haryana,5,8,15,24,52,Fail
Vivaan Khan,30-04-2006,657330,Haryana,18,8,15,21,62,Fail
Yash Fernandes,09-11-2004,802874,Maharashtra,4,15,16,4,39,Fail
Sukhwinder Verma,04-04-2005,588379,Gujarat,18,13,0,11,42,Fail
Krishna Sharma,25-01-2006,133960,Chhattisgarh,20,1,15,3,39,Fail
Paul Fernandes,23-03-2006,385128,Bihar,6,15,3,2,26,Pass
Ishaan Verma,21-02-2005,304554,Bihar,6,21,0,16,43,Pass
Aryan Khan,04-03-2005,605937,Rajasthan,23,4,6,11,44,Pass
Sukhwinder Mehta,19-03-2005,857388,Telangana,12,0,19,18,49,Fail
Aditya Pillai,13-03-2005,790871,Punjab,20,18,21,18,77,Pass
Krishna D'Souza,17-03-2005,614970,Telangana,10,13,0,20,43,Fail
Mathew Chopra,31-03-2005,781484,Uttar Pradesh,0,19,14,7,40,Fail
Mathew Singh,05-09-2005,443477,West Bengal,13,2,5,10,30,Pass
Peter Khan,05-07-2005,915723,Uttar Pradesh,23,21,13,23,80,Fail
Raj Singh,24-01-2005,152347,Madhya Pradesh,7,15,21,16,59,Fail
Krishna Khan,04-12-2004,735518,Andhra Pradesh,2,7,23,19,51,Fail
Aryan Chopra,06-01-2005,842924,Andhra Pradesh,10,24,24,13,71,Fail
Balbir Reddy,31-10-2005,986028,West Bengal,14,4,2,23,43,Pass
Zaid Pillai,09-09-2005,379185,West Bengal,10,8,16,18,52,Pass
Ishaan Mehta,25-12-2005,780553,Rajasthan,9,8,3,22,42,Pass
Aarav Khan,11-03-2005,829607,Punjab,24,21,9,8,62,Fail
Aryan Chopra,06-03-2005,999286,Rajasthan,20,12,15,0,47,Pass
Ishaan D'Souza,13-12-2004,460595,Assam,4,18,11,10,43,Fail
Ishaan Sharma,02-01-2006,811348,Maharashtra,7,13,19,7,46,Fail
Gurpreet Verma,31-01-2006,835030,Bihar,1,0,5,0,6,Pass
Aditya Singh,07-01-2005,996450,Manipur,4,1,6,14,25,Fail
Vivaan Mehta,22-09-2005,815167,Madhya Pradesh,9,23,5,20,57,Fail
Harjeet Fernandes,08-03-2005,569234,Kerala,23,11,20,10,64,Fail
Mathew Verma,04-10-2005,182082,Tamil Nadu,12,2,2,14,30,Pass
Krishna Sharma,27-02-2006,255218,Kerala,18,15,17,22,72,Fail
Harjeet Sharma,15-11-2004,859240,Chhattisgarh,11,13,13,4,41,Fail
Aryan Khan,13-11-2005,782704,Bihar,11,5,20,9,45,Pass
Ishaan Singh,01-02-2006,596975,Kerala,22,20,19,2,63,Fail
Aditya Verma,09-04-2006,734770,Punjab,16,21,22,21,80,Pass
Aryan D'Souza,29-06-2005,104077,Uttar Pradesh,15,15,10,15,55,Fail
Peter D'Souza,23-04-2005,883448,Maharashtra,8,14,20,22,64,Fail
Rohan Verma,25-12-2004,604435,Gujarat,10,21,8,16,55,Fail
Aryan Chopra,08-12-2004,141347,Jammu & Kashmir + Ladakh,21,4,1,10,36,Pass
Aditya Khan,19-07-2005,502636,Haryana,3,0,15,7,25,Fail
Ishaan Singh,26-08-2005,321695,Rajasthan,4,14,6,16,40,Pass
Kunal Verma,19-07-2005,158248,Odisha,17,5,16,1,39,Pass
Yash Fernandes,30-12-2005,668898,Bihar,12,5,10,21,48,Fail
Vivaan Mehta,09-02-2005,932167,Odisha,9,22,11,21,63,Fail
Harjeet D'Souza,04-01-2006,387505,Punjab,13,2,21,5,41,Pass
David D'Souza,09-12-2004,501461,West Bengal,22,5,3,17,47,Pass
Manpreet Pillai,09-03-2005,315390,Uttar Pradesh,5,13,7,6,31,Fail
Krishna Chopra,20-06-2005,839396,Bihar,21,5,12,6,44,Pass
Manpreet Khan,12-01-2006,519009,Haryana,9,17,20,23,69,Fail
Balbir Verma,18-09-2005,431220,Maharashtra,8,18,21,10,57,Fail
Manpreet Singh,07-12-2004,777150,Punjab,20,9,12,22,63,Fail
Ayaan Singh,09-01-2005,606384,Bihar,1,13,5,0,19,Pass
John D'Souza,21-03-2005,973738,Bihar,15,24,24,2,65,Fail
Ishaan D'Souza,06-01-2006,665894,Tamil Nadu,9,23,19,10,61,Pass
Kunal Sharma,14-11-2005,390711,Jammu & Kashmir + Ladakh,23,4,12,22,61,Pass
Krishna Fernandes,15-04-2005,126186,Bihar,5,24,19,2,50,Fail
Peter Singh,06-03-2006,306834,Kerala,0,13,18,13,44,Fail
Ishaan Fernandes,05-01-2006,859225,Andhra Pradesh,2,14,8,8,32,Fail
Vivaan Verma,09-07-2005,348617,Haryana,5,19,21,0,45,Fail
Aditya Fernandes,26-02-2006,197393,Odisha,18,10,12,2,42,Pass
Krishna Mehta,24-05-2005,585145,Maharashtra,20,12,9,20,61,Fail
Raj D'Souza,08-07-2005,780114,Maharashtra,17,18,20,13,68,Fail
Yash Sharma,04-06-2005,686238,Madhya Pradesh,10,0,18,23,51,Fail
Aarav D'Souza,14-04-2006,539709,Uttar Pradesh,3,15,8,0,26,Fail
Harjeet Fernandes,10-03-2006,452140,Rajasthan,14,12,10,19,55,Pass
Kunal Pillai,17-08-2005,189744,Meghalaya,18,20,11,17,66,Fail
Yash Chopra,24-11-2004,155038,Meghalaya,9,0,15,2,26,Pass
Aryan Singh,15-01-2006,362412,Punjab,6,18,12,19,55,Fail
Kunal Singh,24-11-2004,778414,Uttar Pradesh,0,10,21,17,48,Fail
Aditya Pillai,13-01-2006,138103,Maharashtra,2,20,10,8,40,Fail
Rohan Pillai,04-04-2006,192345,Rajasthan,10,8,8,16,42,Pass
Harjeet Sharma,13-09-2005,253495,Rajasthan,16,4,16,3,39,Pass
Manpreet Reddy,29-06-2005,469824,Kerala,12,13,5,7,37,Fail
David Fernandes,10-10-2005,605913,Tamil Nadu,13,16,10,19,58,Fail
Yash Verma,10-10-2005,654069,Maharashtra,10,1,7,4,22,Fail
Rohan Sharma,11-04-2006,939724,Uttar Pradesh,21,10,18,24,73,Fail
Aryan Chopra,28-08-2005,962844,Tamil Nadu,23,17,9,16,65,Pass
Krishna Chopra,08-07-2005,232683,Odisha,17,20,21,11,69,Fail
Yash D'Souza,26-10-2005,918028,West Bengal,22,5,0,5,32,Pass
Peter Verma,25-03-2006,963482,Maharashtra,16,4,0,15,35,Fail
Ishaan Pillai,10-04-2005,966527,Sikkim,3,10,13,3,29,Fail
Rohan Pillai,14-01-2006,632229,Uttar Pradesh,10,21,4,6,41,Fail
Raj Singh,05-11-2005,150220,Andhra Pradesh,0,22,15,12,49,Fail
Aditya Singh,07-09-2005,870776,Jharkhand,21,0,1,7,29,Pass
Harjeet Verma,19-11-2004,729886,Uttarakhand,6,18,18,12,54,Fail
Aryan Khan,27-11-2004,750608,Tamil Nadu,9,5,3,10,27,Pass
Krishna Singh,07-05-2006,398711,Rajasthan,22,16,4,21,63,Fail
Ishaan Sharma,19-06-2005,738322,Bihar,3,7,6,4,20,Pass
Ishaan D'Souza,05-03-2005,924063,Rajasthan,12,13,13,2,40,Pass
Krishna Mehta,31-08-2005,359819,Maharashtra,5,14,20,23,62,Fail
Raj Mehta,14-03-2005,134695,Kerala,11,16,17,13,57,Fail
Aryan Mehta,21-04-2005,604639,Andhra Pradesh,16,19,0,12,47,Fail
Raj Pillai,21-12-2005,625003,Bihar,7,0,12,10,29,Pass
Aditya Pillai,18-02-2005,895659,Andhra Pradesh,8,22,19,13,62,Fail
Yash Verma,06-10-2005,512268,Kerala,21,21,0,3,45,Fail
Harjeet Sharma,15-09-2005,350291,Maharashtra,19,23,20,20,82,Fail
Rohan Mehta,09-10-2005,250563,Uttar Pradesh,19,15,8,0,42,Fail
John Sharma,06-03-2006,974674,Jharkhand,14,1,5,20,40,Pass
Aarav Pillai,09-12-2005,904198,Punjab,15,7,7,1,30,Pass
Krishna Singh,28-09-2005,288211,Bihar,13,12,17,20,62,Fail
Ishaan Pillai,28-05-2005,362919,Rajasthan,21,17,14,19,71,Fail
Rohan Verma,14-06-2005,855028,Jharkhand,7,22,23,11,63,Pass
Imran Pillai,04-04-2005,304288,Rajasthan,13,14,7,3,37,Pass
Gurpreet Reddy,10-02-2006,545478,Bihar,12,9,20,16,57,Fail
Gurpreet Chopra,13-02-2006,929207,Tamil Nadu,20,2,16,6,44,Pass
Krishna Reddy,29-06-2005,285728,Haryana,0,10,18,15,43,Fail
Ishaan Fernandes,24-05-2005,418901,Madhya Pradesh,17,7,18,2,44,Fail
Balbir D'Souza,07-10-2005,411067,Himachal Pradesh,18,15,11,8,52,Pass
Gurpreet Pillai,07-08-2005,882982,Gujarat,17,7,0,0,24,Fail
Krishna Khan,18-09-2005,834666,Bihar,22,3,21,17,63,Fail
Aditya Mehta,11-02-2006,336695,Bihar,2,5,15,3,25,Pass
John Khan,17-02-2006,799781,Bihar,23,23,3,2,51,Fail
Rohan Mehta,12-03-2006,439509,Haryana,8,14,7,20,49,Fail
Yash Fernandes,04-10-2005,893624,West Bengal,3,0,18,9,30,Pass
Krishna Pillai,22-03-2006,930801,Kerala,10,23,23,19,75,Fail
Rohan Chopra,11-11-2005,112440,Tamil Nadu,20,3,2,11,36,Pass
Aryan Verma,23-11-2005,360106,Bihar,13,6,21,20,60,Fail
Rohan Khan,17-10-2005,214474,Uttar Pradesh,3,4,19,13,39,Fail
Raj Mehta,26-12-2004,909090,Chhattisgarh,6,18,21,11,56,Fail
Imran Chopra,08-02-2006,418116,Madhya Pradesh,1,15,17,6,39,Fail
Manpreet D'Souza,08-08-2005,466098,Bihar,10,3,0,15,28,Pass
Yash Pillai,20-06-2005,224599,Uttarakhand,19,19,22,8,68,Fail
Rohan D'Souza,23-09-2005,920616,Jharkhand,23,14,4,19,60,Pass
Aditya D'Souza,12-10-2005,402834,Karnataka,16,22,4,16,58,Pass
Aditya Reddy,21-12-2004,657660,Andhra Pradesh,1,12,17,13,43,Fail
Imran Singh,23-11-2005,107619,Haryana,12,3,19,5,39,Fail
Vivaan Verma,10-03-2006,665116,Kerala,6,8,17,17,48,Fail
Aditya Chopra,04-10-2005,420455,Andhra Pradesh,9,3,17,20,49,Fail
Ishaan Singh,28-06-2005,651122,Punjab,12,12,7,1,32,Pass
Balbir Verma,24-11-2005,750675,Uttar Pradesh,0,4,13,9,26,Fail
Aarav Singh,11-04-2006,151389,Chhattisgarh,9,20,6,14,49,Fail
Manpreet D'Souza,22-04-2005,522178,Uttar Pradesh,4,18,15,14,51,Fail
Vivaan Sharma,19-12-2005,719405,Himachal Pradesh,5,16,23,17,61,Pass
Rohan Verma,18-02-2006,638900,Uttar Pradesh,12,4,6,2,24,Fail
Aditya D'Souza,14-08-2005,383671,Karnataka,9,24,6,0,39,Pass
Ishaan Pillai,08-07-2005,296191,Uttarakhand,17,14,5,7,43,Fail
Mathew Verma,01-09-2005,321983,Gujarat,11,11,19,16,57,Fail
Krishna Singh,20-10-2005,754730,Haryana,4,17,3,13,37,Fail
Manpreet Chopra,07-11-2005,844575,Uttar Pradesh,23,4,13,17,57,Fail
Ishaan Fernandes,11-05-2005,616848,Delhi,16,10,18,20,64,Fail
Rehan Chopra,06-11-2005,953744,Rajasthan,24,11,14,18,67,Fail
Paul Reddy,30-09-2005,791915,Andhra Pradesh,12,3,22,14,51,Fail
Harjeet Khan,31-01-2006,275889,Himachal Pradesh,18,10,9,7,44,Pass
Harjeet D'Souza,07-10-2005,622850,Bihar,21,3,10,10,44,Fail
David Sharma,14-05-2005,716116,Jharkhand,0,5,24,20,49,Pass
John Singh,16-01-2006,493819,Telangana,24,19,16,17,76,Fail
Aryan Singh,15-12-2004,212917,Gujarat,8,10,5,12,35,Fail
Raj D'Souza,01-04-2006,232374,Haryana,19,12,18,18,67,Fail
Vivaan Reddy,20-05-2005,423259,Rajasthan,8,5,7,24,44,Pass
Ishaan Reddy,15-12-2005,837580,West Bengal,7,1,20,10,38,Pass
Gurpreet Verma,22-04-2006,464384,Andhra Pradesh,2,7,14,10,33,Fail
David Verma,21-04-2005,729600,Maharashtra,8,4,21,17,50,Fail
Aryan Fernandes,22-01-2005,211816,Chhattisgarh,3,17,19,12,51,Fail
Vivaan Pillai,08-10-2005,154246,Maharashtra,24,20,3,2,49,Fail
Kunal Singh,11-05-2005,745483,Odisha,8,22,20,16,66,Fail
Balbir Reddy,16-02-2005,684940,Madhya Pradesh,18,15,5,15,53,Fail
Krishna Singh,26-04-2005,466537,Haryana,14,16,18,11,59,Fail
Mathew Fernandes,16-07-2005,640991,Chhattisgarh,17,21,13,22,73,Fail
Rohan Chopra,15-12-2004,639861,Uttar Pradesh,23,17,17,18,75,Fail
Yash Fernandes,11-04-2005,598560,Rajasthan,7,2,24,16,49,Pass
Zaid Chopra,03-02-2005,137833,Karnataka,15,4,2,14,35,Pass
Aarav Khan,07-11-2005,448540,Telangana,10,8,0,23,41,Fail
Yash Sharma,26-03-2006,395951,Telangana,14,9,15,20,58,Fail
Manpreet Fernandes,14-11-2005,388620,Bihar,3,0,2,10,15,Pass
Aditya Fernandes,19-01-2006,404891,Delhi,22,15,3,11,51,Fail
Krishna Chopra,02-01-2005,613893,Telangana,22,22,11,18,73,Fail
Krishna Reddy,02-04-2006,526377,Andhra Pradesh,22,5,12,16,55,Fail
Aryan Reddy,02-01-2005,247062,Bihar,7,19,22,21,69,Fail
Raj D'Souza,25-12-2005,567748,Bihar,24,3,3,24,54,Fail
Aarav D'Souza,08-10-2005,858833,Uttar Pradesh,17,2,14,1,34,Fail
Vivaan Pillai,02-05-2006,643746,Himachal Pradesh,13,1,8,0,22,Pass
Rohan Mehta,30-01-2005,279342,Andhra Pradesh,17,6,11,8,42,Fail
Sukhwinder Chopra,09-09-2005,205220,Madhya Pradesh,5,3,11,17,36,Fail
Manpreet Chopra,29-01-2006,728552,Rajasthan,8,21,21,7,57,Pass
John Chopra,21-09-2005,880268,Andaman & Nicobar,4,22,7,14,47,Pass
Aryan Singh,04-02-2005,392735,Andhra Pradesh,17,21,16,9,63,Fail
Krishna Chopra,26-01-2006,971350,Madhya Pradesh,1,23,2,1,27,Fail
Raj Verma,28-03-2006,950096,Andhra Pradesh,6,22,13,18,59,Fail
Mathew Verma,20-04-2005,667304,Tamil Nadu,12,2,16,7,37,Pass
Yash Mehta,05-10-2005,153824,Haryana,23,19,5,21,68,Fail
David Reddy,22-12-2005,486015,Telangana,6,15,24,15,60,Fail
Raj Verma,10-05-2005,503496,Uttar Pradesh,2,21,6,14,43,Fail
Harjeet Singh,29-11-2005,629108,Uttar Pradesh,14,15,24,15,68,Fail
Rohan Chopra,03-08-2005,521338,Uttar Pradesh,5,16,9,13,43,Fail
Imran Pillai,18-01-2006,705676,Madhya Pradesh,14,2,9,14,39,Fail
Krishna D'Souza,03-04-2005,813605,West Bengal,11,17,5,21,54,Pass
Aditya D'Souza,14-01-2005,760048,Haryana,23,12,9,3,47,Fail
Aarav Fernandes,08-05-2005,616519,Telangana,1,7,6,7,21,Fail
Balbir Singh,01-02-2005,427600,Sikkim,10,16,2,16,44,Fail
Kunal Reddy,20-12-2005,505656,Himachal Pradesh,17,15,9,0,41,Pass
Mathew Chopra,28-12-2005,609828,Odisha,6,12,5,9,32,Pass
Raj Verma,27-02-2005,238639,Uttar Pradesh,5,18,19,4,46,Fail
Sukhwinder Chopra,22-12-2004,342716,Bihar,12,17,22,4,55,Fail
Yash Verma,07-03-2005,561012,Uttarakhand,7,10,21,18,56,Fail
Yash Pillai,24-04-2005,667635,Gujarat,19,24,8,6,57,Fail
Ayaan Fernandes,23-04-2005,981838,Punjab,0,7,3,24,34,Pass
Aditya Sharma,17-12-2005,419936,Odisha,14,18,8,2,42,Pass
Yash Khan,27-02-2005,850973,Uttar Pradesh,1,14,13,8,36,Fail
Sukhwinder Khan,25-01-2006,956956,Bihar,17,9,20,21,67,Fail
Raj Singh,01-04-2006,606810,Uttar Pradesh,19,9,15,16,59,Fail
Aryan D'Souza,02-10-2005,602119,Delhi,23,4,5,8,40,Fail
Aditya Reddy,20-04-2005,640658,Punjab,10,9,15,4,38,Pass
Aditya Singh,24-02-2006,473598,Andhra Pradesh,9,12,11,6,38,Fail
Yash Chopra,17-03-2006,506819,Tamil Nadu,11,2,8,22,43,Fail
Aarav Pillai,12-10-2005,911471,Gujarat,2,3,4,0,9,Fail
Krishna Mehta,06-08-2005,878975,Nagaland,7,22,8,20,57,Fail
Sukhwinder Chopra,16-03-2005,118142,Kerala,10,19,7,20,56,Fail
Balbir Chopra,12-10-2005,321936,Assam,3,17,19,9,48,Fail
Vivaan Reddy,07-11-2005,745579,Uttar Pradesh,23,17,1,15,56,Fail
Krishna D'Souza,01-07-2005,706173,Gujarat,16,18,9,3,46,Fail
Vivaan Singh,06-10-2005,892111,Karnataka,9,5,20,23,57,Pass
Kunal Fernandes,15-04-2005,107021,Telangana,20,9,18,4,51,Fail
Kunal D'Souza,12-03-2006,556220,Gujarat,13,17,7,6,43,Fail
Balbir Verma,10-03-2006,352827,Chhattisgarh,22,11,2,22,57,Fail
Yash Sharma,25-03-2006,742804,Maharashtra,19,15,11,0,45,Fail
Mathew Reddy,02-05-2006,598435,Uttar Pradesh,16,17,11,24,68,Fail
Kunal Singh,09-02-2006,788271,Rajasthan,11,19,8,10,48,Pass
Rohan Verma,07-07-2005,954979,Jammu & Kashmir + Ladakh,9,8,4,12,33,Pass
Vivaan Verma,09-01-2006,806470,Madhya Pradesh,12,22,21,8,63,Fail
Harjeet Khan,29-04-2006,732645,Jharkhand,7,8,20,24,59,Pass
Ishaan Mehta,13-05-2005,404171,Maharashtra,17,21,20,23,81,Fail
Ishaan Verma,28-02-2005,655411,Madhya Pradesh,1,10,0,3,14,Fail
Raj Reddy,04-12-2005,173345,Jharkhand,23,0,17,15,55,Pass
Aryan Chopra,06-01-2005,508827,Telangana,7,4,22,17,50,Fail
Aditya D'Souza,16-10-2005,323215,Haryana,6,9,10,10,35,Fail
Aditya D'Souza,13-04-2005,724042,Uttar Pradesh,20,17,22,13,72,Fail
Yash Mehta,05-12-2004,887714,Maharashtra,9,4,3,14,30,Fail
Aarav Pillai,17-11-2004,920673,Uttar Pradesh,9,9,8,3,29,Fail
Raj Fernandes,23-01-2005,152262,Rajasthan,17,9,5,1,32,Pass
Kunal Fernandes,29-05-2005,678308,Bihar,6,11,24,9,50,Fail
Harjeet Mehta,26-12-2004,916253,Himachal Pradesh,0,21,12,19,52,Pass
Ishaan Verma,18-12-2005,760694,Madhya Pradesh,9,12,10,0,31,Fail
Harjeet Fernandes,21-05-2005,135764,Madhya Pradesh,21,23,19,7,70,Fail
Aarav Pillai,04-05-2006,623163,Bihar,6,3,4,18,31,Fail
Vivaan Sharma,04-07-2005,954513,West Bengal,18,19,2,14,53,Pass
Ishaan Verma,14-01-2006,119902,Assam,22,14,24,9,69,Fail
Krishna Sharma,03-11-2005,160569,Odisha,0,9,20,8,37,Pass
John Singh,06-08-2005,574998,Delhi,11,0,6,5,22,Fail
Harjeet Fernandes,06-09-2005,951632,Maharashtra,8,11,0,14,33,Fail
Kunal Khan,03-04-2005,823170,Jharkhand,21,19,17,6,63,Pass
Zaid Sharma,28-02-2005,801051,Jammu & Kashmir + Ladakh,20,14,18,5,57,Pass
Vivaan Singh,09-12-2005,756087,Sikkim,20,1,4,10,35,Fail
Vivaan Verma,28-09-2005,622817,West Bengal,19,3,19,11,52,Pass
Paul Khan,11-02-2006,335638,Andhra Pradesh,3,3,6,16,28,Fail
Rohan Verma,07-06-2005,552937,Madhya Pradesh,19,10,0,12,41,Fail
Harjeet Singh,19-02-2005,764392,Maharashtra,21,16,18,19,74,Fail
Gurpreet Chopra,30-04-2005,971006,Kerala,19,3,8,16,46,Fail
Rohan Chopra,17-06-2005,463541,Uttar Pradesh,16,13,24,22,75,Fail
Yash Chopra,02-01-2006,348956,Gujarat,16,16,3,0,35,Fail
Rohan Verma,04-06-2005,124776,Bihar,15,21,15,5,56,Fail
Krishna Pillai,09-05-2006,439061,Tamil Nadu,15,4,5,2,26,Pass
Kunal Fernandes,18-12-2004,663462,Uttar Pradesh,19,6,19,24,68,Fail
Krishna Sharma,17-12-2004,712718,Punjab,14,0,18,19,51,Fail
Ishaan Mehta,10-12-2005,633155,Madhya Pradesh,24,18,13,23,78,Fail
Sukhwinder Verma,25-03-2006,468597,Tamil Nadu,21,19,1,15,56,Pass
Kunal Sharma,02-08-2005,233970,Odisha,14,8,20,4,46,Fail
Aditya Khan,30-12-2004,504151,Tamil Nadu,19,0,2,2,23,Pass
Ishaan Singh,08-02-2006,202712,Uttar Pradesh,18,17,21,23,79,Fail
Balbir Fernandes,04-11-2005,662390,Assam,9,15,0,23,47,Fail
Aryan Pillai,04-03-2005,755214,Andhra Pradesh,24,0,12,19,55,Fail
Raj Khan,18-01-2006,369830,Tamil Nadu,20,10,0,19,49,Fail
Mathew Sharma,19-07-2005,467776,Maharashtra,6,8,17,9,40,Fail
Aditya Reddy,22-08-2005,940535,Telangana,11,19,21,19,70,Fail
Krishna Chopra,15-04-2006,628087,Tamil Nadu,10,18,18,9,55,Fail
Paul D'Souza,21-08-2005,168907,Chhattisgarh,21,18,18,7,64,Fail
Vivaan Chopra,22-11-2005,340430,Gujarat,23,7,11,8,49,Fail
Yash Pillai,15-02-2005,834940,West Bengal,17,16,14,4,51,Pass
Paul Pillai,05-02-2005,956893,Karnataka,19,20,16,21,76,Fail
Peter Chopra,29-12-2005,372138,Delhi,5,10,22,21,58,Fail
Sukhwinder Khan,25-01-2006,188194,Bihar,3,0,17,3,23,Pass
Sukhwinder Pillai,04-08-2005,323617,Bihar,14,4,23,24,65,Fail
Vivaan Khan,18-04-2006,484734,West Bengal,16,10,7,0,33,Pass
Vivaan Reddy,03-05-2005,698534,Rajasthan,24,4,23,9,60,Fail
Yash Singh,04-12-2004,716451,Chhattisgarh,16,5,7,1,29,Fail
Yash Verma,02-03-2006,395756,Punjab,16,11,6,5,38,Pass
Aarav Singh,26-08-2005,151069,Telangana,13,2,18,22,55,Fail
Yash Sharma,05-08-2005,862032,Uttar Pradesh,14,3,4,15,36,Fail
Balbir Khan,06-05-2006,953243,Punjab,11,6,18,5,40,Pass
Yash Singh,09-06-2005,495130,Maharashtra,9,17,15,2,43,Fail
Vivaan Chopra,06-12-2005,528364,Uttar Pradesh,14,21,1,21,57,Fail
Ishaan Verma,25-04-2006,317272,Bihar,21,2,18,16,57,Fail
Yash Mehta,01-08-2005,106132,Haryana,7,13,18,22,60,Fail
Raj Pillai,31-12-2004,202719,Goa,13,0,9,7,29,Fail
Aarav Khan,03-05-2006,732210,Andhra Pradesh,0,9,12,5,26,Fail
Yash Pillai,01-06-2005,776502,Delhi,0,12,24,20,56,Fail
Aarav Reddy,21-03-2005,179655,Rajasthan,16,7,4,15,42,Pass
Ishaan Chopra,06-01-2005,448613,Rajasthan,5,17,7,7,36,Pass
Gurpreet Verma,12-03-2005,158755,Odisha,23,14,17,9,63,Fail
Ishaan Chopra,27-01-2006,299314,Maharashtra,17,7,9,24,57,Fail
Manpreet Sharma,10-11-2004,367640,Haryana,17,23,7,15,62,Fail
Aditya Singh,03-05-2006,101075,Chhattisgarh,13,0,2,1,16,Fail
Raj Fernandes,25-11-2004,134297,Telangana,2,10,22,5,39,Fail
Aditya D'Souza,09-02-2006,317560,Odisha,23,4,9,11,47,Fail
Yash Fernandes,29-07-2005,792795,Rajasthan,21,19,20,21,81,Pass
Raj D'Souza,25-05-2005,153614,Kerala,10,2,4,7,23,Fail
Raj Chopra,21-04-2005,549953,Rajasthan,4,3,10,0,17,Pass
Kunal Mehta,20-01-2006,671019,Karnataka,21,23,20,5,69,Fail
Aryan Sharma,20-10-2005,581330,Maharashtra,18,17,5,21,61,Fail
Vivaan Sharma,26-07-2005,814902,Rajasthan,18,13,7,22,60,Fail
Harjeet Pillai,17-07-2005,604398,Maharashtra,18,19,8,5,50,Fail
Peter Fernandes,28-04-2005,157805,Odisha,22,3,9,14,48,Fail
Vivaan D'Souza,21-09-2005,696797,Tamil Nadu,20,5,2,11,38,Pass
Kunal Mehta,13-05-2005,469949,Uttar Pradesh,23,6,4,22,55,Fail
Vivaan Singh,24-02-2006,206269,Maharashtra,18,3,15,24,60,Fail
Peter D'Souza,18-05-2005,468515,Uttar Pradesh,5,23,17,16,61,Fail
Rohan Singh,05-03-2005,644226,Telangana,2,23,10,17,52,Fail
Krishna Sharma,04-04-2005,781472,Jharkhand,22,0,7,15,44,Pass
Aryan Khan,30-03-2006,477442,Uttar Pradesh,24,15,23,7,69,Fail
Gurpreet Verma,18-02-2005,326030,Chhattisgarh,8,23,5,4,40,Fail
Sukhwinder Fernandes,14-03-2005,724881,Jharkhand,19,5,12,16,52,Pass
Ishaan Verma,03-05-2005,104375,Rajasthan,16,0,24,17,57,Pass
Rohan Pillai,13-02-2005,429419,Rajasthan,12,9,4,3,28,Pass
Yash Reddy,05-02-2005,800574,Odisha,19,22,3,15,59,Fail
Krishna Singh,22-05-2005,306730,Uttar Pradesh,21,21,0,18,60,Fail
Aryan Mehta,15-10-2005,414305,Kerala,1,20,17,14,52,Fail
Ishaan Reddy,02-03-2005,518692,Uttar Pradesh,1,7,14,19,41,Fail
Aarav Mehta,11-09-2005,472291,Rajasthan,16,17,13,14,60,Fail
Mathew Khan,06-02-2006,182144,Rajasthan,18,6,23,23,70,Fail
Paul Chopra,30-11-2004,977071,Maharashtra,20,15,24,17,76,Fail
Aditya D'Souza,30-03-2006,379263,Tamil Nadu,23,23,7,17,70,Fail
Rohan Chopra,08-01-2006,472823,Karnataka,23,22,18,1,64,Pass
Ishaan Chopra,02-01-2006,904862,Rajasthan,16,4,15,10,45,Pass
Harjeet Fernandes,21-11-2005,183164,Telangana,16,17,17,1,51,Fail
Aryan Singh,19-02-2005,393701,Telangana,20,17,5,9,51,Fail
Harjeet Pillai,05-07-2005,917698,Punjab,21,19,4,7,51,Fail
Vivaan Mehta,06-02-2006,401475,Gujarat,0,1,11,2,14,Fail
Harjeet Verma,11-04-2005,973658,Uttarakhand,12,13,24,11,60,Fail
Zaid Mehta,03-04-2005,644725,Assam,12,0,12,10,34,Fail
Yash Verma,02-01-2006,514226,Tamil Nadu,3,5,24,7,39,Pass
Gurpreet Fernandes,15-04-2005,980249,Madhya Pradesh,1,13,7,11,32,Fail
Aarav Khan,24-11-2004,623873,Madhya Pradesh,9,13,8,7,37,Fail
Yash Mehta,13-11-2005,623910,Uttar Pradesh,7,16,6,7,36,Fail
Vivaan Pillai,24-03-2006,304756,Bihar,7,2,6,13,28,Pass
Raj Singh,10-03-2006,161590,Haryana,8,16,5,21,50,Fail
Krishna Fernandes,12-05-2005,916077,Uttar Pradesh,16,11,22,14,63,Fail
Aarav D'Souza,24-04-2006,275855,Andhra Pradesh,11,2,9,5,27,Fail
Aryan Mehta,30-07-2005,985909,Kerala,10,18,5,13,46,Fail
Yash Pillai,30-04-2006,671025,Chhattisgarh,2,16,21,15,54,Fail
Yash Mehta,05-04-2005,723101,Madhya Pradesh,14,24,7,20,65,Fail
Krishna Sharma,02-07-2005,932823,Haryana,0,8,5,23,36,Fail
Sukhwinder Sharma,16-01-2005,460035,Gujarat,12,15,13,15,55,Fail
Krishna Sharma,29-12-2004,107964,Madhya Pradesh,10,18,4,10,42,Fail
Krishna Verma,09-11-2005,255066,Assam,7,13,20,1,41,Fail
Aryan Pillai,27-11-2005,859439,West Bengal,9,1,12,13,35,Pass
Aarav Chopra,02-06-2005,856227,Maharashtra,20,3,13,21,57,Fail
Kunal Sharma,08-12-2005,140655,Punjab,24,9,21,16,70,Fail
Peter Singh,22-09-2005,410047,Telangana,21,10,15,2,48,Fail
Zaid D'Souza,27-09-2005,315473,Rajasthan,4,7,12,1,24,Pass
Aryan Chopra,05-06-2005,829633,Madhya Pradesh,18,2,20,22,62,Fail
Rehan Mehta,01-09-2005,262608,West Bengal,3,14,15,6,38,Pass
Krishna Mehta,16-01-2005,845638,West Bengal,2,18,2,23,45,Pass
Ishaan Sharma,20-04-2005,265938,Maharashtra,18,5,6,6,35,Fail
Krishna Chopra,08-10-2005,253976,Assam,17,0,10,14,41,Fail
Raj D'Souza,16-02-2005,498417,Tamil Nadu,6,11,15,7,39,Pass
Aditya Khan,08-05-2006,682324,Telangana,22,19,21,8,70,Fail
Aarav Singh,04-09-2005,979175,Punjab,10,24,15,5,54,Fail
Ishaan Singh,11-03-2005,546353,Punjab,12,21,11,20,64,Fail
Rohan Verma,04-04-2006,184663,Andhra Pradesh,14,23,7,7,51,Fail
Manpreet D'Souza,12-02-2006,833943,Maharashtra,9,3,19,2,33,Fail
Gurpreet Singh,19-03-2005,809341,Madhya Pradesh,8,21,19,2,50,Fail
Aditya D'Souza,04-05-2005,382929,Telangana,8,15,3,2,28,Fail
Kunal Pillai,23-11-2005,321146,Bihar,12,3,20,16,51,Fail
Aarav D'Souza,20-12-2005,881009,Tripura,15,9,18,17,59,Fail
Rohan Reddy,05-02-2006,712152,Uttar Pradesh,21,24,1,1,47,Fail
Rohan Sharma,22-12-2004,436344,Uttar Pradesh,22,0,11,8,41,Fail
Aarav D'Souza,02-01-2006,867833,Telangana,22,22,11,8,63,Fail
Ishaan D'Souza,09-11-2005,170815,Bihar,18,0,5,17,40,Pass
Harjeet Mehta,14-03-2006,332228,West Bengal,21,10,9,7,47,Pass
Kunal Singh,05-06-2005,255496,Maharashtra,24,18,13,6,61,Fail
Aryan Verma,01-10-2005,106997,Uttar Pradesh,10,17,2,12,41,Fail
Aarav D'Souza,07-11-2005,124572,Maharashtra,19,18,18,12,67,Fail
David D'Souza,03-12-2005,112414,Rajasthan,19,24,4,5,52,Pass
Aditya D'Souza,28-02-2006,568089,Maharashtra,12,23,3,3,41,Fail
Harjeet Khan,29-01-2006,631076,Madhya Pradesh,11,21,21,16,69,Fail
Manpreet Khan,09-10-2005,420147,Chhattisgarh,0,11,18,7,36,Fail
Gurpreet Verma,04-12-2005,586802,Uttar Pradesh,21,12,1,8,42,Fail
Yash Singh,12-09-2005,871205,Rajasthan,11,10,7,22,50,Pass
Krishna Pillai,11-01-2005,454672,Punjab,18,1,6,16,41,Pass
Zaid Reddy,11-03-2005,636386,Kerala,18,23,4,24,69,Fail
Aarav Pillai,14-11-2004,558029,Telangana,17,0,2,16,35,Fail
Gurpreet Mehta,27-10-2005,536975,Haryana,23,12,22,18,75,Fail
Ishaan Mehta,04-02-2006,598808,Chhattisgarh,4,8,13,22,47,Fail
Balbir Khan,27-09-2005,996490,Nagaland,0,13,14,22,49,Fail
Ayaan D'Souza,14-02-2006,463648,Madhya Pradesh,6,12,3,15,36,Fail
Krishna Khan,06-09-2005,372393,Punjab,14,4,20,0,38,Pass
Aarav Sharma,06-05-2006,128027,Rajasthan,6,2,2,1,11,Pass
Yash Pillai,29-09-2005,737151,Punjab,23,7,16,12,58,Fail
Balbir Sharma,05-08-2005,140357,West Bengal,7,17,2,12,38,Pass
Rohan Pillai,18-11-2005,278023,Jammu & Kashmir + Ladakh,15,15,14,3,47,Pass
Balbir Pillai,24-01-2006,873920,Madhya Pradesh,5,18,12,12,47,Fail
Balbir Singh,09-07-2005,772773,Himachal Pradesh,16,18,11,16,61,Pass
Aryan D'Souza,27-09-2005,998018,Madhya Pradesh,10,18,6,21,55,Fail
Raj Pillai,11-01-2005,999261,Uttarakhand,8,17,16,23,64,Fail
David Fernandes,24-01-2005,912201,Gujarat,22,17,16,24,79,Fail
Raj Khan,16-10-2005,541355,Bihar,2,6,12,3,23,Pass
Rohan Sharma,16-07-2005,633817,Arunachal Pradesh,0,0,1,0,1,Pass
Ishaan Chopra,07-01-2005,861113,Odisha,18,13,8,15,54,Fail
Rohan Sharma,12-01-2005,651871,Assam,20,18,0,12,50,Fail
Rohan Singh,14-08-2005,473710,Rajasthan,16,12,2,14,44,Pass
Harjeet Pillai,30-01-2005,742561,Bihar,0,22,5,14,41,Pass
Kunal Sharma,24-10-2005,330002,Tamil Nadu,9,22,18,9,58,Fail
Gurpreet Chopra,18-12-2005,162566,Bihar,21,24,19,17,81,Fail
Paul Khan,01-06-2005,419706,Assam,24,21,4,18,67,Fail
Zaid Chopra,04-12-2005,636668,Uttar Pradesh,10,16,17,24,67,Fail
Krishna Verma,10-04-2005,187257,Uttar Pradesh,10,22,23,4,59,Fail
Yash Reddy,17-06-2005,724478,Punjab,18,24,9,5,56,Fail
Aarav Singh,06-02-2006,993629,Rajasthan,14,21,21,19,75,Fail
Raj Mehta,19-01-2005,885184,Odisha,17,16,4,22,59,Fail
Yash Mehta,13-12-2005,460292,Bihar,13,21,2,1,37,Pass
Gurpreet Pillai,04-03-2006,135639,Rajasthan,15,13,20,13,61,Fail
Aarav Reddy,12-08-2005,597558,Rajasthan,13,19,14,20,66,Fail
Kunal Mehta,21-04-2005,139951,Karnataka,16,0,15,4,35,Pass
Vivaan Khan,12-04-2005,990425,Gujarat,19,16,12,20,67,Fail
Raj Verma,17-04-2005,654238,Tamil Nadu,11,15,2,19,47,Pass
Kunal Pillai,30-12-2005,852569,Odisha,23,19,7,19,68,Fail
Aditya Pillai,04-12-2004,711160,Bihar,19,12,24,7,62,Fail
Raj Verma,28-03-2006,352319,Karnataka,20,8,14,8,50,Pass
Sukhwinder Pillai,21-08-2005,243407,Haryana,2,21,2,4,29,Fail
Raj Reddy,08-04-2006,558365,Tamil Nadu,8,21,12,22,63,Fail
Aditya Mehta,13-11-2004,430445,Maharashtra,9,6,12,5,32,Fail
Farhan Sharma,11-09-2005,414858,Jharkhand,21,11,15,4,51,Pass
Ishaan Sharma,18-02-2005,447153,Chhattisgarh,24,5,24,20,73,Fail
Ishaan Singh,17-03-2006,732790,Haryana,11,20,23,17,71,Fail
Kunal Chopra,28-02-2006,644106,Andhra Pradesh,23,1,12,3,39,Fail
Kunal D'Souza,12-01-2006,931832,Chhattisgarh,21,23,21,18,83,Fail
Aryan Verma,10-04-2005,201645,Rajasthan,2,15,24,0,41,Pass
Aditya Singh,03-01-2006,816392,Andhra Pradesh,7,2,20,10,39,Fail
Yash Chopra,22-02-2006,430627,Uttar Pradesh,8,20,13,20,61,Fail
Rohan D'Souza,29-01-2005,839860,Chhattisgarh,7,5,8,3,23,Fail
Vivaan Chopra,26-06-2005,250337,Assam,11,12,13,17,53,Fail
Vivaan Sharma,11-03-2005,177896,Uttar Pradesh,3,3,6,8,20,Fail
Ishaan Pillai,08-06-2005,610819,Uttar Pradesh,0,3,12,0,15,Fail
Vivaan Mehta,30-06-2005,193820,Chhattisgarh,10,9,6,1,26,Fail
Aditya Pillai,12-07-2005,705657,Madhya Pradesh,3,24,0,4,31,Fail
Vivaan Singh,10-11-2004,109349,Andhra Pradesh,0,6,14,11,31,Fail
Kunal Verma,22-10-2005,490151,Gujarat,4,21,24,12,61,Fail
Yash Fernandes,20-02-2005,268357,Maharashtra,8,14,21,13,56,Fail
Manpreet D'Souza,24-12-2005,370722,Punjab,7,3,9,14,33,Pass
Aryan Fernandes,05-12-2005,841419,Arunachal Pradesh,1,17,12,16,46,Fail
Aryan Verma,12-11-2004,636859,Jharkhand,4,0,18,0,22,Pass
Krishna Verma,09-03-2005,185436,Bihar,23,19,24,18,84,Fail
Paul Sharma,11-07-2005,384205,Bihar,20,3,10,17,50,Fail
Aryan Khan,03-02-2006,241916,Maharashtra,20,5,22,4,51,Fail
Aditya Verma,25-07-2005,346942,Odisha,10,14,15,15,54,Fail
Vivaan D'Souza,15-09-2005,553649,Tamil Nadu,12,4,13,0,29,Pass
Sukhwinder D'Souza,12-06-2005,838069,Andhra Pradesh,6,13,2,21,42,Fail
Aryan Verma,26-06-2005,866040,Chhattisgarh,20,19,22,5,66,Fail
Kunal Verma,20-07-2005,615759,Uttar Pradesh,7,13,20,20,60,Fail
Aditya Verma,01-12-2005,332965,Telangana,8,15,20,24,67,Fail
John Mehta,02-02-2005,495474,Karnataka,5,13,2,22,42,Pass
Paul Pillai,15-01-2006,185386,Uttarakhand,14,10,2,14,40,Fail
John Singh,05-12-2005,328657,Punjab,20,3,8,10,41,Pass
Rohan Khan,17-07-2005,454731,Andhra Pradesh,20,15,12,8,55,Fail
Ishaan Fernandes,20-02-2005,564168,Rajasthan,2,20,17,7,46,Pass
Yash Verma,26-05-2005,515029,Gujarat,0,24,10,2,36,Fail
Imran D'Souza,08-01-2006,853761,Bihar,20,13,5,2,40,Pass
Rohan Pillai,17-02-2006,563324,Punjab,21,5,22,24,72,Fail
Rohan Reddy,30-01-2006,984395,Uttar Pradesh,6,22,19,8,55,Fail
Aditya Reddy,26-12-2004,819940,Madhya Pradesh,3,12,23,19,57,Fail
Kunal Khan,12-10-2005,270712,Kerala,13,16,7,11,47,Fail
Raj D'Souza,28-05-2005,751019,Gujarat,7,3,20,1,31,Fail
Krishna Khan,28-03-2005,278831,Bihar,3,1,17,10,31,Pass
Raj D'Souza,09-11-2005,928906,Kerala,7,0,9,7,23,Fail
Sukhwinder D'Souza,31-12-2004,616669,Madhya Pradesh,4,2,0,13,19,Fail
Mathew Reddy,24-09-2005,476837,Maharashtra,18,23,12,7,60,Fail
Raj Pillai,23-06-2005,264993,Jharkhand,4,9,2,18,33,Pass
Aryan Mehta,07-04-2005,652087,Jharkhand,10,2,10,24,46,Pass
Vivaan Reddy,20-02-2005,759705,Madhya Pradesh,5,24,23,1,53,Fail
Ishaan Fernandes,09-03-2006,863811,Odisha,7,1,11,3,22,Pass
Aditya Fernandes,23-11-2005,638561,Uttar Pradesh,5,3,17,22,47,Fail
Paul Khan,04-06-2005,286309,Odisha,10,6,10,1,27,Pass
Ayaan D'Souza,24-05-2005,121446,Uttar Pradesh,12,20,11,17,60,Fail
Gurpreet Mehta,18-02-2005,182537,Kerala,5,2,2,5,14,Fail
Paul Fernandes,06-08-2005,874149,Rajasthan,24,17,7,11,59,Pass
Raj Reddy,24-10-2005,145773,Rajasthan,6,0,11,0,17,Pass
Gurpreet Verma,18-01-2006,875628,Madhya Pradesh,15,21,20,8,64,Fail
Kunal Fernandes,05-12-2005,850667,West Bengal,0,12,18,16,46,Pass
Yash Verma,18-01-2006,103180,Bihar,2,12,7,1,22,Pass
Manpreet Fernandes,26-12-2005,679344,Bihar,11,2,24,20,57,Fail
Aarav Chopra,16-05-2005,509348,Rajasthan,16,13,19,18,66,Fail
Ishaan Khan,27-11-2005,510741,Maharashtra,17,3,9,15,44,Fail
Gurpreet Pillai,19-12-2004,666761,Maharashtra,14,21,24,18,77,Fail
Aryan Khan,24-09-2005,679461,Uttar Pradesh,5,9,7,14,35,Fail
Aditya Verma,15-09-2005,120081,Madhya Pradesh,4,0,19,6,29,Fail
Kunal Sharma,17-05-2005,481645,Bihar,23,15,6,15,59,Fail
Gurpreet Verma,29-01-2005,498873,Punjab,12,0,10,21,43,Pass
Aditya Chopra,19-02-2005,440177,Madhya Pradesh,17,17,17,17,68,Fail
Kunal Mehta,23-06-2005,752149,Rajasthan,11,4,10,21,46,Pass
Farhan Sharma,21-01-2005,768914,Madhya Pradesh,7,13,10,19,49,Fail
Vivaan D'Souza,20-08-2005,443280,Telangana,0,7,5,13,25,Fail
Ayaan Verma,16-12-2004,715986,Telangana,1,6,23,16,46,Fail
Aarav Singh,13-06-2005,264689,Uttar Pradesh,6,22,6,3,37,Fail
Rohan Pillai,16-02-2006,808951,Bihar,18,11,17,14,60,Fail
Peter Pillai,25-03-2005,728531,Uttar Pradesh,1,20,21,17,59,Fail
Sukhwinder Verma,15-04-2006,561170,Punjab,8,8,2,1,19,Pass
Ishaan D'Souza,08-03-2006,956434,West Bengal,0,9,19,0,28,Pass
Raj Chopra,03-03-2006,349941,West Bengal,18,3,2,23,46,Pass
Sukhwinder Fernandes,25-10-2005,287040,West Bengal,19,21,8,0,48,Pass
Balbir Verma,17-04-2006,406174,Rajasthan,4,5,22,11,42,Pass
Ishaan Verma,26-04-2005,836740,Maharashtra,18,8,7,15,48,Fail
Aditya Sharma,12-04-2005,188679,Andhra Pradesh,15,6,22,6,49,Fail
Paul Pillai,29-01-2005,358848,Uttar Pradesh,24,6,8,9,47,Fail
Yash Singh,16-09-2005,712801,Bihar,16,5,13,9,43,Pass
Harjeet Singh,04-06-2005,609184,Madhya Pradesh,13,0,1,15,29,Fail
Rohan Mehta,03-03-2005,415667,Punjab,1,3,23,6,33,Pass
Ishaan Verma,09-11-2004,395488,Uttar Pradesh,8,22,9,11,50,Fail
Harjeet Fernandes,14-03-2006,985503,Rajasthan,20,15,9,12,56,Pass
Ishaan Fernandes,08-03-2005,831422,Rajasthan,24,3,13,19,59,Pass
Yash Singh,05-05-2006,856814,Uttar Pradesh,23,23,9,19,74,Fail
Raj Pillai,03-01-2005,252967,Gujarat,17,5,11,5,38,Fail
Yash Mehta,23-03-2006,283662,Bihar,15,17,0,15,47,Fail
Raj Verma,10-01-2005,881516,Punjab,8,7,15,10,40,Pass
Yash Fernandes,24-04-2005,124950,Bihar,8,10,11,21,50,Fail
Raj Mehta,08-08-2005,264704,Maharashtra,6,19,23,12,60,Fail
Aditya Chopra,16-02-2005,830439,Tamil Nadu,11,11,7,14,43,Fail
Kunal Singh,20-04-2006,358955,Uttar Pradesh,15,11,5,10,41,Fail
Aditya Pillai,15-02-2006,481846,Haryana,10,11,11,5,37,Fail
Ishaan Verma,24-09-2005,620026,Telangana,0,11,1,12,24,Fail
Zaid D'Souza,29-10-2005,524637,Uttar Pradesh,8,1,5,3,17,Fail
Manpreet Chopra,03-04-2005,504122,Haryana,12,20,9,23,64,Fail
Aditya Sharma,07-11-2005,624341,Delhi,6,11,15,6,38,Fail
Krishna Sharma,08-11-2005,619866,Madhya Pradesh,21,16,17,9,63,Fail
Aryan Sharma,01-09-2005,526964,Rajasthan,10,20,11,20,61,Fail
Paul Reddy,28-02-2006,324420,Kerala,5,18,13,0,36,Fail
Aarav Sharma,26-05-2005,988216,Haryana,18,6,19,16,59,Fail
Krishna Fernandes,04-07-2005,133184,Bihar,4,11,18,24,57,Fail
Aryan Singh,10-03-2006,659840,Bihar,7,17,5,8,37,Pass
Krishna D'Souza,27-02-2006,473350,Karnataka,13,20,18,2,53,Pass
Gurpreet Fernandes,16-03-2006,841206,Himachal Pradesh,22,3,1,22,48,Pass
Rohan Pillai,13-04-2006,226241,Haryana,15,14,12,7,48,Fail
Balbir Sharma,14-04-2006,150782,Haryana,23,24,18,11,76,Fail
Aryan D'Souza,08-06-2005,659789,Madhya Pradesh,19,9,7,7,42,Fail
Ishaan D'Souza,24-11-2004,944846,Karnataka,18,14,21,7,60,Pass
Harjeet Chopra,04-07-2005,688693,Rajasthan,2,14,3,19,38,Pass
Aryan Mehta,02-02-2005,147345,Rajasthan,7,13,15,17,52,Pass
Gurpreet Verma,23-11-2005,200190,Tamil Nadu,6,9,17,24,56,Pass
Peter Sharma,20-01-2006,467430,Uttar Pradesh,14,14,7,24,59,Fail
Raj D'Souza,17-03-2006,407718,Maharashtra,19,18,19,18,74,Fail
Balbir Sharma,09-03-2005,525752,Rajasthan,16,3,22,21,62,Fail
Yash Chopra,19-03-2006,112471,Goa,14,6,8,8,36,Fail
Paul Verma,12-02-2006,397948,Maharashtra,3,7,5,7,22,Fail
Mathew Verma,17-02-2005,941953,Rajasthan,11,2,2,0,15,Pass
Raj Singh,21-11-2005,889883,Bihar,20,3,19,22,64,Fail
Ayaan Khan,01-07-2005,253918,Uttar Pradesh,23,2,8,23,56,Fail
Yash Pillai,25-03-2005,646678,Bihar,5,16,23,15,59,Fail
Ishaan Pillai,17-03-2005,994289,Odisha,0,21,23,22,66,Fail
Aryan Sharma,28-03-2006,890242,Bihar,2,13,15,2,32,Pass
Sukhwinder Verma,08-05-2005,251270,Punjab,3,5,0,14,22,Pass
Ishaan Khan,22-12-2005,280837,Himachal Pradesh,6,10,22,12,50,Fail
Rohan Khan,09-08-2005,173330,Madhya Pradesh,11,15,19,17,62,Fail
Mathew Pillai,09-09-2005,704578,Karnataka,3,24,13,6,46,Fail
Rohan Mehta,27-07-2005,841372,Himachal Pradesh,12,23,8,3,46,Fail
Kunal Chopra,04-06-2005,369672,Rajasthan,4,18,21,4,47,Fail
Aryan Fernandes,26-07-2005,486693,Uttar Pradesh,14,23,17,18,72,Fail
Gurpreet Khan,20-04-2006,571758,Uttar Pradesh,14,23,13,3,53,Fail
Vivaan Pillai,22-02-2006,562828,Madhya Pradesh,22,6,13,21,62,Fail
Aarav D'Souza,26-12-2004,177135,Uttar Pradesh,13,3,22,4,42,Fail
Ishaan D'Souza,16-03-2005,397233,Jharkhand,8,10,8,13,39,Fail
Aditya Chopra,13-04-2006,966441,Andhra Pradesh,19,19,12,23,73,Fail
Ishaan Sharma,10-11-2004,633315,Rajasthan,16,15,17,17,65,Fail
Imran Sharma,13-11-2005,647806,Maharashtra,2,15,19,24,60,Fail
John Mehta,02-06-2005,250139,Uttar Pradesh,16,11,21,24,72,Fail
Krishna Fernandes,02-04-2005,563075,Bihar,23,10,11,8,52,Fail
David Khan,10-11-2004,518309,Rajasthan,6,21,8,22,57,Fail
Mathew Singh,30-01-2005,602426,Punjab,3,0,2,13,18,Fail
Yash Sharma,17-10-2005,864680,Punjab,17,3,10,6,36,Fail
Sukhwinder Fernandes,21-04-2006,673057,Odisha,10,12,5,3,30,Fail
Rohan Sharma,07-12-2005,548189,Kerala,9,0,11,4,24,Fail
Balbir Pillai,21-12-2005,137004,Bihar,1,21,22,12,56,Fail
Krishna Mehta,08-03-2006,398476,Goa,4,2,21,13,40,Fail
Kunal Chopra,13-01-2005,954391,Kerala,5,22,7,21,55,Fail
Raj Verma,17-02-2005,675691,Punjab,24,3,12,2,41,Fail
Vivaan Chopra,11-10-2005,311004,Rajasthan,6,21,6,8,41,Fail
Peter Reddy,18-01-2005,973727,Telangana,10,22,2,15,49,Fail
Manpreet Pillai,02-06-2005,761959,Chhattisgarh,18,10,17,23,68,Fail
Harjeet Chopra,22-06-2005,693469,Rajasthan,14,1,6,24,45,Fail
Kunal Pillai,20-07-2005,934450,Bihar,12,3,8,12,35,Fail
Rohan Fernandes,11-11-2004,108629,Bihar,17,0,9,8,34,Fail
Manpreet Sharma,27-05-2005,317842,Rajasthan,18,13,21,23,75,Fail
Yash D'Souza,22-12-2005,211292,Bihar,19,2,11,5,37,Fail
Aarav Singh,31-12-2004,200746,Uttar Pradesh,11,4,6,24,45,Fail
Farhan Khan,17-09-2005,967915,Madhya Pradesh,23,19,6,15,63,Fail
Vivaan Pillai,05-01-2005,898220,Uttar Pradesh,6,7,3,16,32,Fail
Aarav Fernandes,17-02-2005,593082,Tamil Nadu,14,19,8,19,60,Fail
Balbir Chopra,12-11-2004,771029,Jammu & Kashmir + Ladakh,11,2,9,2,24,Fail
Ishaan Khan,15-02-2005,819471,West Bengal,5,8,20,5,38,Pass
Gurpreet Singh,11-11-2005,430819,Madhya Pradesh,9,15,17,0,41,Fail
Aryan D'Souza,22-06-2005,332487,Andhra Pradesh,24,17,14,10,65,Pass
Aditya D'Souza,02-04-2005,839651,Bihar,5,1,24,1,31,Fail
John Reddy,29-04-2006,605719,Jammu & Kashmir + Ladakh,10,7,19,19,55,Fail
Rohan D'Souza,05-05-2006,292998,Andhra Pradesh,11,21,14,5,51,Fail
Harjeet Pillai,15-11-2005,133459,Rajasthan,19,15,10,23,67,Fail
Sukhwinder Khan,28-08-2005,783018,Punjab,19,18,18,14,69,Fail
Aryan Mehta,15-11-2004,268666,Punjab,24,14,24,10,72,Fail
Yash Chopra,28-06-2005,838646,Andhra Pradesh,23,7,11,4,45,Pass
Aditya Khan,02-05-2006,837669,Odisha,2,23,12,20,57,Fail
Manpreet Fernandes,18-06-2005,327479,Rajasthan,14,12,24,13,63,Fail
Kunal Reddy,05-11-2005,464075,Haryana,15,9,8,9,41,Fail
Yash Mehta,04-01-2006,479498,Assam,20,17,15,2,54,Fail
Aryan Fernandes,06-02-2005,758806,Assam,16,10,7,3,36,Fail
Ishaan Reddy,22-11-2004,216071,West Bengal,20,17,18,1,56,Pass
Raj Chopra,12-02-2006,468338,Rajasthan,10,22,5,11,48,Fail
Aditya Pillai,07-12-2004,869212,Kerala,19,22,16,24,81,Fail
David Verma,02-06-2005,278208,Maharashtra,7,18,3,20,48,Fail
Ishaan Khan,24-01-2006,543734,Bihar,5,7,17,22,51,Fail
Raj Khan,25-11-2005,976577,Gujarat,4,13,11,23,51,Fail
Sukhwinder Chopra,27-02-2006,801900,Delhi,9,23,7,17,56,Fail
Aryan Mehta,22-11-2004,298251,Punjab,20,18,0,5,43,Fail
Manpreet Chopra,05-01-2006,905425,Tamil Nadu,7,6,4,17,34,Fail
Aryan Pillai,09-06-2005,538987,Manipur,7,7,18,11,43,Fail
Rehan Chopra,07-08-2005,567405,Andhra Pradesh,14,13,10,4,41,Fail
Krishna Fernandes,15-07-2005,733720,Tripura,13,18,16,8,55,Fail
Rohan Sharma,29-11-2005,245183,Madhya Pradesh,8,12,22,13,55,Fail
Aditya Pillai,29-05-2005,473340,Uttar Pradesh,11,12,21,15,59,Fail
Kunal Pillai,19-12-2004,393894,Punjab,2,4,8,16,30,Fail
Yash Singh,02-02-2006,991515,Andhra Pradesh,7,7,8,5,27,Pass
Mathew Fernandes,13-12-2005,382639,Mizoram,14,6,19,22,61,Fail
Vivaan Singh,05-05-2006,342477,Delhi,0,10,20,12,42,Fail
Raj D'Souza,26-01-2005,816028,Uttar Pradesh,17,7,13,15,52,Fail
Vivaan Fernandes,02-10-2005,296345,Gujarat,22,1,18,24,65,Fail
Balbir Singh,24-01-2005,353758,Tamil Nadu,20,16,1,4,41,Fail
Imran D'Souza,24-11-2005,587907,Madhya Pradesh,13,20,18,0,51,Fail
Ishaan Singh,15-01-2006,349306,Uttar Pradesh,7,17,11,16,51,Fail
Vivaan Khan,28-01-2006,815298,Uttar Pradesh,6,16,22,22,66,Fail
Manpreet Khan,03-05-2005,168207,Gujarat,24,21,18,23,86,Fail
Aarav Sharma,13-01-2006,878953,Madhya Pradesh,18,7,23,19,67,Fail
Rehan Fernandes,31-07-2005,573765,Madhya Pradesh,3,20,18,6,47,Fail
Krishna D'Souza,29-05-2005,566269,Tamil Nadu,0,2,21,12,35,Fail
Sukhwinder Chopra,11-06-2005,774766,Rajasthan,20,8,20,10,58,Fail
Imran Chopra,16-12-2005,264258,Tamil Nadu,4,7,15,21,47,Fail
Krishna Fernandes,15-02-2006,507298,Madhya Pradesh,7,13,18,6,44,Fail
Paul Fernandes,19-11-2004,460703,Madhya Pradesh,15,5,5,2,27,Fail
Rohan Verma,27-08-2005,166817,Karnataka,18,20,0,24,62,Fail
